tract,state_abbr,lon,lat,count_prop,days_above_100_today,days_above_100_30yrs,change_days_above_100,change_perc_above_100
001000100,il,-91.35295,39.95109,2583,19,36,17,89.5
001000201,il,-91.38669,39.95612,952,19,36,17,89.5
001000202,il,-91.38566,39.94174,1145,19,36,17,89.5
001000400,il,-91.40824,39.9518,1540,20,37,17,85
001000500,il,-91.39854,39.94358,833,20,37,17,85
001000600,il,-91.38257,39.9313,1644,19,37,18,94.7
001000700,il,-91.40791,39.93288,695,20,37,17,85
001000800,il,-91.4124,39.91856,995,20,37,17,85
001000900,il,-91.39964,39.91552,1109,20,37,17,85
001001001,il,-91.38511,39.92103,1476,19,36,17,89.5
001001002,il,-91.38763,39.90887,1267,19,37,18,94.7
001001100,il,-91.3577,39.91531,3002,19,36,17,89.5
001010100,il,-91.32519,40.11163,4470,19,36,17,89.5
001010200,il,-91.03011,40.1067,3622,17,34,17,100
001010301,il,-91.01978,39.90767,3074,17,33,16,94.1
001010302,il,-91.16554,39.82926,2474,18,34,16,88.9
001010400,il,-91.25427,39.97971,2377,18,34,16,88.9
001010500,il,-91.42308,39.99251,1470,20,37,17,85
001010600,il,-91.33644,39.84798,3202,19,36,17,89.5
003957600,il,-89.35922,37.28339,2234,32,53,21,65.6
003957700,il,-89.3439,37.13494,2520,33,54,21,63.6
003957800,il,-89.21341,37.05711,1930,39,59,20,51.3
003957900,il,-89.17141,36.98877,1435,39,59,20,51.3
005951200,il,-89.35931,38.96582,3695,20,39,19,95
005951300,il,-89.39016,38.88638,2583,20,40,20,100
005951400,il,-89.53828,38.9239,3403,21,41,20,95.2
005951500,il,-89.40115,38.80491,4416,21,40,19,90.5
007010101,il,-88.84167,42.26981,1617,10,18,8,80
007010102,il,-88.86435,42.26514,1090,10,18,8,80
007010200,il,-88.83231,42.24858,2101,10,18,8,80
007010300,il,-88.85048,42.24399,1723,10,18,8,80
007010400,il,-88.82235,42.20426,3824,10,18,8,80
007010501,il,-88.90879,42.30319,2058,10,18,8,80
007010502,il,-88.80199,42.29278,2966,10,18,8,80
007010601,il,-88.80465,42.42366,2938,10,18,8,80
007010603,il,-88.88271,42.37127,3419,9,18,9,100
007010604,il,-88.86681,42.35495,2405,9,18,9,100
009970400,il,-90.75021,39.96146,3864,20,38,18,90
009970500,il,-90.75731,39.97631,1397,19,36,17,89.5
011964700,il,-89.3254,41.52598,2957,10,22,12,120
011964800,il,-89.69799,41.49465,3623,12,24,12,100
011964900,il,-89.46042,41.43898,2002,12,24,12,100
011965000,il,-89.31932,41.38088,3250,12,25,13,108.3
011965100,il,-89.19597,41.37116,2271,11,24,13,118.2
011965200,il,-89.21369,41.32244,1988,12,25,13,108.3
011965300,il,-89.45904,41.39647,1877,12,25,13,108.3
011965400,il,-89.45176,41.3551,1808,12,25,13,108.3
011965500,il,-89.53605,41.26633,3728,13,27,14,107.7
011965600,il,-89.74486,41.32031,2989,12,25,13,108.3
013951200,il,-90.70984,39.304,1700,23,42,19,82.6
013951300,il,-90.61901,39.01456,1520,26,46,20,76.9
015960100,il,-89.79174,42.14902,4648,10,19,9,90
015960200,il,-90.05662,42.11659,2103,11,21,10,90.9
015960300,il,-90.19875,42.14553,2115,12,22,10,83.3
015960400,il,-89.94345,42.07094,1476,11,21,10,90.9
015960500,il,-89.78187,42.016,2047,11,21,10,90.9
015960600,il,-90.00593,41.96802,1395,11,21,10,90.9
017960100,il,-90.07404,39.97675,2967,18,37,19,105.6
017960200,il,-90.22493,39.94384,2789,19,37,18,94.7
017960300,il,-90.37657,39.98657,3912,20,39,19,95
017960400,il,-90.43485,40.00521,1147,22,41,19,86.4
017960500,il,-90.42105,40.02257,1244,22,41,19,86.4
019000200,il,-88.23304,40.12298,781,14,30,16,114.3
019000301,il,-88.2355,40.11083,294,14,30,16,114.3
019000302,il,-88.2351,40.11447,330,14,30,16,114.3
019000401,il,-88.23234,40.10699,158,14,31,17,121.4
019000402,il,-88.2389,40.10662,217,14,31,17,121.4
019000500,il,-88.25088,40.1052,1314,14,31,17,121.4
019000700,il,-88.24637,40.12912,1334,14,30,16,114.3
019000800,il,-88.24711,40.15017,1474,14,30,16,114.3
019000901,il,-88.2683,40.12978,1482,14,30,16,114.3
019000902,il,-88.31485,40.12831,2310,14,30,16,114.3
019001000,il,-88.27236,40.11702,1587,14,30,16,114.3
019001100,il,-88.26718,40.10548,1608,14,30,16,114.3
019001201,il,-88.29068,40.10569,2031,14,30,16,114.3
019001203,il,-88.28581,40.09109,1875,14,30,16,114.3
019001204,il,-88.28996,40.06935,1263,14,30,16,114.3
019001205,il,-88.32826,40.08366,2179,14,30,16,114.3
019001206,il,-88.30471,40.09132,753,14,30,16,114.3
019001301,il,-88.26081,40.09098,2034,14,30,16,114.3
019001302,il,-88.26239,40.06955,1689,14,30,16,114.3
019001400,il,-88.24061,40.08102,835,14,31,17,121.4
019005300,il,-88.2196,40.1287,1060,14,30,16,114.3
019005401,il,-88.19477,40.12463,819,14,31,17,121.4
019005402,il,-88.15812,40.13372,853,15,31,16,106.7
019005500,il,-88.16226,40.11251,2289,15,31,16,106.7
019005601,il,-88.18375,40.10209,2003,15,31,16,106.7
019005602,il,-88.14961,40.08621,869,15,31,16,106.7
019005701,il,-88.20007,40.09106,1606,14,31,17,121.4
019005702,il,-88.1776,40.06741,704,15,31,16,106.7
019005800,il,-88.21211,40.10475,1179,14,31,17,121.4
019005901,il,-88.22004,40.10368,127,14,31,17,121.4
019005902,il,-88.2242,40.10752,153,14,31,17,121.4
019006000,il,-88.22301,40.07547,62,14,31,17,121.4
019010100,il,-88.14527,40.32659,1536,16,32,16,100
019010204,il,-88.15758,40.30278,2101,16,32,16,100
019010300,il,-88.14451,40.29293,463,16,32,16,100
019010400,il,-88.07684,40.3124,3938,15,31,16,106.7
019010500,il,-88.34655,40.31097,3433,15,31,16,106.7
019010601,il,-88.42896,40.19961,2462,14,31,17,121.4
019010603,il,-88.37802,40.18171,2583,14,31,17,121.4
019010604,il,-88.30272,40.15201,2179,15,31,16,106.7
019010701,il,-88.03256,40.11331,1683,15,31,16,106.7
019010702,il,-88.03567,40.1441,2967,15,31,16,106.7
019010800,il,-88.06278,39.96072,4066,16,33,17,106.3
019010901,il,-88.20395,39.99149,2848,15,32,17,113.3
019010902,il,-88.36361,39.96925,3212,16,33,17,106.3
019011001,il,-88.25135,40.11969,635,14,30,16,114.3
019011002,il,-88.24635,40.11549,758,14,30,16,114.3
019011100,il,-88.21447,40.1141,519,14,31,17,121.4
021958100,il,-89.28666,39.71528,3243,18,37,19,105.6
021958200,il,-89.43454,39.58904,3001,18,37,19,105.6
021958300,il,-89.3008,39.56353,2015,18,37,19,105.6
021958400,il,-89.30952,39.54629,1746,18,37,19,105.6
021958500,il,-89.27904,39.54822,1070,18,37,19,105.6
021958600,il,-89.15098,39.60246,2413,18,37,19,105.6
021958700,il,-89.14029,39.43809,3115,19,38,19,100
021958800,il,-89.07449,39.38324,1417,19,38,19,100
021958900,il,-89.0846,39.39411,1443,19,38,19,100
021959000,il,-89.3872,39.44125,4347,17,36,19,111.8
023060100,il,-87.69723,39.33719,5611,20,39,19,95
023060200,il,-87.68595,39.39548,2307,20,38,18,90
023060300,il,-87.92414,39.30988,3702,18,37,19,105.6
023060400,il,-87.91814,39.33108,2617,19,37,18,94.7
025971900,il,-88.47649,38.845,4339,23,42,19,82.6
025972000,il,-88.50651,38.73831,4256,24,44,20,83.3
025972100,il,-88.47653,38.6704,3201,24,44,20,83.3
025972200,il,-88.48908,38.64148,3431,24,44,20,83.3
027900100,il,-89.65058,38.6188,3396,24,44,20,83.3
027900200,il,-89.48727,38.69825,2044,21,40,19,90.5
027900300,il,-89.49329,38.61531,4215,21,41,20,95.2
027900401,il,-89.20345,38.63993,1967,21,41,20,95.2
027900403,il,-89.35799,38.58447,3064,20,40,20,100
027900404,il,-89.31274,38.68288,2193,20,39,19,95
027900500,il,-89.31458,38.53042,3614,22,42,20,90.9
027900601,il,-89.51127,38.53067,1901,23,43,20,87
027900602,il,-89.63476,38.51644,4179,25,45,20,80
029000100,il,-88.16233,39.59289,3736,18,36,18,100
029000200,il,-88.38656,39.50323,4251,17,34,17,100
029000300,il,-88.39039,39.49679,2211,16,34,18,112.5
029000400,il,-88.3092,39.49703,1605,16,34,18,112.5
029000500,il,-88.19826,39.50214,2738,17,35,18,105.9
029000600,il,-88.10126,39.4613,3484,18,35,17,94.4
029000701,il,-88.13635,39.48731,1113,17,35,18,105.9
029000702,il,-88.17926,39.48699,910,17,35,18,105.9
029000800,il,-88.17619,39.47714,354,17,35,18,105.9
029000900,il,-88.18752,39.4706,1745,17,35,18,105.9
029001000,il,-88.34424,39.47392,1435,16,33,17,106.3
029001100,il,-88.37464,39.46758,1597,16,33,17,106.3
029001200,il,-88.39716,39.47036,1758,16,33,17,106.3
031010100,il,-87.66983,42.02126,317,7,13,6,85.7
031010201,il,-87.68015,42.01601,602,7,13,6,85.7
031010202,il,-87.67333,42.01605,280,7,13,6,85.7
031010300,il,-87.66654,42.01594,415,7,13,6,85.7
031010400,il,-87.65717,42.00544,254,7,13,6,85.7
031010501,il,-87.66396,42.00941,142,7,13,6,85.7
031010502,il,-87.66333,42.00452,186,7,13,6,85.7
031010503,il,-87.66313,42.00032,227,7,13,6,85.7
031010600,il,-87.66768,42.00628,566,7,13,6,85.7
031010701,il,-87.67862,42.00915,475,7,13,6,85.7
031010702,il,-87.67273,42.00902,363,7,13,6,85.7
031020100,il,-87.68712,42.01572,517,6,12,6,100
031020200,il,-87.69952,42.01569,1865,6,12,6,100
031020301,il,-87.70519,42.00687,763,6,12,6,100
031020302,il,-87.69496,42.00854,851,6,12,6,100
031020400,il,-87.68591,42.00849,593,6,12,6,100
031020500,il,-87.6842,42.00131,464,7,13,6,85.7
031020601,il,-87.7018,42.00087,929,6,12,6,100
031020602,il,-87.69364,42.00132,770,6,12,6,100
031020701,il,-87.70369,41.98689,597,6,12,6,100
031020702,il,-87.70489,41.99413,1043,6,12,6,100
031020801,il,-87.69441,41.98681,1082,6,12,6,100
031020802,il,-87.69463,41.99406,945,6,12,6,100
031020901,il,-87.68608,41.99423,471,6,12,6,100
031020902,il,-87.67868,41.99426,267,7,13,6,85.7
031030101,il,-87.65467,41.99127,87,7,13,6,85.7
031030102,il,-87.65513,41.9934,87,7,13,6,85.7
031030103,il,-87.6547,41.99538,43,7,13,6,85.7
031030104,il,-87.65564,41.99728,77,7,13,6,85.7
031030200,il,-87.66523,41.99444,1022,7,13,6,85.7
031030300,il,-87.67253,41.99439,521,7,13,6,85.7
031030400,il,-87.67208,41.98695,494,7,13,6,85.7
031030500,il,-87.66494,41.98723,898,7,13,6,85.7
031030601,il,-87.65494,41.98891,100,7,13,6,85.7
031030603,il,-87.6584,41.98548,87,7,13,6,85.7
031030604,il,-87.65277,41.98594,44,7,13,6,85.7
031030701,il,-87.65797,41.98275,49,7,13,6,85.7
031030702,il,-87.65453,41.98081,3,7,13,6,85.7
031030703,il,-87.65787,41.97887,185,7,13,6,85.7
031030706,il,-87.65154,41.98022,47,7,13,6,85.7
031030800,il,-87.66419,41.97991,854,7,13,6,85.7
031030900,il,-87.67145,41.9798,623,7,13,6,85.7
031031000,il,-87.67111,41.97244,620,7,13,6,85.7
031031100,il,-87.66387,41.97267,528,7,13,6,85.7
031031200,il,-87.65734,41.97271,306,7,13,6,85.7
031031300,il,-87.64679,41.97291,243,7,13,6,85.7
031031400,il,-87.64052,41.96257,149,7,13,6,85.7
031031501,il,-87.65243,41.96729,151,7,13,6,85.7
031031502,il,-87.65237,41.96363,143,7,13,6,85.7
031031700,il,-87.6632,41.96545,445,7,13,6,85.7
031031800,il,-87.67062,41.96701,231,7,13,6,85.7
031031900,il,-87.67018,41.96337,294,7,13,6,85.7
031032100,il,-87.65302,41.95815,376,7,13,6,85.7
031040100,il,-87.68199,41.98333,800,7,13,6,85.7
031040201,il,-87.694,41.97258,1063,7,13,6,85.7
031040202,il,-87.6941,41.97985,806,7,13,6,85.7
031040300,il,-87.70197,41.9768,723,7,13,6,85.7
031040401,il,-87.68608,41.97207,690,7,13,6,85.7
031040402,il,-87.67882,41.97255,499,7,13,6,85.7
031040600,il,-87.68402,41.96683,499,7,13,6,85.7
031040700,il,-87.69408,41.96681,522,7,13,6,85.7
031040800,il,-87.69229,41.96316,286,7,13,6,85.7
031040900,il,-87.68385,41.96318,358,7,13,6,85.7
031050100,il,-87.67637,41.95785,481,7,13,6,85.7
031050200,il,-87.68372,41.95774,1164,7,13,6,85.7
031050300,il,-87.69152,41.95768,684,7,13,6,85.7
031050500,il,-87.68351,41.95045,1121,7,13,6,85.7
031050600,il,-87.67618,41.95055,465,7,13,6,85.7
031050700,il,-87.67606,41.94507,308,7,13,6,85.7
031050800,il,-87.68093,41.94501,334,7,13,6,85.7
031050900,il,-87.68578,41.94495,310,7,13,6,85.7
031051000,il,-87.68573,41.9413,324,7,13,6,85.7
031051100,il,-87.68083,41.94137,335,7,13,6,85.7
031051200,il,-87.67595,41.94142,328,7,13,6,85.7
031051300,il,-87.67584,41.936,682,7,14,7,100
031051400,il,-87.68099,41.93575,420,7,14,7,100
031060100,il,-87.66661,41.95753,492,7,13,6,85.7
031060200,il,-87.67152,41.9579,350,7,13,6,85.7
031060300,il,-87.67133,41.9506,655,7,13,6,85.7
031060400,il,-87.66654,41.95067,549,7,13,6,85.7
031060500,il,-87.6605,41.95272,187,7,13,6,85.7
031060800,il,-87.64376,41.95385,78,7,13,6,85.7
031060900,il,-87.64047,41.95069,140,7,13,6,85.7
031061000,il,-87.65197,41.94922,201,7,13,6,85.7
031061100,il,-87.6568,41.94914,228,7,13,6,85.7
031061200,il,-87.66164,41.94906,311,7,13,6,85.7
031061500,il,-87.66154,41.94528,278,7,13,6,85.7
031061800,il,-87.64711,41.94649,66,7,13,6,85.7
031061901,il,-87.64347,41.94323,150,7,13,6,85.7
031061902,il,-87.63571,41.94493,55,7,14,7,100
031062000,il,-87.64708,41.94258,273,7,13,6,85.7
031062100,il,-87.65177,41.94269,392,7,13,6,85.7
031062200,il,-87.65664,41.94258,424,7,13,6,85.7
031062300,il,-87.66144,41.94163,345,7,13,6,85.7
031062400,il,-87.66629,41.94156,281,7,13,6,85.7
031062500,il,-87.67111,41.94149,263,7,13,6,85.7
031062600,il,-87.67098,41.93598,522,7,14,7,100
031062700,il,-87.66611,41.93609,600,7,14,7,100
031062800,il,-87.66126,41.93616,669,7,14,7,100
031062900,il,-87.65641,41.93624,622,7,14,7,100
031063000,il,-87.65156,41.93631,373,7,14,7,100
031063100,il,-87.64678,41.93823,204,7,14,7,100
031063200,il,-87.63464,41.93917,197,7,14,7,100
031063301,il,-87.64302,41.93454,69,7,14,7,100
031063302,il,-87.63985,41.93476,114,8,15,7,87.5
031063303,il,-87.63466,41.93473,15,8,15,7,87.5
031063400,il,-87.64673,41.93466,235,7,14,7,100
031070101,il,-87.63256,41.93046,136,8,15,7,87.5
031070102,il,-87.6422,41.93058,111,7,14,7,100
031070103,il,-87.64261,41.92681,89,7,14,7,100
031070200,il,-87.64629,41.92908,557,7,14,7,100
031070300,il,-87.65131,41.92905,575,7,14,7,100
031070400,il,-87.65616,41.92897,546,7,14,7,100
031070500,il,-87.66089,41.92895,562,7,14,7,100
031070600,il,-87.66568,41.92876,701,7,14,7,100
031070700,il,-87.6738,41.92926,666,7,14,7,100
031071000,il,-87.65591,41.9217,500,7,14,7,100
031071100,il,-87.65106,41.92178,606,7,14,7,100
031071200,il,-87.64621,41.92185,366,7,14,7,100
031071300,il,-87.64146,41.92178,585,7,14,7,100
031071400,il,-87.62941,41.92215,212,8,15,7,87.5
031071500,il,-87.62676,41.91491,549,8,15,7,87.5
031071600,il,-87.64118,41.91647,349,7,14,7,100
031071700,il,-87.64107,41.91287,285,7,14,7,100
031071800,il,-87.64597,41.91459,572,7,14,7,100
031080100,il,-87.62679,41.90755,205,8,15,7,87.5
031080201,il,-87.63101,41.9095,111,8,15,7,87.5
031080202,il,-87.6309,41.90586,230,8,15,7,87.5
031080300,il,-87.6358,41.90749,680,8,15,7,87.5
031080400,il,-87.6409,41.90741,519,7,14,7,100
031081000,il,-87.63211,41.90027,242,8,15,7,87.5
031081100,il,-87.6291,41.90022,136,8,15,7,87.5
031081201,il,-87.62621,41.89915,255,8,15,7,87.5
031081202,il,-87.6218,41.90614,167,8,15,7,87.5
031081300,il,-87.62075,41.89834,68,8,15,7,87.5
031081401,il,-87.61972,41.89503,150,8,15,7,87.5
031081402,il,-87.60893,41.89298,34,8,15,7,87.5
031081403,il,-87.60985,41.89214,228,8,15,7,87.5
031081500,il,-87.62623,41.89256,193,8,15,7,87.5
031081600,il,-87.62887,41.89211,149,8,15,7,87.5
031081700,il,-87.63187,41.89207,444,8,15,7,87.5
031081800,il,-87.6378,41.89327,535,8,15,7,87.5
031081900,il,-87.64149,41.89799,92,7,15,8,114.3
031090100,il,-87.81359,42.01526,1420,7,14,7,100
031090200,il,-87.8131,42.00559,1991,7,13,6,85.7
031090300,il,-87.81636,41.99911,572,7,14,7,100
031100100,il,-87.78301,41.98958,1826,7,13,6,85.7
031100200,il,-87.79426,41.99577,2100,7,13,6,85.7
031100300,il,-87.80426,41.98873,1917,7,13,6,85.7
031100400,il,-87.81804,41.98897,1249,7,14,7,100
031100500,il,-87.81973,41.97805,2188,7,14,7,100
031100600,il,-87.7974,41.9792,1971,7,13,6,85.7
031100700,il,-87.79763,41.97212,1854,7,13,6,85.7
031110100,il,-87.76967,41.98748,1829,7,13,6,85.7
031110200,il,-87.77344,41.98007,892,7,13,6,85.7
031110300,il,-87.78323,41.97529,1807,7,13,6,85.7
031110400,il,-87.77261,41.97295,1261,7,13,6,85.7
031110501,il,-87.76193,41.977,1393,7,13,6,85.7
031110502,il,-87.75985,41.97029,760,7,13,6,85.7
031120100,il,-87.77501,42.00198,1796,7,13,6,85.7
031120200,il,-87.75761,41.99453,1823,7,13,6,85.7
031120300,il,-87.74007,41.99111,2569,7,13,6,85.7
031120400,il,-87.75216,41.97724,1300,7,13,6,85.7
031130100,il,-87.72081,41.9911,1333,6,12,6,100
031130200,il,-87.73607,41.98085,468,7,13,6,85.7
031130300,il,-87.71339,41.98656,983,6,12,6,100
031140100,il,-87.70579,41.97108,305,7,13,6,85.7
031140200,il,-87.713,41.97069,476,7,13,6,85.7
031140301,il,-87.72317,41.96921,279,7,13,6,85.7
031140302,il,-87.72376,41.97249,535,7,13,6,85.7
031140400,il,-87.73894,41.97154,1727,7,13,6,85.7
031140500,il,-87.73183,41.96536,815,7,13,6,85.7
031140601,il,-87.72589,41.96465,483,7,13,6,85.7
031140602,il,-87.72102,41.96465,528,7,13,6,85.7
031140701,il,-87.71265,41.96704,280,7,13,6,85.7
031140702,il,-87.71358,41.96355,617,7,13,6,85.7
031140800,il,-87.70276,41.9645,1075,7,13,6,85.7
031150200,il,-87.75241,41.96067,1709,7,13,6,85.7
031150300,il,-87.76229,41.96052,1734,7,13,6,85.7
031150401,il,-87.77226,41.96457,1203,7,13,6,85.7
031150402,il,-87.77204,41.9568,1070,7,13,6,85.7
031150501,il,-87.78196,41.96448,1091,7,13,6,85.7
031150502,il,-87.78184,41.95678,1064,7,13,6,85.7
031150600,il,-87.77176,41.94947,1098,7,13,6,85.7
031150700,il,-87.76196,41.94959,1152,7,13,6,85.7
031150800,il,-87.75212,41.94971,1125,7,13,6,85.7
031151001,il,-87.75435,41.94238,511,7,14,7,100
031151002,il,-87.74716,41.94249,895,7,14,7,100
031151100,il,-87.76172,41.94229,1040,7,14,7,100
031151200,il,-87.7715,41.94217,1030,7,14,7,100
031160100,il,-87.7428,41.96463,566,7,13,6,85.7
031160200,il,-87.7384,41.95879,1136,7,13,6,85.7
031160300,il,-87.7309,41.95727,400,7,13,6,85.7
031160400,il,-87.72282,41.95737,1053,7,13,6,85.7
031160501,il,-87.71297,41.95921,610,7,13,6,85.7
031160502,il,-87.71309,41.95558,586,7,13,6,85.7
031160601,il,-87.70329,41.9594,520,7,13,6,85.7
031160602,il,-87.70017,41.95657,544,7,13,6,85.7
031160700,il,-87.70201,41.95041,1232,7,13,6,85.7
031160800,il,-87.71281,41.95021,1063,7,13,6,85.7
031160900,il,-87.72261,41.95008,730,7,13,6,85.7
031161000,il,-87.73068,41.94998,448,7,13,6,85.7
031161100,il,-87.73816,41.94988,635,7,13,6,85.7
031161200,il,-87.73857,41.94255,778,7,14,7,100
031161300,il,-87.731,41.9427,789,7,14,7,100
031170100,il,-87.79482,41.95586,98,7,13,6,85.7
031170200,il,-87.78152,41.94935,1076,7,13,6,85.7
031170300,il,-87.79683,41.94912,1550,7,13,6,85.7
031170400,il,-87.81271,41.94891,1308,7,14,7,100
031170500,il,-87.8289,41.95008,1692,7,14,7,100
031170600,il,-87.8307,41.94129,952,8,15,7,87.5
031170700,il,-87.82216,41.94149,988,8,15,7,87.5
031170800,il,-87.81237,41.94158,1150,8,15,7,87.5
031170900,il,-87.81161,41.9362,495,8,15,7,87.5
031171000,il,-87.79652,41.94181,2232,7,14,7,100
031171100,il,-87.78129,41.94205,1089,7,14,7,100
031180100,il,-87.79863,41.93449,1588,7,15,8,114.3
031190100,il,-87.74439,41.93522,392,7,14,7,100
031190200,il,-87.75165,41.93511,1092,7,14,7,100
031190300,il,-87.76146,41.93499,1168,7,14,7,100
031190401,il,-87.78095,41.93473,1047,7,15,8,114.3
031190402,il,-87.77123,41.93486,1125,7,14,7,100
031190601,il,-87.78046,41.92741,763,7,15,8,114.3
031190602,il,-87.77074,41.92756,1036,7,14,7,100
031190701,il,-87.76142,41.9298,470,7,14,7,100
031190702,il,-87.76104,41.92616,683,7,14,7,100
031190800,il,-87.75136,41.92782,1119,7,14,7,100
031190900,il,-87.7441,41.92792,423,7,14,7,100
031191000,il,-87.7438,41.91923,603,7,14,7,100
031191100,il,-87.75098,41.91963,1359,7,14,7,100
031191200,il,-87.76083,41.92014,578,7,14,7,100
031191301,il,-87.78027,41.92015,961,7,15,8,114.3
031191302,il,-87.77053,41.92023,996,7,14,7,100
031200100,il,-87.73762,41.93506,854,7,14,7,100
031200200,il,-87.73563,41.92785,861,7,14,7,100
031200300,il,-87.73413,41.92348,348,7,14,7,100
031200401,il,-87.73754,41.91983,629,7,14,7,100
031200402,il,-87.72968,41.91963,698,7,14,7,100
031210100,il,-87.70133,41.94287,991,7,13,6,85.7
031210400,il,-87.73031,41.93575,466,7,14,7,100
031210501,il,-87.72233,41.9374,501,7,14,7,100
031210502,il,-87.72205,41.93378,679,7,14,7,100
031210601,il,-87.71221,41.93764,551,7,14,7,100
031210602,il,-87.71257,41.93416,760,7,14,7,100
031210700,il,-87.70384,41.9357,794,7,14,7,100
031210800,il,-87.69893,41.93575,244,7,14,7,100
031210900,il,-87.69334,41.93544,783,7,14,7,100
031220300,il,-87.69509,41.92846,416,7,14,7,100
031220400,il,-87.69997,41.92843,575,7,14,7,100
031220500,il,-87.70499,41.92833,483,7,14,7,100
031220601,il,-87.71288,41.92583,309,7,14,7,100
031220602,il,-87.71209,41.9294,647,7,14,7,100
031220701,il,-87.72157,41.92616,489,7,14,7,100
031220702,il,-87.72423,41.92937,689,7,14,7,100
031220901,il,-87.72125,41.91918,469,7,14,7,100
031220902,il,-87.72184,41.92271,520,7,14,7,100
031221000,il,-87.71525,41.92096,424,7,14,7,100
031221100,il,-87.71036,41.92102,617,7,14,7,100
031221200,il,-87.70465,41.92108,428,7,14,7,100
031221300,il,-87.69975,41.92113,525,7,14,7,100
031221400,il,-87.69453,41.9208,696,7,14,7,100
031221500,il,-87.68995,41.92165,520,7,14,7,100
031221600,il,-87.6851,41.92125,744,7,14,7,100
031222200,il,-87.68383,41.91591,533,7,14,7,100
031222500,il,-87.69959,41.91568,281,7,14,7,100
031222600,il,-87.70448,41.91564,263,7,14,7,100
031222700,il,-87.71021,41.9155,327,7,14,7,100
031222800,il,-87.7151,41.91543,163,7,14,7,100
031222900,il,-87.72007,41.91556,265,7,14,7,100
031230100,il,-87.70437,41.91201,323,7,14,7,100
031230200,il,-87.71008,41.91187,377,7,14,7,100
031230300,il,-87.71499,41.91179,178,7,14,7,100
031230400,il,-87.72155,41.91182,549,7,14,7,100
031230500,il,-87.73394,41.91169,600,7,14,7,100
031230600,il,-87.734,41.90615,1140,7,14,7,100
031230700,il,-87.72154,41.90632,1194,7,14,7,100
031230800,il,-87.71495,41.90584,285,7,14,7,100
031230900,il,-87.71035,41.90669,879,7,14,7,100
031231100,il,-87.71507,41.89925,284,7,14,7,100
031231200,il,-87.72132,41.89906,1287,7,14,7,100
031231500,il,-87.71865,41.89174,1739,7,14,7,100
031240200,il,-87.67018,41.91244,292,7,14,7,100
031240300,il,-87.67507,41.91237,366,7,14,7,100
031240500,il,-87.68363,41.91197,399,7,14,7,100
031240600,il,-87.68971,41.91213,306,7,14,7,100
031240700,il,-87.6946,41.91209,315,7,14,7,100
031240800,il,-87.69949,41.91205,300,7,14,7,100
031240900,il,-87.70189,41.90472,303,7,14,7,100
031241000,il,-87.69453,41.90797,364,7,14,7,100
031241100,il,-87.68958,41.90664,701,7,14,7,100
031241200,il,-87.68469,41.90671,451,7,14,7,100
031241300,il,-87.68102,41.90677,275,7,14,7,100
031241400,il,-87.67531,41.90603,888,7,14,7,100
031241500,il,-87.67093,41.90837,635,7,14,7,100
031241600,il,-87.66533,41.90671,534,7,14,7,100
031242000,il,-87.66495,41.89974,596,7,14,7,100
031242100,il,-87.66984,41.89967,632,7,14,7,100
031242200,il,-87.67472,41.89959,652,7,14,7,100
031242300,il,-87.6796,41.89951,655,7,14,7,100
031242400,il,-87.68449,41.89942,438,7,14,7,100
031242500,il,-87.68932,41.89945,574,7,14,7,100
031242600,il,-87.6942,41.90056,963,7,14,7,100
031242700,il,-87.69937,41.89743,305,7,14,7,100
031242800,il,-87.69032,41.89263,518,7,14,7,100
031242900,il,-87.68429,41.8922,572,7,14,7,100
031243000,il,-87.6794,41.89228,669,7,14,7,100
031243100,il,-87.67451,41.89235,696,7,14,7,100
031243200,il,-87.66962,41.89243,633,7,14,7,100
031243300,il,-87.66474,41.89248,573,7,14,7,100
031243400,il,-87.65985,41.89257,600,7,14,7,100
031243500,il,-87.65252,41.89265,846,7,14,7,100
031250200,il,-87.75107,41.91235,700,7,14,7,100
031250300,il,-87.76085,41.91285,1003,7,14,7,100
031250400,il,-87.77541,41.9129,1291,7,14,7,100
031250500,il,-87.7968,41.91462,2380,7,15,8,114.3
031250600,il,-87.77063,41.90569,1052,7,14,7,100
031250700,il,-87.76081,41.90582,1116,7,14,7,100
031250800,il,-87.75147,41.90619,618,7,14,7,100
031251000,il,-87.74489,41.89869,400,7,14,7,100
031251100,il,-87.75201,41.89862,832,7,14,7,100
031251200,il,-87.7606,41.89855,1015,7,14,7,100
031251300,il,-87.77038,41.89843,1084,8,15,7,87.5
031251400,il,-87.77012,41.89096,712,8,15,7,87.5
031251500,il,-87.76035,41.8911,903,7,15,8,114.3
031251600,il,-87.7518,41.89141,966,7,15,8,114.3
031251700,il,-87.74448,41.89138,655,7,15,8,114.3
031251800,il,-87.74789,41.88414,1106,7,15,8,114.3
031251900,il,-87.76009,41.88381,792,7,15,8,114.3
031252000,il,-87.76988,41.88368,651,8,15,7,87.5
031252101,il,-87.76958,41.8755,251,8,15,7,87.5
031252102,il,-87.75983,41.8766,1091,7,15,8,114.3
031252201,il,-87.75211,41.8767,608,7,15,8,114.3
031252202,il,-87.74458,41.87676,946,7,15,8,114.3
031260100,il,-87.72333,41.88437,387,7,14,7,100
031260200,il,-87.72823,41.88432,444,7,15,8,114.3
031260300,il,-87.73314,41.88428,410,7,15,8,114.3
031260400,il,-87.73804,41.88421,408,7,15,8,114.3
031260500,il,-87.73773,41.87666,560,7,15,8,114.3
031260600,il,-87.73287,41.87711,627,7,15,8,114.3
031260700,il,-87.728,41.87706,665,7,15,8,114.3
031260800,il,-87.7231,41.87708,467,7,14,7,100
031260900,il,-87.72281,41.87103,402,7,14,7,100
031261000,il,-87.73201,41.87134,829,7,15,8,114.3
031270500,il,-87.71779,41.87624,292,7,14,7,100
031271200,il,-87.70356,41.87736,591,7,14,7,100
031271300,il,-87.70845,41.8773,438,7,14,7,100
031271400,il,-87.71333,41.87724,428,7,14,7,100
031271500,il,-87.71316,41.87179,387,7,14,7,100
031271800,il,-87.69849,41.8715,404,7,14,7,100
031280100,il,-87.64288,41.8854,364,7,14,7,100
031280400,il,-87.67188,41.88601,466,7,14,7,100
031280800,il,-87.6889,41.8786,311,7,14,7,100
031280900,il,-87.68513,41.87863,143,7,14,7,100
031281900,il,-87.64262,41.87925,230,7,14,7,100
031282700,il,-87.68868,41.87137,747,7,14,7,100
031282800,il,-87.68491,41.87027,346,7,14,7,100
031283100,il,-87.66409,41.86927,277,7,14,7,100
031283200,il,-87.6592,41.86958,317,7,14,7,100
031283800,il,-87.65375,41.86342,141,7,14,7,100
031290900,il,-87.73246,41.86241,1435,7,15,8,114.3
031291200,il,-87.71287,41.86266,502,7,14,7,100
031291600,il,-87.69222,41.85764,187,7,15,8,114.3
031292200,il,-87.71573,41.85667,769,7,15,8,114.3
031292400,il,-87.7224,41.85524,566,7,15,8,114.3
031292500,il,-87.73224,41.85516,1088,7,15,8,114.3
031300500,il,-87.72194,41.84743,455,7,15,8,114.3
031300600,il,-87.71733,41.84799,499,7,15,8,114.3
031300700,il,-87.71245,41.84807,650,7,15,8,114.3
031300800,il,-87.70758,41.84811,645,7,15,8,114.3
031300900,il,-87.7027,41.84818,682,7,15,8,114.3
031301100,il,-87.69797,41.84703,340,7,15,8,114.3
031301200,il,-87.69148,41.84842,600,7,15,8,114.3
031301600,il,-87.71225,41.84076,711,7,15,8,114.3
031301701,il,-87.71963,41.84248,648,7,15,8,114.3
031301702,il,-87.71952,41.83881,611,7,15,8,114.3
031301801,il,-87.73505,41.84166,701,7,15,8,114.3
031301802,il,-87.72776,41.84518,575,7,15,8,114.3
031301803,il,-87.72787,41.83955,746,7,15,8,114.3
031310200,il,-87.64421,41.85631,617,8,15,7,87.5
031310300,il,-87.64898,41.85614,475,8,15,7,87.5
031310400,il,-87.65226,41.85651,244,8,15,7,87.5
031310500,il,-87.65474,41.85525,293,8,15,7,87.5
031310600,il,-87.65956,41.85633,837,8,15,7,87.5
031310700,il,-87.66491,41.85599,224,8,15,7,87.5
031310800,il,-87.66857,41.85593,660,8,15,7,87.5
031310900,il,-87.67467,41.85577,782,8,15,7,87.5
031320101,il,-87.61702,41.88493,58,8,15,7,87.5
031320102,il,-87.62406,41.88504,165,8,15,7,87.5
031320400,il,-87.61736,41.87771,231,8,15,7,87.5
031320600,il,-87.61688,41.87114,170,8,15,7,87.5
031330101,il,-87.61247,41.85931,207,8,15,7,87.5
031330102,il,-87.62399,41.86357,422,8,15,7,87.5
031330103,il,-87.62342,41.85648,727,8,15,7,87.5
031330200,il,-87.63053,41.86135,717,8,15,7,87.5
031340300,il,-87.63579,41.8428,389,8,15,7,87.5
031340400,il,-87.63204,41.84189,516,8,15,7,87.5
031340500,il,-87.63292,41.83452,441,8,15,7,87.5
031340600,il,-87.63265,41.82729,356,8,15,7,87.5
031350100,il,-87.60842,41.84175,36,8,15,7,87.5
031350400,il,-87.62837,41.84193,33,8,15,7,87.5
031351000,il,-87.60598,41.83478,135,8,15,7,87.5
031351100,il,-87.61419,41.82775,226,8,15,7,87.5
031351400,il,-87.62409,41.8274,452,8,15,7,87.5
031351500,il,-87.62773,41.82724,72,8,15,7,87.5
031360200,il,-87.60989,41.82689,252,8,15,7,87.5
031380100,il,-87.6101,41.8202,720,8,15,7,87.5
031380200,il,-87.61499,41.82057,245,8,15,7,87.5
031380600,il,-87.62294,41.82015,710,8,15,7,87.5
031381200,il,-87.614,41.80851,322,8,16,8,100
031381400,il,-87.62143,41.80762,341,8,16,8,100
031381500,il,-87.62286,41.81019,75,8,16,8,100
031381700,il,-87.62745,41.80555,63,8,16,8,100
031381800,il,-87.6212,41.80385,261,8,16,8,100
031381900,il,-87.61389,41.80396,222,8,16,8,100
031390100,il,-87.59063,41.81384,346,8,16,8,100
031390200,il,-87.59948,41.81304,536,8,16,8,100
031390300,il,-87.60421,41.8132,212,8,16,8,100
031390400,il,-87.60406,41.80592,348,8,16,8,100
031390500,il,-87.5992,41.80598,200,8,16,8,100
031390600,il,-87.59435,41.80602,304,8,16,8,100
031390700,il,-87.58254,41.80638,226,8,16,8,100
031400300,il,-87.61318,41.7931,315,8,16,8,100
031400400,il,-87.61832,41.79113,311,8,16,8,100
031400500,il,-87.62318,41.79104,357,8,16,8,100
031400800,il,-87.62056,41.78286,384,8,16,8,100
031410100,il,-87.57934,41.8015,84,8,16,8,100
031410200,il,-87.59427,41.80167,75,8,16,8,100
031410500,il,-87.60374,41.79783,278,8,16,8,100
031410600,il,-87.59894,41.79797,300,8,16,8,100
031410700,il,-87.5942,41.79805,310,8,16,8,100
031410800,il,-87.58962,41.79796,232,8,16,8,100
031410900,il,-87.57666,41.79788,182,8,16,8,100
031411000,il,-87.57687,41.79072,101,8,16,8,100
031411100,il,-87.5897,41.79046,328,8,16,8,100
031411200,il,-87.59402,41.79056,314,8,16,8,100
031420100,il,-87.57739,41.78341,89,8,16,8,100
031420200,il,-87.59352,41.78347,288,8,16,8,100
031420300,il,-87.5987,41.78322,236,8,16,8,100
031420400,il,-87.60356,41.78317,181,8,16,8,100
031420500,il,-87.60843,41.7831,271,8,16,8,100
031420600,il,-87.61328,41.78301,350,8,16,8,100
031420700,il,-87.61069,41.77669,1212,8,16,8,100
031420800,il,-87.60326,41.77691,540,8,16,8,100
031421200,il,-87.60895,41.77066,531,8,16,8,100
031430101,il,-87.57395,41.76985,323,8,16,8,100
031430102,il,-87.56162,41.76939,93,8,16,8,100
031430200,il,-87.58135,41.76976,689,8,16,8,100
031430300,il,-87.58936,41.76972,465,8,16,8,100
031430400,il,-87.59031,41.7622,799,8,16,8,100
031430500,il,-87.58127,41.76431,446,8,16,8,100
031430600,il,-87.57137,41.76441,343,8,16,8,100
031430700,il,-87.55923,41.76514,182,8,16,8,100
031430800,il,-87.5713,41.76075,428,8,16,8,100
031430900,il,-87.58119,41.76064,385,8,16,8,100
031431200,il,-87.57118,41.7553,1070,8,16,8,100
031431301,il,-87.56019,41.75353,513,8,16,8,100
031431302,il,-87.56279,41.75839,526,8,16,8,100
031431400,il,-87.54723,41.75967,712,8,16,8,100
031440101,il,-87.60145,41.74863,481,8,16,8,100
031440102,il,-87.60116,41.74094,723,8,16,8,100
031440201,il,-87.61007,41.74821,827,8,16,8,100
031440202,il,-87.60976,41.74096,727,8,16,8,100
031440300,il,-87.61954,41.74372,1640,8,16,8,100
031440600,il,-87.61914,41.73267,962,8,16,8,100
031440700,il,-87.60963,41.73475,648,8,16,8,100
031440800,il,-87.60333,41.73171,398,8,16,8,100
031440900,il,-87.60901,41.72867,1075,8,17,9,112.5
031450300,il,-87.57909,41.74194,1606,8,16,8,100
031460100,il,-87.53573,41.74615,1089,8,16,8,100
031460200,il,-87.54701,41.74139,787,8,16,8,100
031460301,il,-87.55637,41.74003,908,8,16,8,100
031460302,il,-87.55739,41.74708,1134,8,16,8,100
031460400,il,-87.56369,41.74449,1018,8,16,8,100
031460500,il,-87.5726,41.74688,2006,8,16,8,100
031460800,il,-87.55318,41.7356,941,8,16,8,100
031461000,il,-87.54649,41.72742,497,8,17,9,112.5
031470100,il,-87.59649,41.72822,1216,8,16,8,100
031480100,il,-87.57573,41.73524,969,8,16,8,100
031480200,il,-87.58988,41.73512,434,8,16,8,100
031480300,il,-87.58797,41.72919,617,8,16,8,100
031480400,il,-87.57564,41.72845,2668,8,16,8,100
031480500,il,-87.55909,41.7276,1335,8,16,8,100
031490200,il,-87.61687,41.72491,1449,8,17,9,112.5
031490500,il,-87.6132,41.71793,825,8,17,9,112.5
031490600,il,-87.62833,41.71797,800,8,17,9,112.5
031490700,il,-87.62836,41.71073,1158,8,17,9,112.5
031490800,il,-87.61535,41.71069,1614,8,17,9,112.5
031490901,il,-87.61627,41.69606,1076,8,17,9,112.5
031490902,il,-87.61533,41.70328,1922,8,17,9,112.5
031491000,il,-87.62805,41.69976,2156,8,17,9,112.5
031491100,il,-87.6377,41.69975,1817,8,17,9,112.5
031491200,il,-87.63744,41.68878,851,9,18,9,100
031491300,il,-87.6278,41.6889,1025,9,18,9,100
031491400,il,-87.61682,41.68912,898,9,18,9,100
031500100,il,-87.59503,41.71468,1047,8,16,8,100
031500200,il,-87.60031,41.70086,714,8,17,9,112.5
031500300,il,-87.60537,41.68932,681,9,18,9,100
031510100,il,-87.54989,41.7131,1250,8,17,9,112.5
031510200,il,-87.56005,41.71427,1389,8,16,8,100
031510300,il,-87.57498,41.71574,2122,8,16,8,100
031520100,il,-87.53049,41.7203,718,8,17,9,112.5
031520200,il,-87.53981,41.71382,1054,8,17,9,112.5
031520300,il,-87.53956,41.70111,1765,8,17,9,112.5
031520400,il,-87.5307,41.70301,1266,8,17,9,112.5
031520500,il,-87.53087,41.69312,1527,9,17,8,88.9
031520600,il,-87.5404,41.68952,883,9,17,8,88.9
031530100,il,-87.61794,41.68185,932,9,18,9,100
031530200,il,-87.6324,41.68156,2076,9,18,9,100
031530300,il,-87.65175,41.68131,1875,10,19,9,90
031530400,il,-87.65153,41.67404,999,10,19,9,90
031530501,il,-87.63217,41.67428,2146,9,18,9,100
031530502,il,-87.62667,41.6648,659,9,18,9,100
031530503,il,-87.63751,41.66356,2232,10,19,9,90
031530600,il,-87.619,41.67039,1192,9,18,9,100
031540101,il,-87.59979,41.65022,688,10,19,9,90
031540102,il,-87.60545,41.66733,500,9,18,9,100
031550100,il,-87.53533,41.66506,2784,9,18,9,100
031550200,il,-87.56403,41.65338,1551,9,18,9,100
031560100,il,-87.74127,41.81534,436,7,15,8,114.3
031560200,il,-87.74783,41.81133,684,7,15,8,114.3
031560300,il,-87.74799,41.80391,1106,7,15,8,114.3
031560400,il,-87.74061,41.80401,524,7,15,8,114.3
031560700,il,-87.75752,41.79646,1038,7,15,8,114.3
031560800,il,-87.77217,41.79621,2076,8,15,7,87.5
031560900,il,-87.79165,41.79577,2048,8,15,7,87.5
031561000,il,-87.7915,41.7885,2084,8,15,7,87.5
031561100,il,-87.77191,41.78887,1997,8,15,7,87.5
031570100,il,-87.71891,41.8162,393,8,15,7,87.5
031570200,il,-87.73072,41.81438,717,7,15,8,114.3
031570300,il,-87.73079,41.80414,1354,7,15,8,114.3
031570400,il,-87.71913,41.80499,442,8,15,7,87.5
031570500,il,-87.73246,41.7986,545,7,15,8,114.3
031580100,il,-87.69075,41.82806,858,7,15,8,114.3
031580200,il,-87.69935,41.82677,785,7,15,8,114.3
031580300,il,-87.70893,41.82519,553,7,15,8,114.3
031580400,il,-87.70918,41.81528,1090,8,15,7,87.5
031580501,il,-87.6995,41.81999,904,7,15,8,114.3
031580502,il,-87.69931,41.81456,892,8,15,7,87.5
031580600,il,-87.69203,41.8174,874,8,15,7,87.5
031580700,il,-87.68685,41.81749,1091,8,15,7,87.5
031580800,il,-87.68664,41.81022,355,8,15,7,87.5
031590500,il,-87.6799,41.82666,506,8,15,7,87.5
031590600,il,-87.67292,41.82683,721,8,15,7,87.5
031590700,il,-87.66376,41.82681,805,8,15,7,87.5
031600400,il,-87.64393,41.84172,777,8,15,7,87.5
031600600,il,-87.65558,41.84239,797,8,15,7,87.5
031600700,il,-87.66075,41.84083,776,8,15,7,87.5
031600900,il,-87.65314,41.83651,818,8,15,7,87.5
031610300,il,-87.6751,41.81618,1032,8,16,8,100
031610400,il,-87.66745,41.8104,307,8,16,8,100
031610800,il,-87.6384,41.81271,550,8,16,8,100
031611200,il,-87.66244,41.80499,613,8,16,8,100
031611300,il,-87.6673,41.80494,646,8,16,8,100
031611400,il,-87.67217,41.80489,568,8,16,8,100
031611500,il,-87.67873,41.80538,660,8,16,8,100
031611600,il,-87.6769,41.79763,560,8,16,8,100
031611700,il,-87.67198,41.7976,689,8,16,8,100
031611800,il,-87.66711,41.79765,678,8,16,8,100
031611900,il,-87.65982,41.79774,779,8,16,8,100
031612000,il,-87.65254,41.79785,646,8,16,8,100
031612100,il,-87.64768,41.79791,668,8,16,8,100
031612200,il,-87.65272,41.80488,1179,8,16,8,100
031620100,il,-87.71803,41.79802,1238,8,15,7,87.5
031620200,il,-87.72923,41.79552,596,7,15,8,114.3
031620300,il,-87.73044,41.7895,1649,7,15,8,114.3
031620400,il,-87.71817,41.78964,1213,8,15,7,87.5
031630300,il,-87.70864,41.79886,1048,8,15,7,87.5
031630400,il,-87.69878,41.79725,1255,8,15,7,87.5
031630500,il,-87.68902,41.79743,1117,8,15,7,87.5
031630600,il,-87.68885,41.80121,814,8,15,7,87.5
031630800,il,-87.69857,41.78997,1182,8,15,7,87.5
031630900,il,-87.70837,41.78981,997,8,15,7,87.5
031640100,il,-87.73986,41.78192,342,7,15,8,114.3
031640300,il,-87.77164,41.78153,2139,8,15,7,87.5
031640400,il,-87.79125,41.78118,1215,8,15,7,87.5
031640500,il,-87.79099,41.77568,1155,8,16,8,100
031640600,il,-87.77143,41.77604,1134,8,15,7,87.5
031640700,il,-87.75194,41.77641,1187,7,15,8,114.3
031640800,il,-87.73974,41.77482,493,8,16,8,100
031650100,il,-87.71785,41.78238,1142,8,15,7,87.5
031650200,il,-87.73023,41.78222,1710,7,15,8,114.3
031650301,il,-87.72999,41.77493,1494,8,16,8,100
031650302,il,-87.71773,41.77509,1139,8,15,7,87.5
031650400,il,-87.71717,41.76531,1671,8,16,8,100
031650500,il,-87.73204,41.76222,1055,8,16,8,100
031660301,il,-87.69829,41.77995,285,8,15,7,87.5
031660302,il,-87.69839,41.7836,899,8,15,7,87.5
031660400,il,-87.70804,41.78253,1200,8,15,7,87.5
031660500,il,-87.70793,41.77525,1052,8,15,7,87.5
031660600,il,-87.69334,41.77729,1152,8,15,7,87.5
031660700,il,-87.6811,41.77385,759,8,16,8,100
031660800,il,-87.69327,41.77364,1106,8,16,8,100
031660900,il,-87.698,41.7681,932,8,16,8,100
031661000,il,-87.68505,41.76182,1799,8,16,8,100
031661100,il,-87.70266,41.76079,1686,8,16,8,100
031670100,il,-87.65721,41.79049,568,8,16,8,100
031670200,il,-87.66206,41.79042,596,8,16,8,100
031670300,il,-87.66692,41.79036,533,8,16,8,100
031670400,il,-87.67177,41.7903,541,8,16,8,100
031670500,il,-87.6764,41.78658,507,8,16,8,100
031670600,il,-87.67158,41.78301,674,8,16,8,100
031670700,il,-87.66673,41.78307,618,8,16,8,100
031670800,il,-87.66188,41.78314,628,8,16,8,100
031670900,il,-87.65702,41.78321,631,8,16,8,100
031671100,il,-87.66172,41.77678,468,8,16,8,100
031671200,il,-87.66658,41.7767,463,8,16,8,100
031671300,il,-87.67135,41.7739,948,8,16,8,100
031671400,il,-87.67623,41.77379,742,8,16,8,100
031671500,il,-87.66963,41.76817,1266,8,16,8,100
031671600,il,-87.66151,41.7695,839,8,16,8,100
031671800,il,-87.65645,41.7614,621,8,16,8,100
031671900,il,-87.66128,41.76133,444,8,16,8,100
031672000,il,-87.67113,41.7612,1474,8,16,8,100
031680500,il,-87.65235,41.79056,616,8,16,8,100
031680600,il,-87.65217,41.78328,696,8,16,8,100
031680900,il,-87.63763,41.77643,1107,8,16,8,100
031681000,il,-87.64955,41.77604,1171,8,16,8,100
031681100,il,-87.64936,41.76877,1178,8,16,8,100
031681200,il,-87.6385,41.76919,1040,8,16,8,100
031681300,il,-87.63984,41.76118,689,8,16,8,100
031681400,il,-87.64917,41.76152,1230,8,16,8,100
031690300,il,-87.62901,41.76867,413,8,16,8,100
031690400,il,-87.6202,41.76926,909,8,16,8,100
031690500,il,-87.6121,41.76818,352,8,16,8,100
031690900,il,-87.61034,41.76214,1201,8,16,8,100
031691000,il,-87.62002,41.76197,730,8,16,8,100
031691100,il,-87.62987,41.76171,821,8,16,8,100
031691200,il,-87.63218,41.75444,773,8,16,8,100
031691300,il,-87.61985,41.75468,775,8,16,8,100
031691400,il,-87.61017,41.75485,1189,8,16,8,100
031691500,il,-87.60027,41.75505,679,8,16,8,100
031700100,il,-87.69531,41.75359,1255,8,16,8,100
031700200,il,-87.72378,41.75299,1826,8,16,8,100
031700301,il,-87.73171,41.74562,1663,8,16,8,100
031700302,il,-87.73131,41.73837,1740,8,16,8,100
031700401,il,-87.71204,41.74554,2100,8,16,8,100
031700402,il,-87.71182,41.73823,1449,8,16,8,100
031700501,il,-87.69034,41.74621,2579,8,16,8,100
031700502,il,-87.68877,41.73885,1029,8,16,8,100
031710100,il,-87.64197,41.75339,341,8,16,8,100
031710200,il,-87.65143,41.75511,930,8,16,8,100
031710300,il,-87.66111,41.75405,320,8,16,8,100
031710400,il,-87.67093,41.75392,1655,8,16,8,100
031710500,il,-87.67079,41.74753,998,8,16,8,100
031710600,il,-87.66094,41.74766,380,8,16,8,100
031710700,il,-87.65688,41.74711,788,8,16,8,100
031710800,il,-87.64881,41.74784,1198,8,16,8,100
031710900,il,-87.63969,41.74215,923,8,16,8,100
031711000,il,-87.64858,41.73964,1121,8,16,8,100
031711100,il,-87.6583,41.7395,870,8,16,8,100
031711200,il,-87.66983,41.74056,1741,8,16,8,100
031711300,il,-87.66729,41.7335,584,8,16,8,100
031711400,il,-87.65212,41.73366,1049,8,16,8,100
031711500,il,-87.63869,41.73244,1014,8,16,8,100
031720100,il,-87.67474,41.72762,1544,8,17,9,112.5
031720200,il,-87.66605,41.71304,1556,9,17,8,88.9
031720300,il,-87.67714,41.71392,1570,9,17,8,88.9
031720400,il,-87.68667,41.70999,843,9,18,9,100
031720500,il,-87.6891,41.70284,826,9,18,9,100
031720600,il,-87.67721,41.70278,660,9,17,8,88.9
031720700,il,-87.66514,41.70311,969,9,17,8,88.9
031730100,il,-87.63843,41.7252,1045,8,17,9,112.5
031730201,il,-87.6579,41.72686,1519,9,17,8,88.9
031730202,il,-87.64854,41.72643,1177,9,17,8,88.9
031730300,il,-87.66457,41.72747,419,9,17,8,88.9
031730400,il,-87.65265,41.71784,1497,9,17,8,88.9
031730500,il,-87.63814,41.71427,1969,8,17,9,112.5
031730600,il,-87.65049,41.7106,1493,9,17,8,88.9
031730700,il,-87.65008,41.70308,1193,9,17,8,88.9
031740100,il,-87.69861,41.69729,1557,9,18,9,100
031740200,il,-87.71271,41.7047,2064,9,18,9,100
031740300,il,-87.71072,41.69507,1833,9,18,9,100
031740400,il,-87.71932,41.68724,1657,10,19,9,90
031750100,il,-87.65203,41.69583,1889,9,17,8,88.9
031750200,il,-87.67142,41.69566,1089,9,17,8,88.9
031750300,il,-87.68617,41.69539,961,9,18,9,100
031750400,il,-87.68507,41.68566,1283,10,19,9,90
031750500,il,-87.67123,41.68462,2160,10,19,9,90
031750600,il,-87.65205,41.68863,1885,10,19,9,90
031760801,il,-87.84485,41.98349,149,7,14,7,100
031760802,il,-87.84722,41.95783,768,7,14,7,100
031760803,il,-87.84414,41.97534,479,7,14,7,100
031770201,il,-88.01737,41.99797,1013,8,16,8,100
031770202,il,-88.0175,42.0244,1505,8,15,7,87.5
031770300,il,-87.98935,42.0183,2742,8,15,7,87.5
031770400,il,-87.97459,42.02396,1807,8,15,7,87.5
031770500,il,-87.94474,42.00801,545,8,15,7,87.5
031770601,il,-87.90874,42.02915,1236,8,15,7,87.5
031770602,il,-87.90449,42.01239,1316,8,15,7,87.5
031770700,il,-87.86942,41.98544,1016,7,15,8,114.3
031770800,il,-87.86642,41.96332,1972,8,15,7,87.5
031770901,il,-87.81686,41.97056,1684,7,14,7,100
031770902,il,-87.83618,41.97006,1092,7,14,7,100
031800100,il,-87.74882,42.13815,1044,6,11,5,83.3
031800200,il,-87.77049,42.13519,2554,6,11,5,83.3
031800300,il,-87.75518,42.11308,1271,6,11,5,83.3
031800400,il,-87.72409,42.10942,1445,6,11,5,83.3
031800500,il,-87.74075,42.10023,1755,6,11,5,83.3
031800600,il,-87.71433,42.08878,941,6,11,5,83.3
031800700,il,-87.74258,42.08471,1931,6,11,5,83.3
031800800,il,-87.75929,42.09459,1122,6,12,6,100
031800900,il,-87.75276,42.07351,1735,6,12,6,100
031801000,il,-87.73486,42.07231,1755,6,11,5,83.3
031801100,il,-87.71497,42.07518,1714,6,11,5,83.3
031801200,il,-87.69211,42.08432,1059,6,11,5,83.3
031801300,il,-87.69704,42.0741,1541,6,11,5,83.3
031801400,il,-87.7656,42.07114,1203,6,12,6,100
031801500,il,-87.81389,42.14042,2254,6,12,6,100
031801601,il,-87.86302,42.14529,1801,6,12,6,100
031801603,il,-87.87788,42.08719,744,7,13,6,85.7
031801605,il,-87.86702,42.13159,1927,6,12,6,100
031801606,il,-87.86822,42.11624,2098,6,12,6,100
031801607,il,-87.85892,42.08942,1674,7,13,6,85.7
031801608,il,-87.8307,42.10688,1747,6,12,6,100
031801701,il,-87.84294,42.12649,1321,6,12,6,100
031801702,il,-87.8269,42.12446,1624,6,12,6,100
031801800,il,-87.78777,42.11492,2679,6,12,6,100
031801901,il,-87.80506,42.09383,997,6,12,6,100
031801902,il,-87.78337,42.08654,1289,6,12,6,100
031802002,il,-87.83208,42.07325,1752,7,12,5,71.4
031802003,il,-87.84564,42.0796,828,7,12,5,71.4
031802004,il,-87.85373,42.0693,387,7,13,6,85.7
031802100,il,-87.81154,42.07226,1181,7,12,5,71.4
031802200,il,-87.78812,42.07294,1729,6,12,6,100
031802300,il,-87.82421,42.09048,1271,7,12,5,71.4
031802402,il,-87.90945,42.14642,1472,7,13,6,85.7
031802403,il,-87.95313,42.14187,55,7,14,7,100
031802404,il,-87.94403,42.14775,337,7,14,7,100
031802503,il,-87.95377,42.13162,1209,7,14,7,100
031802504,il,-87.93676,42.13279,2173,7,14,7,100
031802505,il,-87.91118,42.12092,1356,7,13,6,85.7
031802506,il,-87.89776,42.12995,729,7,13,6,85.7
031802605,il,-87.91295,42.09713,1659,7,14,7,100
031802607,il,-87.93195,42.09888,608,7,14,7,100
031802608,il,-87.94889,42.10095,1394,8,14,6,75
031802609,il,-87.89967,42.10536,118,7,14,7,100
031802610,il,-87.89549,42.0977,636,7,14,7,100
031802701,il,-87.91665,42.08439,2011,7,14,7,100
031802702,il,-87.90762,42.07425,1640,7,14,7,100
031802801,il,-87.95666,42.08279,1834,8,15,7,87.5
031802802,il,-87.94325,42.07167,2511,7,14,7,100
031802900,il,-87.96902,42.09716,2396,8,15,7,87.5
031803005,il,-87.99205,42.13224,850,8,15,7,87.5
031803007,il,-87.97067,42.13174,1368,7,14,7,100
031803008,il,-87.97047,42.11811,1487,7,14,7,100
031803010,il,-87.98157,42.15037,1563,7,14,7,100
031803012,il,-87.99523,42.14328,290,8,15,7,87.5
031803013,il,-87.97189,42.14309,1189,7,14,7,100
031803014,il,-87.93191,42.11702,618,7,13,6,85.7
031803015,il,-87.94962,42.11641,1152,7,14,7,100
031803016,il,-87.98652,42.12082,402,8,15,7,87.5
031803017,il,-87.99826,42.11917,1344,8,15,7,87.5
031803100,il,-87.98641,42.10039,1296,8,15,7,87.5
031803200,il,-87.99768,42.09884,1692,8,15,7,87.5
031803300,il,-87.98948,42.08507,1383,8,15,7,87.5
031803400,il,-87.97119,42.07455,2527,8,15,7,87.5
031803500,il,-87.99406,42.07393,1945,8,15,7,87.5
031803603,il,-88.09537,42.12036,2480,8,15,7,87.5
031803604,il,-88.04098,42.12988,1137,7,14,7,100
031803605,il,-88.02488,42.12916,1925,7,14,7,100
031803607,il,-88.01416,42.11731,1764,8,14,6,75
031803608,il,-88.07741,42.14473,1853,8,15,7,87.5
031803611,il,-88.01787,42.14783,377,7,14,7,100
031803612,il,-88.00879,42.14985,255,8,14,6,75
031803613,il,-88.01367,42.14147,175,8,14,6,75
031803614,il,-88.01122,42.13633,150,8,15,7,87.5
031803615,il,-88.07845,42.13169,727,8,15,7,87.5
031803616,il,-88.05975,42.13034,1554,8,14,6,75
031803701,il,-88.05256,42.11907,885,8,14,6,75
031803702,il,-88.05415,42.10569,1991,8,15,7,87.5
031803800,il,-88.03544,42.10903,2077,8,14,6,75
031803901,il,-88.0192,42.0978,833,8,15,7,87.5
031803902,il,-88.01523,42.08296,1403,8,15,7,87.5
031804000,il,-88.01808,42.07276,1639,8,15,7,87.5
031804102,il,-88.07687,42.09468,2456,8,15,7,87.5
031804104,il,-88.10917,42.10472,1883,9,16,7,77.8
031804105,il,-88.09637,42.07999,1634,9,16,7,77.8
031804106,il,-88.05009,42.08792,2159,8,15,7,87.5
031804108,il,-88.05079,42.07495,142,8,15,7,87.5
031804109,il,-88.03673,42.0755,1069,8,15,7,87.5
031804202,il,-88.13062,42.10788,3071,8,15,7,87.5
031804203,il,-88.16071,42.08904,1533,9,17,8,88.9
031804204,il,-88.19568,42.11667,2821,8,16,8,100
031804305,il,-88.16259,42.03366,2041,10,18,8,80
031804306,il,-88.17401,42.02198,1842,10,18,8,80
031804308,il,-88.1527,42.02392,1271,10,18,8,80
031804309,il,-88.15757,42.01257,1022,10,18,8,80
031804312,il,-88.19995,42.05602,846,10,19,9,90
031804313,il,-88.2402,42.06252,1579,10,18,8,80
031804314,il,-88.20401,42.03771,763,10,19,9,90
031804315,il,-88.18818,42.02007,684,10,18,8,80
031804316,il,-88.20066,42.02625,1474,10,19,9,90
031804403,il,-88.2426,42.052,2056,10,18,8,80
031804404,il,-88.24412,42.04229,1680,10,18,8,80
031804405,il,-88.24299,42.03477,576,10,18,8,80
031804406,il,-88.25324,42.01576,1731,10,18,8,80
031804505,il,-88.17516,41.99361,1042,10,18,8,80
031804506,il,-88.19571,42.00221,2008,10,18,8,80
031804508,il,-88.1801,42.00732,589,10,18,8,80
031804509,il,-88.16512,42.00441,1616,10,18,8,80
031804510,il,-88.15256,42.00004,1153,10,18,8,80
031804511,il,-88.15221,41.99227,537,10,18,8,80
031804512,il,-88.22114,42.02005,1103,10,18,8,80
031804513,il,-88.22548,42.00852,1319,10,18,8,80
031804514,il,-88.23336,41.99423,1149,10,18,8,80
031804603,il,-88.05399,42.05372,1088,9,16,7,77.8
031804606,il,-88.04664,42.00932,2094,9,16,7,77.8
031804607,il,-88.05359,41.99612,2134,9,17,8,88.9
031804608,il,-88.07061,42.03534,835,9,17,8,88.9
031804609,il,-88.04461,42.03158,1303,8,16,8,100
031804610,il,-88.0526,42.02223,139,9,16,7,77.8
031804611,il,-88.06778,42.01883,1100,10,18,8,80
031804701,il,-88.15349,42.05456,1370,10,18,8,80
031804705,il,-88.11857,42.05628,817,10,18,8,80
031804706,il,-88.10613,42.05445,860,10,18,8,80
031804709,il,-88.08797,42.03793,1617,9,17,8,88.9
031804710,il,-88.10611,42.03103,1225,10,18,8,80
031804711,il,-88.13896,42.03473,964,10,18,8,80
031804712,il,-88.12756,42.03584,1557,10,18,8,80
031804713,il,-88.08995,42.05352,634,9,17,8,88.9
031804714,il,-88.09481,42.06317,1007,10,17,7,70
031804715,il,-88.0977,42.04502,443,10,18,8,80
031804716,il,-88.11419,42.04202,1685,10,18,8,80
031804803,il,-88.08812,41.99956,2168,10,18,8,80
031804804,il,-88.12761,41.99645,1287,10,19,9,90
031804805,il,-88.12908,42.02007,2064,10,19,9,90
031804806,il,-88.13638,42.00869,826,10,19,9,90
031804807,il,-88.11999,42.01038,1799,10,19,9,90
031804808,il,-88.10003,42.02202,951,10,18,8,80
031804809,il,-88.10126,42.01108,1620,10,19,9,90
031804810,il,-88.08298,42.01615,1815,10,18,8,80
031804901,il,-87.93222,42.05942,2275,8,15,7,87.5
031804902,il,-87.93097,42.04461,1945,8,15,7,87.5
031805001,il,-87.95125,42.05644,1786,8,15,7,87.5
031805002,il,-87.95077,42.04235,895,8,15,7,87.5
031805105,il,-88.01516,42.05968,627,8,16,8,100
031805106,il,-87.9983,42.06082,581,8,16,8,100
031805107,il,-87.9797,42.04256,500,8,16,8,100
031805108,il,-87.96753,42.04409,759,8,15,7,87.5
031805109,il,-87.9761,42.05507,1512,8,16,8,100
031805110,il,-87.97447,42.06282,1165,8,16,8,100
031805111,il,-87.94373,42.03128,1067,8,15,7,87.5
031805112,il,-87.93228,42.02268,1104,8,15,7,87.5
031805201,il,-87.83074,42.06086,1217,7,13,6,85.7
031805202,il,-87.81474,42.05965,1252,7,13,6,85.7
031805301,il,-87.81965,42.04497,1058,7,13,6,85.7
031805302,il,-87.81344,42.04977,1376,7,13,6,85.7
031805401,il,-87.82598,42.03308,1536,7,13,6,85.7
031805402,il,-87.81133,42.02977,2208,7,13,6,85.7
031805501,il,-87.8379,42.01961,1269,7,14,7,100
031805502,il,-87.82398,42.01715,1419,7,14,7,100
031805600,il,-87.83092,42.00251,1699,7,14,7,100
031805701,il,-87.85103,42.00297,1606,7,14,7,100
031805702,il,-87.84683,41.99206,832,7,14,7,100
031805801,il,-87.8633,42.01883,942,7,14,7,100
031805802,il,-87.84702,42.01465,1756,7,14,7,100
031805901,il,-87.86995,42.03504,1311,7,14,7,100
031805902,il,-87.84721,42.03291,2180,7,13,6,85.7
031806001,il,-87.84915,42.06036,416,7,13,6,85.7
031806002,il,-87.86656,42.04842,983,7,14,7,100
031806004,il,-87.83582,42.04725,1551,7,13,6,85.7
031806005,il,-87.85068,42.04353,402,7,14,7,100
031806006,il,-87.85022,42.05063,956,7,14,7,100
031806102,il,-87.90246,42.04795,1427,8,15,7,87.5
031806103,il,-87.91181,42.05883,2077,8,15,7,87.5
031806104,il,-87.87892,42.05988,429,7,14,7,100
031806201,il,-87.88979,42.04545,761,7,14,7,100
031806202,il,-87.88889,42.03761,889,7,14,7,100
031806300,il,-87.90238,42.03792,1947,8,15,7,87.5
031806400,il,-87.88387,42.02824,982,7,14,7,100
031806501,il,-87.89107,42.0158,844,8,15,7,87.5
031806502,il,-87.87828,42.01652,1761,7,14,7,100
031806600,il,-87.87263,42.00309,1266,7,14,7,100
031806700,il,-87.7228,42.05281,1853,6,12,6,100
031806801,il,-87.73954,42.05638,1137,6,13,7,116.7
031806802,il,-87.73977,42.04438,1149,6,13,7,116.7
031806900,il,-87.75571,42.05677,1225,6,13,7,116.7
031807000,il,-87.75554,42.04445,1295,6,13,7,116.7
031807100,il,-87.72108,42.04445,1608,6,12,6,100
031807200,il,-87.72851,42.03717,2418,6,12,6,100
031807300,il,-87.75491,42.03376,2025,6,13,7,116.7
031807400,il,-87.73984,42.02819,1804,7,13,6,85.7
031807500,il,-87.72814,42.02796,1376,6,12,6,100
031807600,il,-87.72246,42.02144,2868,6,13,7,116.7
031807700,il,-87.75422,42.02076,1616,7,13,6,85.7
031807800,il,-87.76373,42.01516,1195,7,13,6,85.7
031807900,il,-87.74878,42.00419,1614,7,13,6,85.7
031808001,il,-87.73541,42.00702,1619,7,13,6,85.7
031808002,il,-87.71944,42.00506,2034,6,12,6,100
031808100,il,-87.79,42.0113,1136,7,13,6,85.7
031808200,il,-87.79732,42.02642,1975,7,13,6,85.7
031808301,il,-87.78514,42.03334,1699,7,13,6,85.7
031808302,il,-87.76679,42.03228,1510,7,13,6,85.7
031808400,il,-87.79386,42.04874,1785,7,13,6,85.7
031808500,il,-87.7736,42.04724,1947,7,13,6,85.7
031808600,il,-87.78561,42.06023,854,7,13,6,85.7
031808702,il,-87.67188,42.05554,133,7,13,6,85.7
031808800,il,-87.6827,42.06549,1116,6,12,6,100
031808900,il,-87.71747,42.06651,1413,6,12,6,100
031809000,il,-87.71891,42.05976,1466,6,12,6,100
031809100,il,-87.70436,42.05935,1062,6,12,6,100
031809200,il,-87.69927,42.05255,1348,6,12,6,100
031809300,il,-87.68647,42.05795,792,6,12,6,100
031809401,il,-87.66891,42.04337,311,7,13,6,85.7
031809402,il,-87.68203,42.04903,160,6,12,6,100
031809500,il,-87.68773,42.04646,443,6,12,6,100
031809600,il,-87.6999,42.04475,1016,6,12,6,100
031809700,il,-87.69992,42.03747,1241,6,12,6,100
031809800,il,-87.6855,42.03753,560,6,12,6,100
031809900,il,-87.67526,42.03762,508,7,13,6,85.7
031810000,il,-87.66706,42.02615,605,7,13,6,85.7
031810100,il,-87.68463,42.03021,767,6,12,6,100
031810200,il,-87.68334,42.02282,838,6,12,6,100
031810301,il,-87.70161,42.02531,1391,6,12,6,100
031810302,il,-87.69472,42.02941,1024,6,12,6,100
031810400,il,-87.82944,41.98757,2114,7,14,7,100
031810501,il,-87.82599,41.96028,1858,7,14,7,100
031810502,il,-87.81046,41.95958,1681,7,14,7,100
031810600,il,-87.7961,41.96422,1257,7,13,6,85.7
031810701,il,-87.81147,41.93091,1013,8,15,7,87.5
031810702,il,-87.816,41.92528,878,8,15,7,87.5
031810800,il,-87.82097,41.93229,1615,8,15,7,87.5
031810900,il,-87.81007,41.91653,1569,8,15,7,87.5
031811000,il,-87.81972,41.91567,1599,8,15,7,87.5
031811100,il,-87.83442,41.92708,1538,8,15,7,87.5
031811200,il,-87.84538,41.92223,2193,8,16,8,100
031811301,il,-87.88329,41.91599,1558,8,16,8,100
031811302,il,-87.85954,41.91608,965,8,16,8,100
031811401,il,-87.87071,41.93358,1834,8,16,8,100
031811402,il,-87.87482,41.92665,1584,8,16,8,100
031811500,il,-87.86867,41.94138,2776,8,15,7,87.5
031811600,il,-87.8722,41.95119,1583,8,15,7,87.5
031811701,il,-87.90299,41.94213,1224,8,15,7,87.5
031811702,il,-87.9046,41.92645,1221,8,15,7,87.5
031811800,il,-87.90644,41.91411,1716,8,15,7,87.5
031811900,il,-87.81893,41.90085,1664,8,15,7,87.5
031812000,il,-87.82006,41.88767,1771,8,16,8,100
031812100,il,-87.77985,41.9025,1466,8,15,7,87.5
031812200,il,-87.79469,41.90541,1469,7,15,8,114.3
031812301,il,-87.79846,41.88915,472,8,15,7,87.5
031812302,il,-87.80154,41.89675,791,8,15,7,87.5
031812400,il,-87.79112,41.89577,1093,8,15,7,87.5
031812500,il,-87.7807,41.89138,759,8,15,7,87.5
031812600,il,-87.77967,41.88355,605,8,15,7,87.5
031812700,il,-87.78948,41.88339,612,8,15,7,87.5
031812801,il,-87.80241,41.88319,367,8,15,7,87.5
031812802,il,-87.79718,41.88329,356,8,15,7,87.5
031812900,il,-87.79531,41.87632,1510,8,15,7,87.5
031813000,il,-87.78066,41.87636,1197,8,15,7,87.5
031813100,il,-87.78162,41.86901,1497,8,15,7,87.5
031813200,il,-87.79697,41.86906,1375,8,15,7,87.5
031813301,il,-87.75442,41.86216,652,7,15,8,114.3
031813302,il,-87.74467,41.86227,823,7,15,8,114.3
031813400,il,-87.76664,41.86098,1493,8,15,7,87.5
031813500,il,-87.77577,41.85816,1307,8,15,7,87.5
031813600,il,-87.76486,41.85406,940,7,15,8,114.3
031813701,il,-87.7542,41.85488,584,7,15,8,114.3
031813702,il,-87.74651,41.85518,624,7,15,8,114.3
031813801,il,-87.74346,41.85035,711,7,15,8,114.3
031813802,il,-87.75399,41.84797,925,7,15,8,114.3
031813900,il,-87.76849,41.8465,1120,8,15,7,87.5
031814000,il,-87.77542,41.84537,970,8,15,7,87.5
031814100,il,-87.76304,41.84228,778,7,15,8,114.3
031814200,il,-87.74562,41.83565,1496,7,15,8,114.3
031814300,il,-87.75825,41.8342,1006,7,15,8,114.3
031814400,il,-87.76355,41.82769,2084,7,15,8,114.3
031814500,il,-87.77455,41.83021,1537,8,15,7,87.5
031814600,il,-87.78507,41.86165,1505,8,15,7,87.5
031814700,il,-87.79763,41.86145,1459,8,15,7,87.5
031814800,il,-87.79834,41.84944,1682,8,15,7,87.5
031814900,il,-87.78979,41.85338,935,8,15,7,87.5
031815000,il,-87.78459,41.85543,849,8,15,7,87.5
031815100,il,-87.78558,41.84751,1067,8,15,7,87.5
031815200,il,-87.78405,41.83831,1897,8,15,7,87.5
031815300,il,-87.79535,41.83938,1204,8,15,7,87.5
031815400,il,-87.79619,41.83137,1793,8,15,7,87.5
031815500,il,-87.78777,41.82515,2495,8,15,7,87.5
031815600,il,-87.82404,41.84497,1966,8,16,8,100
031815701,il,-87.81108,41.83671,1555,8,16,8,100
031815702,il,-87.81922,41.82788,1848,8,16,8,100
031815800,il,-87.837,41.83155,717,8,16,8,100
031815900,il,-87.80972,41.88324,718,8,16,8,100
031816000,il,-87.81635,41.87638,895,8,16,8,100
031816100,il,-87.81839,41.86156,2096,8,16,8,100
031816200,il,-87.84083,41.90362,1216,8,16,8,100
031816300,il,-87.85771,41.90425,1482,8,16,8,100
031816401,il,-87.86033,41.89558,992,8,16,8,100
031816402,il,-87.85098,41.89438,1278,8,16,8,100
031816500,il,-87.88111,41.89817,865,8,16,8,100
031816600,il,-87.88084,41.90322,1233,8,16,8,100
031816700,il,-87.89638,41.90457,857,8,15,7,87.5
031816800,il,-87.91191,41.89144,2547,8,16,8,100
031816900,il,-87.89066,41.88678,1926,8,16,8,100
031817000,il,-87.87251,41.88736,1960,8,16,8,100
031817101,il,-87.8781,41.87625,1477,8,16,8,100
031817102,il,-87.86578,41.87719,1233,8,16,8,100
031817200,il,-87.85453,41.88301,1421,8,16,8,100
031817300,il,-87.84785,41.88408,950,8,16,8,100
031817400,il,-87.83826,41.893,1110,8,16,8,100
031817500,il,-87.83582,41.88029,1258,8,16,8,100
031817600,il,-87.83844,41.8701,1283,8,16,8,100
031817700,il,-87.85174,41.87175,1741,8,16,8,100
031817900,il,-87.845,41.85878,2003,8,16,8,100
031818000,il,-87.85844,41.85436,1871,8,16,8,100
031818100,il,-87.87375,41.85119,1088,9,17,8,88.9
031818200,il,-87.87514,41.86352,2056,8,16,8,100
031818300,il,-87.89878,41.87727,2167,8,16,8,100
031818401,il,-87.90312,41.86142,1631,8,16,8,100
031818402,il,-87.89186,41.8519,1218,9,17,8,88.9
031818500,il,-87.89843,41.84074,3022,9,17,8,88.9
031818600,il,-87.8655,41.84024,1789,9,17,8,88.9
031818700,il,-87.84612,41.83355,1663,8,16,8,100
031818800,il,-87.85442,41.82712,2544,9,17,8,88.9
031818900,il,-87.86686,41.82759,1278,9,17,8,88.9
031819000,il,-87.89551,41.82628,1694,9,17,8,88.9
031819100,il,-87.81356,41.81506,1269,8,16,8,100
031819200,il,-87.83003,41.81188,2178,8,16,8,100
031819300,il,-87.85012,41.81745,1578,9,17,8,88.9
031819400,il,-87.84987,41.81003,2101,9,17,8,88.9
031819500,il,-87.86726,41.8143,1161,9,17,8,88.9
031819600,il,-87.86842,41.80512,1448,9,17,8,88.9
031819700,il,-87.88082,41.80904,2186,9,17,8,88.9
031819801,il,-87.8974,41.81219,1959,9,18,9,100
031819802,il,-87.89491,41.7972,1044,9,18,9,100
031819900,il,-87.90716,41.80418,1391,9,18,9,100
031820000,il,-87.91395,41.80141,901,9,18,9,100
031820101,il,-87.90323,41.77629,2767,9,18,9,100
031820103,il,-87.87312,41.79452,1505,9,17,8,88.9
031820104,il,-87.8771,41.78215,1249,9,17,8,88.9
031820202,il,-87.8503,41.77555,1794,9,17,8,88.9
031820203,il,-87.90133,41.7346,1659,10,19,9,90
031820204,il,-87.89171,41.75948,1197,9,18,9,100
031820300,il,-87.80703,41.79198,1515,8,15,7,87.5
031820400,il,-87.81263,41.78211,1713,8,16,8,100
031820501,il,-87.82109,41.76131,2296,9,17,8,88.9
031820502,il,-87.80481,41.75386,1621,8,17,9,112.5
031820603,il,-87.84339,41.75434,1147,9,17,8,88.9
031820604,il,-87.82688,41.74988,746,9,17,8,88.9
031820605,il,-87.83046,41.73806,596,9,17,8,88.9
031820606,il,-87.85429,41.73775,1135,9,17,8,88.9
031820700,il,-87.77301,41.8183,2285,8,15,7,87.5
031820800,il,-87.77581,41.80653,1679,7,15,8,114.3
031820901,il,-87.77452,41.7629,2448,8,17,9,112.5
031820902,il,-87.75302,41.75399,1876,8,17,9,112.5
031821001,il,-87.79136,41.74217,1627,8,17,9,112.5
031821002,il,-87.77643,41.74153,1901,8,17,9,112.5
031821101,il,-87.76219,41.73828,1562,8,17,9,112.5
031821102,il,-87.74925,41.74292,1356,8,17,9,112.5
031821200,il,-87.6723,41.66839,2108,10,19,9,90
031821300,il,-87.66845,41.65426,1440,10,19,9,90
031821401,il,-87.65787,41.66621,1183,10,19,9,90
031821402,il,-87.65218,41.66229,1304,10,19,9,90
031821500,il,-87.63659,41.65138,771,10,20,10,100
031821600,il,-87.69933,41.73002,2077,9,18,9,100
031821700,il,-87.71535,41.72117,2100,9,18,9,100
031821800,il,-87.70042,41.7195,2384,9,18,9,100
031821900,il,-87.69698,41.71224,2255,9,18,9,100
031822000,il,-87.73113,41.73125,1683,9,18,9,100
031822101,il,-87.74562,41.72416,1784,9,18,9,100
031822102,il,-87.7315,41.72155,1253,9,18,9,100
031822200,il,-87.7591,41.72721,1683,9,18,9,100
031822301,il,-87.77126,41.72985,1606,9,18,9,100
031822302,il,-87.77408,41.71716,1779,9,18,9,100
031822400,il,-87.78847,41.72294,1760,9,18,9,100
031822500,il,-87.75828,41.71787,2057,9,18,9,100
031822601,il,-87.75381,41.70896,1631,9,18,9,100
031822602,il,-87.75322,41.69914,1875,9,18,9,100
031822701,il,-87.73033,41.71238,1004,9,18,9,100
031822702,il,-87.73058,41.70569,1236,9,18,9,100
031822801,il,-87.7382,41.6954,968,9,18,9,100
031822802,il,-87.72787,41.69756,1269,9,18,9,100
031822900,il,-87.79477,41.72769,634,9,18,9,100
031823001,il,-87.78419,41.70696,1195,9,18,9,100
031823002,il,-87.76949,41.69607,1714,9,18,9,100
031823101,il,-87.79285,41.69085,1214,9,18,9,100
031823102,il,-87.77891,41.68584,1226,9,18,9,100
031823200,il,-87.75382,41.67595,1770,10,19,9,90
031823302,il,-87.72311,41.66164,1622,10,19,9,90
031823303,il,-87.72791,41.67774,1396,10,19,9,90
031823304,il,-87.70275,41.68143,1626,10,19,9,90
031823400,il,-87.69651,41.66517,2171,10,19,9,90
031823500,il,-87.68318,41.6656,1544,10,19,9,90
031823602,il,-87.75887,41.65375,1629,10,19,9,90
031823603,il,-87.71116,41.65007,1766,10,19,9,90
031823604,il,-87.78843,41.65786,1326,9,18,9,100
031823605,il,-87.7753,41.66727,1418,9,18,9,100
031823702,il,-87.83209,41.711,1531,9,18,9,100
031823703,il,-87.80825,41.71881,1530,9,18,9,100
031823704,il,-87.83917,41.72666,1427,9,18,9,100
031823705,il,-87.82619,41.72447,1340,9,18,9,100
031823801,il,-87.88082,41.68831,2453,10,19,9,90
031823803,il,-87.82678,41.69702,2084,9,18,9,100
031823805,il,-87.82435,41.68736,674,9,18,9,100
031823806,il,-87.80601,41.6881,1055,9,18,9,100
031823901,il,-87.83885,41.66871,1697,9,18,9,100
031823903,il,-87.81873,41.66064,1891,9,18,9,100
031823904,il,-87.80501,41.65726,1310,9,18,9,100
031824003,il,-87.98572,41.6636,2422,11,20,9,81.8
031824004,il,-87.94681,41.6834,2528,10,20,10,100
031824005,il,-88.01438,41.66333,2431,10,20,10,100
031824006,il,-87.95206,41.65291,2169,10,20,10,100
031824105,il,-87.83749,41.63782,2191,9,18,9,100
031824106,il,-87.82489,41.61783,2152,9,19,10,111.1
031824107,il,-87.81331,41.60842,1969,9,19,10,111.1
031824113,il,-87.90169,41.62231,2622,10,20,10,100
031824114,il,-87.87962,41.61732,2252,10,20,10,100
031824115,il,-87.84325,41.62392,1056,9,19,10,111.1
031824116,il,-87.8683,41.62661,1576,10,20,10,100
031824119,il,-87.90038,41.57873,2205,10,21,11,110
031824121,il,-87.82754,41.59181,1033,10,19,9,90
031824122,il,-87.81785,41.57995,1869,10,20,10,100
031824123,il,-87.80355,41.59123,2423,9,19,10,111.1
031824124,il,-87.84446,41.59551,1014,10,19,9,90
031824125,il,-87.83806,41.58588,1472,10,19,9,90
031824126,il,-87.83116,41.56749,1893,10,20,10,100
031824127,il,-87.84525,41.57163,1381,10,20,10,100
031824128,il,-87.86803,41.57122,1404,10,20,10,100
031824129,il,-87.87573,41.58867,1489,10,20,10,100
031824300,il,-87.69926,41.64132,4620,10,19,9,90
031824400,il,-87.72621,41.63996,1365,9,19,10,111.1
031824503,il,-87.78026,41.63784,1854,9,18,9,100
031824505,il,-87.76864,41.60808,1799,9,18,9,100
031824507,il,-87.77483,41.59529,1360,9,19,10,111.1
031824508,il,-87.79148,41.61631,745,9,18,9,100
031824509,il,-87.77181,41.61879,1363,9,18,9,100
031824601,il,-87.74494,41.62867,1630,9,18,9,100
031824602,il,-87.7385,41.61741,2179,9,18,9,100
031824701,il,-87.71865,41.62817,1584,9,19,10,111.1
031824702,il,-87.70848,41.62199,2075,10,19,9,90
031824800,il,-87.68526,41.62446,3950,10,19,9,90
031824900,il,-87.69771,41.6095,3907,9,19,10,111.1
031825000,il,-87.73901,41.60291,1704,9,18,9,100
031825200,il,-87.72724,41.59671,740,9,18,9,100
031825302,il,-87.75741,41.58117,1974,9,18,9,100
031825303,il,-87.78586,41.58163,1370,9,19,10,111.1
031825304,il,-87.80399,41.57361,1207,9,19,10,111.1
031825400,il,-87.77803,41.5654,1717,9,19,10,111.1
031825501,il,-87.71709,41.57846,1854,9,18,9,100
031825503,il,-87.68461,41.57141,2816,9,19,10,111.1
031825504,il,-87.70403,41.56442,1194,9,19,10,111.1
031825505,il,-87.73307,41.56434,1957,9,19,10,111.1
031825600,il,-87.69792,41.593,3110,9,19,10,111.1
031825700,il,-87.5447,41.63754,2001,10,19,9,90
031825801,il,-87.57251,41.63448,829,10,20,10,100
031825802,il,-87.56006,41.62638,2094,10,19,9,90
031825803,il,-87.56204,41.61924,2115,10,19,9,90
031825900,il,-87.54237,41.6217,2133,10,19,9,90
031826000,il,-87.53241,41.62392,1560,10,19,9,90
031826100,il,-87.53668,41.60656,3174,10,20,10,100
031826201,il,-87.56478,41.60493,703,10,20,10,100
031826202,il,-87.53637,41.59317,2212,11,21,10,90.9
031826301,il,-87.60649,41.61529,1652,10,20,10,100
031826303,il,-87.59145,41.61341,1523,10,20,10,100
031826304,il,-87.58251,41.61806,1108,10,20,10,100
031826401,il,-87.59391,41.63882,1537,10,20,10,100
031826402,il,-87.59009,41.62807,2188,10,20,10,100
031826500,il,-87.61544,41.63011,2672,10,20,10,100
031826600,il,-87.62302,41.63635,2096,10,20,10,100
031826700,il,-87.63356,41.63621,1707,10,20,10,100
031826800,il,-87.66002,41.63736,2820,10,19,9,90
031826901,il,-87.66448,41.62105,1825,10,19,9,90
031826902,il,-87.66401,41.61487,986,10,19,9,90
031827000,il,-87.64511,41.62634,1895,10,20,10,100
031827100,il,-87.64636,41.61806,1333,10,20,10,100
031827200,il,-87.62682,41.61181,3052,10,20,10,100
031827300,il,-87.64622,41.60903,1298,10,19,9,90
031827400,il,-87.66595,41.60537,2912,10,19,9,90
031827500,il,-87.6385,41.59248,3478,10,20,10,100
031827600,il,-87.66414,41.59205,1882,10,19,9,90
031827700,il,-87.66576,41.58243,1785,10,19,9,90
031827801,il,-87.60816,41.60123,1877,11,20,9,81.8
031827802,il,-87.59043,41.6007,1296,11,21,10,90.9
031827804,il,-87.59509,41.59009,1234,11,21,10,90.9
031827805,il,-87.60107,41.58394,1228,11,21,10,90.9
031827901,il,-87.57214,41.58721,1192,11,21,10,90.9
031827902,il,-87.54498,41.58473,1951,11,21,10,90.9
031828000,il,-87.54176,41.57323,2217,11,21,10,90.9
031828100,il,-87.53563,41.56344,2177,11,21,10,90.9
031828201,il,-87.56799,41.57071,1795,11,21,10,90.9
031828202,il,-87.56585,41.56107,1483,11,21,10,90.9
031828300,il,-87.61208,41.56997,1716,10,20,10,100
031828401,il,-87.6652,41.56799,1599,10,19,9,90
031828402,il,-87.64591,41.56828,1268,10,19,9,90
031828503,il,-87.55959,41.50308,1641,10,19,9,90
031828504,il,-87.54963,41.48132,2131,9,19,10,111.1
031828505,il,-87.56093,41.54322,2851,11,21,10,90.9
031828507,il,-87.5349,41.53049,1138,11,21,10,90.9
031828508,il,-87.54539,41.52043,1304,10,20,10,100
031828601,il,-87.66086,41.54896,1780,10,19,9,90
031828602,il,-87.64473,41.5478,1527,10,19,9,90
031828701,il,-87.62527,41.54314,1442,10,20,10,100
031828702,il,-87.59906,41.53784,1895,10,20,10,100
031828801,il,-87.66175,41.53428,1966,10,19,9,90
031828802,il,-87.64274,41.53217,1220,10,19,9,90
031828900,il,-87.63495,41.51616,2568,9,19,10,111.1
031829000,il,-87.62349,41.51033,1411,9,19,10,111.1
031829100,il,-87.62949,41.49661,2576,9,19,10,111.1
031829200,il,-87.64832,41.50926,2032,9,19,10,111.1
031829301,il,-87.66378,41.51838,1585,9,19,10,111.1
031829302,il,-87.66628,41.50494,1188,9,19,10,111.1
031829401,il,-87.65976,41.49695,676,9,19,10,111.1
031829402,il,-87.66192,41.48186,476,9,19,10,111.1
031829500,il,-87.63539,41.48433,2270,9,19,10,111.1
031829600,il,-87.63304,41.47343,2643,9,19,10,111.1
031829700,il,-87.59736,41.49486,3292,10,19,9,90
031829800,il,-87.68434,41.54259,2414,10,19,9,90
031829902,il,-87.72666,41.53822,2091,9,19,10,111.1
031829903,il,-87.72281,41.55,1696,9,19,10,111.1
031829904,il,-87.76734,41.54668,1528,10,19,9,90
031830001,il,-87.77042,41.49539,19,10,19,9,90
031830003,il,-87.77052,41.5137,2791,10,19,9,90
031830004,il,-87.72883,41.51621,2690,9,19,10,111.1
031830005,il,-87.69214,41.51788,1744,9,19,10,111.1
031830006,il,-87.72867,41.49971,1183,9,19,10,111.1
031830007,il,-87.72288,41.48161,1426,9,19,10,111.1
031830008,il,-87.76123,41.48077,1761,9,19,10,111.1
031830100,il,-87.68777,41.50237,1263,9,19,10,111.1
031830201,il,-87.70862,41.48343,1564,9,19,10,111.1
031830202,il,-87.69189,41.49206,1285,9,19,10,111.1
031830300,il,-87.68106,41.48386,749,9,19,10,111.1
031830400,il,-87.69184,41.47492,1991,9,19,10,111.1
031830500,il,-87.72395,41.83007,1141,7,15,8,114.3
031830600,il,-87.67357,42.0017,598,7,13,6,85.7
031830700,il,-87.65917,41.96098,299,7,13,6,85.7
031830800,il,-87.67658,41.96514,288,7,13,6,85.7
031830900,il,-87.68537,41.92863,808,7,14,7,100
031831000,il,-87.677,41.9148,570,7,14,7,100
031831100,il,-87.7175,41.94286,1445,7,13,6,85.7
031831200,il,-87.73226,41.91532,867,7,14,7,100
031831300,il,-87.74426,41.90777,419,7,14,7,100
031831400,il,-87.75609,41.86912,1241,7,15,8,114.3
031831500,il,-87.78801,41.9276,830,7,15,8,114.3
031831600,il,-87.79761,41.92561,1589,7,15,8,114.3
031831700,il,-87.74525,41.95265,662,7,13,6,85.7
031831800,il,-87.71649,41.97822,1221,7,13,6,85.7
031831900,il,-87.66879,41.94517,550,7,13,6,85.7
031832000,il,-87.6543,41.94629,267,7,13,6,85.7
031832100,il,-87.65324,41.95282,300,7,13,6,85.7
031832200,il,-87.67997,41.92048,787,7,14,7,100
031832300,il,-87.67145,41.91921,732,7,14,7,100
031832400,il,-87.69226,41.91574,664,7,14,7,100
031832500,il,-87.66412,41.92188,832,7,14,7,100
031832600,il,-87.65406,41.91475,1030,7,14,7,100
031832900,il,-87.66193,41.87418,505,7,14,7,100
031833000,il,-87.65725,41.88529,1071,7,14,7,100
031833100,il,-87.65705,41.87908,1004,7,14,7,100
031833300,il,-87.65412,41.87169,636,7,14,7,100
031833900,il,-87.54785,41.73188,796,8,16,8,100
031834000,il,-87.62943,41.72739,594,8,16,8,100
031834200,il,-87.58361,41.75557,1373,8,16,8,100
031834300,il,-87.59179,41.74584,2628,8,16,8,100
031834400,il,-87.5963,41.77695,783,8,16,8,100
031834500,il,-87.62474,41.78808,681,8,16,8,100
031834600,il,-87.63431,41.78725,1757,8,16,8,100
031834700,il,-87.64503,41.79069,966,8,16,8,100
031834800,il,-87.64509,41.78363,1048,8,16,8,100
031834900,il,-87.65674,41.7723,734,8,16,8,100
031835000,il,-87.68605,41.78285,1206,8,15,7,87.5
031835100,il,-87.68625,41.79016,1254,8,15,7,87.5
031835200,il,-87.74529,41.79664,590,7,15,8,114.3
031835500,il,-87.63254,41.81635,1006,8,16,8,100
031835600,il,-87.6322,41.80183,1001,8,16,8,100
031835800,il,-87.61872,41.81305,355,8,16,8,100
031836000,il,-87.61168,41.814,740,8,16,8,100
031836100,il,-87.61868,41.79981,426,8,16,8,100
031836200,il,-87.60128,41.79047,239,8,16,8,100
031836300,il,-87.60176,41.80153,110,8,16,8,100
031836400,il,-87.59583,41.82118,636,8,15,7,87.5
031836500,il,-87.60061,41.82827,276,8,15,7,87.5
031836600,il,-87.70881,41.8987,806,7,14,7,100
031836700,il,-87.70217,41.8917,705,7,14,7,100
031836800,il,-87.71386,41.88504,675,7,14,7,100
031836900,il,-87.70614,41.88188,260,7,14,7,100
031837000,il,-87.69867,41.87832,828,7,14,7,100
031837100,il,-87.69872,41.88567,935,7,14,7,100
031837300,il,-87.70555,41.87162,709,7,14,7,100
031837400,il,-87.6938,41.87597,849,7,14,7,100
031837800,il,-87.68413,41.88475,1018,7,14,7,100
031838000,il,-87.68065,41.87737,661,7,14,7,100
031838100,il,-87.67169,41.87867,534,7,14,7,100
031838200,il,-87.67513,41.87041,1028,7,14,7,100
031838300,il,-87.6384,41.90157,295,8,15,7,87.5
031838600,il,-87.70082,41.86782,398,7,14,7,100
031838700,il,-87.72019,41.86258,1000,7,14,7,100
031838800,il,-87.57231,41.68349,3291,9,18,9,100
031839000,il,-87.6314,41.87104,223,8,15,7,87.5
031839100,il,-87.63275,41.88103,1372,8,15,7,87.5
031839200,il,-87.62204,41.84201,373,8,15,7,87.5
031839500,il,-87.61929,41.8341,462,8,15,7,87.5
031839600,il,-87.61925,41.82744,557,8,15,7,87.5
031839700,il,-87.65218,41.8331,1139,8,15,7,87.5
031839800,il,-87.64316,41.83507,591,8,15,7,87.5
031839900,il,-87.6486,41.82711,1500,8,15,7,87.5
031840000,il,-87.63841,41.83144,906,8,15,7,87.5
031840100,il,-87.6392,41.84183,562,8,15,7,87.5
031840200,il,-87.64932,41.84471,938,8,15,7,87.5
031840300,il,-87.68188,41.8321,1156,8,15,7,87.5
031840400,il,-87.66753,41.83383,1106,8,15,7,87.5
031840700,il,-87.69427,41.85293,695,7,15,8,114.3
031840800,il,-87.70737,41.84083,543,7,15,8,114.3
031841000,il,-87.61739,41.84844,651,8,15,7,87.5
031841100,il,-87.63511,41.85099,1479,8,15,7,87.5
031841200,il,-87.68334,41.85556,889,8,15,7,87.5
031841300,il,-87.68302,41.84408,966,8,15,7,87.5
031841500,il,-87.70791,41.86162,691,7,14,7,100
031841700,il,-87.70418,41.85313,349,7,15,8,114.3
031841800,il,-87.59942,41.76631,1094,8,16,8,100
031841900,il,-87.64297,41.86789,1290,7,14,7,100
031842000,il,-87.62517,41.83496,297,8,15,7,87.5
031842100,il,-87.73361,41.89528,1586,7,14,7,100
031842200,il,-87.64979,41.90488,862,7,14,7,100
031842300,il,-87.65617,41.9024,1241,7,14,7,100
031842400,il,-87.63007,41.74243,1387,8,16,8,100
031842500,il,-87.62322,41.77695,423,8,16,8,100
031842600,il,-87.65169,41.81622,2022,8,16,8,100
031842800,il,-87.6983,41.80753,1448,8,15,7,87.5
031842900,il,-87.67294,41.86314,1154,7,14,7,100
031843000,il,-87.72275,41.86794,933,7,14,7,100
031843100,il,-87.70071,41.86075,460,7,14,7,100
031843200,il,-87.6635,41.84747,1042,8,15,7,87.5
031843300,il,-87.69255,41.86376,528,7,14,7,100
031843400,il,-87.73202,41.84933,553,7,15,8,114.3
031843500,il,-87.69675,41.83822,439,7,15,8,114.3
031843600,il,-87.60895,41.80677,598,8,16,8,100
031843700,il,-87.6908,41.94485,751,7,13,6,85.7
031843800,il,-87.64048,41.80166,1236,8,16,8,100
031843900,il,-87.57602,41.77659,433,8,16,8,100
031844600,il,-87.62544,41.81339,373,8,16,8,100
031844700,il,-87.7117,41.85415,681,7,15,8,114.3
031980000,il,-87.90384,41.98028,200,8,15,7,87.5
031980100,il,-87.7509,41.78598,11,7,15,8,114.3
033880100,il,-87.78964,39.1113,3527,24,43,19,79.2
033880200,il,-87.85962,39.00801,3155,24,43,19,79.2
033880300,il,-87.75172,39.01516,2052,26,45,19,73.1
033880400,il,-87.74116,38.99786,1894,26,45,19,73.1
033880500,il,-87.63717,39.00617,2348,27,46,19,70.4
033880600,il,-87.74244,38.90487,3977,24,43,19,79.2
035972400,il,-88.09499,39.25622,3763,19,37,18,94.7
035972500,il,-88.23344,39.29469,3784,19,38,19,100
035972600,il,-88.39338,39.26954,3939,19,37,18,94.7
037000100,il,-88.65253,42.10661,3237,9,18,9,100
037000200,il,-88.82573,42.11145,2865,9,18,9,100
037000300,il,-88.86924,41.96281,1980,9,18,9,100
037000401,il,-88.63426,41.99418,1637,9,17,8,88.9
037000402,il,-88.70585,42.03775,2511,9,17,8,88.9
037000500,il,-88.73647,41.9878,1420,8,17,9,112.5
037000600,il,-88.68183,41.98247,2690,8,17,9,112.5
037000700,il,-88.70226,41.97375,1677,8,16,8,100
037000800,il,-88.71498,41.94646,3058,8,17,9,112.5
037000900,il,-88.7504,41.94877,1741,8,17,9,112.5
037001002,il,-88.78339,41.94078,240,9,18,9,100
037001003,il,-88.76977,41.94652,126,9,18,9,100
037001004,il,-88.78309,41.95741,754,8,17,9,112.5
037001300,il,-88.7556,41.92858,1756,8,17,9,112.5
037001400,il,-88.7873,41.8928,2684,9,17,8,88.9
037001500,il,-88.73727,41.88407,1549,8,17,9,112.5
037001600,il,-88.65382,41.91644,2509,8,17,9,112.5
037001700,il,-88.6752,41.79069,2527,10,20,10,100
037001800,il,-88.84659,41.73947,3060,9,18,9,100
037001900,il,-88.68498,41.67436,1471,10,21,11,110
037002000,il,-88.62953,41.65672,2064,11,21,10,90.9
037002100,il,-88.62891,41.63915,1010,11,21,10,90.9
037002200,il,-88.76975,41.93423,97,9,17,8,88.9
039971400,il,-88.68366,40.22401,1786,14,31,17,121.4
039971500,il,-88.84823,40.16724,2831,15,32,17,113.3
039971600,il,-89.05768,40.16574,2899,16,33,17,106.3
039971700,il,-88.97137,40.15105,1521,15,33,18,120
039971800,il,-88.94915,40.14823,1712,15,33,18,120
041952000,il,-88.08282,39.75884,3717,18,36,18,100
041952100,il,-88.20609,39.82734,2929,19,37,18,94.7
041952200,il,-88.27891,39.79663,2235,20,39,19,95
041952300,il,-88.40297,39.77348,3799,18,37,19,105.6
041952400,il,-88.30602,39.72376,2177,18,37,19,105.6
043840000,il,-87.9388,41.97568,1753,8,15,7,87.5
043840101,il,-87.97719,41.97771,2345,8,15,7,87.5
043840102,il,-87.99403,41.95966,1514,9,17,8,88.9
043840103,il,-87.97272,41.9468,2480,8,16,8,100
043840104,il,-87.99226,41.94348,1111,10,18,8,80
043840201,il,-88.0144,41.97885,2296,9,17,8,88.9
043840202,il,-88.01499,41.95438,1858,9,17,8,88.9
043840303,il,-88.00575,41.93531,708,10,19,9,90
043840304,il,-88.02328,41.93818,1321,11,20,9,81.8
043840600,il,-87.94957,41.90948,1715,9,16,7,77.8
043840703,il,-87.92987,41.93883,850,8,16,8,100
043840704,il,-87.95226,41.93779,688,9,16,7,77.8
043840705,il,-87.95104,41.92267,1356,9,16,7,77.8
043840706,il,-87.92831,41.91928,1238,8,16,8,100
043840801,il,-87.93173,41.95074,671,8,15,7,87.5
043840802,il,-87.95005,41.95355,1511,8,15,7,87.5
043840901,il,-88.04107,41.97244,1033,10,18,8,80
043840904,il,-88.05475,41.9281,712,12,21,9,75
043840906,il,-88.03702,41.94217,621,11,20,9,81.8
043840907,il,-88.05236,41.94433,1192,11,19,8,72.7
043840908,il,-88.04825,41.9122,1287,11,21,10,90.9
043840910,il,-88.07191,41.91065,1376,12,22,10,83.3
043840911,il,-88.0732,41.92183,769,12,22,10,83.3
043841002,il,-88.06611,41.96406,1128,11,19,8,72.7
043841003,il,-88.06297,41.98605,1214,10,18,8,80
043841004,il,-88.0671,41.97655,1093,11,20,9,81.8
043841102,il,-88.12132,41.98104,1495,10,19,9,90
043841103,il,-88.0954,41.96689,1300,11,20,9,81.8
043841104,il,-88.09259,41.98113,1689,10,19,9,90
043841108,il,-88.13568,41.96603,1424,10,19,9,90
043841109,il,-88.07281,41.94038,1028,12,21,9,75
043841110,il,-88.07071,41.94884,1170,11,20,9,81.8
043841111,il,-88.0887,41.95664,1454,11,20,9,81.8
043841112,il,-88.11515,41.96239,956,10,19,9,90
043841113,il,-88.08645,41.94601,805,11,20,9,81.8
043841114,il,-88.1176,41.94611,1431,11,20,9,81.8
043841204,il,-88.09107,41.93001,1846,12,22,10,83.3
043841205,il,-88.13339,41.92349,1322,11,21,10,90.9
043841206,il,-88.13526,41.91091,1745,11,20,9,81.8
043841207,il,-88.09129,41.91946,892,12,22,10,83.3
043841208,il,-88.10111,41.90962,1338,12,21,9,75
043841209,il,-88.12321,41.9349,1091,11,20,9,81.8
043841210,il,-88.11512,41.92254,487,11,21,10,90.9
043841307,il,-88.16226,41.91821,2003,11,20,9,81.8
043841308,il,-88.23398,41.96787,1741,10,18,8,80
043841310,il,-88.24001,41.94071,1223,9,18,9,100
043841312,il,-88.23567,41.90922,884,10,19,9,90
043841313,il,-88.22989,41.92643,1120,10,18,8,80
043841314,il,-88.17122,41.97902,2188,10,19,9,90
043841315,il,-88.15408,41.98192,990,10,19,9,90
043841316,il,-88.19483,41.9777,1361,10,18,8,80
043841318,il,-88.17096,41.96492,882,10,19,9,90
043841320,il,-88.14909,41.96162,870,10,19,9,90
043841321,il,-88.16465,41.96043,638,10,19,9,90
043841322,il,-88.15524,41.9463,1382,10,19,9,90
043841323,il,-88.17047,41.94505,963,10,19,9,90
043841324,il,-88.1505,41.92332,861,11,20,9,81.8
043841325,il,-88.1592,41.93505,1828,11,20,9,81.8
043841326,il,-88.18586,41.91847,1465,10,19,9,90
043841327,il,-88.1943,41.95239,1562,10,18,8,80
043841401,il,-88.17889,41.88101,2425,11,21,10,90.9
043841403,il,-88.16408,41.86505,1792,12,21,9,75
043841404,il,-88.1593,41.89188,1281,11,21,10,90.9
043841501,il,-88.2279,41.88717,2065,11,20,9,81.8
043841503,il,-88.19948,41.87013,905,11,20,9,81.8
043841504,il,-88.20071,41.88349,956,11,20,9,81.8
043841603,il,-88.17316,41.84024,1500,12,22,10,83.3
043841604,il,-88.23445,41.82666,1284,11,21,10,90.9
043841605,il,-88.23322,41.85772,1042,11,21,10,90.9
043841606,il,-88.15986,41.81733,611,12,23,11,91.7
043841607,il,-88.19043,41.81974,1743,12,22,10,83.3
043841704,il,-88.1245,41.8949,1778,12,22,10,83.3
043841705,il,-88.06571,41.89667,1476,12,22,10,83.3
043841706,il,-88.03957,41.88567,834,12,22,10,83.3
043841707,il,-88.09113,41.89934,147,12,22,10,83.3
043841708,il,-88.09433,41.89213,289,12,23,11,91.7
043841801,il,-88.10487,41.8806,1765,12,22,10,83.3
043841802,il,-88.13178,41.88057,2171,12,22,10,83.3
043841901,il,-88.0859,41.88145,912,12,23,11,91.7
043841902,il,-88.09334,41.87065,801,12,23,11,91.7
043842000,il,-88.06033,41.8847,1729,12,23,11,91.7
043842100,il,-88.0498,41.87013,1887,12,23,11,91.7
043842200,il,-88.06651,41.875,1414,12,23,11,91.7
043842300,il,-88.07372,41.86697,1364,12,23,11,91.7
043842400,il,-88.09078,41.86247,1635,12,23,11,91.7
043842500,il,-88.10889,41.86462,1145,12,23,11,91.7
043842601,il,-88.12626,41.82609,1266,13,24,11,84.6
043842602,il,-88.1193,41.84254,1617,13,24,11,84.6
043842603,il,-88.12976,41.86795,1056,12,22,10,83.3
043842604,il,-88.13859,41.85202,945,13,23,10,76.9
043842605,il,-88.12195,41.85634,1572,13,23,10,76.9
043842702,il,-88.09181,41.83524,824,14,25,11,78.6
043842703,il,-88.0957,41.84967,1351,14,25,11,78.6
043842704,il,-88.08283,41.84669,1380,14,25,11,78.6
043842706,il,-88.05399,41.83028,1839,13,24,11,84.6
043842708,il,-88.0482,41.84606,987,13,24,11,84.6
043842709,il,-88.03866,41.84495,1063,13,24,11,84.6
043842710,il,-88.0702,41.84554,731,14,25,11,78.6
043842711,il,-88.08958,41.82221,1095,14,25,11,78.6
043842800,il,-87.92689,41.89647,1659,8,16,8,100
043842900,il,-87.94105,41.89855,1447,9,17,8,88.9
043843000,il,-87.95898,41.89746,1391,9,18,9,100
043843100,il,-87.97503,41.89818,1213,10,19,9,90
043843200,il,-87.9866,41.89478,1831,11,20,9,81.8
043843301,il,-88.00567,41.9009,1410,11,20,9,81.8
043843302,il,-88.0052,41.89361,1126,11,21,10,90.9
043843400,il,-88.02558,41.89643,1265,12,22,10,83.3
043843500,il,-88.02179,41.88227,1687,12,22,10,83.3
043843601,il,-87.9945,41.88221,1150,11,21,10,90.9
043843602,il,-88.00619,41.88257,1190,11,21,10,90.9
043843700,il,-87.97972,41.87704,1742,11,20,9,81.8
043843800,il,-87.96824,41.88347,1242,10,19,9,90
043843900,il,-87.95184,41.88384,1370,10,18,8,80
043844001,il,-87.93274,41.8752,1271,9,17,8,88.9
043844002,il,-87.93498,41.88534,1551,9,17,8,88.9
043844100,il,-87.94893,41.87343,1462,10,18,8,80
043844201,il,-88.02028,41.86729,1919,12,22,10,83.3
043844202,il,-88.0002,41.86809,1011,11,21,10,90.9
043844304,il,-88.02171,41.8564,648,13,23,10,76.9
043844305,il,-88.02712,41.8448,463,13,24,11,84.6
043844306,il,-87.98261,41.85222,1366,12,22,10,83.3
043844307,il,-87.98493,41.86461,715,11,21,10,90.9
043844308,il,-88.0031,41.84197,55,12,22,10,83.3
043844309,il,-88.00169,41.85302,827,12,22,10,83.3
043844310,il,-88.01782,41.84185,411,12,22,10,83.3
043844401,il,-88.01593,41.82778,1268,12,23,11,91.7
043844402,il,-87.98814,41.82971,1543,12,22,10,83.3
043844501,il,-87.96601,41.85953,1318,10,19,9,90
043844502,il,-87.96418,41.82975,1079,11,20,9,81.8
043844601,il,-87.9418,41.84062,1384,10,19,9,90
043844602,il,-87.92885,41.85596,1453,9,17,8,88.9
043844701,il,-87.98135,41.80819,1721,12,22,10,83.3
043844702,il,-87.94559,41.81318,2073,10,19,9,90
043844801,il,-88.00074,41.80938,1831,12,22,10,83.3
043844802,il,-88.02232,41.80888,1058,12,23,11,91.7
043844901,il,-88.00191,41.79824,1054,12,22,10,83.3
043844902,il,-88.02234,41.79444,1468,12,23,11,91.7
043845000,il,-87.97547,41.79534,2110,11,21,10,90.9
043845100,il,-87.95608,41.79962,2155,11,20,9,81.8
043845200,il,-87.93988,41.79782,1758,11,20,9,81.8
043845300,il,-87.92529,41.79877,1324,9,18,9,100
043845401,il,-87.92572,41.78053,1001,10,18,8,80
043845402,il,-87.93894,41.77467,1088,10,20,10,100
043845502,il,-87.95406,41.78156,656,11,20,9,81.8
043845505,il,-87.98378,41.7589,1160,11,21,10,90.9
043845506,il,-87.98126,41.77024,773,11,21,10,90.9
043845507,il,-87.96507,41.75999,1202,11,20,9,81.8
043845508,il,-87.95574,41.76775,1020,11,20,9,81.8
043845509,il,-87.96793,41.7809,1100,11,20,9,81.8
043845510,il,-87.97969,41.78085,630,12,22,10,83.3
043845601,il,-87.99973,41.77945,1246,12,22,10,83.3
043845602,il,-87.9937,41.78837,1620,12,22,10,83.3
043845701,il,-88.02455,41.77601,1574,12,22,10,83.3
043845702,il,-88.00646,41.77294,1929,12,22,10,83.3
043845703,il,-88.02309,41.75808,1205,11,22,11,100
043845704,il,-88.00739,41.75935,1087,11,21,10,90.9
043845802,il,-87.99954,41.74578,1233,11,21,10,90.9
043845803,il,-87.98492,41.70465,1493,11,21,10,90.9
043845805,il,-87.95918,41.73178,1237,11,20,9,81.8
043845807,il,-87.99248,41.73368,2248,11,21,10,90.9
043845808,il,-88.02007,41.71926,1459,11,21,10,90.9
043845809,il,-88.02164,41.73982,1561,11,21,10,90.9
043845810,il,-87.9661,41.74963,910,11,20,9,81.8
043845811,il,-87.95364,41.74674,1048,11,20,9,81.8
043845901,il,-87.92908,41.72244,1512,10,20,10,100
043845902,il,-87.93079,41.74912,1624,10,20,10,100
043846002,il,-88.04859,41.80161,1624,13,23,10,76.9
043846003,il,-88.06808,41.79775,1592,13,24,11,84.6
043846004,il,-88.08447,41.80042,1018,13,24,11,84.6
043846102,il,-88.10652,41.80539,799,13,24,11,84.6
043846103,il,-88.12358,41.78031,1678,13,24,11,84.6
043846104,il,-88.10749,41.78997,1566,13,24,11,84.6
043846105,il,-88.13578,41.78787,1431,13,24,11,84.6
043846106,il,-88.13278,41.80443,980,13,24,11,84.6
043846201,il,-88.11653,41.73277,1613,11,22,11,100
043846202,il,-88.10469,41.76895,1440,12,23,11,91.7
043846203,il,-88.11499,41.74585,1462,12,23,11,91.7
043846205,il,-88.11677,41.76548,1154,12,23,11,91.7
043846206,il,-88.13645,41.74603,1293,12,23,11,91.7
043846207,il,-88.14084,41.73622,1714,12,22,10,83.3
043846208,il,-88.12803,41.76218,1182,12,23,11,91.7
043846209,il,-88.1383,41.766,1246,12,23,11,91.7
043846304,il,-88.08282,41.74268,2041,12,23,11,91.7
043846305,il,-88.05378,41.75449,1837,11,22,11,100
043846307,il,-88.03855,41.7659,1297,12,22,10,83.3
043846308,il,-88.03552,41.73974,536,11,22,11,100
043846310,il,-88.04462,41.7452,706,11,22,11,100
043846311,il,-88.05225,41.73425,1405,11,21,10,90.9
043846312,il,-88.08323,41.77848,679,13,24,11,84.6
043846313,il,-88.08434,41.76469,1454,12,23,11,91.7
043846314,il,-88.04767,41.77851,1062,12,23,11,91.7
043846315,il,-88.06382,41.77588,1614,13,23,10,76.9
043846404,il,-88.15865,41.78562,1034,12,23,11,91.7
043846405,il,-88.16807,41.79785,1237,12,23,11,91.7
043846408,il,-88.24286,41.78435,1198,11,21,10,90.9
043846409,il,-88.24879,41.79873,1683,11,21,10,90.9
043846410,il,-88.21413,41.78573,738,12,22,10,83.3
043846411,il,-88.21905,41.79835,935,12,22,10,83.3
043846412,il,-88.19418,41.78432,607,12,22,10,83.3
043846413,il,-88.18733,41.80428,664,12,22,10,83.3
043846504,il,-88.16243,41.77156,2021,12,23,11,91.7
043846507,il,-88.23353,41.77175,436,11,21,10,90.9
043846509,il,-88.21932,41.76184,1208,11,21,10,90.9
043846510,il,-88.21974,41.75078,674,11,21,10,90.9
043846511,il,-88.24925,41.73013,1817,11,21,10,90.9
043846513,il,-88.22069,41.7287,809,11,21,10,90.9
043846514,il,-88.21972,41.73955,1388,11,22,11,100
043846515,il,-88.24053,41.74209,1592,11,21,10,90.9
043846517,il,-88.24863,41.75945,1194,11,21,10,90.9
043846518,il,-88.25143,41.74669,1257,11,21,10,90.9
043846519,il,-88.19398,41.76757,762,12,22,10,83.3
043846521,il,-88.17486,41.75871,1545,12,22,10,83.3
043846522,il,-88.19147,41.75134,1205,11,22,11,100
043846523,il,-88.15776,41.75463,979,12,22,10,83.3
043846524,il,-88.17709,41.73661,1465,12,22,10,83.3
043846603,il,-87.99454,41.92704,763,10,19,9,90
043846604,il,-88.0153,41.92434,1152,11,19,8,72.7
043846701,il,-87.97965,41.92343,1356,10,19,9,90
043846702,il,-88.0007,41.91208,2126,10,19,9,90
045070100,il,-87.62758,39.7662,3596,18,35,17,94.4
045070200,il,-87.84451,39.73864,3928,18,35,17,94.4
045070300,il,-87.7011,39.64447,2424,18,35,17,94.4
045070400,il,-87.6807,39.59712,3046,18,35,17,94.4
045070500,il,-87.7319,39.54699,4827,18,35,17,94.4
047956900,il,-88.04866,38.49399,3269,28,48,20,71.4
047957000,il,-88.05811,38.33505,2939,30,50,20,66.7
047957100,il,-88.05647,38.38099,1372,31,51,20,64.5
049950100,il,-88.45293,39.1486,2796,20,38,18,90
049950200,il,-88.69316,39.15653,4182,20,38,18,90
049950300,il,-88.74638,39.00329,2941,20,38,18,90
049950400,il,-88.61921,38.99492,2905,21,39,18,85.7
049950500,il,-88.45177,39.00416,3595,21,39,18,85.7
049950600,il,-88.5222,39.13226,2610,19,38,19,100
049950700,il,-88.55712,39.15108,1373,19,38,19,100
049950800,il,-88.57899,39.09278,2583,19,38,19,100
051950500,il,-88.86044,39.10732,2690,19,36,17,89.5
051950600,il,-88.99215,39.09161,3194,19,37,18,94.7
051950700,il,-89.16327,39.09442,4655,18,37,19,105.6
051950800,il,-89.10278,38.98308,1917,19,38,19,100
051950900,il,-89.10814,38.94934,1230,19,38,19,100
051951000,il,-89.14283,38.86508,3298,20,38,18,90
051951100,il,-88.87049,38.90146,4003,19,37,18,94.7
053961600,il,-88.18397,40.81473,2180,14,28,14,100
053961700,il,-88.1345,40.48849,2102,13,28,15,115.4
053961800,il,-88.09749,40.45785,2242,13,27,14,107.7
053961900,il,-88.35547,40.51397,1979,13,28,15,115.4
053962000,il,-88.38001,40.45883,1834,13,28,15,115.4
055040100,il,-89.04203,38.08527,2366,28,48,20,71.4
055040200,il,-89.06616,38.00285,3043,29,49,20,69
055040300,il,-89.05318,37.96895,2183,30,49,19,63.3
055040400,il,-89.08513,37.90977,3012,30,50,20,66.7
055040500,il,-88.91763,38.06627,2179,29,49,20,69
055040600,il,-88.9454,38.0033,1944,30,50,20,66.7
055040700,il,-88.91658,37.97842,3140,30,50,20,66.7
055040800,il,-88.90523,37.90321,3050,29,49,20,69
055040900,il,-88.94369,37.90189,1869,29,49,20,69
055041000,il,-88.92244,37.90434,1417,29,49,20,69
055041100,il,-88.91047,37.88038,2132,29,49,20,69
055041200,il,-88.78226,38.0137,4254,28,48,20,71.4
057952800,il,-90.00712,40.69877,1478,12,27,15,125
057952900,il,-90.07276,40.63135,3066,14,31,17,121.4
057953000,il,-90.32654,40.6211,2814,16,33,17,106.3
057953100,il,-90.32702,40.41718,3209,18,35,17,94.4
057953200,il,-90.15698,40.48644,2583,16,33,17,106.3
057953300,il,-90.05143,40.58127,1795,15,32,17,113.3
057953400,il,-90.04065,40.55551,1060,15,32,17,113.3
057953500,il,-90.04378,40.53778,1644,15,32,17,113.3
057953600,il,-90.01831,40.56667,2314,15,32,17,113.3
057953700,il,-90.02851,40.43617,2759,18,36,18,100
057953800,il,-90.15734,40.38964,1773,18,36,18,100
057953900,il,-90.29359,40.25225,3094,18,36,18,100
059972700,il,-88.23458,37.83465,4149,31,51,20,64.5
059972800,il,-88.22638,37.69205,3943,31,51,20,64.5
061973600,il,-90.26673,39.37691,3654,20,40,20,100
061973700,il,-90.366,39.49004,1139,18,37,19,105.6
061973800,il,-90.51402,39.34461,2831,21,40,19,90.5
061973900,il,-90.40358,39.43769,1531,20,40,20,100
061974000,il,-90.37688,39.32528,2467,21,41,20,95.2
063000102,il,-88.31191,41.44114,3010,11,23,12,109.1
063000103,il,-88.33056,41.39829,3203,12,23,11,91.7
063000200,il,-88.49807,41.40124,3582,11,23,12,109.1
063000300,il,-88.41215,41.37525,1524,12,23,11,91.7
063000400,il,-88.44862,41.36291,2342,12,23,11,91.7
063000500,il,-88.46439,41.30876,1930,12,23,11,91.7
063000600,il,-88.46149,41.19465,2960,12,24,12,100
063000700,il,-88.30566,41.34141,3154,12,24,12,100
063000800,il,-88.29448,41.25872,2821,12,24,12,100
063000900,il,-88.29099,41.17174,2379,12,25,13,108.3
065973100,il,-88.55189,38.09738,2083,28,48,20,71.4
065973200,il,-88.53971,37.99386,3933,29,49,20,69
065973300,il,-88.53783,38.17175,3913,27,47,20,74.1
067953700,il,-91.02044,40.54701,2869,19,36,17,89.5
067953800,il,-91.13621,40.41311,1648,20,37,17,85
067953900,il,-91.18996,40.52158,2400,18,34,16,88.9
067954000,il,-91.30263,40.50273,3192,18,34,16,88.9
067954100,il,-91.34814,40.39298,2167,19,36,17,89.5
067954200,il,-91.37131,40.28188,3002,19,36,17,89.5
067954300,il,-91.06872,40.31517,5411,19,37,18,94.7
069970900,il,-88.35781,37.51712,2133,27,47,20,74.1
069971000,il,-88.2045,37.519,2479,29,49,20,69
071973300,il,-90.87184,40.99122,2214,16,31,15,93.8
071973400,il,-90.93782,40.8434,2469,16,31,15,93.8
071973500,il,-90.94329,40.71055,3139,17,33,16,94.1
073030100,il,-90.34725,41.47505,2830,13,26,13,100
073030201,il,-90.38382,41.36287,2622,12,26,14,116.7
073030202,il,-90.25,41.34968,2564,12,26,14,116.7
073030203,il,-90.23857,41.49081,2352,13,27,14,107.7
073030301,il,-90.15334,41.43851,1885,13,27,14,107.7
073030302,il,-90.13126,41.45815,1816,13,27,14,107.7
073030400,il,-89.99965,41.5017,2629,13,26,13,100
073030500,il,-90.01589,41.32187,2443,12,25,13,108.3
073030600,il,-89.93126,41.26217,1873,11,24,13,118.2
073030800,il,-89.88577,41.24186,1316,11,24,13,118.2
073030900,il,-89.93122,41.23874,1794,11,24,13,118.2
073031000,il,-89.92622,41.18695,2075,11,25,14,127.3
073031100,il,-90.04237,41.17069,1607,12,26,14,116.7
073031200,il,-90.26231,41.21145,2995,12,26,14,116.7
075950100,il,-87.64232,40.89592,3936,13,25,12,92.3
075950200,il,-87.94109,40.95076,2916,13,26,13,100
075950300,il,-87.93139,40.83912,3473,13,26,13,100
075950400,il,-87.72201,40.78225,1983,12,26,14,116.7
075950500,il,-87.6422,40.73496,3075,13,26,13,100
075950600,il,-87.97939,40.75107,2654,14,28,14,100
075950700,il,-88.0365,40.62259,3602,13,28,15,115.4
075950800,il,-87.85257,40.60141,3162,14,28,14,100
075950900,il,-87.64055,40.58765,2942,13,27,14,107.7
077010100,il,-89.44177,37.89695,3674,29,49,20,69
077010200,il,-89.22002,37.8748,3786,30,51,21,70
077010300,il,-89.48898,37.72934,4701,31,51,20,64.5
077010400,il,-89.35612,37.80865,2778,32,52,20,62.5
077010601,il,-89.36318,37.73374,1246,30,51,21,70
077010602,il,-89.34898,37.76311,1941,31,51,20,64.5
077010700,il,-89.31055,37.76301,2552,31,51,20,64.5
077010800,il,-89.24464,37.76419,2090,31,51,20,64.5
077010900,il,-89.18762,37.77378,1892,30,51,21,70
077011001,il,-89.27479,37.74433,872,31,51,20,64.5
077011002,il,-89.26406,37.71646,2210,30,51,21,70
077011100,il,-89.22164,37.72304,729,30,51,21,70
077011200,il,-89.17729,37.72679,1285,30,50,20,66.7
077011400,il,-89.19441,37.70893,530,30,51,21,70
077011600,il,-89.21937,37.64605,2544,29,49,20,69
077011701,il,-89.20013,37.68535,475,30,50,20,66.7
077011702,il,-89.22773,37.70024,423,30,50,20,66.7
079977300,il,-88.13344,39.09692,5958,21,40,19,90.5
079977400,il,-88.16383,38.987,2160,21,40,19,90.5
079977500,il,-88.17007,38.94077,7519,21,40,19,90.5
081050100,il,-88.99958,38.42554,4345,23,42,19,82.6
081050200,il,-88.76558,38.38341,2915,23,42,19,82.6
081050300,il,-89.05166,38.2365,5022,26,46,20,76.9
081050400,il,-88.81265,38.196,3652,26,46,20,76.9
081050500,il,-88.96765,38.31725,2016,23,43,20,87
081050600,il,-88.9336,38.33524,1778,23,43,20,87
081050700,il,-88.92114,38.3632,2366,22,42,20,90.9
081050800,il,-88.84801,38.33316,2681,22,41,19,86.4
081050900,il,-88.91824,38.30734,1432,24,44,20,83.3
081051000,il,-88.90428,38.31387,1287,24,43,19,79.2
081051100,il,-88.89873,38.27876,2255,24,44,20,83.3
083010100,il,-90.23819,39.16659,3073,21,41,20,95.2
083010200,il,-90.2002,39.05929,2275,22,42,20,90.9
083010300,il,-90.31865,38.98929,2142,24,44,20,83.3
083010401,il,-90.333,39.0874,3186,21,40,19,90.5
083010402,il,-90.46523,39.10297,1803,22,42,20,90.9
083010500,il,-90.50759,39.01797,1690,25,46,21,84
085020101,il,-90.26261,42.463,3934,8,16,8,100
085020102,il,-90.03936,42.45605,2155,7,15,8,114.3
085020200,il,-90.54282,42.47057,3070,10,19,9,90
085020300,il,-90.42737,42.41215,3733,9,18,9,100
085020401,il,-90.30032,42.36806,4366,8,16,8,100
085020402,il,-90.23333,42.28404,2977,9,18,9,100
085020500,il,-90.00828,42.29419,2495,8,17,9,112.5
087977600,il,-88.81229,37.50698,6342,29,50,21,72.4
087977700,il,-88.98169,37.50943,2740,30,50,20,66.7
087977800,il,-88.90695,37.37063,3354,32,53,21,65.6
087980000,il,-88.76825,37.39959,41,33,53,20,60.6
089850101,il,-88.25588,42.14453,1390,8,16,8,100
089850103,il,-88.33051,42.11393,1872,9,17,8,88.9
089850105,il,-88.33381,42.13896,1713,9,17,8,88.9
089850106,il,-88.29956,42.1339,3121,8,16,8,100
089850201,il,-88.24717,42.1253,1146,9,16,7,77.8
089850202,il,-88.24925,42.11236,1743,9,16,7,77.8
089850301,il,-88.26972,42.12898,2204,9,16,7,77.8
089850302,il,-88.27352,42.11327,1159,9,16,7,77.8
089850400,il,-88.2562,42.09985,1245,9,17,8,88.9
089850500,il,-88.26646,42.08122,1718,9,17,8,88.9
089850600,il,-88.32288,42.08465,2817,9,17,8,88.9
089850703,il,-88.53332,42.02463,1690,8,16,8,100
089850704,il,-88.45069,42.14154,3213,8,16,8,100
089850705,il,-88.51401,42.09245,3727,8,16,8,100
089850706,il,-88.5314,42.13089,1746,8,16,8,100
089850707,il,-88.39733,42.11237,4555,8,16,8,100
089850708,il,-88.36836,42.07796,1045,8,16,8,100
089850709,il,-88.42848,42.00379,2094,8,16,8,100
089850710,il,-88.43291,42.07768,2482,8,16,8,100
089850711,il,-88.41708,42.04381,2490,8,16,8,100
089850800,il,-88.2732,42.05508,2357,10,18,8,80
089851000,il,-88.29828,42.05905,1269,9,18,9,100
089851101,il,-88.30254,42.03421,1419,9,18,9,100
089851102,il,-88.30234,42.04234,1161,9,18,9,100
089851301,il,-88.27308,42.03707,760,9,18,9,100
089851302,il,-88.27645,42.04576,800,9,18,9,100
089851400,il,-88.2675,42.02851,1679,9,18,9,100
089851500,il,-88.27679,42.02345,297,9,18,9,100
089851600,il,-88.28978,42.02707,1667,9,18,9,100
089851801,il,-88.28463,41.99703,3023,9,17,8,88.9
089851904,il,-88.3445,42.04146,2244,9,17,8,88.9
089851907,il,-88.32741,41.99588,1797,9,17,8,88.9
089851908,il,-88.32657,42.01811,1564,9,17,8,88.9
089851909,il,-88.32488,42.04698,1288,9,17,8,88.9
089851910,il,-88.34394,42.05995,1433,9,17,8,88.9
089851911,il,-88.36008,42.03012,1721,8,16,8,100
089851912,il,-88.35704,41.99614,1148,9,17,8,88.9
089851913,il,-88.35606,42.01423,2508,9,17,8,88.9
089852001,il,-88.28946,41.9591,2803,9,17,8,88.9
089852002,il,-88.28291,41.90929,2382,9,17,8,88.9
089852004,il,-88.27157,41.93355,1076,9,17,8,88.9
089852005,il,-88.29707,41.92787,1765,9,17,8,88.9
089852101,il,-88.3574,41.95359,2660,9,17,8,88.9
089852103,il,-88.32611,41.95305,2719,9,18,9,100
089852104,il,-88.3068,41.9804,887,9,17,8,88.9
089852201,il,-88.32259,41.90273,1762,9,18,9,100
089852203,il,-88.3377,41.91323,1463,9,18,9,100
089852204,il,-88.36467,41.90871,1036,9,18,9,100
089852300,il,-88.31064,41.9112,944,9,18,9,100
089852403,il,-88.54323,41.85393,4178,10,19,9,90
089852404,il,-88.39126,41.95195,1051,9,17,8,88.9
089852405,il,-88.43868,41.94423,1309,9,17,8,88.9
089852406,il,-88.43436,41.96921,1286,9,17,8,88.9
089852407,il,-88.39206,41.92158,1309,9,18,9,100
089852408,il,-88.43831,41.9161,1964,9,18,9,100
089852500,il,-88.28412,41.87982,3116,9,18,9,100
089852606,il,-88.32458,41.87057,1651,10,19,9,90
089852607,il,-88.33065,41.89071,1093,10,19,9,90
089852608,il,-88.31611,41.88863,1908,10,19,9,90
089852700,il,-88.32041,41.85365,2391,10,20,10,100
089852803,il,-88.2815,41.85188,1764,10,19,9,90
089852805,il,-88.30932,41.82534,2153,10,20,10,100
089852806,il,-88.28148,41.82637,2337,10,20,10,100
089852807,il,-88.35949,41.83025,1568,11,20,9,81.8
089852808,il,-88.32954,41.82998,2736,11,20,9,81.8
089852903,il,-88.27225,41.79105,1522,11,21,10,90.9
089852904,il,-88.27218,41.76466,694,11,21,10,90.9
089852905,il,-88.32202,41.78157,1514,11,21,10,90.9
089852906,il,-88.30207,41.79839,1764,11,21,10,90.9
089852907,il,-88.29377,41.77855,1196,11,21,10,90.9
089853001,il,-88.36274,41.7956,1063,11,21,10,90.9
089853004,il,-88.33657,41.80297,1231,11,21,10,90.9
089853005,il,-88.3674,41.77275,1306,11,21,10,90.9
089853006,il,-88.3545,41.77229,1005,11,21,10,90.9
089853007,il,-88.33994,41.77578,1160,11,21,10,90.9
089853008,il,-88.34005,41.78837,1164,11,21,10,90.9
089853100,il,-88.33958,41.76636,921,11,21,10,90.9
089853200,il,-88.32015,41.76578,1425,11,21,10,90.9
089853300,il,-88.30184,41.76921,1050,11,21,10,90.9
089853401,il,-88.29366,41.76065,513,11,21,10,90.9
089853402,il,-88.30085,41.76025,968,11,21,10,90.9
089853500,il,-88.28651,41.7618,1201,11,21,10,90.9
089853601,il,-88.30661,41.75324,612,11,21,10,90.9
089853602,il,-88.29219,41.75241,901,11,21,10,90.9
089853900,il,-88.34412,41.75791,1950,11,21,10,90.9
089854001,il,-88.36085,41.75254,1632,11,21,10,90.9
089854002,il,-88.34956,41.7335,2268,11,21,10,90.9
089854100,il,-88.32102,41.74297,1153,11,21,10,90.9
089854200,il,-88.31592,41.74445,1168,11,21,10,90.9
089854301,il,-88.30185,41.74663,1307,11,21,10,90.9
089854302,il,-88.29833,41.73847,1151,11,21,10,90.9
089854401,il,-88.30083,41.72822,885,10,20,10,100
089854402,il,-88.27091,41.74834,1109,11,21,10,90.9
089854403,il,-88.27609,41.73502,1411,11,21,10,90.9
089854504,il,-88.44185,41.78837,3622,11,21,10,90.9
089854505,il,-88.39507,41.86557,2422,10,19,9,90
089854506,il,-88.43387,41.82681,1768,11,20,9,81.8
089854507,il,-88.44526,41.87301,2772,10,19,9,90
089854508,il,-88.39209,41.73826,1903,11,21,10,90.9
089854509,il,-88.43287,41.75227,3054,11,21,10,90.9
089854600,il,-88.28667,42.04296,1309,9,18,9,100
089854700,il,-88.32557,41.7535,901,11,21,10,90.9
089854800,il,-88.35789,41.87282,2961,10,19,9,90
089854900,il,-88.29971,42.01274,1721,9,17,8,88.9
091010100,il,-87.70373,41.25182,1536,11,22,11,100
091010201,il,-87.93051,41.25294,1633,13,26,13,100
091010203,il,-87.83923,41.2235,1428,13,25,12,92.3
091010204,il,-87.80718,41.25527,1833,13,25,12,92.3
091010300,il,-88.15298,41.11779,3123,13,26,13,100
091010400,il,-87.96622,41.1295,2801,14,28,14,100
091010500,il,-87.93018,41.17105,2438,15,28,13,86.7
091010601,il,-87.91717,41.19235,2313,14,27,13,92.9
091010602,il,-87.86329,41.18524,1391,14,27,13,92.9
091010701,il,-87.81194,41.1827,1773,14,27,13,92.9
091010702,il,-87.81688,41.14882,3318,14,27,13,92.9
091010800,il,-87.70955,41.14835,2952,12,25,13,108.3
091010900,il,-87.58561,41.20366,3302,11,23,12,109.1
091011000,il,-87.59557,41.06329,4122,12,24,12,100
091011100,il,-87.71604,41.04174,1282,13,25,12,92.3
091011200,il,-87.78432,41.05714,1414,13,26,13,100
091011300,il,-87.79388,41.10275,1213,14,27,13,92.9
091011400,il,-87.81394,41.12121,621,14,27,13,92.9
091011500,il,-87.84226,41.12331,1145,14,27,13,92.9
091011600,il,-87.85632,41.12787,1093,14,27,13,92.9
091011700,il,-87.87354,41.12948,1242,14,27,13,92.9
091011800,il,-87.87646,41.13978,1141,14,27,13,92.9
091011900,il,-87.86804,41.14539,623,14,27,13,92.9
091012000,il,-87.87876,41.16053,1250,14,27,13,92.9
091012100,il,-87.89071,41.12324,1309,14,28,14,100
091012200,il,-87.89891,41.11101,1382,14,28,14,100
091012300,il,-87.86215,41.11724,1619,14,27,13,92.9
091012400,il,-87.8477,41.10762,1606,14,27,13,92.9
091012500,il,-87.87884,41.08424,776,14,28,14,100
091012600,il,-88.00219,41.04882,3010,14,27,13,92.9
093890103,il,-88.30632,41.70621,1757,11,21,10,90.9
093890104,il,-88.28052,41.71741,1649,11,20,9,81.8
093890105,il,-88.28373,41.67192,3125,10,20,10,100
093890106,il,-88.35359,41.67523,1840,10,21,11,110
093890107,il,-88.3231,41.67595,2096,10,20,10,100
093890108,il,-88.36823,41.65156,2156,10,21,11,110
093890201,il,-88.32835,41.71769,1569,11,21,10,90.9
093890202,il,-88.33819,41.71384,980,11,21,10,90.9
093890301,il,-88.36035,41.7043,1968,11,21,10,90.9
093890302,il,-88.33902,41.70062,2166,11,21,10,90.9
093890401,il,-88.46692,41.68222,2488,11,21,10,90.9
093890402,il,-88.41967,41.67719,4046,11,21,10,90.9
093890403,il,-88.38803,41.70169,1912,11,21,10,90.9
093890404,il,-88.41796,41.71426,3210,11,21,10,90.9
093890501,il,-88.52763,41.67039,3600,11,21,10,90.9
093890502,il,-88.57042,41.68507,2273,11,21,10,90.9
093890601,il,-88.45979,41.62824,2228,10,20,10,100
093890602,il,-88.48579,41.5874,3574,10,20,10,100
093890701,il,-88.26533,41.5571,1619,11,22,11,100
093890702,il,-88.3142,41.59348,2598,11,21,10,90.9
093890703,il,-88.42537,41.50309,4509,11,21,10,90.9
095000100,il,-90.15868,41.07784,3429,12,27,15,125
095000200,il,-90.27314,41.00972,5164,13,28,15,115.4
095000300,il,-90.34809,40.98343,2122,12,26,14,116.7
095000400,il,-90.40216,40.98763,1976,12,26,14,116.7
095000500,il,-90.41847,40.95088,1668,12,26,14,116.7
095000600,il,-90.3747,40.95563,1490,12,26,14,116.7
095000700,il,-90.34187,40.95657,1024,12,26,14,116.7
095000800,il,-90.36885,40.94587,694,12,26,14,116.7
095000900,il,-90.39997,40.9292,1469,12,26,14,116.7
095001000,il,-90.35988,40.93035,1928,12,26,14,116.7
095001100,il,-90.33434,40.93085,978,12,26,14,116.7
095001200,il,-90.26944,40.94552,1146,12,27,15,125
095001300,il,-90.29173,40.89868,1864,13,27,14,107.7
095001400,il,-90.3105,40.82529,2044,14,29,15,107.1
095001500,il,-90.3907,40.7751,2347,14,30,16,114.3
095001600,il,-90.09435,40.82563,3664,13,29,16,123.1
097860103,il,-87.83522,42.48598,1579,4,8,4,100
097860104,il,-87.81653,42.47068,2694,4,8,4,100
097860105,il,-87.86601,42.46135,1923,5,9,4,80
097860106,il,-87.87369,42.47947,1164,5,9,4,80
097860200,il,-87.81813,42.45104,1440,4,8,4,100
097860301,il,-87.84977,42.45526,1164,4,9,5,125
097860302,il,-87.83956,42.45419,950,4,8,4,100
097860400,il,-87.86435,42.42886,2238,5,9,4,80
097860500,il,-87.8344,42.44062,1620,4,8,4,100
097860600,il,-87.81986,42.42663,2203,4,9,5,125
097860805,il,-88.16244,42.4868,1714,8,14,6,75
097860806,il,-88.11302,42.48588,2200,8,15,7,87.5
097860807,il,-88.18083,42.44852,2222,8,14,6,75
097860808,il,-88.14676,42.44517,2988,8,14,6,75
097860809,il,-88.11533,42.45953,1676,8,14,6,75
097860811,il,-88.05361,42.45684,3170,8,14,6,75
097860812,il,-88.04225,42.47943,1623,8,14,6,75
097860813,il,-88.07823,42.48822,1292,8,15,7,87.5
097860903,il,-88.16478,42.40208,2871,7,14,7,100
097860905,il,-88.14105,42.3816,3308,7,14,7,100
097860906,il,-88.14485,42.34865,3422,8,14,6,75
097860907,il,-88.1849,42.35429,1824,7,14,7,100
097860908,il,-88.18636,42.38988,1323,8,14,6,75
097861007,il,-88.03483,42.4351,1777,7,14,7,100
097861008,il,-88.03467,42.42054,2024,7,14,7,100
097861009,il,-88.01317,42.4096,1636,7,13,6,85.7
097861010,il,-88.11396,42.40404,2364,8,14,6,75
097861011,il,-88.07923,42.40001,2828,8,14,6,75
097861012,il,-88.095,42.42936,2499,8,14,6,75
097861013,il,-88.05303,42.4074,1545,8,14,6,75
097861014,il,-88.03686,42.39389,2076,8,14,6,75
097861105,il,-88.04315,42.33662,1654,8,14,6,75
097861106,il,-88.01991,42.35832,3380,8,14,6,75
097861107,il,-88.05402,42.36357,1481,8,14,6,75
097861108,il,-88.04983,42.35125,1998,8,14,6,75
097861201,il,-88.08139,42.37393,2542,8,14,6,75
097861202,il,-88.05601,42.3792,1762,8,14,6,75
097861301,il,-88.10951,42.37833,1864,8,14,6,75
097861303,il,-88.09996,42.37561,1676,8,14,6,75
097861304,il,-88.10027,42.36843,1216,8,14,6,75
097861402,il,-88.09263,42.34146,2113,8,15,7,87.5
097861403,il,-88.09429,42.35901,890,8,15,7,87.5
097861404,il,-88.0761,42.35626,1961,8,15,7,87.5
097861504,il,-87.89861,42.34196,1224,6,11,5,83.3
097861505,il,-87.93945,42.39758,1327,6,11,5,83.3
097861506,il,-87.91855,42.40163,1360,5,11,6,120
097861507,il,-87.89451,42.39231,1680,5,10,5,100
097861508,il,-87.92271,42.37976,1028,6,11,5,83.3
097861509,il,-87.92612,42.36344,1057,6,11,5,83.3
097861510,il,-87.90149,42.36073,1752,6,11,5,83.3
097861603,il,-87.94858,42.3464,2879,6,11,5,83.3
097861604,il,-87.97591,42.4001,2028,7,13,6,85.7
097861607,il,-87.99342,42.33998,1708,7,13,6,85.7
097861608,il,-87.97558,42.34708,1294,6,12,6,100
097861609,il,-87.98546,42.38137,1424,7,13,6,85.7
097861610,il,-87.98063,42.35876,1042,7,13,6,85.7
097861611,il,-87.98355,42.37029,1616,7,13,6,85.7
097861701,il,-87.8187,42.40048,830,4,9,5,125
097861702,il,-87.8359,42.38908,1462,5,9,4,80
097861803,il,-87.85503,42.40267,1742,5,10,5,100
097861804,il,-87.86029,42.38477,851,5,10,5,100
097861901,il,-87.87475,42.403,1775,5,10,5,100
097861902,il,-87.87502,42.38123,1649,5,10,5,100
097862000,il,-87.85347,42.36853,1664,5,10,5,100
097862100,il,-87.84123,42.37706,1336,5,9,4,80
097862200,il,-87.81925,42.37106,1001,5,9,4,80
097862300,il,-87.82737,42.34526,893,5,10,5,100
097862401,il,-87.84052,42.36567,761,5,9,4,80
097862402,il,-87.84084,42.35742,705,5,10,5,100
097862501,il,-87.85073,42.35367,1074,5,10,5,100
097862502,il,-87.85043,42.34122,630,5,10,5,100
097862603,il,-87.87034,42.36491,1636,5,10,5,100
097862604,il,-87.87101,42.35452,994,5,10,5,100
097862605,il,-87.86766,42.34378,675,5,10,5,100
097862700,il,-87.84065,42.34687,863,5,10,5,100
097862800,il,-87.87251,42.3335,324,5,10,5,100
097862901,il,-87.83666,42.33502,908,5,10,5,100
097862902,il,-87.84913,42.33048,860,5,10,5,100
097863003,il,-87.83116,42.31543,8,5,10,5,100
097863004,il,-87.86427,42.30466,27,5,10,5,100
097863005,il,-87.84892,42.30416,17,5,10,5,100
097863006,il,-87.85384,42.30034,1,5,10,5,100
097863100,il,-87.84781,42.32129,1142,5,10,5,100
097863201,il,-87.87216,42.31967,1642,5,10,5,100
097863202,il,-87.86639,42.28529,2556,5,10,5,100
097863300,il,-87.8333,42.28634,1196,5,10,5,100
097863400,il,-87.82591,42.25407,1427,5,11,6,120
097863500,il,-87.86444,42.25545,1640,5,11,6,120
097863601,il,-87.9465,42.31673,1352,6,11,5,83.3
097863603,il,-87.98287,42.29918,1139,7,12,5,71.4
097863604,il,-87.97059,42.28782,1228,6,12,6,100
097863701,il,-87.93965,42.29431,1740,6,11,5,83.3
097863702,il,-87.90446,42.29471,913,5,11,6,120
097863801,il,-87.93718,42.26241,1565,6,12,6,100
097863902,il,-87.9603,42.24634,1091,6,12,6,100
097863903,il,-87.96641,42.27599,1480,6,12,6,100
097863904,il,-87.9643,42.26026,1923,6,12,6,100
097864001,il,-87.99023,42.27438,1721,7,13,6,85.7
097864002,il,-87.99359,42.25137,1802,7,13,6,85.7
097864105,il,-88.0363,42.28123,2499,8,14,6,75
097864106,il,-88.0115,42.28784,1622,7,13,6,85.7
097864107,il,-88.03825,42.25504,1990,7,14,7,100
097864108,il,-88.011,42.25762,2094,7,13,6,85.7
097864109,il,-88.09469,42.27436,2595,8,15,7,87.5
097864110,il,-88.05678,42.30924,1937,8,14,6,75
097864203,il,-88.18071,42.29911,2365,8,14,6,75
097864204,il,-88.17385,42.25685,2106,8,14,6,75
097864206,il,-88.13481,42.25148,1259,8,14,6,75
097864207,il,-88.14254,42.30132,2658,8,14,6,75
097864208,il,-88.13136,42.27133,1847,8,14,6,75
097864303,il,-88.17873,42.2239,2350,8,15,7,87.5
097864305,il,-88.13815,42.22507,914,7,14,7,100
097864306,il,-88.15165,42.20161,1182,7,14,7,100
097864307,il,-88.17634,42.17366,1012,8,15,7,87.5
097864308,il,-88.13684,42.17219,1799,7,14,7,100
097864402,il,-88.03132,42.21931,3415,8,14,6,75
097864403,il,-88.0322,42.17504,2226,8,14,6,75
097864407,il,-88.09017,42.22746,2586,8,14,6,75
097864408,il,-88.09087,42.20389,2591,7,14,7,100
097864409,il,-88.08517,42.19028,1515,8,14,6,75
097864410,il,-88.06618,42.18302,1753,8,14,6,75
097864411,il,-88.10622,42.17175,1733,7,14,7,100
097864412,il,-88.07887,42.16527,1552,8,14,6,75
097864510,il,-87.98272,42.23457,631,7,13,6,85.7
097864511,il,-87.99374,42.21948,1863,7,14,7,100
097864512,il,-87.97579,42.20802,1364,7,13,6,85.7
097864513,il,-87.9545,42.22582,2340,6,13,7,116.7
097864514,il,-87.94795,42.20466,829,7,13,6,85.7
097864515,il,-87.99575,42.17394,831,7,14,7,100
097864516,il,-87.97579,42.16203,1450,7,14,7,100
097864517,il,-87.97512,42.19035,705,7,13,6,85.7
097864518,il,-87.97162,42.17707,1619,7,14,7,100
097864519,il,-87.95973,42.16435,1347,7,13,6,85.7
097864520,il,-87.94972,42.17175,1772,7,13,6,85.7
097864521,il,-87.93373,42.19004,709,7,13,6,85.7
097864522,il,-87.90119,42.18893,1860,6,12,6,100
097864523,il,-87.92719,42.15846,143,6,12,6,100
097864524,il,-87.91411,42.16875,1153,6,12,6,100
097864601,il,-87.86972,42.22007,1595,6,11,5,83.3
097864602,il,-87.84364,42.22738,1487,6,11,5,83.3
097864700,il,-87.83882,42.19241,1346,6,12,6,100
097864801,il,-87.86594,42.1894,1807,6,12,6,100
097864802,il,-87.8771,42.17114,1072,6,12,6,100
097864901,il,-87.84447,42.17638,1495,6,12,6,100
097864903,il,-87.85651,42.15964,1638,6,12,6,100
097864904,il,-87.8373,42.1606,750,6,12,6,100
097865000,il,-87.81788,42.23287,523,6,11,5,83.3
097865200,il,-87.81248,42.20681,1302,6,11,5,83.3
097865300,il,-87.82856,42.20956,1279,6,11,5,83.3
097865400,il,-87.8152,42.18915,1272,6,12,6,100
097865501,il,-87.80207,42.21006,666,5,11,6,120
097865502,il,-87.78677,42.18639,802,6,11,5,83.3
097865600,il,-87.77062,42.1657,1404,6,11,5,83.3
097865700,il,-87.7948,42.16698,2255,6,11,5,83.3
097865801,il,-87.81127,42.16629,1352,6,12,6,100
097865802,il,-87.82122,42.16154,1142,6,12,6,100
097866000,il,-87.94373,42.45451,3474,5,11,6,120
097866100,il,-87.852,42.38238,681,5,10,5,100
097866200,il,-87.90959,42.23789,2645,6,11,5,83.3
099961701,il,-88.66506,41.6095,2673,10,21,11,110
099961702,il,-88.73711,41.56746,2342,10,21,11,110
099961800,il,-88.94271,41.55564,3452,10,21,11,110
099961900,il,-89.14409,41.56328,2146,10,21,11,110
099962000,il,-89.09598,41.5396,1629,10,21,11,110
099962100,il,-89.08523,41.43386,3451,11,23,12,109.1
099962200,il,-88.92348,41.39678,4193,11,23,12,109.1
099962300,il,-88.70053,41.45017,4523,10,20,10,100
099962400,il,-88.64661,41.35766,4027,10,21,11,110
099962500,il,-88.72371,41.34906,1272,10,21,11,110
099962600,il,-88.83415,41.36487,2738,11,23,12,109.1
099962700,il,-88.84279,41.34957,1270,11,23,12,109.1
099962800,il,-88.86356,41.3444,1617,11,24,13,118.2
099962900,il,-89.10118,41.33877,1458,12,25,13,108.3
099963000,il,-89.11748,41.34772,2321,12,24,12,100
099963100,il,-89.14652,41.346,1784,12,24,12,100
099963200,il,-89.12653,41.2881,2080,12,24,12,100
099963300,il,-89.09781,41.32318,1235,12,25,13,108.3
099963400,il,-89.06789,41.29106,2283,12,24,12,100
099963500,il,-88.8617,41.30575,2162,11,23,12,109.1
099963600,il,-88.84545,41.33445,1532,11,23,12,109.1
099963700,il,-88.69075,41.20298,4419,11,23,12,109.1
099963800,il,-88.81517,41.13599,2046,13,26,13,100
099963900,il,-88.86741,41.13231,2902,13,26,13,100
099964000,il,-88.90534,41.26331,2399,11,23,12,109.1
099964100,il,-89.00929,41.11379,4592,13,27,14,107.7
099964200,il,-88.84186,41.11359,1430,13,27,14,107.7
099964300,il,-88.82389,41.11611,1867,13,27,14,107.7
101880700,il,-87.69553,38.78243,5138,24,43,19,79.2
101880800,il,-87.76849,38.64033,4906,26,45,19,73.1
101880900,il,-87.76593,38.7099,2090,25,45,20,80
101881000,il,-87.6827,38.73171,1116,25,44,19,76
101881100,il,-87.68002,38.70803,2322,25,44,19,76
103000100,il,-89.11341,41.82426,2599,10,19,9,90
103000200,il,-89.3893,41.82421,2488,10,20,10,100
103000300,il,-89.45855,41.83979,1895,9,19,10,111.1
103000400,il,-89.49192,41.87843,2154,10,19,9,90
103000500,il,-89.57343,41.85659,2540,10,20,10,100
103000600,il,-89.49605,41.8323,1791,9,19,10,111.1
103000700,il,-89.52104,41.68847,2529,11,22,11,100
103000800,il,-89.33044,41.67005,8922,10,20,10,100
103000900,il,-89.11208,41.6858,3622,9,19,10,111.1
105960100,il,-88.42744,41.09446,1777,12,25,13,108.3
105960200,il,-88.40861,40.99281,3944,13,27,14,107.7
105960300,il,-88.73252,41.05305,2877,14,28,14,100
105960400,il,-88.83232,40.9006,3606,15,30,15,100
105960500,il,-88.64702,40.92594,1355,14,29,15,107.1
105960600,il,-88.61025,40.89452,1861,14,29,15,107.1
105960700,il,-88.64155,40.86668,1602,14,29,15,107.1
105960800,il,-88.62079,40.82321,4013,14,29,15,107.1
105960900,il,-88.38336,40.81812,2416,14,29,15,107.1
105961000,il,-88.40309,40.67938,2537,14,29,15,107.1
107952900,il,-89.25927,40.22207,3017,17,35,18,105.9
107953000,il,-89.48702,40.23647,2454,18,36,18,100
107953100,il,-89.38543,40.1687,1252,19,37,18,94.7
107953200,il,-89.345,40.16131,1738,19,37,18,94.7
107953300,il,-89.36938,40.13361,1852,19,37,18,94.7
107953400,il,-89.39733,40.1455,1768,19,37,18,94.7
107953500,il,-89.44184,40.03983,3405,18,36,18,100
107953600,il,-89.22888,40.02765,3087,18,37,19,105.6
109010100,il,-90.5032,40.58526,2313,17,35,18,105.9
109010200,il,-90.76567,40.56948,2265,19,36,17,89.5
109010300,il,-90.73108,40.4723,1636,19,37,18,94.7
109010401,il,-90.68102,40.47735,257,19,36,17,89.5
109010402,il,-90.68938,40.46465,1323,19,36,17,89.5
109010600,il,-90.65532,40.47946,1191,19,36,17,89.5
109010700,il,-90.64689,40.44563,2010,19,36,17,89.5
109010900,il,-90.69507,40.44239,1025,19,36,17,89.5
109011000,il,-90.55854,40.40925,3013,18,36,18,100
109011100,il,-90.80839,40.36145,2869,19,37,18,94.7
109980000,il,-90.68453,40.47143,19,19,36,17,89.5
111870103,il,-88.40442,42.45489,2067,9,17,8,88.9
111870104,il,-88.29528,42.45813,2661,9,16,7,77.8
111870105,il,-88.22967,42.44077,2879,8,15,7,87.5
111870106,il,-88.23011,42.4672,1336,8,16,8,100
111870200,il,-88.57047,42.39769,4711,10,18,8,80
111870301,il,-88.65604,42.45691,2131,10,18,8,80
111870302,il,-88.60135,42.44342,1868,10,18,8,80
111870402,il,-88.43473,42.33317,1778,9,16,7,77.8
111870403,il,-88.41525,42.38913,2538,9,16,7,77.8
111870404,il,-88.4098,42.34937,1994,9,16,7,77.8
111870501,il,-88.32849,42.36308,2041,8,16,8,100
111870502,il,-88.34806,42.38954,3138,9,16,7,77.8
111870603,il,-88.29395,42.36545,2442,8,15,7,87.5
111870604,il,-88.26647,42.36725,2697,8,15,7,87.5
111870605,il,-88.29876,42.33853,1966,8,15,7,87.5
111870606,il,-88.26782,42.33616,1526,8,15,7,87.5
111870702,il,-88.22299,42.3565,4875,8,15,7,87.5
111870703,il,-88.27045,42.40022,2905,8,16,8,100
111870704,il,-88.21238,42.40332,2035,8,14,6,75
111870807,il,-88.33892,42.25317,1737,8,15,7,87.5
111870808,il,-88.30238,42.25412,1727,8,15,7,87.5
111870809,il,-88.27082,42.28101,3397,8,15,7,87.5
111870810,il,-88.24104,42.27122,3331,8,15,7,87.5
111870811,il,-88.22188,42.30707,3622,8,15,7,87.5
111870812,il,-88.20928,42.26361,2640,8,15,7,87.5
111870813,il,-88.30079,42.29488,1774,8,15,7,87.5
111870814,il,-88.33411,42.30027,1650,8,15,7,87.5
111870903,il,-88.43161,42.32059,1274,9,16,7,77.8
111870904,il,-88.46198,42.31287,1899,9,17,8,88.9
111870905,il,-88.44145,42.30549,1606,9,17,8,88.9
111870906,il,-88.41584,42.2663,2203,9,16,7,77.8
111870907,il,-88.39118,42.3058,1970,9,16,7,77.8
111871003,il,-88.6437,42.28736,2555,10,19,9,90
111871004,il,-88.64266,42.20416,3107,10,19,9,90
111871105,il,-88.3613,42.22501,2134,8,16,8,100
111871107,il,-88.36171,42.17354,1916,8,16,8,100
111871108,il,-88.37084,42.19737,1784,8,16,8,100
111871109,il,-88.3935,42.1905,1561,8,16,8,100
111871110,il,-88.41384,42.18833,1182,9,16,7,77.8
111871111,il,-88.3799,42.17051,1966,8,16,8,100
111871112,il,-88.38218,42.2218,2433,8,16,8,100
111871113,il,-88.4082,42.21882,1401,9,16,7,77.8
111871114,il,-88.40578,42.17054,1542,9,16,7,77.8
111871115,il,-88.41519,42.15956,858,9,16,7,77.8
111871201,il,-88.34625,42.22275,2325,8,16,8,100
111871202,il,-88.32947,42.21936,1493,8,16,8,100
111871205,il,-88.31817,42.18243,1813,8,16,8,100
111871206,il,-88.33519,42.16487,2371,8,16,8,100
111871207,il,-88.3424,42.18297,1290,8,16,8,100
111871208,il,-88.34705,42.19613,1150,8,16,8,100
111871209,il,-88.3259,42.20008,832,8,16,8,100
111871301,il,-88.31121,42.2341,1942,8,15,7,87.5
111871304,il,-88.26519,42.23127,1689,8,15,7,87.5
111871305,il,-88.22461,42.22951,2450,8,15,7,87.5
111871307,il,-88.21917,42.21226,1851,8,15,7,87.5
111871310,il,-88.30048,42.16022,1888,8,16,8,100
111871311,il,-88.29572,42.18473,2357,8,16,8,100
111871312,il,-88.27138,42.20503,2030,8,15,7,87.5
111871313,il,-88.29534,42.21524,781,8,16,8,100
111871402,il,-88.22574,42.17642,2824,8,15,7,87.5
111871404,il,-88.27035,42.1617,1676,8,16,8,100
111871501,il,-88.52864,42.17443,3867,9,17,8,88.9
111871502,il,-88.50866,42.253,4538,9,17,8,88.9
111871600,il,-88.25531,42.19102,2177,8,15,7,87.5
113000105,il,-88.98374,40.55758,1368,16,33,17,106.3
113000106,il,-88.98215,40.51569,681,16,33,17,106.3
113000107,il,-88.98936,40.52326,1154,16,33,17,106.3
113000108,il,-89.0161,40.52857,676,17,33,16,94.1
113000109,il,-88.96854,40.52959,2181,16,33,17,106.3
113000200,il,-88.99398,40.51069,76,16,33,17,106.3
113000301,il,-89.00343,40.5031,1074,16,33,17,106.3
113000302,il,-89.02633,40.50263,1760,16,33,17,106.3
113000400,il,-88.98954,40.50027,631,16,33,17,106.3
113000501,il,-88.97839,40.50283,676,16,33,17,106.3
113000502,il,-88.96598,40.50462,1015,16,33,17,106.3
113000504,il,-88.95451,40.51565,1516,16,33,17,106.3
113000506,il,-88.93309,40.51047,1271,16,33,17,106.3
113000507,il,-88.93344,40.52962,928,16,33,17,106.3
113001103,il,-88.93815,40.48094,1103,16,33,17,106.3
113001105,il,-88.93287,40.49514,1375,16,33,17,106.3
113001106,il,-88.94705,40.49617,815,16,33,17,106.3
113001107,il,-88.93753,40.46981,1324,16,33,17,106.3
113001108,il,-88.94308,40.44578,1560,16,33,17,106.3
113001200,il,-88.9644,40.49349,881,16,33,17,106.3
113001301,il,-88.98195,40.49015,795,16,33,17,106.3
113001302,il,-88.99045,40.49011,314,16,33,17,106.3
113001303,il,-88.99796,40.48908,683,16,33,17,106.3
113001402,il,-89.03498,40.4548,1453,17,34,17,100
113001403,il,-89.01555,40.48441,1655,16,33,17,106.3
113001404,il,-89.01736,40.46078,1134,17,33,16,94.1
113001500,il,-89.00424,40.47815,880,16,33,17,106.3
113001600,il,-88.99413,40.47915,791,16,33,17,106.3
113001700,il,-88.98365,40.47875,882,16,33,17,106.3
113001800,il,-88.96536,40.48082,1364,16,33,17,106.3
113002101,il,-88.9888,40.44519,1022,16,33,17,106.3
113002102,il,-88.98579,40.41663,626,16,33,17,106.3
113005102,il,-88.90406,40.63489,5088,16,32,16,100
113005103,il,-88.89435,40.50984,1767,16,33,17,106.3
113005104,il,-88.89397,40.49529,1083,16,33,17,106.3
113005201,il,-89.08112,40.50832,710,17,34,17,100
113005202,il,-89.15891,40.55283,2430,16,33,17,106.3
113005401,il,-88.89958,40.4139,3408,16,32,16,100
113005402,il,-88.91185,40.324,2052,15,32,17,113.3
113005501,il,-88.75621,40.3698,1287,14,31,17,121.4
113005502,il,-88.61562,40.33626,2193,14,30,16,114.3
113005601,il,-88.61599,40.53724,1656,14,30,16,114.3
113005602,il,-88.64439,40.45234,2554,13,29,16,123.1
113005700,il,-88.67543,40.65736,4051,15,30,15,100
113005800,il,-88.96876,40.46735,1423,16,33,17,106.3
113005900,il,-88.99404,40.46638,1680,16,33,17,106.3
113006000,il,-89.15162,40.38412,3038,17,34,17,100
115000200,il,-88.93492,39.8433,1501,18,37,19,105.6
115000300,il,-88.94506,39.83263,2195,19,38,19,100
115000400,il,-88.96854,39.83428,694,19,38,19,100
115000501,il,-88.959,39.83494,187,19,38,19,100
115000502,il,-88.96525,39.842,800,19,38,19,100
115000600,il,-88.96498,39.85053,1167,19,38,19,100
115000900,il,-88.93694,39.85684,1288,19,37,18,94.7
115001000,il,-88.90841,39.86039,876,18,36,18,100
115001100,il,-88.90667,39.85002,1911,18,36,18,100
115001200,il,-88.93041,39.82868,1462,18,37,19,105.6
115001300,il,-88.94537,39.81359,1079,18,37,19,105.6
115001400,il,-88.96096,39.81253,1041,19,37,18,94.7
115001500,il,-89.00093,39.83223,1977,19,38,19,100
115001600,il,-88.97757,39.84124,917,19,38,19,100
115001700,il,-89.00224,39.85346,1158,19,38,19,100
115001801,il,-89.0071,39.86686,1006,19,38,19,100
115001802,il,-88.9808,39.86588,1229,19,38,19,100
115001900,il,-88.96836,39.86202,1170,19,37,18,94.7
115002001,il,-88.96109,39.87269,278,18,37,19,105.6
115002002,il,-88.95773,39.86209,1568,19,37,18,94.7
115002100,il,-88.91471,39.87044,992,18,37,19,105.6
115002200,il,-88.82845,39.9142,3195,17,36,19,111.8
115002300,il,-88.81148,39.82472,1957,17,35,18,105.9
115002401,il,-88.88982,39.83589,1304,17,36,19,111.8
115002402,il,-88.89744,39.80898,2367,18,36,18,100
115002500,il,-88.85466,39.72901,3737,17,36,19,111.8
115002601,il,-88.96302,39.79948,2009,18,37,19,105.6
115002602,il,-88.97738,39.72094,1552,18,37,19,105.6
115002700,il,-89.08266,39.73105,1751,18,37,19,105.6
115002800,il,-89.10751,39.91406,3450,19,38,19,100
115002901,il,-88.9772,39.93234,1992,19,37,18,94.7
115002902,il,-88.97328,39.89869,1749,19,37,18,94.7
115002904,il,-88.98429,39.88326,2269,19,37,18,94.7
115002905,il,-88.93241,39.90043,277,18,36,18,100
115002906,il,-88.93202,39.88466,493,18,37,19,105.6
115003000,il,-88.88718,40.00954,2474,17,35,18,105.9
115003100,il,-88.95097,39.84884,1391,19,38,19,100
117956000,il,-89.77104,39.50182,1910,19,39,20,105.3
117956100,il,-89.78264,39.46881,2530,18,38,20,111.1
117956200,il,-90.0189,39.43879,3821,19,39,20,105.3
117956300,il,-89.80385,39.30222,4179,19,39,20,105.3
117956400,il,-89.88746,39.28179,2810,20,39,19,95
117956500,il,-90.02681,39.25514,3542,21,41,20,95.2
117956600,il,-90.08953,39.09206,3170,22,42,20,90.9
117956700,il,-89.98582,39.0695,3450,22,42,20,90.9
117956800,il,-89.86945,39.0845,2389,22,41,19,86.4
117956900,il,-89.80897,39.13849,2518,21,40,19,90.5
117957000,il,-89.76442,39.10546,3207,21,40,19,90.5
117957100,il,-89.72345,39.05789,1810,21,40,19,90.5
117957200,il,-89.78888,39.01181,2449,22,41,19,86.4
119400101,il,-90.12957,38.71877,1249,28,49,21,75
119400102,il,-90.13479,38.70791,2229,28,49,21,75
119400200,il,-90.1622,38.70882,2455,28,49,21,75
119400600,il,-90.15593,38.68432,1616,29,51,22,75.9
119400700,il,-90.16907,38.67198,1277,29,51,22,75.9
119400801,il,-90.1151,38.72713,896,28,49,21,75
119400802,il,-90.11386,38.71293,2677,28,49,21,75
119400903,il,-90.08348,38.69099,3188,28,49,21,75
119400904,il,-90.11823,38.73907,1683,26,48,22,84.6
119400951,il,-90.0983,38.72763,1996,27,48,21,77.8
119400952,il,-90.08181,38.72986,1449,27,48,21,77.8
119401000,il,-90.07409,38.84304,1229,25,46,21,84
119401101,il,-90.09952,38.86712,1461,24,45,21,87.5
119401102,il,-90.08609,38.86755,1554,24,45,21,87.5
119401200,il,-90.10446,38.85687,992,25,45,20,80
119401300,il,-90.1105,38.8793,2379,24,45,21,87.5
119401400,il,-90.12713,38.89617,1566,24,45,21,87.5
119401500,il,-90.1371,38.88558,1646,24,45,21,87.5
119401701,il,-90.10114,38.90896,960,24,44,20,83.3
119401721,il,-90.05621,38.91419,2620,24,45,21,87.5
119401722,il,-90.04136,38.90517,1300,25,45,20,80
119401800,il,-90.0762,38.88616,3102,24,45,21,87.5
119401901,il,-90.05125,38.87311,948,25,45,20,80
119401905,il,-90.06491,38.78813,2932,26,47,21,80.8
119402000,il,-90.14808,38.9126,2471,24,44,20,83.3
119402100,il,-90.17067,38.90846,1624,24,44,20,83.3
119402200,il,-90.19101,38.91212,2093,23,43,20,87
119402300,il,-90.19704,38.89737,1166,23,44,21,91.3
119402400,il,-90.15668,38.87871,1187,24,45,21,87.5
119402500,il,-90.16976,38.89495,1216,24,45,21,87.5
119402600,il,-90.15353,38.89383,1270,24,45,21,87.5
119402701,il,-90.17917,38.96543,3407,23,43,20,87
119402721,il,-90.23194,38.9643,3483,23,43,20,87
119402722,il,-90.24005,38.92654,1525,24,44,20,83.3
119402801,il,-90.11898,38.96213,2090,24,44,20,83.3
119402803,il,-89.98394,38.86538,1664,25,46,21,84
119402804,il,-90.01751,38.96729,1610,24,44,20,83.3
119402805,il,-89.97459,38.92702,3389,25,46,21,84
119402900,il,-89.95442,38.82067,2494,25,46,21,84
119403001,il,-89.96258,38.79618,2131,25,46,21,84
119403002,il,-89.94016,38.79756,3326,25,46,21,84
119403101,il,-90.01099,38.79493,1496,25,46,21,84
119403121,il,-89.97884,38.76265,3968,25,46,21,84
119403122,il,-89.94241,38.76295,2464,25,46,21,84
119403200,il,-89.97501,38.68107,2166,26,47,21,80.8
119403300,il,-89.98763,38.66903,1429,26,47,21,80.8
119403401,il,-89.99256,38.68735,1334,26,47,21,80.8
119403403,il,-90.0169,38.67043,1117,26,47,21,80.8
119403404,il,-90.0032,38.66235,1268,26,47,21,80.8
119403502,il,-89.95213,38.68407,2638,26,46,20,76.9
119403531,il,-89.86557,38.73048,3623,25,46,21,84
119403532,il,-89.87331,38.68704,2517,25,46,21,84
119403533,il,-89.95141,38.72748,4829,25,46,21,84
119403534,il,-90.01444,38.71368,2005,26,47,21,80.8
119403601,il,-89.68726,38.75651,2088,23,43,20,87
119403603,il,-89.65068,38.7483,782,23,43,20,87
119403604,il,-89.67003,38.72945,2577,23,43,20,87
119403701,il,-89.81801,38.78692,4054,25,45,20,80
119403702,il,-89.69139,38.72396,3856,23,44,21,91.3
119403801,il,-89.87075,38.91522,3463,24,44,20,83.3
119403802,il,-89.72027,38.91064,3855,22,42,20,90.9
119404000,il,-90.14522,38.69788,1612,28,49,21,75
119404100,il,-90.14313,38.75903,1772,26,47,21,80.8
121951600,il,-88.80901,38.71552,3414,22,41,19,86.4
121951700,il,-89.01977,38.74405,3286,21,40,19,90.5
121951800,il,-89.11343,38.59304,1570,23,42,19,82.6
121951900,il,-89.02936,38.59819,2395,23,43,20,87
121952000,il,-88.94923,38.64308,2078,23,43,20,87
121952100,il,-88.95629,38.61893,2047,24,43,19,79.2
121952200,il,-88.82902,38.55165,3684,23,43,20,87
121952300,il,-89.03484,38.51287,2499,24,43,19,79.2
121952400,il,-89.10482,38.51843,1736,24,43,19,79.2
121952500,il,-89.13612,38.5,1834,23,43,20,87
121952600,il,-89.13342,38.52713,1336,24,44,20,83.3
121952700,il,-89.12364,38.54212,2052,24,44,20,83.3
123961100,il,-89.2144,41.06597,4075,15,30,15,100
123961200,il,-89.35809,41.11655,1465,16,31,15,93.8
123961300,il,-89.5176,41.06667,2929,15,30,15,100
123961400,il,-89.36824,40.97953,2254,16,32,16,100
123961500,il,-89.17142,40.9749,2234,15,30,15,100
125956300,il,-89.79271,40.36814,2588,18,37,19,105.6
125956400,il,-89.95666,40.33197,3442,19,37,18,94.7
125956500,il,-90.06077,40.29276,1964,19,38,19,100
125956600,il,-90.11875,40.15279,3457,19,37,18,94.7
125956700,il,-89.76861,40.22149,3484,17,36,19,111.8
125956800,il,-89.70088,40.19239,1381,17,36,19,111.8
127970100,il,-88.79231,37.25984,4360,34,55,21,61.8
127970200,il,-88.72908,37.16359,2158,35,56,21,60
127970300,il,-88.59505,37.16833,3056,34,54,20,58.8
127970400,il,-88.70188,37.14988,1323,35,55,20,57.1
129010100,il,-89.70522,40.04517,5671,17,35,18,105.9
129010200,il,-89.8435,40.02096,2902,17,36,19,111.8
129010300,il,-89.90896,40.00769,3298,17,36,19,111.8
131040100,il,-90.63969,41.28302,3535,13,27,14,107.7
131040200,il,-90.91499,41.20963,4195,16,31,15,93.8
131040300,il,-90.74806,41.18961,2118,14,28,14,100
131040400,il,-90.57718,41.15484,3650,14,28,14,100
133600102,il,-90.23096,38.43267,2452,26,46,20,76.9
133600103,il,-90.19038,38.44572,1703,25,46,21,84
133600104,il,-90.21135,38.46576,1574,26,46,20,76.9
133600401,il,-90.10464,38.34416,3241,24,45,21,87.5
133600402,il,-90.27239,38.3478,2913,25,45,20,80
133600501,il,-90.14949,38.27161,3735,24,44,20,83.3
133600502,il,-90.15068,38.20612,3519,28,48,20,71.4
135957300,il,-89.23917,39.29233,3134,18,36,18,100
135957400,il,-89.38386,39.2474,2954,20,40,20,100
135957500,il,-89.6039,39.38915,3872,18,37,19,105.6
135957600,il,-89.60989,39.15188,4261,21,41,20,95.2
135957700,il,-89.64754,39.18921,1578,20,39,19,95
135957800,il,-89.64446,39.1701,2041,20,39,19,95
135957900,il,-89.47294,39.1632,3177,25,45,20,80
135958000,il,-89.39159,39.09329,4442,22,41,19,86.4
137951400,il,-90.4362,39.82045,2812,20,39,19,95
137951500,il,-90.1693,39.79542,3560,19,37,18,94.7
137951600,il,-90.21428,39.73572,1346,18,37,19,105.6
137951700,il,-90.23596,39.7447,1330,19,37,18,94.7
137951800,il,-90.24448,39.73246,1384,18,37,19,105.6
137951900,il,-90.27289,39.73721,2182,19,37,18,94.7
137952000,il,-90.20898,39.7138,1262,18,37,19,105.6
137952100,il,-90.25951,39.70065,1705,18,37,19,105.6
137952200,il,-90.20209,39.61584,3244,18,37,19,105.6
137952300,il,-90.02602,39.62175,3247,18,38,20,111.1
139976900,il,-88.53355,39.61521,3976,18,36,18,100
139977000,il,-88.69119,39.72179,2169,17,36,19,111.8
139977100,il,-88.69114,39.59832,2735,18,36,18,100
139977200,il,-88.60593,39.59476,2026,18,36,18,100
141960700,il,-89.34884,42.14269,2608,10,19,9,90
141960800,il,-89.5671,42.11869,2919,10,20,10,100
141960900,il,-89.42378,42.02578,2539,10,20,10,100
141961001,il,-89.03166,42.06051,2265,9,18,9,100
141961002,il,-89.13488,42.10032,1898,9,18,9,100
141961100,il,-89.00247,41.9383,2021,10,20,10,100
141961200,il,-89.11832,41.9519,2942,11,21,10,90.9
141961301,il,-89.26802,41.94757,3189,10,20,10,100
141961302,il,-89.22325,42.09204,1721,9,19,10,111.1
141961400,il,-89.31222,42.01485,2141,11,21,10,90.9
141961500,il,-89.54411,41.96123,3207,10,21,11,110
141961600,il,-89.10381,41.90342,1296,11,21,10,90.9
141961700,il,-89.27745,42.10413,2397,10,19,9,90
143000200,il,-89.63756,40.67234,885,15,31,16,106.7
143000300,il,-89.62801,40.67226,1222,15,31,16,106.7
143000600,il,-89.6335,40.68412,1319,15,31,16,106.7
143000900,il,-89.6009,40.68881,716,15,31,16,106.7
143001200,il,-89.58744,40.69333,513,15,31,16,106.7
143001300,il,-89.57617,40.70121,1065,15,32,17,113.3
143001500,il,-89.56047,40.71071,1095,15,32,17,113.3
143001600,il,-89.58706,40.70624,1547,15,32,17,113.3
143001800,il,-89.60661,40.70146,1175,15,31,16,106.7
143001900,il,-89.61758,40.69326,537,15,31,16,106.7
143002000,il,-89.61916,40.70305,631,14,31,17,121.4
143002100,il,-89.60713,40.7123,2080,15,31,16,106.7
143002200,il,-89.60709,40.72145,1782,15,31,16,106.7
143002300,il,-89.60015,40.73298,2146,14,30,16,114.3
143002400,il,-89.58461,40.72517,2142,15,32,17,113.3
143002500,il,-89.58183,40.71554,1372,15,32,17,113.3
143002600,il,-89.5625,40.72925,1111,15,31,16,106.7
143002701,il,-89.63308,40.71828,1441,14,31,17,121.4
143002702,il,-89.63324,40.73035,1377,14,30,16,114.3
143002800,il,-89.6285,40.74013,1340,13,29,16,123.1
143002900,il,-89.60108,40.74977,1508,14,29,15,107.1
143003000,il,-89.62849,40.75376,1949,13,28,15,115.4
143003101,il,-89.65953,40.75736,2163,14,29,15,107.1
143003103,il,-89.62368,40.77089,709,13,28,15,115.4
143003104,il,-89.64165,40.76881,1016,13,29,16,123.1
143003200,il,-89.60983,40.77341,1218,13,28,15,115.4
143003300,il,-89.58686,40.76958,1255,14,31,17,121.4
143003402,il,-89.57064,40.82327,2038,14,29,15,107.1
143003403,il,-89.61017,40.79791,1706,13,29,16,123.1
143003404,il,-89.63009,40.81963,2269,12,27,15,125
143003601,il,-89.5139,40.8873,1372,14,30,16,114.3
143003602,il,-89.50125,40.92183,2685,15,31,16,106.7
143003700,il,-89.57019,40.9195,2439,14,29,15,107.1
143003800,il,-89.81402,40.92809,2718,11,25,14,127.3
143003900,il,-89.81153,40.83975,4801,13,28,15,115.4
143004000,il,-89.90158,40.72576,3190,13,29,16,123.1
143004101,il,-89.72128,40.75444,2935,14,29,15,107.1
143004102,il,-89.65774,40.72682,623,14,30,16,114.3
143004200,il,-89.56906,40.74944,1583,14,31,17,121.4
143004300,il,-89.58045,40.73798,1346,15,31,16,106.7
143004400,il,-89.63202,40.70071,2095,15,31,16,106.7
143004500,il,-89.69248,40.70413,2421,14,29,15,107.1
143004600,il,-89.65342,40.63355,2889,16,33,17,106.3
143004801,il,-89.70543,40.65345,2477,14,31,17,121.4
143004802,il,-89.65835,40.66643,2149,15,31,16,106.7
143004901,il,-89.77858,40.58064,2807,17,34,17,100
143004902,il,-89.81374,40.67913,2995,14,30,16,114.3
143005000,il,-89.61451,40.68636,1831,15,31,16,106.7
143005100,il,-89.62274,40.66546,2030,15,31,16,106.7
145030100,il,-89.36907,38.16608,3453,26,46,20,76.9
145030200,il,-89.36011,38.09467,3750,28,48,20,71.4
145030300,il,-89.45926,38.01907,2525,28,48,20,71.4
145030400,il,-89.26531,38.02373,1900,28,48,20,71.4
145030500,il,-89.18449,38.0358,2139,28,49,21,75
145030600,il,-89.22954,38.01888,2187,28,48,20,71.4
147954500,il,-88.57039,40.15103,3712,15,32,17,113.3
147954600,il,-88.57885,40.01425,3070,16,33,17,106.3
147954700,il,-88.52664,39.90669,2743,17,35,18,105.9
147954800,il,-88.67705,39.91968,2351,16,34,18,112.5
149952400,il,-90.78761,39.74814,5327,20,38,18,90
149952500,il,-91.18336,39.70039,3501,20,38,18,90
149952600,il,-90.97049,39.55612,5237,22,40,18,81.8
149952700,il,-90.80635,39.61077,2743,20,38,18,90
149952800,il,-90.70984,39.51841,4621,21,40,19,90.5
151971200,il,-88.56433,37.49115,3835,28,48,20,71.4
151971300,il,-88.55657,37.26992,3301,32,52,20,62.5
153971000,il,-89.0684,37.2243,3642,35,56,21,60
153971100,il,-89.19262,37.22188,3705,35,56,21,60
155954500,il,-89.21988,41.25761,2599,11,24,13,118.2
155954600,il,-89.31131,41.18391,5201,13,27,14,107.7
157950500,il,-89.64886,38.12081,2504,26,46,20,76.9
157950600,il,-89.71196,38.1452,2600,25,46,21,84
157950700,il,-89.80507,38.15928,2976,27,47,20,74.1
157950800,il,-89.96981,38.18849,2806,29,49,20,69
157950900,il,-89.98493,38.06927,3991,31,52,21,67.7
157951000,il,-89.74806,37.96315,3810,29,50,21,72.4
157951100,il,-89.64174,38.00961,2478,29,49,20,69
157951201,il,-89.81296,37.93146,982,31,51,20,64.5
157951202,il,-89.87503,37.92732,1024,31,52,21,67.7
157951300,il,-89.77657,37.88216,2286,31,51,20,64.5
159977900,il,-88.12191,38.77885,4130,22,42,20,90.9
159978000,il,-88.09614,38.72912,1223,23,42,19,82.6
159978100,il,-88.07182,38.741,1810,22,42,20,90.9
159978200,il,-88.07318,38.72425,1482,23,43,20,87
159978300,il,-88.05497,38.6571,4199,24,44,20,83.3
161020101,il,-90.25702,41.56047,1822,13,26,13,100
161020102,il,-90.26685,41.62306,2278,12,25,13,108.3
161020103,il,-90.27492,41.7161,841,12,25,13,108.3
161020200,il,-90.38683,41.49833,1787,13,26,13,100
161020301,il,-90.41371,41.49566,1559,13,26,13,100
161020302,il,-90.41133,41.51318,1137,13,26,13,100
161020400,il,-90.38474,41.54882,2474,13,26,13,100
161020600,il,-90.43706,41.53192,1251,13,26,13,100
161020700,il,-90.44827,41.51491,692,13,26,13,100
161020800,il,-90.44211,41.50748,2225,13,26,13,100
161020900,il,-90.44294,41.49511,2015,13,26,13,100
161021000,il,-90.44431,41.48391,738,13,26,13,100
161021100,il,-90.46038,41.46595,1299,13,26,13,100
161021200,il,-90.4676,41.48116,1476,13,26,13,100
161021300,il,-90.47037,41.50075,1693,13,26,13,100
161021400,il,-90.47423,41.51577,647,13,26,13,100
161021500,il,-90.48945,41.50095,2078,13,26,13,100
161021600,il,-90.50309,41.50033,994,13,26,13,100
161021700,il,-90.51257,41.49774,1370,13,26,13,100
161021800,il,-90.49368,41.48299,2090,13,26,13,100
161021900,il,-90.51459,41.46726,1027,13,26,13,100
161022000,il,-90.52,41.48272,1696,13,26,13,100
161022100,il,-90.53194,41.48337,967,13,26,13,100
161022200,il,-90.52872,41.49889,1424,13,26,13,100
161022300,il,-90.51264,41.51071,858,13,26,13,100
161022600,il,-90.587,41.50666,1079,13,26,13,100
161022800,il,-90.54729,41.49911,1679,13,26,13,100
161022900,il,-90.54778,41.48979,1335,13,26,13,100
161023000,il,-90.54628,41.4746,1830,13,26,13,100
161023100,il,-90.56958,41.47138,1202,13,27,14,107.7
161023200,il,-90.56937,41.48642,1833,13,26,13,100
161023300,il,-90.5651,41.50008,1351,13,26,13,100
161023500,il,-90.57592,41.49747,775,13,26,13,100
161023600,il,-90.5902,41.49804,700,13,26,13,100
161023700,il,-90.59297,41.48748,1165,13,26,13,100
161024000,il,-90.46275,41.43433,1919,12,25,13,108.3
161024101,il,-90.50791,41.37615,2128,13,25,12,92.3
161024102,il,-90.6667,41.42584,2991,13,26,13,100
161024103,il,-90.8361,41.37851,3434,14,27,13,92.9
161024200,il,-90.58392,41.4355,1486,13,26,13,100
161024300,il,-90.55459,41.4525,2093,13,27,14,107.7
161024400,il,-90.59567,41.47611,716,13,27,14,107.7
161024500,il,-90.54308,41.51512,759,13,26,13,100
163500400,il,-90.11982,38.63038,1788,29,50,21,72.4
163500500,il,-90.10668,38.63234,1685,29,50,21,72.4
163500900,il,-90.14775,38.61555,2731,30,51,21,70
163501100,il,-90.1353,38.60239,1581,29,50,21,72.4
163501200,il,-90.12333,38.61164,2521,29,50,21,72.4
163501300,il,-90.09271,38.60737,3288,27,48,21,77.8
163501400,il,-90.06373,38.59528,1488,27,48,21,77.8
163501501,il,-90.05119,38.58231,1030,27,47,20,74.1
163501502,il,-90.03877,38.56179,1347,27,48,21,77.8
163501602,il,-90.01136,38.53373,2387,27,48,21,77.8
163501604,il,-90.01866,38.54748,1614,27,48,21,77.8
163501605,il,-90.04395,38.54735,1181,27,48,21,77.8
163501606,il,-90.00457,38.51535,2214,27,48,21,77.8
163501607,il,-90.0251,38.52812,1079,27,48,21,77.8
163501700,il,-89.98855,38.51222,1975,27,48,21,77.8
163501801,il,-89.96666,38.52618,1724,27,48,21,77.8
163501802,il,-89.97577,38.52058,1358,27,48,21,77.8
163501900,il,-89.97171,38.50951,1772,27,48,21,77.8
163502100,il,-90.1164,38.65009,1762,29,50,21,72.4
163502200,il,-90.08893,38.63273,3511,28,49,21,75
163502300,il,-90.19262,38.57817,3209,29,50,21,72.4
163502401,il,-90.0999,38.62191,1428,29,49,20,69
163502404,il,-90.05916,38.62636,2962,27,48,21,77.8
163502500,il,-90.11484,38.58638,1425,28,49,21,75
163502602,il,-90.16948,38.55684,2625,28,49,21,75
163502603,il,-90.14203,38.56524,2248,28,49,21,75
163502700,il,-90.12733,38.57947,1430,28,49,21,75
163502800,il,-90.10826,38.56788,1330,28,49,21,75
163502900,il,-90.09207,38.59014,2323,27,48,21,77.8
163503101,il,-90.17029,38.49903,1769,26,47,21,80.8
163503102,il,-90.22616,38.52787,3187,27,48,21,77.8
163503202,il,-90.08853,38.51621,2964,27,48,21,77.8
163503203,il,-90.08401,38.42317,4100,26,46,20,76.9
163503211,il,-90.0667,38.5648,2201,27,48,21,77.8
163503301,il,-89.99066,38.53222,1529,27,48,21,77.8
163503304,il,-89.98881,38.49614,3304,27,48,21,77.8
163503322,il,-90.00366,38.55914,3003,27,48,21,77.8
163503323,il,-89.96634,38.55372,2476,27,48,21,77.8
163503324,il,-89.93846,38.55728,2123,27,48,21,77.8
163503332,il,-89.94741,38.51402,2124,26,48,22,84.6
163503334,il,-89.94192,38.5321,2269,27,48,21,77.8
163503404,il,-89.95629,38.62821,3121,26,47,21,80.8
163503411,il,-90.02934,38.63014,1866,26,47,21,80.8
163503412,il,-90.00866,38.63377,3388,26,47,21,80.8
163503413,il,-89.97567,38.58628,2240,26,47,21,80.8
163503414,il,-89.94846,38.58368,2045,26,47,21,80.8
163503415,il,-90.02103,38.58596,1713,26,47,21,80.8
163503416,il,-89.99704,38.59376,1755,26,47,21,80.8
163503800,il,-89.85084,38.54302,75,27,48,21,77.8
163503903,il,-89.87751,38.47137,2062,26,47,21,80.8
163503905,il,-89.93114,38.43936,1491,26,47,21,80.8
163503906,il,-89.94627,38.42997,3290,27,47,20,74.1
163503907,il,-89.90535,38.55257,2029,27,48,21,77.8
163503908,il,-89.87342,38.52659,1122,27,48,21,77.8
163504001,il,-89.92622,38.35166,3877,27,47,20,74.1
163504002,il,-89.78271,38.33171,6127,26,47,21,80.8
163504351,il,-89.90101,38.60152,1409,26,47,21,80.8
163504352,il,-89.89276,38.58117,1840,26,47,21,80.8
163504353,il,-89.89111,38.62791,1658,26,47,21,80.8
163504354,il,-89.91957,38.58422,2404,26,47,21,80.8
163504355,il,-89.91969,38.6281,1833,26,47,21,80.8
163504356,il,-89.81508,38.50291,2027,27,47,20,74.1
163504357,il,-89.7649,38.51542,2505,26,47,21,80.8
163504358,il,-89.77694,38.57515,2772,26,47,21,80.8
163504359,il,-89.79188,38.62918,2076,26,47,21,80.8
163504501,il,-90.1495,38.59855,3665,30,51,21,70
163504502,il,-90.16526,38.63561,2494,30,51,21,70
163504600,il,-90.13922,38.6299,2470,29,50,21,72.4
165955100,il,-88.4513,37.81325,1639,31,51,20,64.5
165955500,il,-88.43086,37.81729,1526,31,51,20,64.5
165955600,il,-88.48466,37.83655,3447,31,51,20,64.5
165955700,il,-88.65066,37.8075,2820,31,51,20,64.5
165955800,il,-88.55474,37.74679,2042,32,52,20,62.5
165955900,il,-88.52725,37.74322,1932,32,52,20,62.5
165956000,il,-88.55733,37.72075,1657,33,53,20,60.6
165956100,il,-88.62122,37.69991,2118,32,52,20,62.5
165956200,il,-88.51276,37.66735,4203,30,50,20,66.7
167000100,il,-89.65453,39.85151,2234,16,35,19,118.8
167000201,il,-89.69843,39.82479,1090,16,35,19,118.8
167000202,il,-89.67947,39.81463,1325,16,35,19,118.8
167000300,il,-89.66399,39.81889,1733,16,35,19,118.8
167000400,il,-89.65112,39.8245,1678,16,35,19,118.8
167000501,il,-89.61081,39.83786,1266,16,35,19,118.8
167000503,il,-89.63079,39.8241,1985,16,35,19,118.8
167000504,il,-89.6096,39.82699,1327,16,35,19,118.8
167000600,il,-89.60436,39.80762,2275,16,35,19,118.8
167000700,il,-89.62236,39.81444,1259,16,35,19,118.8
167000800,il,-89.63593,39.80881,1037,16,35,19,118.8
167000900,il,-89.64497,39.81157,1045,16,35,19,118.8
167001001,il,-89.70357,39.80776,775,16,35,19,118.8
167001003,il,-89.71103,39.79404,354,16,35,19,118.8
167001004,il,-89.69681,39.79428,1342,16,35,19,118.8
167001100,il,-89.67997,39.79415,1083,16,35,19,118.8
167001200,il,-89.66801,39.79219,1638,16,35,19,118.8
167001300,il,-89.66088,39.80096,934,16,35,19,118.8
167001400,il,-89.64708,39.79992,381,16,35,19,118.8
167001600,il,-89.61954,39.79576,1675,16,35,19,118.8
167001800,il,-89.64795,39.78583,1414,16,35,19,118.8
167001900,il,-89.65771,39.78956,1564,16,35,19,118.8
167002001,il,-89.6966,39.77888,1667,16,35,19,118.8
167002002,il,-89.70608,39.77196,1158,16,35,19,118.8
167002100,il,-89.6773,39.7787,1742,16,35,19,118.8
167002200,il,-89.65968,39.7773,1702,16,35,19,118.8
167002300,il,-89.63925,39.78085,1566,16,35,19,118.8
167002400,il,-89.61807,39.78,2301,16,35,19,118.8
167002500,il,-89.61851,39.76083,2043,16,36,20,125
167002600,il,-89.64127,39.76995,1503,16,36,20,125
167002700,il,-89.64585,39.75383,2020,16,36,20,125
167002801,il,-89.67239,39.76822,1617,16,36,20,125
167002802,il,-89.67267,39.75471,565,16,36,20,125
167002900,il,-89.70162,39.75302,2231,16,36,20,125
167003000,il,-89.64671,39.72713,1946,17,36,19,111.8
167003100,il,-89.61832,39.71674,3447,17,36,19,111.8
167003201,il,-89.68882,39.6954,1958,17,37,20,117.6
167003202,il,-89.76405,39.66239,2106,17,37,20,117.6
167003203,il,-89.65545,39.65085,2973,17,37,20,117.6
167003300,il,-89.61687,39.58,3662,17,37,20,117.6
167003400,il,-89.76234,39.57118,3744,18,38,20,111.1
167003500,il,-89.89537,39.727,5596,17,37,20,117.6
167003601,il,-89.77843,39.84579,1804,16,35,19,118.8
167003602,il,-89.73654,39.80558,1844,16,35,19,118.8
167003603,il,-89.76296,39.73772,3043,17,36,19,111.8
167003604,il,-89.72638,39.76753,2006,16,35,19,118.8
167003701,il,-89.53963,39.92374,2221,17,35,18,105.9
167003702,il,-89.65104,39.92111,2804,16,35,19,118.8
167003801,il,-89.57016,39.83379,1179,17,36,19,111.8
167003802,il,-89.51108,39.84993,3004,17,36,19,111.8
167003901,il,-89.52856,39.69576,3017,17,37,20,117.6
167003902,il,-89.49762,39.75932,2373,17,36,19,111.8
167004000,il,-89.36016,39.84932,4262,18,37,19,105.6
167004200,il,-89.63588,39.79544,1645,16,35,19,118.8
169970100,il,-90.69016,40.18939,4163,20,37,17,85
169970200,il,-90.55345,40.13057,1966,19,36,17,89.5
169970300,il,-90.45965,40.09322,2922,20,38,18,90
171970600,il,-90.51261,39.70637,2764,21,40,19,90.5
171970700,il,-90.43827,39.58415,3791,19,38,19,100
173959100,il,-88.88207,39.57625,3123,18,37,19,105.6
173959200,il,-88.90095,39.43978,3161,19,38,19,100
173959300,il,-88.80294,39.40649,2733,19,38,19,100
173959400,il,-88.63312,39.41388,3599,19,37,18,94.7
173959500,il,-88.6414,39.28277,4126,19,37,18,94.7
173959600,il,-88.97294,39.28262,3719,19,37,18,94.7
175951400,il,-89.80132,41.15742,3034,12,26,14,116.7
175951500,il,-89.79424,41.04033,2893,12,26,14,116.7
177000100,il,-89.48228,42.42281,3620,9,17,8,88.9
177000200,il,-89.68055,42.43387,2622,9,17,8,88.9
177000300,il,-89.84897,42.44649,2563,8,17,9,112.5
177000400,il,-89.83521,42.28556,2272,9,17,8,88.9
177000500,il,-89.69493,42.28528,2121,9,18,9,100
177000600,il,-89.51531,42.27757,2652,9,18,9,100
177000700,il,-89.5914,42.30067,1432,9,18,9,100
177000800,il,-89.63454,42.30605,1726,9,18,9,100
177000900,il,-89.66789,42.30332,1769,9,18,9,100
177001000,il,-89.65938,42.27838,1463,9,18,9,100
177001100,il,-89.63872,42.28391,1405,9,18,9,100
177001200,il,-89.62606,42.27519,1676,9,18,9,100
177001300,il,-89.60658,42.27712,1543,9,18,9,100
179020100,il,-89.56687,40.68331,1754,14,30,16,114.3
179020301,il,-89.53293,40.65442,2583,14,30,16,114.3
179020302,il,-89.55515,40.64122,2512,13,29,16,123.1
179020400,il,-89.59753,40.64521,2698,14,30,16,114.3
179020500,il,-89.6096,40.61619,2342,14,30,16,114.3
179020600,il,-89.64127,40.58173,882,15,33,18,120
179020700,il,-89.62429,40.59202,2067,15,31,16,106.7
179020800,il,-89.64759,40.58061,1779,16,33,17,106.3
179020900,il,-89.66043,40.55786,1221,16,34,18,112.5
179021000,il,-89.64023,40.56037,2505,15,33,18,120
179021101,il,-89.61774,40.56993,2067,15,31,16,106.7
179021102,il,-89.62026,40.54544,2559,15,32,17,113.3
179021201,il,-89.49125,40.7286,2128,14,30,16,114.3
179021202,il,-89.53437,40.68997,1435,14,30,16,114.3
179021203,il,-89.50684,40.69443,2026,14,30,16,114.3
179021500,il,-89.53831,40.59963,3490,14,30,16,114.3
179021603,il,-89.44578,40.63954,2514,14,30,16,114.3
179021604,il,-89.47985,40.60162,960,14,31,17,121.4
179021605,il,-89.4571,40.60639,1123,14,31,17,121.4
179021606,il,-89.43684,40.58953,2351,14,31,17,121.4
179021701,il,-89.33949,40.56606,3838,15,31,16,106.7
179021702,il,-89.50085,40.52322,3537,15,32,17,113.3
179021801,il,-89.64827,40.51056,2183,16,34,18,112.5
179021802,il,-89.78606,40.49151,2102,18,36,18,100
179021900,il,-89.60467,40.40023,3373,17,35,18,105.9
179022000,il,-89.37814,40.40349,3436,16,34,18,112.5
179022100,il,-89.36795,40.70391,1747,14,30,16,114.3
179022200,il,-89.43647,40.68245,2196,14,30,16,114.3
179022300,il,-89.42609,40.72186,2321,14,30,16,114.3
179022400,il,-89.48846,40.6798,2091,14,30,16,114.3
181950100,il,-89.14509,37.52829,3078,30,51,21,70
181950200,il,-89.37947,37.52092,2451,30,51,21,70
181950300,il,-89.27746,37.45003,1155,30,51,21,70
181950400,il,-89.23739,37.45035,2573,30,50,20,66.7
181950500,il,-89.22914,37.38907,3143,32,53,21,65.6
183000100,il,-87.62717,40.1244,1297,16,32,16,100
183000200,il,-87.61775,40.12698,1474,16,32,16,100
183000300,il,-87.60691,40.12535,1205,16,32,16,100
183000400,il,-87.56622,40.15109,1314,15,31,16,106.7
183000500,il,-87.60646,40.159,1621,16,31,15,93.8
183000600,il,-87.63218,40.14029,1531,16,32,16,100
183000700,il,-87.66298,40.15527,1844,16,32,16,100
183000800,il,-87.66841,40.1365,1621,16,32,16,100
183000900,il,-87.65853,40.11666,1900,16,32,16,100
183001200,il,-87.6124,40.184,1455,16,31,15,93.8
183001300,il,-87.66045,40.18291,2154,16,32,16,100
183010100,il,-87.75944,40.4124,4278,14,28,14,100
183010200,il,-87.66001,40.46648,2946,13,28,15,115.4
183010300,il,-87.73511,40.27086,6219,15,31,16,106.7
183010400,il,-87.57918,40.22516,1735,15,31,16,106.7
183010500,il,-87.58171,40.0864,2349,15,31,16,106.7
183010600,il,-87.63058,40.04164,2722,14,29,15,107.1
183010701,il,-87.66,40.08136,2089,15,31,16,106.7
183010702,il,-87.72998,40.08656,1904,15,31,16,106.7
183010800,il,-87.83858,40.12926,2717,16,32,16,100
183010900,il,-87.81393,39.98053,4382,16,32,16,100
183011000,il,-87.65336,39.98697,2629,15,30,15,100
183011100,il,-87.59616,39.9509,2881,15,31,16,106.7
183011200,il,-87.56605,40.1277,2546,15,31,16,106.7
185957200,il,-87.85072,38.45031,5220,28,48,20,71.4
185957300,il,-87.79602,38.42718,1404,29,48,19,65.5
185957400,il,-87.75119,38.43201,1302,28,48,20,71.4
185957500,il,-87.79755,38.38795,1887,29,48,19,65.5
187870100,il,-90.71739,40.94376,2155,16,31,15,93.8
187870200,il,-90.61749,40.71698,3854,16,32,16,100
187870300,il,-90.54055,40.92902,3114,14,29,15,107.1
187870400,il,-90.64744,40.92372,2181,16,32,16,100
187870500,il,-90.64594,40.90203,2547,16,32,16,100
189950100,il,-89.2864,38.43256,5172,22,42,20,90.9
189950200,il,-89.56269,38.38126,5426,24,44,20,83.3
189950300,il,-89.37634,38.35583,2491,22,42,20,90.9
189950400,il,-89.39341,38.27326,7083,23,43,20,87
191954900,il,-88.25764,38.43093,5895,26,46,20,76.9
191955000,il,-88.53563,38.49723,6178,24,44,20,83.3
191955100,il,-88.36436,38.395,1752,24,44,20,83.3
191955200,il,-88.36027,38.37098,2489,24,44,20,83.3
191955300,il,-88.54095,38.32142,3813,26,46,20,76.9
193958000,il,-88.18551,38.08943,2137,32,52,20,62.5
193958100,il,-88.16778,38.0745,2224,32,52,20,62.5
193958200,il,-88.08468,38.15811,5424,31,50,19,61.3
193958300,il,-88.28483,38.14026,5230,29,49,20,69
193958400,il,-88.19883,37.9732,5564,30,50,20,66.7
195000100,il,-89.77098,41.8526,3204,11,22,11,100
195000200,il,-89.94498,41.87115,2492,12,24,12,100
195000300,il,-89.97153,41.79411,1909,13,26,13,100
195000400,il,-90.10832,41.83508,3046,12,23,11,91.7
195000500,il,-90.16216,41.861,1896,12,23,11,91.7
195000600,il,-90.07255,41.70916,3623,13,26,13,100
195000700,il,-90.00047,41.63093,2308,13,26,13,100
195000800,il,-89.78072,41.65043,2220,12,25,13,108.3
195000900,il,-89.68918,41.81935,1969,11,22,11,100
195001000,il,-89.73218,41.7897,1583,11,22,11,100
195001101,il,-89.6954,41.80447,1141,11,22,11,100
195001102,il,-89.69699,41.78955,1066,11,22,11,100
195001200,il,-89.68304,41.80006,1697,11,22,11,100
195001300,il,-89.66732,41.80266,1010,11,22,11,100
195001400,il,-89.65809,41.77192,1234,11,22,11,100
195001500,il,-89.6871,41.7777,1720,11,22,11,100
195001600,il,-89.70712,41.77627,1192,11,22,11,100
195001700,il,-89.71747,41.76313,1352,11,23,12,109.1
195001800,il,-89.68918,41.71886,1275,11,23,12,109.1
197880105,il,-88.1092,41.6978,2427,11,21,10,90.9
197880106,il,-88.09209,41.6988,1310,11,21,10,90.9
197880107,il,-88.07763,41.7061,1820,11,20,9,81.8
197880109,il,-88.05339,41.72221,1907,11,21,10,90.9
197880111,il,-88.05811,41.70234,1020,11,21,10,90.9
197880112,il,-88.04091,41.70283,664,11,21,10,90.9
197880113,il,-88.06004,41.69402,1066,11,21,10,90.9
197880114,il,-88.07895,41.68521,408,12,22,10,83.3
197880115,il,-88.07782,41.69464,592,11,21,10,90.9
197880116,il,-88.05827,41.71006,1068,11,21,10,90.9
197880117,il,-88.03937,41.71477,625,11,21,10,90.9
197880118,il,-88.09592,41.71981,1577,11,21,10,90.9
197880119,il,-88.13626,41.71781,1526,11,21,10,90.9
197880122,il,-88.1343,41.6916,1853,11,21,10,90.9
197880123,il,-88.11947,41.70694,1010,11,21,10,90.9
197880124,il,-88.10862,41.67709,1412,11,22,11,100
197880125,il,-88.13611,41.66645,1666,11,21,10,90.9
197880202,il,-88.06034,41.66596,2331,11,22,11,100
197880203,il,-88.08804,41.64719,1335,12,22,10,83.3
197880204,il,-88.11887,41.64596,2407,11,22,11,100
197880303,il,-88.17705,41.71794,1375,11,21,10,90.9
197880304,il,-88.15764,41.71827,1635,11,21,10,90.9
197880305,il,-88.17651,41.70209,1716,11,21,10,90.9
197880307,il,-88.19646,41.71761,1493,11,21,10,90.9
197880309,il,-88.19566,41.69535,1571,11,21,10,90.9
197880314,il,-88.24541,41.6659,2542,11,21,10,90.9
197880315,il,-88.15544,41.6905,1133,11,21,10,90.9
197880316,il,-88.16752,41.69549,987,11,21,10,90.9
197880317,il,-88.16749,41.65544,2118,11,22,11,100
197880318,il,-88.18931,41.66748,1151,11,21,10,90.9
197880319,il,-88.21913,41.67317,1456,11,21,10,90.9
197880320,il,-88.21427,41.64473,1038,11,22,11,100
197880321,il,-88.21829,41.65877,1179,11,21,10,90.9
197880322,il,-88.21986,41.69132,2186,11,21,10,90.9
197880323,il,-88.22068,41.71365,2575,11,21,10,90.9
197880324,il,-88.24796,41.7199,1440,11,21,10,90.9
197880325,il,-88.25547,41.70532,732,11,21,10,90.9
197880326,il,-88.24333,41.70827,811,11,21,10,90.9
197880408,il,-88.15378,41.63062,1645,11,22,11,100
197880411,il,-88.1827,41.61609,1496,11,22,11,100
197880412,il,-88.15251,41.56145,1635,11,22,11,100
197880414,il,-88.1716,41.56088,1650,11,22,11,100
197880416,il,-88.1904,41.55793,1126,12,24,12,100
197880417,il,-88.18144,41.58004,1110,12,22,10,83.3
197880418,il,-88.2086,41.55709,1509,12,24,12,100
197880421,il,-88.21906,41.58382,2879,12,22,10,83.3
197880422,il,-88.21932,41.60171,1624,11,22,11,100
197880423,il,-88.21279,41.62341,1177,11,22,11,100
197880424,il,-88.2418,41.61746,1456,11,22,11,100
197880425,il,-88.15845,41.60904,1306,11,22,11,100
197880426,il,-88.14883,41.60931,1331,11,22,11,100
197880427,il,-88.1602,41.57693,1210,11,22,11,100
197880428,il,-88.152,41.58839,1519,11,22,11,100
197880429,il,-88.21695,41.56402,1551,12,23,11,91.7
197880430,il,-88.23174,41.56185,1089,11,22,11,100
197880431,il,-88.2477,41.57179,1675,11,22,11,100
197880432,il,-88.24713,41.55738,1345,11,22,11,100
197880502,il,-88.04481,41.61854,2006,10,21,11,110
197880503,il,-88.13443,41.63135,2156,11,22,11,100
197880508,il,-88.10813,41.63123,1181,11,22,11,100
197880509,il,-88.0883,41.63426,1281,12,23,11,91.7
197880510,il,-88.12828,41.61689,622,11,22,11,100
197880511,il,-88.13867,41.61664,1173,11,22,11,100
197880601,il,-88.03576,41.58902,1143,11,21,10,90.9
197880602,il,-88.05479,41.59054,1492,11,21,10,90.9
197880701,il,-88.04363,41.5761,1925,11,21,10,90.9
197880702,il,-88.05475,41.56362,1968,12,22,10,83.3
197880901,il,-88.13251,41.57376,2993,11,22,11,100
197880903,il,-88.11418,41.56094,925,11,22,11,100
197880905,il,-88.09693,41.55611,1161,12,23,11,91.7
197881001,il,-88.00227,41.62015,2330,10,20,10,100
197881002,il,-87.96394,41.62102,1804,10,20,10,100
197881005,il,-87.94072,41.62886,1371,10,20,10,100
197881006,il,-87.92149,41.6365,1026,10,20,10,100
197881007,il,-87.9405,41.58085,2222,10,21,11,110
197881009,il,-88.01608,41.57621,2834,11,21,10,90.9
197881010,il,-87.98313,41.57287,1451,11,21,10,90.9
197881011,il,-87.92104,41.62201,1204,10,20,10,100
197881012,il,-87.93016,41.60727,1042,10,20,10,100
197881105,il,-87.9374,41.53707,3080,11,21,10,90.9
197881107,il,-87.97489,41.52514,1183,11,21,10,90.9
197881108,il,-87.99987,41.53741,2623,11,22,11,100
197881109,il,-88.00321,41.47983,1360,11,21,10,90.9
197881111,il,-87.97993,41.5117,1308,11,21,10,90.9
197881112,il,-87.98813,41.49427,1918,11,21,10,90.9
197881113,il,-87.93654,41.48346,2161,10,21,11,110
197881115,il,-87.94553,41.50775,1558,10,20,10,100
197881116,il,-87.91977,41.50608,1499,10,20,10,100
197881201,il,-88.04811,41.5487,1441,12,22,10,83.3
197881202,il,-88.03179,41.53842,786,11,22,11,100
197881301,il,-88.06689,41.54142,936,12,23,11,91.7
197881302,il,-88.07699,41.54095,523,12,23,11,91.7
197881401,il,-88.0907,41.5476,1284,12,23,11,91.7
197881402,il,-88.10804,41.54728,1336,11,22,11,100
197881500,il,-88.11723,41.54301,1439,11,22,11,100
197881601,il,-88.13313,41.53333,672,11,22,11,100
197881603,il,-88.13325,41.54053,611,11,22,11,100
197881604,il,-88.13383,41.54771,466,11,22,11,100
197881700,il,-88.11317,41.53383,1316,11,22,11,100
197881800,il,-88.09449,41.53823,1266,12,23,11,91.7
197881900,il,-88.08824,41.53113,760,12,23,11,91.7
197882000,il,-88.0796,41.52537,1134,12,22,10,83.3
197882100,il,-88.06455,41.53185,687,12,23,11,91.7
197882200,il,-88.04924,41.53364,1967,11,22,11,100
197882300,il,-88.03577,41.52129,1754,11,22,11,100
197882400,il,-88.06019,41.51938,1335,11,22,11,100
197882500,il,-88.08073,41.51542,921,11,22,11,100
197882601,il,-88.10817,41.51695,1269,12,23,11,91.7
197882602,il,-88.09501,41.51707,911,11,22,11,100
197882701,il,-88.10811,41.52591,966,11,22,11,100
197882702,il,-88.0962,41.5271,821,12,22,10,83.3
197882801,il,-88.11983,41.52073,755,11,22,11,100
197882802,il,-88.13266,41.52038,861,12,23,11,91.7
197882900,il,-88.12188,41.5011,1402,12,23,11,91.7
197883000,il,-88.04997,41.50525,1672,11,22,11,100
197883100,il,-88.07951,41.48278,2614,11,22,11,100
197883206,il,-88.15065,41.52933,1465,12,23,11,91.7
197883208,il,-88.15124,41.54384,947,12,22,10,83.3
197883209,il,-88.17048,41.54362,967,12,22,10,83.3
197883210,il,-88.16582,41.52468,1017,12,23,11,91.7
197883211,il,-88.16904,41.49074,2586,12,24,12,100
197883212,il,-88.22528,41.485,2598,12,24,12,100
197883213,il,-88.22303,41.51408,2883,12,24,12,100
197883214,il,-88.1898,41.53623,902,12,24,12,100
197883216,il,-88.20857,41.52871,1248,12,24,12,100
197883217,il,-88.20555,41.5471,1277,12,24,12,100
197883218,il,-88.23802,41.54624,1443,11,23,12,109.1
197883219,il,-88.23243,41.5326,1267,12,23,11,91.7
197883303,il,-88.23791,41.44508,1495,12,23,11,91.7
197883304,il,-88.00272,41.33018,1556,12,24,12,100
197883305,il,-88.21118,41.44624,1326,12,23,11,91.7
197883306,il,-88.18668,41.41564,1735,12,23,11,91.7
197883307,il,-88.07994,41.42907,2656,11,22,11,100
197883401,il,-88.14835,41.30155,1734,12,24,12,100
197883402,il,-88.20335,41.32986,1434,12,24,12,100
197883504,il,-87.84669,41.49248,2612,10,20,10,100
197883505,il,-87.80933,41.49274,3358,10,20,10,100
197883507,il,-87.84529,41.42629,2297,10,20,10,100
197883509,il,-87.96135,41.40432,2230,11,22,11,100
197883510,il,-87.96077,41.44741,3104,11,22,11,100
197883511,il,-87.79974,41.52516,1707,10,19,9,90
197883513,il,-87.83518,41.53063,2066,10,20,10,100
197883514,il,-87.81955,41.54622,2636,10,20,10,100
197883515,il,-87.87994,41.50917,1579,10,20,10,100
197883516,il,-87.88609,41.48811,2847,10,20,10,100
197883517,il,-87.89913,41.52473,1204,10,20,10,100
197883519,il,-87.89111,41.5468,2087,11,21,10,90.9
197883521,il,-87.8778,41.53293,1224,11,21,10,90.9
197883522,il,-87.86477,41.53447,1407,11,21,10,90.9
197883602,il,-87.74059,41.41742,2753,10,20,10,100
197883603,il,-87.69015,41.45817,1144,9,19,10,111.1
197883605,il,-87.68426,41.44157,771,9,19,10,111.1
197883606,il,-87.71011,41.4419,1514,9,19,10,111.1
197883700,il,-87.63271,41.46541,1897,9,19,10,111.1
197883803,il,-87.66193,41.46367,323,9,19,10,111.1
197883804,il,-87.64999,41.45304,1442,9,19,10,111.1
197883806,il,-87.54571,41.43798,1655,9,19,10,111.1
197883808,il,-87.57852,41.40533,728,9,19,10,111.1
197883809,il,-87.64972,41.41362,1438,9,19,10,111.1
197883810,il,-87.59799,41.46392,1989,9,19,10,111.1
197883811,il,-87.6064,41.43552,2543,9,19,10,111.1
197883902,il,-87.59813,41.34107,3867,10,20,10,100
197883903,il,-87.72761,41.33998,1051,11,22,11,100
197883904,il,-87.84343,41.33874,2238,11,22,11,100
197884003,il,-88.22787,41.27486,2225,12,24,12,100
197884004,il,-88.21381,41.23756,1947,12,24,12,100
197884005,il,-88.13256,41.23418,1022,12,25,13,108.3
197884006,il,-88.07084,41.26061,1658,12,24,12,100
197884101,il,-88.09512,41.61194,1718,11,22,11,100
197884103,il,-88.09251,41.58081,1071,11,22,11,100
197980000,il,-88.09957,41.36726,104,12,23,11,91.7
197980100,il,-88.10166,41.5747,8,11,22,11,100
199020100,il,-89.11219,37.82167,3460,29,49,20,69
199020201,il,-89.0714,37.76328,3634,29,49,20,69
199020202,il,-89.12376,37.75958,1878,30,50,20,66.7
199020300,il,-89.00261,37.78515,3201,28,48,20,71.4
199020400,il,-89.03298,37.80194,2326,28,47,19,67.9
199020500,il,-89.01374,37.79971,1790,27,47,20,74.1
199020600,il,-89.02661,37.83397,2781,28,48,20,71.4
199020700,il,-88.9339,37.83208,3876,28,47,19,67.9
199020801,il,-88.81013,37.8172,2919,28,48,20,71.4
199020802,il,-88.78401,37.68561,4382,29,49,20,69
199020900,il,-88.91084,37.76961,3096,28,47,19,67.9
199021001,il,-88.93455,37.74235,1539,28,48,20,71.4
199021002,il,-88.9912,37.75213,1557,28,48,20,71.4
199021003,il,-88.94945,37.74297,879,29,48,19,65.5
199021100,il,-88.92177,37.73033,2031,28,48,20,71.4
199021200,il,-88.9567,37.72092,2247,30,50,20,66.7
199021300,il,-88.89574,37.69476,2993,29,49,20,69
199021400,il,-89.04366,37.66174,5837,29,50,21,72.4
201000101,il,-89.05451,42.35361,2241,9,18,9,100
201000103,il,-89.05406,42.33246,1375,9,17,8,88.9
201000104,il,-89.03743,42.33257,1113,9,17,8,88.9
201000105,il,-89.0383,42.35038,1603,9,17,8,88.9
201000200,il,-89.0498,42.32089,1431,9,18,9,100
201000300,il,-89.05547,42.3083,2033,9,18,9,100
201000401,il,-89.04943,42.28173,923,9,17,8,88.9
201000402,il,-89.03834,42.28634,1293,9,17,8,88.9
201000403,il,-89.04154,42.30136,1348,9,17,8,88.9
201000501,il,-89.01436,42.24567,1835,9,17,8,88.9
201000502,il,-89.01368,42.25898,1133,9,17,8,88.9
201000506,il,-89.01454,42.28915,1685,9,17,8,88.9
201000507,il,-89.01461,42.27329,1073,9,17,8,88.9
201000510,il,-88.98981,42.30761,1123,9,17,8,88.9
201000511,il,-88.98996,42.28236,943,9,17,8,88.9
201000512,il,-88.96075,42.2955,1621,9,18,9,100
201000513,il,-88.98974,42.2533,1241,9,18,9,100
201000514,il,-88.95971,42.25562,1472,9,18,9,100
201000515,il,-89.01634,42.31416,824,9,17,8,88.9
201000516,il,-89.0132,42.30368,1530,9,17,8,88.9
201000600,il,-89.04281,42.27163,1784,9,17,8,88.9
201000700,il,-89.06659,42.27778,1431,9,18,9,100
201000800,il,-89.07824,42.2716,1076,9,18,9,100
201001000,il,-89.09195,42.25836,682,9,18,9,100
201001100,il,-89.08394,42.26575,574,9,18,9,100
201001200,il,-89.08005,42.25527,909,9,18,9,100
201001300,il,-89.07284,42.26168,781,9,18,9,100
201001400,il,-89.06224,42.25864,1530,9,18,9,100
201001500,il,-89.04387,42.25938,2315,9,17,8,88.9
201001600,il,-89.03743,42.245,1705,9,17,8,88.9
201001700,il,-89.05109,42.24627,1134,9,17,8,88.9
201001800,il,-89.07192,42.24479,1938,9,18,9,100
201001900,il,-89.06487,42.22881,1637,9,17,8,88.9
201002000,il,-89.07954,42.22873,1490,9,17,8,88.9
201002100,il,-89.09501,42.23669,1002,9,18,9,100
201002200,il,-89.12247,42.2434,1921,9,18,9,100
201002301,il,-89.15042,42.28379,1494,9,18,9,100
201002302,il,-89.16127,42.27154,797,9,18,9,100
201002400,il,-89.13977,42.27053,1594,9,18,9,100
201002500,il,-89.11853,42.27391,1503,9,18,9,100
201002600,il,-89.10268,42.27562,998,9,18,9,100
201002700,il,-89.11068,42.26177,1102,9,18,9,100
201002800,il,-89.10196,42.25898,789,9,18,9,100
201002900,il,-89.09362,42.27283,268,9,18,9,100
201003000,il,-89.0763,42.28466,656,9,18,9,100
201003100,il,-89.09269,42.28446,1469,9,18,9,100
201003200,il,-89.11481,42.28463,1233,9,18,9,100
201003300,il,-89.10666,42.29487,1636,9,18,9,100
201003400,il,-89.08675,42.29579,1900,9,18,9,100
201003500,il,-89.0708,42.29786,1016,9,18,9,100
201003601,il,-89.14436,42.30678,1225,9,18,9,100
201003602,il,-89.10641,42.31285,1171,9,18,9,100
201003604,il,-89.09193,42.30845,1093,9,18,9,100
201003605,il,-89.08301,42.32034,357,9,18,9,100
201003606,il,-89.08019,42.31036,965,9,18,9,100
201003705,il,-88.99141,42.18366,2722,9,18,9,100
201003706,il,-89.05069,42.20089,2673,9,17,8,88.9
201003707,il,-89.01516,42.20258,685,9,18,9,100
201003708,il,-89.03214,42.22665,1086,9,17,8,88.9
201003709,il,-89.02585,42.23518,586,9,17,8,88.9
201003710,il,-88.98936,42.23202,912,9,18,9,100
201003711,il,-89.13227,42.19499,2647,9,18,9,100
201003801,il,-89.11098,42.37123,3260,10,18,8,80
201003805,il,-89.02119,42.38194,3061,9,18,9,100
201003806,il,-88.96941,42.39234,2044,9,18,9,100
201003808,il,-89.02266,42.34832,1491,9,17,8,88.9
201003809,il,-89.01247,42.32736,1003,9,17,8,88.9
201003810,il,-88.97751,42.32901,2124,9,17,8,88.9
201003811,il,-88.97335,42.35171,678,9,17,8,88.9
201003901,il,-89.11396,42.44535,1964,10,19,9,90
201003903,il,-88.9666,42.45613,2601,9,17,8,88.9
201003904,il,-89.01109,42.42656,1950,10,18,8,80
201004002,il,-89.05938,42.4554,2656,10,19,9,90
201004003,il,-89.07744,42.48183,959,10,18,8,80
201004004,il,-89.02406,42.48283,2817,10,18,8,80
201004005,il,-89.01715,42.45627,1281,10,18,8,80
201004100,il,-89.28358,42.43873,4266,9,18,9,100
201004200,il,-89.22729,42.29036,3539,9,18,9,100
201004300,il,-89.33918,42.2889,3091,9,18,9,100
201980000,il,-89.09759,42.19802,137,9,18,9,100
203030100,il,-89.32002,40.8776,2642,15,30,15,100
203030200,il,-89.04584,40.88282,2656,15,31,16,106.7
203030300,il,-89.15774,40.7966,2415,15,30,15,100
203030400,il,-89.367,40.79096,3157,14,30,16,114.3
203030501,il,-89.47412,40.77886,3438,14,29,15,107.1
203030502,il,-89.51827,40.80869,1575,14,30,16,114.3
203030601,il,-89.2586,40.71634,3050,15,30,15,100
203030602,il,-89.18903,40.64373,2947,15,31,16,106.7
203030700,il,-89.04198,40.74692,3541,15,31,16,106.7
