geoid (zcta),state_abbr,lon,lat,count_prop,days_above_100_today,days_above_100_30yrs,change_days_above_100,change_perc_above_100
01001,ma,-72.62588,42.06258,5355,6,13,7,116.7
01002,ma,-72.4621,42.37492,7060,2,7,5,250
01003,ma,-72.52476,42.39191,11,3,9,6,200
01005,ma,-72.10616,42.42018,3001,1,3,2,200
01007,ma,-72.40037,42.27875,6492,2,6,4,200
01008,ma,-72.952,42.18428,1179,1,2,1,100
01009,ma,-72.33974,42.20967,354,2,6,4,200
01010,ma,-72.20621,42.12863,2329,1,4,3,300
01011,ma,-72.9597,42.29654,1109,1,3,2,200
01012,ma,-72.84636,42.38701,495,0,2,2,NA
01013,ma,-72.60824,42.15955,6731,5,12,7,140
01020,ma,-72.56535,42.17635,10001,4,11,7,175
01022,ma,-72.5427,42.1973,96,4,10,6,150
01026,ma,-72.92027,42.46333,928,0,2,2,NA
01027,ma,-72.74312,42.29507,7137,3,8,5,166.7
01028,ma,-72.49905,42.05977,6601,4,10,6,150
01029,ma,-73.04836,42.19633,1952,0,1,1,NA
01030,ma,-72.67996,42.06898,4488,5,11,6,120
01031,ma,-72.19815,42.32938,583,1,3,2,200
01032,ma,-72.813,42.45042,629,0,2,2,NA
01033,ma,-72.50362,42.26082,3188,3,8,5,166.7
01034,ma,-72.95767,42.0848,2051,1,3,2,200
01035,ma,-72.56922,42.35565,3055,3,9,6,200
01036,ma,-72.41585,42.06372,2316,2,6,4,200
01037,ma,-72.19772,42.37009,484,1,3,2,200
01038,ma,-72.60694,42.38549,1640,4,10,6,150
01039,ma,-72.69364,42.40627,741,3,8,5,166.7
01040,ma,-72.64106,42.21258,10122,4,11,7,175
01050,ma,-72.86985,42.28786,1740,1,4,3,300
01053,ma,-72.71162,42.35349,598,3,9,6,200
01054,ma,-72.48747,42.47361,1219,1,5,4,400
01056,ma,-72.45805,42.19211,8515,3,9,6,200
01057,ma,-72.3243,42.09165,4046,1,4,3,300
01060,ma,-72.63128,42.32226,5047,4,10,6,150
01062,ma,-72.69278,42.32189,4988,4,10,6,150
01063,ma,-72.63853,42.31888,26,4,10,6,150
01066,ma,-72.65477,42.40763,53,3,9,6,200
01068,ma,-72.04606,42.35003,1027,1,2,1,100
01069,ma,-72.30554,42.18807,4122,2,5,3,150
01070,ma,-72.9239,42.51853,672,0,1,1,NA
01071,ma,-72.85996,42.16034,772,2,5,3,150
01072,ma,-72.41841,42.45736,1129,1,3,2,200
01073,ma,-72.73857,42.23083,3012,4,10,6,150
01074,ma,-72.09427,42.38661,109,1,2,1,100
01075,ma,-72.57921,42.25674,6523,4,10,6,150
01077,ma,-72.77856,42.05441,4239,3,9,6,200
01079,ma,-72.33014,42.19435,277,2,6,4,200
01080,ma,-72.36556,42.18201,886,2,6,4,200
01081,ma,-72.23097,42.06229,1123,1,3,2,200
01082,ma,-72.27777,42.2948,4944,1,4,3,300
01083,ma,-72.19493,42.20378,1470,1,3,2,200
01084,ma,-72.88089,42.39039,197,1,3,2,200
01085,ma,-72.76959,42.15371,13727,4,11,7,175
01088,ma,-72.64775,42.3901,411,4,10,6,150
01089,ma,-72.65025,42.12534,9035,5,13,8,160
01092,ma,-72.2373,42.19974,673,1,4,3,300
01093,ma,-72.65304,42.43438,250,3,9,6,200
01094,ma,-72.1384,42.35952,162,1,3,2,200
01095,ma,-72.42993,42.12764,5744,2,7,5,250
01096,ma,-72.7682,42.40418,1439,1,3,2,200
01097,ma,-72.83131,42.17604,85,3,8,5,166.7
01098,ma,-72.94241,42.39461,865,1,2,1,100
01103,ma,-72.59198,42.10401,348,5,12,7,140
01104,ma,-72.56684,42.13402,7088,5,12,7,140
01105,ma,-72.57893,42.09917,1929,5,12,7,140
01106,ma,-72.57181,42.04798,5889,4,11,7,175
01107,ma,-72.60551,42.12132,2043,6,13,7,116.7
01108,ma,-72.55986,42.08054,6178,4,11,7,175
01109,ma,-72.54883,42.1184,8269,5,11,6,120
01118,ma,-72.52531,42.09479,5475,4,10,6,150
01119,ma,-72.51125,42.12455,4563,4,10,6,150
01128,ma,-72.48812,42.09485,1186,4,10,6,150
01129,ma,-72.48771,42.12103,2788,4,10,6,150
01151,ma,-72.50881,42.15294,2596,4,10,6,150
01201,ma,-73.27646,42.44994,19005,1,2,1,100
01220,ma,-73.11719,42.62374,3807,0,2,2,NA
01222,ma,-73.32084,42.05902,484,2,5,3,150
01223,ma,-73.09945,42.31172,4756,0,2,2,NA
01224,ma,-73.19751,42.50653,107,1,2,1,100
01225,ma,-73.15483,42.56267,1662,0,1,1,NA
01226,ma,-73.13986,42.48167,2821,0,1,1,NA
01229,ma,-73.33203,42.27793,74,1,3,2,200
01230,ma,-73.34379,42.18476,6096,1,4,3,300
01235,ma,-73.07241,42.42976,2260,0,1,1,NA
01236,ma,-73.37665,42.26647,887,1,4,3,300
01237,ma,-73.26263,42.54972,1809,0,2,2,NA
01238,ma,-73.22889,42.29524,3298,1,2,1,100
01240,ma,-73.27645,42.37211,2200,1,2,1,100
01242,ma,-73.24922,42.33333,229,1,2,1,100
01243,ma,-73.02326,42.35146,435,1,2,1,100
01244,ma,-73.26273,42.11609,126,1,3,2,200
01245,ma,-73.21886,42.18822,1345,0,2,2,NA
01247,ma,-73.07998,42.69548,6755,1,2,1,100
01253,ma,-73.11613,42.21186,1063,0,2,2,NA
01254,ma,-73.36552,42.37981,814,1,2,1,100
01255,ma,-73.12289,42.10839,1312,0,2,2,NA
01256,ma,-73.01957,42.59627,589,0,1,1,NA
01257,ma,-73.36887,42.09704,2086,2,5,3,150
01258,ma,-73.46184,42.10259,548,1,3,2,200
01259,ma,-73.23567,42.07555,804,1,3,2,200
01260,ma,-73.34505,42.29581,175,1,3,2,200
01262,ma,-73.31773,42.29358,1067,1,3,2,200
01264,ma,-73.199,42.23416,262,0,2,2,NA
01266,ma,-73.38422,42.30797,1518,1,3,2,200
01267,ma,-73.23899,42.67195,3065,1,3,2,200
01270,ma,-73.04125,42.51496,807,0,1,1,NA
01301,ma,-72.60394,42.62418,6891,3,9,6,200
01330,ma,-72.81394,42.51385,1144,0,1,1,NA
01331,ma,-72.18294,42.56729,7006,1,4,3,300
01337,ma,-72.57722,42.69521,1836,2,6,4,200
01338,ma,-72.82133,42.57359,162,0,2,2,NA
01339,ma,-72.89006,42.60801,1261,0,2,2,NA
01340,ma,-72.718,42.68323,1676,1,3,2,200
01341,ma,-72.70515,42.50446,1346,1,4,3,300
01342,ma,-72.6059,42.54452,1168,3,8,5,166.7
01343,ma,-72.98106,42.6544,79,0,1,1,NA
01344,ma,-72.42876,42.60778,797,1,3,2,200
01346,ma,-72.81701,42.68891,835,0,1,1,NA
01347,ma,-72.5169,42.56143,253,1,4,3,300
01349,ma,-72.48332,42.57272,739,1,4,3,300
01350,ma,-72.98239,42.72268,197,0,1,1,NA
01351,ma,-72.51912,42.54287,1473,2,6,4,200
01354,ma,-72.51112,42.63373,868,2,7,5,250
01355,ma,-72.33043,42.45289,835,1,4,3,300
01360,ma,-72.44597,42.67574,2273,1,4,3,300
01364,ma,-72.29241,42.61293,3752,2,5,3,150
01366,ma,-72.18776,42.48058,1129,1,3,2,200
01367,ma,-72.91182,42.69585,777,0,1,1,NA
01368,ma,-72.18604,42.68081,1323,1,4,3,300
01370,ma,-72.7286,42.59657,2484,1,4,3,300
01373,ma,-72.61562,42.47294,2765,3,9,6,200
01375,ma,-72.55462,42.46511,1494,3,8,5,166.7
01376,ma,-72.55569,42.59542,2175,3,8,5,166.7
01378,ma,-72.34579,42.67478,778,1,4,3,300
01379,ma,-72.40253,42.55285,932,1,3,2,200
01420,ma,-71.81663,42.58579,12501,2,5,3,150
01430,ma,-71.92369,42.66015,3978,1,3,2,200
01431,ma,-71.82319,42.67651,1754,1,4,3,300
01432,ma,-71.5714,42.56467,2714,3,8,5,166.7
01434,ma,-71.61145,42.53854,33,3,8,5,166.7
01436,ma,-72.08851,42.60547,1363,1,3,2,200
01438,ma,-72.03176,42.56178,272,0,2,2,NA
01440,ma,-71.9865,42.58739,6679,1,2,1,100
01450,ma,-71.56141,42.61367,4711,3,8,5,166.7
01451,ma,-71.57377,42.50123,2366,2,7,5,250
01452,ma,-72.00513,42.48379,2505,1,2,1,100
01453,ma,-71.76138,42.51864,12743,2,6,4,200
01460,ma,-71.4891,42.53502,4292,3,9,6,200
01462,ma,-71.7199,42.58968,4683,2,7,5,250
01463,ma,-71.60421,42.67118,4291,3,8,5,166.7
01464,ma,-71.64838,42.57331,2479,3,8,5,166.7
01467,ma,-71.61724,42.48775,170,2,7,5,250
01468,ma,-72.06894,42.55207,2257,1,2,1,100
01469,ma,-71.694,42.66657,2836,2,7,5,250
01473,ma,-71.90265,42.55122,3903,1,3,2,200
01474,ma,-71.75221,42.66786,973,2,6,4,200
01475,ma,-72.049,42.66666,4934,1,2,1,100
01501,ma,-71.84535,42.19721,6576,1,4,3,300
01503,ma,-71.63552,42.38378,1478,2,7,5,250
01504,ma,-71.53125,42.03992,3461,3,8,5,166.7
01505,ma,-71.72123,42.35632,2109,2,5,3,150
01506,ma,-72.10441,42.19364,1560,1,4,3,300
01507,ma,-71.96803,42.13509,6364,1,4,3,300
01510,ma,-71.68884,42.4119,3995,2,6,4,200
01515,ma,-72.04672,42.20326,1384,1,3,2,200
01516,ma,-71.75085,42.05279,4396,2,6,4,200
01518,ma,-72.1186,42.12347,1440,1,4,3,300
01519,ma,-71.68005,42.20107,2440,2,6,4,200
01520,ma,-71.8528,42.33539,6248,1,3,2,200
01521,ma,-72.16595,42.06017,2429,1,3,2,200
01522,ma,-71.86912,42.38138,1628,1,3,2,200
01523,ma,-71.67843,42.47972,2917,2,7,5,250
01524,ma,-71.91984,42.24921,3048,1,3,2,200
01525,ma,-71.63244,42.10671,86,3,8,5,166.7
01527,ma,-71.77417,42.19218,5229,2,5,3,150
01529,ma,-71.57767,42.03901,1284,3,8,5,166.7
01531,ma,-72.12795,42.3193,755,1,3,2,200
01532,ma,-71.64622,42.32314,5464,2,7,5,250
01534,ma,-71.64295,42.14042,2125,2,7,5,250
01535,ma,-72.07794,42.2695,2330,1,3,2,200
01536,ma,-71.69107,42.23239,2553,2,6,4,200
01537,ma,-71.89147,42.16157,953,1,4,3,300
01540,ma,-71.85733,42.11634,4486,1,4,3,300
01541,ma,-71.88128,42.45649,1919,1,3,2,200
01542,ma,-71.91077,42.20184,924,1,3,2,200
01543,ma,-71.96726,42.38482,4185,1,2,1,100
01545,ma,-71.71554,42.28423,11429,2,6,4,200
01550,ma,-72.03377,42.06043,5670,2,5,3,150
01560,ma,-71.67764,42.17497,1193,2,6,4,200
01561,ma,-71.68558,42.44397,70,2,7,5,250
01562,ma,-71.99189,42.24715,5193,1,2,1,100
01564,ma,-71.77297,42.44124,3716,2,5,3,150
01566,ma,-72.08116,42.10238,3073,1,4,3,300
01568,ma,-71.60464,42.17701,3089,2,7,5,250
01569,ma,-71.63708,42.05865,5269,3,8,5,166.7
01570,ma,-71.84848,42.05206,6408,2,5,3,150
01571,ma,-71.93518,42.055,5077,2,5,3,150
01581,ma,-71.61401,42.26816,5371,2,6,4,200
01583,ma,-71.78498,42.37024,2796,1,5,4,400
01585,ma,-72.16191,42.24156,2965,1,4,3,300
01588,ma,-71.66951,42.11994,3177,2,7,5,250
01590,ma,-71.75086,42.13395,4496,2,5,3,150
01602,ma,-71.84942,42.2722,6826,1,4,3,300
01603,ma,-71.84442,42.24405,4869,1,4,3,300
01604,ma,-71.76774,42.25145,8911,2,5,3,150
01605,ma,-71.78746,42.28944,5024,1,5,4,400
01606,ma,-71.79554,42.31444,6605,1,4,3,300
01607,ma,-71.7888,42.22745,2184,1,5,4,400
01608,ma,-71.80146,42.26198,332,1,5,4,400
01609,ma,-71.82893,42.28644,4058,1,4,3,300
01610,ma,-71.80959,42.24671,3313,1,5,4,400
01611,ma,-71.87731,42.2383,1117,1,4,3,300
01612,ma,-71.93072,42.31035,1981,1,2,1,100
01701,ma,-71.43818,42.32173,11069,4,10,6,150
01702,ma,-71.43385,42.28216,6530,4,10,6,150
01718,ma,-71.42929,42.51982,5,4,10,6,150
01719,ma,-71.51779,42.48837,1746,3,8,5,166.7
01720,ma,-71.43803,42.48416,6892,4,9,5,125
01721,ma,-71.46865,42.25726,4933,4,10,6,150
01730,ma,-71.27834,42.49695,4363,4,10,6,150
01731,ma,-71.27948,42.45675,7,4,10,6,150
01740,ma,-71.60728,42.43616,2358,2,7,5,250
01741,ma,-71.35127,42.53001,2131,4,10,6,150
01742,ma,-71.36424,42.46226,6147,4,10,6,150
01745,ma,-71.50124,42.2919,187,3,9,6,200
01746,ma,-71.44499,42.19775,5701,4,10,6,150
01747,ma,-71.53502,42.12477,2247,4,9,5,125
01748,ma,-71.53781,42.2255,5801,3,8,5,166.7
01749,ma,-71.54647,42.38868,5879,2,7,5,250
01752,ma,-71.54682,42.3494,10526,3,8,5,166.7
01754,ma,-71.45611,42.42639,3486,4,10,6,150
01756,ma,-71.55147,42.09302,2809,3,8,5,166.7
01757,ma,-71.51915,42.15681,8844,4,9,5,125
01760,ma,-71.34981,42.28435,11416,4,10,6,150
01770,ma,-71.37531,42.23417,1878,4,10,6,150
01772,ma,-71.5304,42.30143,3559,3,8,5,166.7
01773,ma,-71.31042,42.42522,2311,4,10,6,150
01775,ma,-71.51148,42.42983,2730,3,9,6,200
01776,ma,-71.42341,42.38473,6592,4,10,6,150
01778,ma,-71.35919,42.3583,5130,4,10,6,150
01801,ma,-71.15424,42.48694,11351,4,9,5,125
01803,ma,-71.20258,42.50215,7636,4,10,6,150
01810,ma,-71.16506,42.64655,11115,4,9,5,125
01821,ma,-71.25218,42.55017,10690,4,10,6,150
01824,ma,-71.35564,42.59112,8703,4,9,5,125
01826,ma,-71.30057,42.68318,9954,3,9,6,200
01827,ma,-71.50052,42.67641,1504,3,9,6,200
01830,ma,-71.0531,42.79598,7071,4,9,5,125
01832,ma,-71.13137,42.7911,5875,4,9,5,125
01833,ma,-70.98211,42.72401,3123,3,7,4,133.3
01834,ma,-71.01487,42.75199,2478,3,8,5,166.7
01835,ma,-71.08595,42.75295,4062,3,8,5,166.7
01840,ma,-71.16018,42.7069,681,4,10,6,150
01841,ma,-71.16506,42.71081,6833,4,10,6,150
01843,ma,-71.16097,42.68981,4808,4,9,5,125
01844,ma,-71.18886,42.73402,14759,4,9,6,162.5
01845,ma,-71.08652,42.67135,8299,3,8,5,166.7
01850,ma,-71.30286,42.65566,3479,3,9,6,200
01851,ma,-71.33564,42.62811,5834,4,9,5,125
01852,ma,-71.29537,42.63233,7701,3,9,6,200
01854,ma,-71.34806,42.64906,4878,4,9,5,125
01860,ma,-71.01203,42.83866,2236,3,7,4,133.3
01862,ma,-71.2934,42.57488,3538,4,10,6,150
01863,ma,-71.39056,42.63239,2465,4,9,5,125
01864,ma,-71.08754,42.58155,5382,4,10,6,150
01867,ma,-71.10553,42.53506,7816,4,10,6,150
01876,ma,-71.22746,42.61223,9333,4,10,6,150
01879,ma,-71.4287,42.66635,4105,4,9,5,125
01880,ma,-71.06698,42.50229,8504,4,10,6,150
01886,ma,-71.44007,42.58642,8043,3,9,6,200
01887,ma,-71.16544,42.56092,8999,4,10,6,150
01890,ma,-71.14631,42.45179,6859,4,10,6,150
01901,ma,-70.94651,42.46066,216,4,10,6,150
01902,ma,-70.93991,42.47065,7870,4,10,6,150
01904,ma,-70.97267,42.49147,6091,4,10,6,150
01905,ma,-70.97555,42.46581,5163,4,10,6,150
01906,ma,-71.01442,42.46801,9713,4,10,6,150
01907,ma,-70.90559,42.47481,4658,4,9,5,125
01908,ma,-70.92594,42.42877,1399,4,9,5,125
01913,ma,-70.94463,42.85295,5270,2,6,4,200
01915,ma,-70.86185,42.56723,11639,2,6,4,200
01921,ma,-71.01898,42.68152,3186,3,8,5,166.7
01922,ma,-70.91453,42.7587,1180,2,6,4,200
01923,ma,-70.94928,42.574,8002,3,8,5,166.7
01929,ma,-70.7769,42.63474,2149,2,4,2,100
01930,ma,-70.68834,42.62508,13024,1,3,2,200
01937,ma,-70.98405,42.58572,1,4,10,6,150
01938,ma,-70.84204,42.68363,5375,2,5,3,150
01940,ma,-71.03752,42.53454,4483,4,10,6,150
01944,ma,-70.76737,42.57744,2368,2,5,3,150
01945,ma,-70.85846,42.50175,7985,3,8,5,166.7
01949,ma,-71.01645,42.60432,2947,4,10,6,150
01950,ma,-70.88784,42.81238,6496,1,5,4,400
01951,ma,-70.84789,42.77809,2277,1,4,3,300
01952,ma,-70.85986,42.84657,4331,1,4,2,250
01960,ma,-70.97225,42.53373,14338,4,9,5,125
01966,ma,-70.61863,42.65346,4005,1,2,1,100
01969,ma,-70.89295,42.72122,2650,2,6,4,200
01970,ma,-70.88063,42.51847,9589,4,9,5,125
01982,ma,-70.85797,42.6267,2800,2,6,4,200
01983,ma,-70.94259,42.63727,2334,3,9,6,200
01984,ma,-70.88264,42.6008,1490,2,7,5,250
01985,ma,-70.9691,42.79391,1908,2,6,4,200
02019,ma,-71.47408,42.07776,6111,4,9,5,125
02021,ma,-71.12649,42.17518,7039,4,9,5,125
02025,ma,-70.81829,42.23641,3104,3,7,4,133.3
02026,ma,-71.17776,42.24671,8549,4,9,5,125
02030,ma,-71.28417,42.23663,2503,4,10,6,150
02032,ma,-71.21551,42.1549,1562,4,10,6,150
02035,ma,-71.24613,42.06266,5924,4,9,5,125
02038,ma,-71.41128,42.08622,9949,4,9,5,125
02043,ma,-70.88498,42.21669,7613,3,7,4,133.3
02045,ma,-70.90172,42.28838,4785,2,7,5,250
02047,ma,-70.68599,42.13357,323,3,8,5,166.7
02048,ma,-71.21868,42.01625,7293,4,10,6,150
02050,ma,-70.71178,42.11738,12274,3,8,5,166.7
02052,ma,-71.30497,42.18483,4317,4,10,6,150
02053,ma,-71.42903,42.15353,4768,4,11,7,175
02054,ma,-71.36253,42.16932,3159,5,11,6,120
02056,ma,-71.32962,42.11634,3857,4,10,6,150
02061,ma,-70.81775,42.16076,4425,3,7,4,133.3
02062,ma,-71.19488,42.18604,8074,5,10,5,100
02066,ma,-70.75959,42.20161,7916,2,6,4,200
02067,ma,-71.18145,42.10814,6422,4,9,5,125
02071,ma,-71.27209,42.10279,348,3,9,6,200
02072,ma,-71.10191,42.11922,9401,4,9,5,125
02081,ma,-71.25887,42.14652,6830,4,10,6,150
02090,ma,-71.21068,42.22026,5151,4,10,6,150
02093,ma,-71.35517,42.05133,4338,4,9,5,125
02108,ma,-71.0649,42.35776,609,3,8,5,166.7
02109,ma,-71.05287,42.36486,346,3,8,5,166.7
02110,ma,-71.05179,42.35814,192,3,8,5,166.7
02111,ma,-71.05911,42.35002,450,3,8,5,166.7
02113,ma,-71.05523,42.36533,931,3,8,5,166.7
02114,ma,-71.0673,42.36311,1073,3,8,5,166.7
02115,ma,-71.09448,42.34117,1192,3,8,5,166.7
02116,ma,-71.07571,42.35068,2118,3,8,5,166.7
02118,ma,-71.07076,42.33814,2398,3,8,5,166.7
02119,ma,-71.08502,42.32403,4819,3,8,5,166.7
02120,ma,-71.09654,42.33209,1390,3,8,5,166.7
02121,ma,-71.08584,42.30584,3804,3,8,5,166.7
02122,ma,-71.02705,42.30195,4633,3,8,5,166.7
02124,ma,-71.07108,42.28567,9104,3,8,5,166.7
02125,ma,-71.05535,42.31548,5469,3,8,5,166.7
02126,ma,-71.09386,42.27427,5737,3,8,5,166.7
02127,ma,-71.03751,42.33476,6356,3,8,5,166.7
02128,ma,-71.01659,42.37275,6524,3,8,5,166.7
02129,ma,-71.06165,42.37975,3081,3,8,5,166.7
02130,ma,-71.11487,42.30986,6461,4,9,5,125
02131,ma,-71.12658,42.28462,6934,4,9,5,125
02132,ma,-71.16149,42.28022,9598,4,9,5,125
02134,ma,-71.12942,42.35787,2180,3,9,6,200
02135,ma,-71.15377,42.34989,5252,3,8,5,166.7
02136,ma,-71.12935,42.25529,6984,3,8,5,166.7
02138,ma,-71.13454,42.38006,4616,3,9,6,200
02139,ma,-71.103,42.36255,3981,3,9,6,200
02140,ma,-71.13334,42.39329,2688,4,9,5,125
02141,ma,-71.08261,42.37,1725,3,8,5,166.7
02142,ma,-71.08201,42.36198,123,3,8,5,166.7
02143,ma,-71.09671,42.38141,4353,3,9,6,200
02144,ma,-71.12196,42.40072,4641,4,9,5,125
02145,ma,-71.08958,42.39203,4287,3,8,5,166.7
02148,ma,-71.05761,42.43047,11577,3,9,6,200
02149,ma,-71.05447,42.40642,7902,3,8,5,166.7
02150,ma,-71.0325,42.3959,4935,3,8,5,166.7
02151,ma,-71.00174,42.41799,12838,4,9,5,125
02152,ma,-70.97557,42.37379,4595,3,8,5,166.7
02155,ma,-71.10884,42.42324,14842,4,9,5,125
02163,ma,-71.12075,42.36638,5,3,9,6,200
02169,ma,-71.00183,42.24826,12467,3,7,4,133.3
02170,ma,-71.016,42.2665,4834,3,7,4,133.3
02171,ma,-71.02099,42.29273,3965,3,8,5,166.7
02176,ma,-71.05901,42.45561,8485,4,9,5,125
02180,ma,-71.09716,42.47409,6336,4,10,6,150
02184,ma,-71.00222,42.20385,11648,3,8,5,166.7
02186,ma,-71.0843,42.24126,8471,3,7,4,133.3
02188,ma,-70.95749,42.20807,4167,3,8,5,166.7
02189,ma,-70.93161,42.20878,4183,3,7,4,133.3
02190,ma,-70.95272,42.16645,5411,4,8,4,100
02191,ma,-70.94183,42.24394,3098,3,7,4,133.3
02199,ma,-71.08204,42.34748,12,3,8,5,166.7
02203,ma,-71.05874,42.36059,11,3,8,5,166.7
02210,ma,-71.03893,42.3476,349,3,8,5,166.7
02215,ma,-71.10304,42.34771,897,3,8,5,166.7
02301,ma,-71.04224,42.07791,14542,5,10,5,100
02302,ma,-70.99865,42.08792,10583,5,10,5,100
02322,ma,-71.04924,42.12666,1948,4,9,5,125
02324,ma,-70.97487,41.97283,8076,5,11,6,120
02330,ma,-70.7563,41.87388,4615,4,9,5,125
02332,ma,-70.70977,42.04466,6232,3,8,5,166.7
02333,ma,-70.94239,42.03515,6081,5,11,6,120
02338,ma,-70.86325,41.99139,3040,5,10,5,100
02339,ma,-70.85665,42.1224,5163,5,10,5,100
02341,ma,-70.87232,42.05576,4096,5,10,5,100
02343,ma,-71.00483,42.14731,4825,4,9,5,125
02346,ma,-70.87431,41.88035,9345,5,11,6,120
02347,ma,-70.95911,41.83128,5111,5,11,6,120
02351,ma,-70.95955,42.11726,5173,4,10,6,150
02356,ma,-71.12058,42.05508,4581,4,10,6,150
02357,ma,-71.0808,42.05771,8,5,10,5,100
02359,ma,-70.80143,42.0655,6661,4,9,5,125
02360,ma,-70.63044,41.88353,26027,2,5,3,150
02364,ma,-70.74653,41.98657,5488,3,8,5,166.7
02367,ma,-70.80973,41.96346,1398,5,10,5,100
02368,ma,-71.05342,42.17696,9277,3,8,5,166.7
02370,ma,-70.91096,42.12987,5279,4,10,6,150
02375,ma,-71.1015,42.01748,3447,4,10,6,150
02379,ma,-71.02669,42.02139,3149,5,11,6,120
02382,ma,-70.93992,42.07999,4719,5,10,5,100
02420,ma,-71.21671,42.45635,4967,4,9,5,125
02421,ma,-71.23998,42.43853,6369,4,9,5,125
02445,ma,-71.13407,42.32595,3495,3,8,5,166.7
02446,ma,-71.12164,42.34352,2760,3,8,5,166.7
02451,ma,-71.25716,42.39818,5061,4,10,6,150
02452,ma,-71.21963,42.3936,2306,4,9,5,125
02453,ma,-71.24032,42.36909,5945,4,10,6,150
02457,ma,-71.26842,42.29837,7,4,10,6,150
02458,ma,-71.18751,42.35278,3442,3,9,6,200
02459,ma,-71.19173,42.31495,5616,3,9,6,200
02460,ma,-71.20837,42.352,2449,3,9,6,200
02461,ma,-71.20841,42.31675,2350,4,9,5,125
02462,ma,-71.2562,42.32989,504,4,9,5,125
02464,ma,-71.21946,42.3129,781,4,9,5,125
02465,ma,-71.22666,42.34916,3930,4,9,5,125
02466,ma,-71.24803,42.34406,1841,4,9,5,125
02467,ma,-71.16116,42.31641,3586,3,8,5,166.7
02468,ma,-71.23066,42.32728,2005,4,9,5,125
02472,ma,-71.17727,42.36999,7727,4,9,5,125
02474,ma,-71.15655,42.42024,7454,4,10,6,150
02476,ma,-71.17516,42.41622,5134,4,9,5,125
02478,ma,-71.17951,42.396,7296,4,9,5,125
02481,ma,-71.27433,42.31292,5010,4,10,6,150
02482,ma,-71.29986,42.29386,3365,4,10,6,150
02492,ma,-71.24373,42.27612,6734,4,9,5,125
02493,ma,-71.30008,42.35893,4043,4,10,6,150
02494,ma,-71.23208,42.29966,3036,4,9,5,125
02532,ma,-70.59742,41.75152,6381,2,6,4,200
02534,ma,-70.62038,41.6672,928,2,5,3,150
02535,ma,-70.76269,41.32943,3583,0,0,0,NA
02536,ma,-70.56717,41.59676,13208,0,1,1,NA
02537,ma,-70.44002,41.72985,3581,1,2,1,100
02538,ma,-70.64918,41.77703,2209,2,5,3,150
02539,ma,-70.52224,41.3794,6302,0,0,0,NA
02540,ma,-70.62891,41.57348,6081,0,1,1,NA
02542,ma,-70.54686,41.7026,16,2,5,3,150
02543,ma,-70.76636,41.47872,936,0,1,1,NA
02553,ma,-70.61983,41.71274,195,2,6,4,200
02554,ma,-70.09472,41.28767,12121,0,0,0,NA
02556,ma,-70.62585,41.63957,2983,1,2,1,100
02557,ma,-70.57396,41.44171,4993,0,0,0,NA
02558,ma,-70.65358,41.74492,1702,2,5,3,150
02559,ma,-70.61642,41.69103,2786,2,5,3,150
02561,ma,-70.53311,41.76887,282,2,6,4,200
02562,ma,-70.52683,41.78746,1793,1,4,3,300
02563,ma,-70.47815,41.72059,5172,1,2,1,100
02564,ma,-69.98461,41.26465,1445,0,0,0,NA
02568,ma,-70.61519,41.45867,3363,0,0,0,NA
02571,ma,-70.69718,41.76072,6744,2,5,3,150
02575,ma,-70.65529,41.39976,2792,0,0,0,NA
02576,ma,-70.7637,41.77806,2142,2,6,4,200
02584,ma,-70.00733,41.25885,14,0,0,0,NA
02601,ma,-70.29672,41.66006,6529,0,0,0,NA
02630,ma,-70.30315,41.70466,1336,0,1,1,NA
02631,ma,-70.06949,41.7471,7386,0,0,0,NA
02632,ma,-70.34749,41.66056,6395,0,1,1,NA
02633,ma,-69.97222,41.68893,4671,0,0,0,NA
02635,ma,-70.44055,41.62326,2593,0,1,1,NA
02637,ma,-70.27236,41.7057,207,0,1,1,NA
02638,ma,-70.19509,41.73279,3357,0,0,0,NA
02639,ma,-70.13571,41.66588,3685,0,0,0,NA
02641,ma,-70.15268,41.75128,784,0,0,0,NA
02642,ma,-69.97526,41.84019,6427,0,0,0,NA
02643,ma,-69.93348,41.7675,117,0,0,0,NA
02644,ma,-70.5102,41.68426,1747,1,3,2,200
02645,ma,-70.06083,41.70421,7567,0,0,0,NA
02646,ma,-70.07217,41.67034,2553,0,0,0,NA
02647,ma,-70.30701,41.63082,277,0,0,0,NA
02648,ma,-70.41633,41.67069,3581,0,2,2,NA
02649,ma,-70.4904,41.6172,9529,0,1,1,NA
02650,ma,-69.96586,41.70342,894,0,0,0,NA
02651,ma,-70.00344,41.87505,37,0,0,0,NA
02652,ma,-70.09566,42.04635,1599,0,1,1,NA
02653,ma,-69.97411,41.76893,5409,0,0,0,NA
02655,ma,-70.39245,41.62973,3052,0,0,0,NA
02657,ma,-70.19792,42.05771,2370,0,2,2,NA
02659,ma,-70.02216,41.68221,1419,0,0,0,NA
02660,ma,-70.15434,41.70543,4793,0,0,0,NA
02663,ma,-69.99994,41.90537,526,0,1,1,NA
02664,ma,-70.19485,41.67386,6472,0,0,0,NA
02666,ma,-70.04389,41.99074,1751,0,1,1,NA
02667,ma,-70.02065,41.9259,4504,0,1,1,NA
02668,ma,-70.35581,41.71231,2155,0,1,1,NA
02669,ma,-69.99251,41.67076,587,0,0,0,NA
02670,ma,-70.17182,41.65901,2270,0,0,0,NA
02671,ma,-70.11099,41.6723,1302,0,0,0,NA
02672,ma,-70.31811,41.63545,346,0,0,0,NA
02673,ma,-70.24728,41.65528,5850,0,0,0,NA
02675,ma,-70.23097,41.7051,3766,0,0,0,NA
02702,ma,-71.06118,41.78452,1863,5,11,6,120
02703,ma,-71.2949,41.9311,14454,4,10,6,150
02713,ma,-70.88738,41.43693,205,0,0,0,NA
02715,ma,-71.15059,41.81753,1904,4,10,6,150
02717,ma,-70.97167,41.75874,2321,4,10,6,150
02718,ma,-71.01162,41.86894,2479,5,11,6,120
02719,ma,-70.86936,41.63429,7746,2,5,3,150
02720,ma,-71.11805,41.73286,6960,4,10,6,150
02721,ma,-71.14768,41.67471,6006,4,9,5,125
02723,ma,-71.12965,41.69275,3056,4,10,6,150
02724,ma,-71.17939,41.68403,3719,4,9,5,125
02725,ma,-71.18424,41.71255,1129,4,10,6,150
02726,ma,-71.14444,41.76073,6164,4,9,5,125
02738,ma,-70.75582,41.70431,3499,2,5,3,150
02739,ma,-70.81535,41.66729,4773,2,5,3,150
02740,ma,-70.93809,41.63771,11405,2,6,4,200
02743,ma,-70.90122,41.71386,4667,3,8,5,166.7
02744,ma,-70.91172,41.6072,2691,2,5,3,150
02745,ma,-70.94821,41.6989,8801,4,9,5,125
02746,ma,-70.94167,41.66146,2816,4,9,5,125
02747,ma,-71.01628,41.66783,8423,3,7,4,133.3
02748,ma,-70.97776,41.56,6011,2,5,3,150
02760,ma,-71.33581,41.97007,9041,4,9,5,125
02762,ma,-71.33644,42.0141,2885,4,9,5,125
02763,ma,-71.30745,41.96669,708,4,10,6,150
02764,ma,-71.16054,41.85665,1772,5,10,5,100
02766,ma,-71.18419,41.96402,6508,4,10,6,150
02767,ma,-71.05113,41.9371,5437,5,12,7,140
02769,ma,-71.24558,41.84394,5863,4,10,6,150
02770,ma,-70.84082,41.75848,2733,3,8,5,166.7
02771,ma,-71.31744,41.83778,6448,4,10,6,150
02777,ma,-71.21203,41.75706,8004,4,9,5,125
02779,ma,-71.07545,41.83488,2862,5,11,6,120
02780,ma,-71.11957,41.90753,15604,5,11,6,120
02790,ma,-71.08291,41.59882,9162,3,7,4,133.3
02791,ma,-71.078,41.52796,320,1,3,2,200
02802,ri,-71.45535,41.95188,133,3,8,5,166.7
02804,ri,-71.77238,41.43186,1183,2,6,4,200
02806,ri,-71.31929,41.73425,6562,4,9,5,125
02807,ri,-71.57829,41.17834,2189,0,0,0,NA
02808,ri,-71.74864,41.40859,1053,1,4,3,300
02809,ri,-71.27329,41.67612,9455,3,8,5,166.7
02812,ri,-71.65442,41.47766,629,2,7,5,250
02813,ri,-71.6703,41.3966,5941,1,2,1,100
02814,ri,-71.69768,41.89874,3970,2,6,4,200
02815,ri,-71.65832,41.77306,146,2,7,5,250
02816,ri,-71.61976,41.69086,10895,3,7,4,133.3
02817,ri,-71.66701,41.62918,1,3,8,5,166.7
02818,ri,-71.48505,41.64574,6946,3,8,5,166.7
02822,ri,-71.6329,41.56735,2845,3,7,4,133.3
02825,ri,-71.7261,41.78115,2395,2,6,4,200
02826,ri,-71.63707,41.97398,372,2,6,4,200
02827,ri,-71.73966,41.69778,993,2,6,4,200
02828,ri,-71.55937,41.87804,2628,3,7,4,133.3
02830,ri,-71.6498,41.98204,2385,2,7,5,250
02831,ri,-71.58911,41.75262,570,3,8,5,166.7
02832,ri,-71.72598,41.50835,2120,3,7,4,133.3
02833,ri,-71.77813,41.48725,370,2,6,4,200
02835,ri,-71.37724,41.51078,3640,1,2,1,100
02836,ri,-71.62048,41.45166,53,2,7,5,250
02837,ri,-71.16624,41.5122,3274,1,3,2,200
02838,ri,-71.47615,41.96514,847,3,8,5,166.7
02839,ri,-71.64318,41.9429,537,2,6,4,200
02840,ri,-71.32327,41.47628,7470,0,1,1,NA
02841,ri,-71.32564,41.51458,20,0,1,1,NA
02842,ri,-71.27774,41.51725,5862,0,2,2,NA
02852,ri,-71.45879,41.58767,9685,2,6,4,200
02857,ri,-71.63204,41.82936,3771,2,7,5,250
02858,ri,-71.64827,41.96345,206,2,6,4,200
02859,ri,-71.74517,41.96664,2723,2,6,4,200
02860,ri,-71.38835,41.87003,10497,4,10,6,150
02861,ma,-71.35231,41.87861,8768,4,10,6,137.5
02863,ri,-71.39351,41.88998,2876,4,10,6,150
02864,ri,-71.4197,41.97034,14091,3,8,5,166.7
02865,ri,-71.44845,41.91261,6401,3,9,6,200
02871,ri,-71.2576,41.58811,7253,2,5,3,150
02872,ri,-71.33244,41.62069,882,1,4,3,300
02873,ri,-71.77558,41.53103,125,2,7,5,250
02874,ri,-71.4677,41.51559,3084,1,3,2,200
02875,ri,-71.63808,41.45556,147,2,7,5,250
02876,ri,-71.58196,41.99626,52,3,7,4,133.3
02878,ri,-71.17558,41.60878,7375,3,7,4,133.3
02879,ri,-71.53661,41.42606,10389,1,3,2,200
02881,ri,-71.52347,41.47891,918,2,6,4,200
02882,ri,-71.47135,41.41825,13441,0,2,2,NA
02885,ri,-71.25765,41.72423,5461,4,9,5,125
02886,ri,-71.45519,41.70352,12005,3,9,6,200
02888,ri,-71.4067,41.74769,9296,4,9,5,125
02889,ri,-71.37796,41.70057,14587,3,8,5,166.7
02891,ri,-71.7982,41.35686,11235,0,2,2,NA
02892,ri,-71.59694,41.49592,2193,3,7,4,133.3
02893,ri,-71.51537,41.69852,9929,3,8,5,166.7
02894,ri,-71.70055,41.44728,300,2,6,4,200
02895,ri,-71.49932,42.00102,10668,3,7,4,133.3
02896,ri,-71.55106,41.97239,4663,2,7,5,250
02898,ri,-71.67572,41.51524,810,3,7,4,133.3
02903,ri,-71.40913,41.81801,2110,4,10,6,150
02904,ri,-71.43536,41.86034,8733,4,9,5,125
02905,ri,-71.39593,41.78454,7530,4,10,6,150
02906,ri,-71.38993,41.83919,7049,4,10,6,150
02907,ri,-71.42552,41.7983,5530,4,10,6,150
02908,ri,-71.43687,41.83913,9638,4,10,6,150
02909,ri,-71.45161,41.82029,8904,4,10,6,150
02910,ri,-71.43571,41.77559,9304,4,10,6,150
02911,ri,-71.47353,41.85473,5032,4,9,5,125
02912,ri,-71.40224,41.82559,17,4,10,6,150
02914,ma,-71.36526,41.81375,6790,4,10,6,150
02915,ri,-71.35518,41.77275,5642,4,10,6,150
02916,ri,-71.35215,41.8445,2942,4,10,6,150
02917,ri,-71.52465,41.9065,4681,3,7,4,133.3
02919,ri,-71.52002,41.82737,11864,3,9,6,200
02920,ri,-71.46601,41.76735,14102,4,9,5,125
02921,ri,-71.51729,41.76216,4635,3,9,6,200
03031,nh,-71.60785,42.87034,4723,2,7,5,250
03032,nh,-71.34379,42.9906,2482,2,5,3,150
03033,nh,-71.67052,42.74623,2227,2,6,4,200
03034,nh,-71.31145,43.06362,1928,2,5,3,150
03036,nh,-71.25089,42.96716,2055,2,7,5,250
03037,nh,-71.25257,43.13973,2327,2,5,3,150
03038,nh,-71.27991,42.88877,11576,2,7,5,250
03042,nh,-71.07479,43.05005,2723,3,9,6,200
03043,nh,-71.81343,42.994,1089,1,3,2,200
03044,nh,-71.12526,42.98869,1989,3,9,6,200
03045,nh,-71.56997,43.01992,4763,1,5,4,400
03046,nh,-71.60549,43.10178,1469,1,4,3,300
03047,nh,-71.87016,42.94004,1018,1,2,1,100
03048,nh,-71.76172,42.74823,1929,1,4,3,300
03049,nh,-71.58347,42.74937,3493,3,7,4,133.3
03051,nh,-71.40714,42.76391,7339,3,8,5,166.7
03052,nh,-71.455,42.84285,2816,2,7,5,250
03053,nh,-71.38634,42.8786,9995,2,6,4,200
03054,nh,-71.5188,42.85471,7983,2,7,5,250
03055,nh,-71.67337,42.81744,4858,2,6,4,200
03057,nh,-71.68332,42.90244,1187,2,5,3,150
03060,nh,-71.45932,42.74131,6814,3,8,5,166.7
03062,nh,-71.49561,42.72216,6309,3,8,5,166.7
03063,nh,-71.51938,42.7795,3188,3,8,5,166.7
03064,nh,-71.47465,42.77884,4264,3,8,5,166.7
03070,nh,-71.6863,42.97738,2340,1,4,3,300
03071,nh,-71.87468,42.74888,2098,1,2,1,100
03076,nh,-71.32404,42.73355,5346,3,8,5,166.7
03077,nh,-71.19804,43.03293,4373,3,8,5,166.7
03079,nh,-71.22025,42.7902,10289,3,9,6,200
03082,nh,-71.7742,42.90021,945,1,4,3,300
03084,nh,-71.85495,42.82852,740,1,3,2,200
03086,nh,-71.77105,42.82935,1943,1,4,3,300
03087,nh,-71.29946,42.80758,5710,3,8,5,166.7
03101,nh,-71.46586,42.9888,617,2,6,4,200
03102,nh,-71.49127,43.00796,7319,2,6,4,200
03103,nh,-71.44432,42.95358,9933,2,6,4,200
03104,nh,-71.44142,43.00934,9162,2,6,4,200
03106,nh,-71.4364,43.07113,4571,2,5,3,150
03109,nh,-71.40168,42.96627,3843,2,6,4,200
03110,nh,-71.53028,42.94066,7372,2,6,4,200
03215,nh,-71.45287,43.94526,345,0,0,0,NA
03216,nh,-71.7957,43.44562,1373,1,3,2,200
03217,nh,-71.63094,43.71531,1103,1,2,1,100
03218,nh,-71.28913,43.33461,591,1,4,3,300
03220,nh,-71.47519,43.46768,4189,1,3,2,200
03221,nh,-71.96172,43.25183,1736,1,3,2,200
03222,nh,-71.78285,43.6275,5007,1,3,2,200
03223,nh,-71.68157,43.84969,3172,0,1,1,NA
03224,nh,-71.55092,43.34987,1659,1,4,3,300
03225,nh,-71.23805,43.3584,2834,1,3,2,200
03226,nh,-71.51123,43.70404,1021,1,3,2,200
03227,nh,-71.46773,43.82769,21,0,2,2,NA
03229,nh,-71.69676,43.19789,3032,1,5,4,400
03230,nh,-71.87149,43.52595,1202,1,2,1,100
03231,nh,-71.75671,43.46652,169,1,3,2,200
03233,nh,-71.93313,43.42522,93,1,3,2,200
03234,nh,-71.33906,43.21492,2217,1,4,3,300
03235,nh,-71.67181,43.44836,3329,1,4,3,300
03237,nh,-71.38204,43.42965,2043,1,2,1,100
03238,nh,-71.89868,43.98287,52,0,1,1,NA
03240,nh,-71.97227,43.57597,1444,0,2,2,NA
03241,nh,-71.8198,43.72169,918,1,2,1,100
03242,nh,-71.8224,43.17359,1916,1,3,2,200
03243,nh,-71.76468,43.52492,720,1,3,2,200
03244,nh,-71.91862,43.11791,5266,1,3,2,200
03245,nh,-71.58781,43.74999,1336,1,3,2,200
03246,nh,-71.47748,43.5727,6250,1,3,2,200
03249,nh,-71.385,43.55787,4211,1,2,1,100
03251,nh,-71.57276,44.08542,2087,0,0,0,NA
03253,nh,-71.49962,43.63071,5492,1,3,2,200
03254,nh,-71.3777,43.72492,6454,1,3,2,200
03255,nh,-72.02625,43.31474,2449,1,3,2,200
03256,nh,-71.63356,43.62433,1661,1,3,2,200
03257,nh,-71.99059,43.41692,2707,1,3,2,200
03258,nh,-71.39921,43.25749,853,1,5,4,400
03259,nh,-71.39651,43.87213,6,1,3,2,200
03260,nh,-71.92171,43.35363,790,1,3,2,200
03261,nh,-71.2097,43.2134,2820,1,5,4,400
03262,nh,-71.73798,43.99914,1143,0,2,2,NA
03263,nh,-71.31102,43.29473,1803,1,4,3,300
03264,nh,-71.71125,43.72979,2169,1,2,1,100
03266,nh,-71.8961,43.7904,2290,0,1,1,NA
03268,nh,-71.75659,43.38648,799,1,4,3,300
03269,nh,-71.60142,43.52786,2115,1,3,2,200
03273,nh,-71.93204,43.29898,361,1,3,2,200
03275,nh,-71.41797,43.1602,3741,2,5,3,150
03276,nh,-71.57503,43.42784,3681,1,3,2,200
03278,nh,-71.82597,43.29328,1999,1,4,3,300
03279,nh,-71.88136,43.94315,750,0,1,1,NA
03280,nh,-72.08932,43.18286,1603,0,2,2,NA
03281,nh,-71.72191,43.08125,4279,1,4,3,300
03282,nh,-71.92952,43.86015,864,0,2,2,NA
03284,nh,-72.03075,43.4928,904,0,2,2,NA
03285,nh,-71.64355,43.92406,2132,0,2,2,NA
03287,nh,-71.91671,43.44511,19,1,2,1,100
03290,nh,-71.12077,43.12462,2566,3,8,5,166.7
03291,nh,-71.14261,43.17917,20,2,7,5,250
03293,nh,-71.67829,43.97008,132,0,2,2,NA
03301,nh,-71.54338,43.22433,9871,2,6,4,200
03303,nh,-71.67186,43.29816,5230,2,5,3,150
03304,nh,-71.53071,43.13078,3146,1,5,4,400
03307,nh,-71.44365,43.32542,2286,1,4,3,300
03431,nh,-72.29551,42.96263,7882,1,4,3,300
03440,nh,-71.98229,43.05406,1870,1,3,2,200
03441,nh,-72.43851,42.77999,208,1,4,3,300
03442,nh,-71.90817,43.01242,835,1,2,1,100
03443,nh,-72.46157,42.87709,475,1,2,1,100
03444,nh,-72.0723,42.89429,1093,1,2,1,100
03445,nh,-72.21303,43.01438,506,0,2,2,NA
03446,nh,-72.29753,42.86048,2986,1,3,2,200
03447,nh,-72.14831,42.75899,1872,1,2,1,100
03448,nh,-72.27197,43.0397,614,0,2,2,NA
03449,nh,-71.99581,42.97581,1249,1,3,2,200
03450,nh,-72.09135,42.94158,963,0,2,2,NA
03451,nh,-72.49867,42.80751,1782,2,6,4,200
03452,nh,-72.05967,42.82929,2472,1,2,1,100
03455,nh,-72.18348,42.89834,1155,1,2,1,100
03456,nh,-72.21508,43.13092,693,0,2,2,NA
03457,nh,-72.12253,42.9959,286,0,2,2,NA
03458,nh,-71.93787,42.86901,2733,1,2,1,100
03461,nh,-72.01053,42.75235,2775,0,2,2,NA
03462,nh,-72.40472,42.89547,1281,1,2,1,100
03464,nh,-72.11418,43.07915,1871,0,2,2,NA
03465,nh,-72.19014,42.8272,1096,1,2,1,100
03466,nh,-72.50962,42.89559,796,1,3,2,200
03467,nh,-72.4321,42.96934,1068,1,3,2,200
03470,nh,-72.34417,42.77882,3026,1,4,3,300
03561,nh,-71.81169,44.33167,3430,0,2,2,NA
03570,nh,-71.15712,44.49914,4588,0,1,1,NA
03574,nh,-71.5988,44.25337,1955,0,1,1,NA
03575,nh,-71.42372,44.2961,286,0,0,0,NA
03576,nh,-71.38465,44.91618,3502,0,0,0,NA
03579,me,-71.03298,44.96865,616,0,0,0,NA
03580,nh,-71.70155,44.16775,1019,0,1,1,NA
03581,nh,-71.13251,44.33931,1971,0,1,1,NA
03582,nh,-71.43858,44.59553,1875,0,1,1,NA
03583,nh,-71.46473,44.39675,1163,0,1,1,NA
03584,nh,-71.54518,44.48467,269,0,2,2,NA
03585,nh,-71.89463,44.22059,2543,0,1,1,NA
03586,nh,-71.79642,44.22035,757,0,1,1,NA
03588,nh,-71.20762,44.61223,1647,0,1,1,NA
03590,nh,-71.51816,44.74749,1242,0,1,1,NA
03592,nh,-71.26295,45.12285,2376,0,0,0,NA
03593,nh,-71.30374,44.31658,504,0,0,0,NA
03595,nh,-71.52679,44.30621,964,0,0,0,NA
03597,nh,-71.39284,44.73607,328,0,0,0,NA
03598,nh,-71.63208,44.37967,1710,0,2,2,NA
03601,nh,-72.29568,43.23374,346,0,2,2,NA
03602,nh,-72.33049,43.13391,1890,1,2,1,100
03603,nh,-72.38147,43.25137,2431,1,3,2,200
03604,nh,-72.3798,43.128,31,0,2,2,NA
03605,nh,-72.18131,43.2274,863,0,2,2,NA
03607,nh,-72.26864,43.19565,304,0,2,2,NA
03608,nh,-72.40642,43.07065,1606,1,2,1,100
03609,nh,-72.44548,43.14466,345,2,5,3,150
03740,nh,-71.9828,44.1808,1036,1,2,1,100
03741,nh,-72.01591,43.67191,2152,1,2,1,100
03743,nh,-72.32528,43.35815,5342,1,3,2,200
03745,nh,-72.3323,43.47006,718,1,3,2,200
03746,nh,-72.25743,43.49432,96,0,2,2,NA
03748,nh,-72.1139,43.59371,2951,1,2,1,100
03750,nh,-72.2026,43.7076,460,1,2,1,100
03751,nh,-72.08876,43.44895,407,1,3,2,200
03752,nh,-72.11522,43.28921,600,0,2,2,NA
03753,nh,-72.14982,43.51695,1860,1,2,1,100
03754,nh,-72.13839,43.37746,29,1,3,2,200
03755,nh,-72.18929,43.71773,2318,1,4,3,300
03765,nh,-72.05268,44.03409,301,1,2,1,100
03766,nh,-72.23726,43.63466,3042,1,3,2,200
03768,nh,-72.11584,43.80537,1121,1,2,1,100
03770,nh,-72.26649,43.53404,249,1,2,1,100
03771,nh,-72.00933,44.28505,411,0,1,1,NA
03773,nh,-72.19943,43.38519,4241,1,3,2,200
03774,nh,-71.99525,44.08898,1355,1,2,1,100
03777,nh,-72.0696,43.89525,1011,0,2,2,NA
03779,nh,-72.0288,43.97236,601,0,1,1,NA
03780,nh,-71.9775,44.0323,396,0,1,1,NA
03781,nh,-72.28409,43.55277,1071,1,3,2,200
03782,nh,-72.09278,43.39094,2902,1,3,2,200
03784,nh,-72.30601,43.6365,1344,1,4,3,300
03785,nh,-71.89421,44.06389,1693,1,2,1,100
03801,nh,-70.80517,43.07295,6767,2,5,3,150
03809,nh,-71.2124,43.45375,2397,1,3,2,200
03810,nh,-71.28095,43.52704,2690,1,3,2,200
03811,nh,-71.16039,42.83699,2896,3,9,6,200
03812,nh,-71.29206,44.0806,1148,0,1,1,NA
03813,nh,-71.04517,44.09755,2270,2,5,3,150
03814,nh,-71.18481,43.76919,2763,1,3,2,200
03816,nh,-71.25523,43.68472,1700,1,3,2,200
03817,nh,-71.23221,43.88752,480,1,4,3,300
03818,nh,-71.25002,43.97359,2570,1,4,3,300
03819,nh,-71.12121,42.92843,1611,3,9,6,200
03820,nh,-70.88677,43.18881,8592,4,9,5,125
03823,nh,-70.941,43.17289,784,4,9,5,125
03824,nh,-70.91947,43.11743,2439,3,8,5,166.7
03825,nh,-71.04282,43.2136,4795,3,8,5,166.7
03826,nh,-71.13382,42.88617,749,3,9,6,200
03827,nh,-70.98772,42.90687,1351,3,8,5,166.7
03830,nh,-71.00251,43.63403,2691,1,3,2,200
03832,nh,-71.04782,43.90307,685,1,3,2,200
03833,nh,-70.98918,42.97475,6766,3,8,5,166.7
03835,nh,-71.07602,43.36294,3081,2,5,3,150
03836,nh,-71.07151,43.8262,2322,1,4,3,300
03837,nh,-71.3291,43.42164,1092,1,3,2,200
03838,nh,-71.24097,44.11232,1705,1,2,1,100
03839,nh,-70.98373,43.26201,1423,4,9,5,125
03840,nh,-70.848,43.03847,1662,2,6,4,200
03841,nh,-71.18095,42.88311,2843,3,8,5,166.7
03842,nh,-70.83714,42.93966,6351,1,4,3,300
03844,nh,-70.88581,42.92704,1144,2,5,3,150
03845,nh,-71.12526,44.10662,1403,1,3,2,200
03846,nh,-71.19065,44.18531,1509,0,1,1,NA
03847,nh,-71.11318,44.07002,167,1,3,2,200
03848,nh,-71.06648,42.91561,2986,4,9,5,125
03849,nh,-71.13379,43.90044,2264,1,3,2,200
03850,nh,-71.302,43.69269,435,1,3,2,200
03851,nh,-71.01645,43.43607,49,1,4,3,300
03852,nh,-70.97541,43.49811,11,1,4,3,300
03853,nh,-71.27899,43.63949,992,1,3,2,200
03854,nh,-70.71783,43.0635,588,1,3,2,200
03855,nh,-71.14195,43.46355,2672,1,3,2,200
03856,nh,-70.96626,43.03922,781,4,9,5,125
03857,nh,-70.95186,43.06912,2636,4,9,5,125
03858,nh,-71.04358,42.86848,1828,3,9,6,200
03860,nh,-71.11988,44.04207,2427,2,5,3,150
03861,nh,-71.00688,43.11968,1606,4,10,6,150
03862,nh,-70.83025,42.97906,2014,2,5,3,150
03864,nh,-71.10883,43.69142,1570,1,3,2,200
03865,nh,-71.09613,42.84031,2597,4,9,5,125
03867,nh,-70.987,43.30338,7379,3,9,6,200
03868,nh,-70.94129,43.31998,1600,3,8,5,166.7
03869,nh,-70.84195,43.22077,1087,4,10,6,150
03870,nh,-70.76035,43.01525,2828,1,4,3,300
03871,nh,-70.77478,42.98228,78,1,4,3,300
03872,nh,-71.04499,43.56974,3192,1,3,2,200
03873,nh,-71.18211,42.93399,2442,3,8,5,166.7
03874,ma,-70.86033,42.88706,3322,1,4,3,300
03875,nh,-71.18604,43.89549,895,1,4,3,300
03878,nh,-70.88514,43.25288,3509,4,9,5,125
03882,nh,-71.04223,43.74559,1533,1,4,3,300
03883,nh,-71.30767,43.80764,149,0,1,1,NA
03884,nh,-71.14822,43.27981,2436,2,5,3,150
03885,nh,-70.9006,43.01575,2380,3,7,4,133.3
03886,nh,-71.28683,43.86244,1653,1,3,2,200
03887,nh,-71.06264,43.48599,1562,1,3,2,200
03890,nh,-71.19659,43.80808,396,1,4,3,300
03894,nh,-71.17168,43.61214,4683,1,3,2,200
03901,me,-70.84363,43.30063,2213,4,9,5,125
03902,me,-70.63619,43.22098,1870,0,1,1,NA
03903,me,-70.78602,43.1488,3198,2,6,4,200
03904,me,-70.73105,43.11059,3104,1,4,3,300
03905,me,-70.68673,43.08643,1243,1,3,2,200
03906,me,-70.77776,43.34578,2300,3,7,4,133.3
03907,me,-70.60937,43.25412,1655,0,1,1,NA
03908,me,-70.74782,43.23879,2999,3,8,5,166.7
03909,me,-70.679,43.16612,6408,1,2,1,100
03910,me,-70.61681,43.17239,470,0,1,1,NA
03911,me,-70.6262,43.14085,224,1,2,1,100
04001,me,-70.92096,43.52727,3014,1,4,3,300
04002,me,-70.67937,43.49584,4212,2,6,4,200
04003,me,-69.96367,43.7259,646,0,0,0,NA
04005,me,-70.48834,43.4935,8463,0,2,2,NA
04006,me,-70.34457,43.44429,120,0,0,0,NA
04008,me,-69.86214,44.03708,1515,0,2,2,NA
04009,me,-70.73378,44.04834,5367,1,3,2,200
04010,me,-70.91673,43.93298,8,2,4,2,100
04011,me,-69.9779,43.89725,7347,0,1,1,NA
04015,me,-70.51793,43.97435,3247,1,4,3,300
04019,me,-70.10075,43.68322,242,0,0,0,NA
04020,me,-70.8103,43.76812,1,1,4,3,300
04021,me,-70.2649,43.79743,2567,0,1,1,NA
04022,me,-70.80718,43.98056,1703,1,3,2,200
04024,me,-70.6777,43.83305,527,1,4,3,300
04027,me,-70.91151,43.40333,3000,3,7,4,133.3
04029,me,-70.68775,43.90165,2103,1,3,2,200
04030,me,-70.69233,43.58948,1,2,6,4,200
04032,me,-70.09397,43.8467,3834,0,0,0,NA
04037,me,-70.94978,44.09266,3170,2,4,2,100
04038,me,-70.45808,43.70341,6480,1,4,3,300
04039,me,-70.34215,43.88748,4033,1,3,2,200
04040,me,-70.71843,44.11099,3206,1,3,2,200
04041,me,-70.8256,43.86395,1443,1,3,2,200
04042,me,-70.62452,43.62953,2266,2,5,3,150
04043,me,-70.57025,43.39701,6862,0,1,1,NA
04046,me,-70.49005,43.41877,5534,0,1,1,NA
04048,me,-70.78286,43.68738,3431,1,4,3,300
04049,me,-70.70295,43.73769,2130,1,4,3,300
04050,me,-70.15143,43.68191,719,0,0,0,NA
04051,me,-70.88457,44.18865,1937,1,3,2,200
04055,me,-70.61542,43.97018,3758,1,4,3,300
04057,me,-70.69892,44.10155,21,1,4,3,300
04062,me,-70.40447,43.79746,7858,1,3,2,200
04063,me,-70.39613,43.50111,544,0,1,1,NA
04064,me,-70.38826,43.52537,3770,0,1,1,NA
04066,me,-69.9679,43.77199,597,0,0,0,NA
04068,me,-70.94065,43.83991,6,1,4,3,300
04069,me,-70.18185,43.89915,830,0,1,1,NA
04071,me,-70.45083,43.92835,4081,1,4,3,300
04072,me,-70.45771,43.53565,7009,0,2,2,NA
04073,me,-70.74235,43.41333,7127,3,7,4,133.3
04074,me,-70.36448,43.58772,8457,0,1,1,NA
04076,me,-70.83788,43.55244,2861,2,5,3,150
04079,me,-69.97285,43.79161,3807,0,0,0,NA
04083,me,-70.81381,43.46726,1930,3,8,5,166.7
04084,me,-70.56599,43.76607,4378,1,4,3,300
04085,me,-70.62666,43.77447,945,1,4,3,300
04086,me,-69.95874,43.96146,3892,0,1,1,NA
04087,me,-70.75253,43.56554,5,1,4,3,300
04088,me,-70.7163,44.19309,1665,1,2,1,100
04090,me,-70.633,43.32651,6594,0,2,2,NA
04091,me,-70.75143,43.83211,636,1,3,2,200
04092,me,-70.3539,43.69533,6278,0,1,1,NA
04093,me,-70.53764,43.64284,3761,2,5,3,150
04095,me,-70.91512,43.63554,22,1,4,3,300
04096,me,-70.15931,43.78834,3521,0,0,0,NA
04097,me,-70.23634,43.85121,1734,0,1,1,NA
04101,me,-70.25727,43.66266,3704,0,0,0,NA
04102,me,-70.30617,43.6588,7779,0,1,1,NA
04103,me,-70.2909,43.69383,16692,0,1,1,NA
04105,me,-70.27156,43.74251,5379,0,1,1,NA
04106,me,-70.28592,43.63153,8814,0,0,0,NA
04107,me,-70.23234,43.58645,4421,0,0,0,NA
04108,me,-70.19088,43.65813,2178,0,0,0,NA
04109,me,-70.19933,43.65864,717,0,0,0,NA
04110,me,-70.18785,43.75097,731,0,0,0,NA
04210,me,-70.24925,44.08506,8743,1,4,3,300
04216,me,-70.82147,44.70672,88,0,1,1,NA
04217,me,-70.83319,44.36772,3832,0,2,2,NA
04219,me,-70.59287,44.40927,1887,0,1,1,NA
04220,me,-70.35341,44.33662,2333,0,2,2,NA
04221,me,-70.29982,44.46023,1026,0,2,2,NA
04222,me,-70.12965,43.96445,2018,0,2,2,NA
04224,me,-70.40114,44.58014,1875,0,1,1,NA
04227,me,-70.29766,44.55717,46,0,1,1,NA
04228,me,-70.11506,44.43249,11,1,2,1,100
04231,me,-70.8875,44.26412,529,1,2,1,100
04234,me,-70.1919,44.62383,74,0,2,2,NA
04236,me,-70.14461,44.19037,2202,1,3,2,200
04237,me,-70.72595,44.49674,372,0,1,1,NA
04238,me,-70.38175,44.2107,768,1,2,1,100
04240,me,-70.16808,44.09146,11317,1,4,3,300
04250,me,-70.11656,44.02598,1483,1,3,2,200
04252,me,-70.05959,44.02708,1945,0,2,2,NA
04254,me,-70.14275,44.43248,1614,1,2,1,100
04255,me,-70.67051,44.33624,1318,0,1,1,NA
04256,me,-70.40897,44.10236,1516,1,3,2,200
04257,me,-70.51359,44.57345,1,1,2,1,100
04258,me,-70.33787,44.14835,1494,1,3,2,200
04259,me,-70.00852,44.2284,2245,1,3,2,200
04260,me,-70.29587,43.96407,2809,1,4,3,300
04261,me,-70.92005,44.56456,1462,0,1,1,NA
04265,me,-70.04637,44.28446,627,1,3,2,200
04267,me,-70.79025,44.21037,79,0,1,1,NA
04268,me,-70.60648,44.2292,3111,1,2,1,100
04270,me,-70.51559,44.11239,2419,1,3,2,200
04271,me,-70.49819,44.26361,49,0,2,2,NA
04274,me,-70.38948,44.04615,3106,1,3,2,200
04276,me,-70.61543,44.53471,3279,0,2,2,NA
04280,me,-70.06151,44.12157,822,1,3,2,200
04281,me,-70.48829,44.2444,2704,1,2,1,100
04282,me,-70.24293,44.26708,3010,1,2,1,100
04284,me,-70.06612,44.35129,1060,1,3,2,200
04285,me,-70.4461,44.70318,874,0,1,1,NA
04286,me,-70.86508,44.40144,29,1,2,1,100
04287,me,-69.96821,44.05734,1672,1,2,1,100
04289,me,-70.53378,44.3211,1114,0,2,2,NA
04290,me,-70.45065,44.47355,1426,0,1,1,NA
04292,me,-70.44687,44.37404,948,0,1,1,NA
04294,me,-70.26957,44.62899,2659,0,1,1,NA
04330,me,-69.73741,44.36396,12517,1,3,2,200
04342,me,-69.73938,44.07944,1088,0,2,2,NA
04343,me,-69.89169,44.32871,29,1,3,2,200
04344,me,-69.82132,44.25884,2,1,3,2,200
04345,me,-69.78481,44.19822,2478,1,3,2,200
04346,me,-69.75065,44.2347,784,1,3,2,200
04347,me,-69.81406,44.29048,1173,1,3,2,200
04348,me,-69.4992,44.21522,2311,1,2,1,100
04349,me,-70.06854,44.43724,1538,1,2,1,100
04350,me,-69.93985,44.16256,2222,1,3,2,200
04351,me,-69.86101,44.33137,1348,1,3,2,200
04352,me,-69.96094,44.46558,5,1,2,1,100
04353,me,-69.61259,44.20521,1585,1,3,2,200
04354,me,-69.42711,44.39603,1309,1,3,2,200
04355,me,-69.94907,44.38209,1730,1,3,2,200
04357,me,-69.82884,44.12363,1845,1,3,2,200
04358,me,-69.53289,44.41815,3186,1,3,2,200
04359,me,-69.76062,44.17745,199,1,3,2,200
04363,me,-69.57806,44.311,2,1,3,2,200
04364,me,-69.96244,44.31155,3479,1,3,2,200
04401,me,-68.84473,44.84923,13404,1,2,1,100
04406,me,-69.56992,45.23453,309,0,0,0,NA
04408,me,-68.2307,44.99135,799,0,1,1,NA
04411,me,-68.57613,44.88125,863,1,2,1,100
04412,me,-68.73516,44.78356,3828,1,2,1,100
04413,me,-67.74363,45.55074,373,0,1,1,NA
04414,me,-69.10659,45.44461,838,0,1,1,NA
04416,me,-68.75342,44.62558,3423,0,2,2,NA
04417,me,-68.37898,45.23488,113,0,1,1,NA
04418,me,-68.47216,45.08637,491,0,1,1,NA
04421,me,-68.81164,44.40875,777,1,2,1,100
04424,me,-67.86815,45.67061,1066,0,1,1,NA
04426,me,-69.18344,45.21953,3192,0,1,1,NA
04428,me,-68.55584,44.80644,1751,1,2,1,100
04429,me,-68.6165,44.72075,3937,1,2,1,100
04430,me,-68.58517,45.63921,8,0,1,1,NA
04431,me,-68.6706,44.5622,75,0,1,1,NA
04441,me,-69.47536,45.89603,3802,0,0,0,NA
04442,me,-69.6939,45.47957,362,0,0,0,NA
04443,me,-69.39897,45.22429,206,0,1,1,NA
04444,me,-68.94587,44.72593,3559,1,2,1,100
04448,me,-68.70995,45.31876,849,0,1,1,NA
04451,me,-68.2104,45.61089,628,0,1,1,NA
04454,me,-67.56427,45.55609,141,0,1,1,NA
04455,me,-68.27478,45.32349,54,0,1,1,NA
04456,me,-68.99767,44.88647,1264,1,2,1,100
04457,me,-68.47824,45.41628,3914,0,1,1,NA
04459,me,-68.34063,45.59417,145,0,1,1,NA
04460,me,-68.54589,45.69386,170,0,1,1,NA
04461,me,-68.56868,44.96417,1356,1,2,1,100
04462,me,-68.9809,45.93675,1179,0,1,1,NA
04463,me,-68.9061,45.27529,920,0,1,1,NA
04464,me,-69.39796,45.41866,176,0,0,0,NA
04468,me,-68.7275,45.02314,3422,1,2,1,100
04469,me,-68.6683,44.90107,1,1,3,2,200
04471,me,-67.8471,45.89107,317,0,1,1,NA
04472,me,-68.67725,44.57362,1840,0,1,1,NA
04473,me,-68.7172,44.8865,2158,1,3,2,200
04474,me,-68.77902,44.71499,2040,1,2,1,100
04476,me,-68.70874,44.47501,1250,0,2,2,NA
04478,me,-69.87682,45.8641,1842,0,0,0,NA
04479,me,-69.30704,45.12759,1,0,1,1,NA
04485,me,-69.62015,45.36095,13,0,0,0,NA
04487,me,-68.10191,45.39059,1529,0,1,1,NA
04489,me,-68.69019,44.91036,76,1,2,1,100
04490,me,-67.85559,45.43362,345,0,1,1,NA
04491,me,-67.46937,45.57016,223,0,1,1,NA
04492,me,-67.67799,45.34917,141,0,1,1,NA
04493,me,-68.53378,45.23784,7,0,1,1,NA
04497,me,-68.05134,45.7637,627,0,1,1,NA
04530,me,-69.8306,43.8916,5587,0,1,1,NA
04535,me,-69.63437,44.08777,649,0,1,1,NA
04537,me,-69.61734,43.87575,1792,0,0,0,NA
04538,me,-69.6278,43.85175,1972,0,0,0,NA
04539,me,-69.50668,43.96422,1054,0,0,0,NA
04541,me,-69.47624,43.89501,230,0,0,0,NA
04543,me,-69.4921,44.03447,1323,0,0,0,NA
04544,me,-69.58562,43.84437,1209,0,0,0,NA
04547,me,-69.33486,43.98067,1250,0,0,0,NA
04548,me,-69.74845,43.80752,1524,0,0,0,NA
04551,me,-69.42135,43.99735,1000,0,0,0,NA
04553,me,-69.57146,44.04788,1495,0,1,1,NA
04554,me,-69.50613,43.86394,1280,0,0,0,NA
04555,me,-69.47689,44.10599,1631,0,1,1,NA
04556,me,-69.62314,43.96867,1041,0,0,0,NA
04558,me,-69.51705,43.89741,408,0,0,0,NA
04562,me,-69.826,43.77823,2128,0,0,0,NA
04563,me,-69.25903,44.01213,1344,0,0,0,NA
04564,me,-69.46055,43.93446,640,0,0,0,NA
04568,me,-69.55919,43.87738,935,0,0,0,NA
04571,me,-69.67624,43.89802,323,0,0,0,NA
04572,me,-69.36956,44.10982,3022,0,1,1,NA
04573,me,-69.55376,43.95141,439,0,0,0,NA
04574,me,-69.39126,44.27335,1462,1,2,1,100
04575,me,-69.66403,43.85295,205,0,0,0,NA
04578,me,-69.6926,43.97698,2944,0,1,1,NA
04579,me,-69.76867,43.96219,1927,0,1,1,NA
04605,me,-68.41513,44.66459,9600,0,1,1,NA
04606,me,-67.705,44.54194,1417,0,0,0,NA
04607,me,-68.08389,44.46783,1407,0,0,0,NA
04609,me,-68.26821,44.38711,3563,0,0,0,NA
04611,me,-67.6052,44.47698,702,0,0,0,NA
04612,me,-68.39128,44.24233,567,0,0,0,NA
04613,me,-68.027,44.3719,180,0,0,0,NA
04614,me,-68.56737,44.4037,1948,0,1,1,NA
04616,me,-68.55351,44.26843,1119,0,1,1,NA
04617,me,-68.75392,44.3544,1048,1,2,1,100
04619,me,-67.22392,45.13395,2700,0,1,1,NA
04622,me,-67.98454,44.75696,2142,0,1,1,NA
04623,me,-67.72821,44.72803,1468,0,0,0,NA
04624,me,-67.98025,44.4211,517,0,0,0,NA
04625,me,-68.26243,44.25985,220,0,0,0,NA
04626,me,-67.23149,44.67052,620,0,0,0,NA
04627,me,-68.62389,44.21612,1712,0,1,1,NA
04628,me,-67.26991,44.8715,832,0,1,1,NA
04629,me,-68.51748,44.42815,99,0,1,1,NA
04630,me,-67.4583,44.83723,1314,0,0,0,NA
04634,me,-68.22034,44.64893,2438,0,1,1,NA
04635,me,-68.34413,44.15184,83,0,0,0,NA
04637,me,-67.8076,45.19615,479,1,1,0,0
04640,me,-68.29287,44.52861,1760,0,1,1,NA
04642,me,-68.80416,44.33401,194,0,2,2,NA
04643,me,-67.8062,44.54906,1078,0,0,0,NA
04644,me,-68.25208,44.41384,5,0,0,0,NA
04645,me,-68.61804,44.06377,257,0,0,0,NA
04646,me,-68.22462,44.24642,235,0,0,0,NA
04648,me,-67.59007,44.66376,639,0,0,0,NA
04649,me,-67.54145,44.55724,1540,0,0,0,NA
04650,me,-68.70583,44.28472,375,0,1,1,NA
04652,me,-67.06888,44.81627,2522,0,0,0,NA
04653,me,-68.33808,44.21797,436,0,0,0,NA
04654,me,-67.54856,44.76007,2894,0,0,0,NA
04655,me,-67.38005,44.64436,1123,0,0,0,NA
04657,me,-67.42293,44.97017,807,1,2,1,100
04658,me,-67.86532,44.5114,1622,0,0,0,NA
04660,me,-68.34636,44.3402,1529,0,0,0,NA
04662,me,-68.29384,44.30433,638,0,0,0,NA
04664,me,-68.12793,44.54577,1419,0,0,0,NA
04666,me,-67.22512,44.98172,1470,0,1,1,NA
04667,me,-67.09783,44.98202,996,0,0,0,NA
04668,me,-67.59023,45.20968,994,1,2,1,100
04669,me,-68.01411,44.41097,294,0,0,0,NA
04671,me,-67.15983,45.06584,559,0,1,1,NA
04673,me,-68.67599,44.30908,173,0,1,1,NA
04674,me,-68.43978,44.28384,429,0,0,0,NA
04675,me,-68.25259,44.30213,413,0,0,0,NA
04676,me,-68.64279,44.34187,918,0,1,1,NA
04677,me,-68.18089,44.47551,403,0,0,0,NA
04679,me,-68.32482,44.27367,1494,0,0,0,NA
04680,me,-67.94001,44.49048,1534,0,0,0,NA
04681,me,-68.64449,44.15109,1156,0,1,1,NA
04683,me,-68.78562,44.23603,212,0,1,1,NA
04684,me,-68.51326,44.47847,1471,0,1,1,NA
04685,me,-68.46004,44.15189,908,0,0,0,NA
04686,me,-67.69907,44.98535,876,1,2,1,100
04691,me,-67.25154,44.7622,816,0,0,0,NA
04693,me,-68.09273,44.37437,685,0,0,0,NA
04694,me,-67.4722,45.10347,2385,1,2,1,100
04730,me,-67.91375,46.13231,3024,0,1,1,NA
04732,me,-68.76395,46.50718,228,0,0,0,NA
04733,me,-68.40148,45.75696,356,0,1,1,NA
04734,me,-67.92234,46.47856,127,0,1,1,NA
04735,me,-67.86464,46.41797,8,0,1,1,NA
04736,me,-68.02126,46.91539,5821,0,1,1,NA
04739,me,-68.69166,47.01093,529,0,0,0,NA
04740,me,-67.85474,46.64326,868,0,1,1,NA
04741,me,-69.19123,47.4494,44,0,0,0,NA
04742,me,-67.85525,46.7777,2190,0,1,1,NA
04743,me,-68.61739,47.195,2766,0,0,0,NA
04747,me,-68.23816,46.00423,87,0,1,1,NA
04750,me,-67.85724,46.95838,1258,0,0,0,NA
04756,me,-68.30327,47.32211,2059,0,0,0,NA
04757,me,-68.17241,46.66262,2046,0,1,1,NA
04758,me,-67.84723,46.55424,970,0,1,1,NA
04760,me,-67.93644,46.34675,63,0,1,1,NA
04762,me,-68.13494,46.97074,538,0,0,0,NA
04764,me,-68.56825,46.41873,171,0,0,0,NA
04765,me,-68.62644,46.15344,1458,0,1,1,NA
04766,me,-68.23911,46.88164,378,0,0,0,NA
04768,me,-68.8673,46.82668,73,0,0,0,NA
04769,me,-67.98735,46.68672,4359,0,1,1,NA
04772,me,-68.31319,47.22732,128,0,0,0,NA
04773,me,-68.22328,47.27603,1138,0,0,0,NA
04774,me,-69.12358,47.07989,669,0,0,0,NA
04776,me,-68.32332,45.85101,160,0,1,1,NA
04777,me,-68.50728,45.84785,87,0,1,1,NA
04779,me,-68.32295,47.12216,918,0,0,0,NA
04780,me,-68.25254,46.23764,200,0,1,1,NA
04783,me,-68.17585,47.04261,257,0,0,0,NA
04785,me,-67.98694,47.13004,404,0,1,1,NA
04786,me,-68.1788,46.79208,1251,0,1,1,NA
04787,me,-67.97683,46.5517,446,0,1,1,NA
04841,me,-69.13612,44.12704,3399,0,0,0,NA
04843,me,-69.07197,44.22289,3050,0,1,1,NA
04847,me,-69.18958,44.25103,1232,0,1,1,NA
04848,me,-68.91812,44.29788,1212,0,1,1,NA
04849,me,-69.03275,44.31891,1999,0,1,1,NA
04851,me,-68.8504,43.86099,35,0,0,0,NA
04852,me,-69.31345,43.76514,294,0,0,0,NA
04854,me,-69.08142,44.06866,1355,0,0,0,NA
04855,me,-69.26844,43.93636,462,0,0,0,NA
04856,me,-69.118,44.17718,2439,0,1,1,NA
04858,me,-69.14322,44.04405,1203,0,0,0,NA
04859,me,-69.11675,43.98036,947,0,0,0,NA
04860,me,-69.24928,43.94319,1656,0,0,0,NA
04861,me,-69.17486,44.09303,1539,0,0,0,NA
04862,me,-69.27714,44.26193,2804,0,2,2,NA
04863,me,-68.84393,44.06781,1804,0,0,0,NA
04864,me,-69.24481,44.12948,2510,0,1,1,NA
04901,me,-69.57045,44.55447,9216,1,4,3,300
04910,me,-69.44123,44.51701,8,1,2,1,100
04911,me,-69.95559,44.77798,1833,0,2,2,NA
04912,me,-69.68384,44.98411,10,0,0,0,NA
04915,me,-69.03866,44.46418,3440,1,2,1,100
04920,me,-69.85023,45.14011,2091,0,1,1,NA
04921,me,-69.13347,44.57089,1171,1,2,1,100
04924,me,-69.5497,44.77934,5,1,2,1,100
04925,me,-69.90478,45.21793,68,0,0,0,NA
04926,me,-69.51658,44.4818,32,1,3,2,200
04930,me,-69.31485,45.03115,2420,0,1,1,NA
04936,me,-70.62826,45.33562,888,0,0,0,NA
04937,me,-69.67623,44.63567,3156,1,3,2,200
04938,me,-70.1033,44.65892,5554,0,2,2,NA
04940,me,-70.08339,44.62498,66,1,2,1,100
04941,me,-69.3017,44.46542,606,1,3,2,200
04942,me,-69.58548,45.06368,245,0,0,0,NA
04944,me,-69.64364,44.68729,25,1,3,2,200
04945,me,-70.23378,45.76302,840,0,0,0,NA
04947,me,-70.23876,45.03263,2646,0,0,0,NA
04949,me,-69.3403,44.36714,1177,1,3,2,200
04950,me,-69.80561,44.83239,3023,0,2,2,NA
04951,me,-69.04758,44.60847,752,1,2,1,100
04952,me,-69.14266,44.40944,10,1,2,1,100
04955,me,-70.00698,44.63924,1213,0,1,1,NA
04956,me,-70.11432,44.80839,931,0,1,1,NA
04957,me,-69.84602,44.70143,4,0,2,2,NA
04958,me,-69.93069,44.90757,792,0,1,1,NA
04961,me,-70.13472,45.133,1117,0,1,1,NA
04962,me,-69.62594,44.48907,50,1,3,2,200
04963,me,-69.81472,44.56628,3339,1,3,2,200
04964,me,-70.78326,44.87585,1301,0,0,0,NA
04966,me,-70.43003,44.82812,535,0,1,1,NA
04970,me,-70.63809,45.0045,3339,0,0,0,NA
04973,me,-69.19299,44.36225,1129,1,2,1,100
04974,me,-68.92493,44.47281,2156,1,2,1,100
04975,me,-69.58833,44.62535,35,1,3,2,200
04976,me,-69.66953,44.79877,4036,0,2,2,NA
04979,me,-69.79265,44.94293,17,0,1,1,NA
04981,me,-68.85331,44.52156,14,1,2,1,100
04982,me,-70.42299,45.11159,1011,0,0,0,NA
04983,me,-70.30929,44.92281,1895,0,1,1,NA
04985,me,-69.94294,45.37079,970,0,0,0,NA
04986,me,-69.22253,44.55294,663,1,3,2,200
04987,me,-69.25361,44.67914,831,1,2,1,100
04988,me,-69.35974,44.59591,1206,1,2,1,100
04989,me,-69.64789,44.42979,2522,1,3,2,200
04992,me,-70.16,44.66301,51,0,2,2,NA
05001,vt,-72.38116,43.67213,3572,1,4,3,300
05031,vt,-72.59125,43.71221,271,0,1,1,NA
05032,vt,-72.65937,43.80653,1676,0,1,1,NA
05033,vt,-72.15809,44.00886,1331,1,3,2,200
05034,vt,-72.63197,43.58458,187,0,1,1,NA
05035,vt,-72.68738,43.60127,585,0,1,1,NA
05036,vt,-72.57967,44.02651,573,0,1,1,NA
05037,vt,-72.49136,43.45928,419,0,1,1,NA
05038,vt,-72.45687,43.99418,815,0,1,1,NA
05039,vt,-72.29678,44.03649,824,0,1,1,NA
05040,vt,-72.20244,44.06713,348,0,2,2,NA
05041,vt,-72.54067,43.9507,194,0,1,1,NA
05042,vt,-72.09954,44.2275,393,1,2,1,100
05043,vt,-72.20834,43.80813,343,1,4,3,300
05045,vt,-72.19881,43.91716,1326,1,3,2,200
05046,vt,-72.25271,44.2364,899,0,1,1,NA
05048,vt,-72.42382,43.58207,1064,1,3,2,200
05050,vt,-72.06404,44.26691,83,1,2,1,100
05051,vt,-72.12135,44.10302,1112,1,2,1,100
05052,vt,-72.3581,43.59931,141,1,4,3,300
05053,vt,-72.48798,43.71934,161,0,1,1,NA
05055,vt,-72.31302,43.75414,1665,1,4,3,300
05056,vt,-72.7226,43.51918,1048,0,1,1,NA
05058,vt,-72.26983,43.88559,194,1,2,1,100
05059,vt,-72.42624,43.64007,562,1,3,2,200
05060,vt,-72.68992,43.95914,1958,0,2,2,NA
05061,vt,-72.58625,43.93203,617,0,1,1,NA
05062,vt,-72.59204,43.49732,574,1,2,1,100
05065,vt,-72.42342,43.78431,554,1,2,1,100
05067,vt,-72.51354,43.68821,153,1,2,1,100
05068,vt,-72.53523,43.7965,1608,1,2,1,100
05069,vt,-72.13676,44.19053,329,0,2,2,NA
05070,vt,-72.36402,43.84002,314,0,1,1,NA
05071,vt,-72.55358,43.56057,318,0,1,1,NA
05072,vt,-72.37852,43.88311,344,0,1,1,NA
05075,vt,-72.27983,43.83713,604,1,3,2,200
05076,vt,-72.23238,44.15057,355,0,1,1,NA
05077,vt,-72.48062,43.90321,822,0,1,1,NA
05079,vt,-72.32437,43.95621,525,0,1,1,NA
05081,vt,-72.0723,44.13695,348,1,3,2,200
05083,vt,-72.26809,43.9189,66,1,2,1,100
05084,vt,-72.44994,43.72719,63,1,3,2,200
05086,vt,-72.30082,44.11436,526,0,1,1,NA
05089,vt,-72.44631,43.49218,2097,1,4,3,300
05091,vt,-72.57312,43.64029,2137,0,1,1,NA
05101,vt,-72.49467,43.17894,1837,1,5,4,400
05141,vt,-72.56727,43.1531,60,1,2,1,100
05142,vt,-72.58634,43.40283,731,1,2,1,100
05143,vt,-72.63194,43.2691,2918,1,2,1,100
05146,vt,-72.61687,43.17586,658,0,1,1,NA
05148,vt,-72.79985,43.22858,1094,0,0,0,NA
05149,vt,-72.71154,43.37958,2679,0,1,1,NA
05150,vt,-72.52941,43.33463,403,1,4,3,300
05151,vt,-72.49059,43.3969,920,1,4,3,300
05152,vt,-72.91521,43.25355,594,0,0,0,NA
05153,vt,-72.64155,43.40997,590,0,2,2,NA
05154,vt,-72.53559,43.13557,249,1,3,2,200
05155,vt,-72.89464,43.12411,807,0,0,0,NA
05156,vt,-72.47029,43.30586,3890,1,4,3,300
05158,vt,-72.47023,43.09821,545,2,5,3,150
05161,vt,-72.80658,43.31656,641,0,0,0,NA
05201,vt,-73.14133,42.88114,5801,1,2,1,100
05250,vt,-73.19315,43.12022,2198,0,2,2,NA
05251,vt,-73.07032,43.26217,1142,0,1,1,NA
05252,vt,-73.06095,43.0666,237,0,0,0,NA
05253,vt,-72.99928,43.2515,429,0,0,0,NA
05254,vt,-73.06686,43.15697,230,0,2,2,NA
05255,vt,-73.06701,43.16698,2225,0,1,1,NA
05257,vt,-73.25393,42.95909,981,1,4,3,300
05260,vt,-73.26462,42.80756,243,1,2,1,100
05261,vt,-73.19738,42.78232,1115,0,2,2,NA
05262,vt,-73.12689,42.9804,1322,1,2,1,100
05301,vt,-72.66073,42.84633,6673,1,4,3,300
05340,vt,-72.93485,43.16221,1742,0,0,0,NA
05341,vt,-72.79689,42.96387,401,0,1,1,NA
05342,vt,-72.79472,42.76822,454,0,1,1,NA
05343,vt,-72.80024,43.09897,1123,0,1,1,NA
05345,vt,-72.67996,42.98431,1462,0,2,2,NA
05346,vt,-72.53128,43.02419,2216,1,4,3,300
05350,vt,-72.97184,42.79885,822,0,1,1,NA
05352,vt,-73.07848,42.78799,726,0,1,1,NA
05353,vt,-72.66648,43.06531,772,0,2,2,NA
05354,vt,-72.52584,42.76223,908,2,6,4,200
05355,vt,-72.80621,43.02078,961,0,0,0,NA
05356,vt,-72.86947,42.95428,1785,0,0,0,NA
05358,vt,-72.72088,42.7629,167,0,2,2,NA
05359,vt,-72.71547,43.15276,636,0,0,0,NA
05360,vt,-72.94417,43.0027,489,0,0,0,NA
05361,vt,-72.87658,42.78283,889,0,0,0,NA
05362,vt,-72.66135,42.93635,93,1,2,1,100
05363,vt,-72.89276,42.88201,3147,0,0,0,NA
05401,vt,-73.20999,44.47626,5553,1,4,3,300
05403,vt,-73.17229,44.447,7918,1,4,3,300
05404,vt,-73.18439,44.49499,1769,1,4,3,300
05405,vt,-73.19568,44.47386,8,1,4,3,300
05408,vt,-73.24918,44.51203,3012,2,5,3,150
05439,vt,-73.16371,44.49515,20,1,4,3,300
05440,vt,-73.27954,44.9595,1528,1,4,3,300
05441,vt,-72.76979,44.79168,523,0,1,1,NA
05442,vt,-72.67685,44.75813,272,0,0,0,NA
05443,vt,-73.03658,44.13327,3116,0,1,1,NA
05444,vt,-72.90079,44.64764,816,1,2,1,100
05445,vt,-73.22156,44.3094,1740,1,4,3,300
05446,vt,-73.18542,44.54853,5027,1,4,3,300
05447,vt,-72.70268,44.93089,35,0,1,1,NA
05448,vt,-72.89744,44.75541,632,1,2,1,100
05450,vt,-72.79135,44.90033,2437,1,2,1,100
05452,vt,-73.06251,44.5242,6333,1,3,2,200
05454,vt,-73.02711,44.70245,2219,1,2,1,100
05455,vt,-72.96666,44.80288,503,1,2,1,100
05456,vt,-73.25508,44.20763,667,1,4,3,300
05457,vt,-72.91335,44.97118,1062,1,3,2,200
05458,vt,-73.30546,44.71823,1207,1,5,4,400
05459,vt,-73.00437,44.95329,935,1,3,2,200
05461,vt,-73.09133,44.32209,1818,1,2,1,100
05462,vt,-72.95314,44.2999,965,0,1,1,NA
05463,vt,-73.34103,44.86945,566,1,4,3,300
05464,vt,-72.81779,44.64529,1476,0,1,1,NA
05465,vt,-72.95002,44.46825,2219,0,2,2,NA
05468,vt,-73.14545,44.65528,5171,1,3,2,200
05471,vt,-72.59448,44.85573,806,0,0,0,NA
05472,vt,-73.15983,44.10894,909,1,4,3,300
05473,vt,-73.19335,44.24341,733,1,3,2,200
05474,vt,-73.27369,44.84032,1046,1,4,3,300
05476,vt,-72.6413,44.96296,1658,0,1,1,NA
05477,vt,-72.95439,44.40248,1943,0,1,1,NA
05478,vt,-73.0811,44.80959,5890,1,2,1,100
05481,vt,-73.20536,44.77289,2,1,3,2,200
05482,vt,-73.20959,44.38508,2940,1,4,3,300
05483,vt,-72.97191,44.88183,717,1,2,1,100
05485,vt,-72.97541,44.90723,43,1,3,2,200
05486,vt,-73.31085,44.64052,1112,2,5,3,150
05487,vt,-73.01087,44.23159,740,0,1,1,NA
05488,vt,-73.12471,44.9216,3690,1,3,2,200
05489,vt,-72.88754,44.54093,1498,0,1,1,NA
05491,vt,-73.30865,44.11247,2780,2,5,3,150
05492,vt,-72.75509,44.71747,388,0,1,1,NA
05494,vt,-73.0051,44.60236,877,1,2,1,100
05495,vt,-73.09206,44.42919,3356,1,3,2,200
05602,vt,-72.60502,44.28379,4913,1,2,1,100
05640,vt,-72.49323,44.34525,122,0,1,1,NA
05641,vt,-72.47287,44.18886,7021,0,1,1,NA
05647,vt,-72.28837,44.40809,748,0,1,1,NA
05648,vt,-72.49347,44.385,317,0,1,1,NA
05649,vt,-72.35793,44.15606,295,0,1,1,NA
05650,vt,-72.44201,44.38004,799,0,1,1,NA
05651,vt,-72.48846,44.27952,719,0,2,2,NA
05652,vt,-72.58718,44.7285,403,0,1,1,NA
05653,vt,-72.49322,44.70136,475,0,0,0,NA
05654,vt,-72.47447,44.13963,377,0,1,1,NA
05655,vt,-72.57027,44.62382,1331,0,2,2,NA
05656,vt,-72.68821,44.64898,1289,0,2,2,NA
05657,vt,-72.52576,44.53469,98,0,1,1,NA
05658,vt,-72.35591,44.35813,773,0,1,1,NA
05660,vt,-72.74141,44.24712,994,0,1,1,NA
05661,vt,-72.61822,44.53775,2738,0,1,1,NA
05663,vt,-72.67799,44.15197,2369,0,1,1,NA
05664,vt,-72.65314,44.16717,6,0,1,1,NA
05667,vt,-72.39197,44.27113,1077,0,1,1,NA
05669,vt,-72.7308,44.06659,570,0,0,0,NA
05672,vt,-72.72184,44.48134,3179,0,1,1,NA
05673,vt,-72.84351,44.19389,1748,0,1,1,NA
05674,vt,-72.86078,44.11108,3161,0,0,0,NA
05675,vt,-72.41836,44.07372,721,0,0,0,NA
05676,vt,-72.80856,44.34293,2309,0,2,2,NA
05677,vt,-72.70967,44.39288,995,0,1,1,NA
05678,vt,-72.47571,44.15627,78,0,1,1,NA
05679,vt,-72.53964,44.10734,1465,0,1,1,NA
05680,vt,-72.47064,44.54411,1326,0,1,1,NA
05681,vt,-72.40374,44.45479,547,0,1,1,NA
05682,vt,-72.57145,44.40299,656,0,1,1,NA
05701,vt,-72.91004,43.62478,8036,1,2,1,100
05730,vt,-72.82306,43.41508,302,0,0,0,NA
05732,vt,-73.18256,43.68538,717,1,4,3,300
05733,vt,-73.09196,43.81991,3542,1,3,2,200
05734,vt,-73.3304,43.98205,757,2,7,5,250
05735,vt,-73.15644,43.64413,1850,1,3,2,200
05736,vt,-73.00954,43.61456,318,1,3,2,200
05737,vt,-72.91196,43.75903,550,0,0,0,NA
05738,vt,-72.85626,43.52965,708,0,0,0,NA
05739,vt,-73.00597,43.33992,766,0,0,0,NA
05740,vt,-73.10527,43.97175,16,2,5,3,150
05742,vt,-72.9014,43.43607,499,0,0,0,NA
05743,vt,-73.30606,43.66965,2630,2,6,4,200
05744,vt,-73.08491,43.69841,294,1,3,2,200
05747,vt,-72.84126,44.00559,311,0,0,0,NA
05748,vt,-72.91056,43.92004,267,0,0,0,NA
05751,vt,-72.78912,43.65416,1533,0,0,0,NA
05753,vt,-73.17501,43.99991,3895,2,5,3,150
05757,vt,-73.12481,43.47871,540,0,0,0,NA
05758,vt,-72.78681,43.43437,759,0,0,0,NA
05759,vt,-72.96324,43.53665,822,0,1,1,NA
05760,vt,-73.29282,43.80281,768,2,5,3,150
05761,vt,-73.14944,43.3624,630,0,1,1,NA
05762,vt,-72.82905,43.7923,508,0,0,0,NA
05763,vt,-72.99963,43.72667,1333,1,3,2,200
05764,vt,-73.19172,43.53185,1711,1,3,2,200
05765,vt,-73.03509,43.65245,866,1,3,2,200
05766,vt,-72.98693,43.9921,501,0,0,0,NA
05767,vt,-72.82896,43.87514,944,0,0,0,NA
05769,vt,-73.11536,43.91916,770,1,4,3,300
05770,vt,-73.32058,43.88678,643,2,7,5,250
05772,vt,-72.74447,43.75604,952,0,1,1,NA
05773,vt,-72.98614,43.42166,1231,0,1,1,NA
05774,vt,-73.1901,43.4313,930,0,2,2,NA
05775,vt,-73.23135,43.36238,336,1,2,1,100
05776,vt,-73.1905,43.26361,593,0,1,1,NA
05777,vt,-73.0569,43.55856,1625,1,2,1,100
05778,vt,-73.21115,43.87371,395,2,6,4,200
05819,vt,-71.98769,44.40527,4108,0,2,2,NA
05820,vt,-72.34496,44.73884,453,0,1,1,NA
05821,vt,-72.10948,44.31349,967,0,1,1,NA
05822,vt,-72.14263,44.75038,1210,0,1,1,NA
05824,vt,-71.86132,44.43678,984,0,1,1,NA
05825,vt,-72.24555,44.86228,107,0,1,1,NA
05826,vt,-72.40262,44.64663,613,0,1,1,NA
05827,vt,-72.35814,44.68111,248,0,1,1,NA
05828,vt,-72.11962,44.43681,1226,0,1,1,NA
05829,vt,-72.07031,44.95196,1078,0,1,1,NA
05830,vt,-71.98516,44.98022,816,0,0,0,NA
05832,vt,-71.91278,44.58829,715,0,1,1,NA
05833,vt,-71.97764,44.82601,203,0,0,0,NA
05836,vt,-72.26641,44.51515,714,0,0,0,NA
05837,vt,-71.81515,44.6585,295,0,0,0,NA
05839,vt,-72.21307,44.6747,581,0,0,0,NA
05841,vt,-72.29445,44.60687,758,0,1,1,NA
05842,vt,-72.22032,44.55277,372,0,0,0,NA
05843,vt,-72.34699,44.50921,1329,0,1,1,NA
05845,vt,-72.30002,44.79633,704,0,1,1,NA
05846,vt,-71.86312,44.80123,1101,0,0,0,NA
05847,vt,-72.45684,44.79155,709,0,0,0,NA
05850,vt,-72.01745,44.54159,65,0,2,2,NA
05851,vt,-72.07158,44.55551,2797,0,1,1,NA
05853,vt,-71.96616,44.89474,855,0,0,0,NA
05855,vt,-72.19223,44.92779,3510,0,1,1,NA
05857,vt,-72.30464,44.93575,894,0,1,1,NA
05858,vt,-71.79585,44.54949,408,0,1,1,NA
05859,vt,-72.44517,44.96729,1643,0,1,1,NA
05860,vt,-72.10295,44.80181,1838,0,1,1,NA
05862,vt,-72.22581,44.31891,425,0,1,1,NA
05866,vt,-72.12752,44.64225,527,0,1,1,NA
05867,vt,-72.04223,44.66286,543,0,1,1,NA
05868,vt,-72.37746,44.89481,274,0,1,1,NA
05871,vt,-71.9418,44.68776,1210,0,1,1,NA
05872,vt,-72.04654,44.86687,570,0,0,0,NA
05873,vt,-72.20534,44.42221,707,0,1,1,NA
05874,vt,-72.46764,44.87715,399,0,1,1,NA
05875,vt,-72.25669,44.71056,398,0,0,0,NA
05901,vt,-71.68203,44.94276,218,0,0,0,NA
05902,vt,-71.49089,45.00852,105,0,0,0,NA
05903,nh,-71.58283,44.93222,700,0,0,0,NA
05904,vt,-71.70707,44.41612,133,0,1,1,NA
05905,nh,-71.66907,44.69348,1180,0,1,1,NA
05906,vt,-71.71466,44.47597,983,0,1,1,NA
05907,vt,-71.80092,44.92022,392,0,0,0,NA
06001,ct,-72.85386,41.79072,8033,3,9,6,200
06002,ct,-72.74062,41.84254,6993,4,11,7,175
06010,ct,-72.94071,41.68114,13128,3,8,5,166.7
06013,ct,-72.95895,41.75976,44,3,9,6,200
06016,ct,-72.54439,41.9042,2131,3,9,6,200
06018,ct,-73.30875,42.02648,1335,1,4,3,300
06019,ct,-72.90698,41.85965,3811,2,7,5,250
06020,ct,-72.92872,41.83462,1,2,8,6,300
06021,ct,-73.10433,42.0219,218,1,2,1,100
06022,ct,-72.92733,41.86543,80,2,6,4,200
06023,ct,-72.71996,41.61377,428,5,12,7,140
06024,ct,-73.27426,42.01214,365,0,2,2,NA
06026,ct,-72.74234,41.94269,2552,4,11,7,175
06027,ct,-72.91183,42.00395,2,2,5,3,150
06029,ct,-72.44931,41.91506,5387,2,5,3,150
06031,ct,-73.31737,41.95782,425,1,4,3,300
06032,ct,-72.83126,41.72529,5936,3,9,6,200
06033,ct,-72.54198,41.70787,10012,2,7,5,250
06035,ct,-72.80093,41.96066,2952,4,10,6,150
06037,ct,-72.77777,41.61128,7294,5,12,7,140
06039,ct,-73.44483,41.95023,1381,2,5,3,150
06040,ct,-72.52251,41.76166,9942,2,6,4,200
06042,ct,-72.52697,41.79751,6167,2,7,5,250
06043,ct,-72.439,41.76648,2090,1,4,3,300
06051,ct,-72.76981,41.66513,5530,4,11,7,175
06052,ct,-72.80521,41.65721,2383,4,10,6,150
06053,ct,-72.79422,41.68859,7904,4,10,6,150
06057,ct,-73.00623,41.84409,3269,1,4,3,300
06058,ct,-73.1954,41.97191,1319,0,2,2,NA
06059,ct,-72.94477,41.94906,2,1,3,2,200
06060,ct,-72.84572,42.00705,1129,3,7,4,133.3
06061,ct,-72.96684,41.8756,87,2,6,4,200
06062,ct,-72.86076,41.67339,7351,3,9,6,200
06063,ct,-72.97158,41.92703,1730,1,4,3,300
06065,ct,-73.00406,41.97397,244,1,4,3,300
06066,ct,-72.46064,41.83642,7946,1,5,4,400
06067,ct,-72.66321,41.6572,4850,4,10,6,150
06068,ct,-73.42041,42.01476,1149,2,5,3,150
06069,ct,-73.44723,41.85446,2174,2,5,3,150
06070,ct,-72.81476,41.87612,4537,3,9,6,200
06071,ct,-72.45218,41.99473,3590,2,6,4,200
06073,ct,-72.55774,41.66029,2254,3,8,5,166.7
06074,ct,-72.57335,41.83528,8319,3,9,6,200
06076,ct,-72.26165,41.98967,6021,1,3,2,200
06078,ct,-72.64994,41.9891,3342,5,12,7,140
06081,ct,-72.76902,41.90645,302,4,11,7,175
06082,ct,-72.55474,41.98403,14318,4,11,7,175
06084,ct,-72.36459,41.87891,6487,1,4,3,300
06085,ct,-72.88806,41.74643,2834,4,9,5,125
06088,ct,-72.59645,41.90579,1528,5,12,7,140
06089,ct,-72.82294,41.8373,716,3,8,5,166.7
06090,ct,-72.86319,41.94649,660,3,7,4,133.3
06092,ct,-72.85913,41.87327,1318,3,9,6,200
06093,ct,-72.72425,42.00295,1635,4,10,6,150
06095,ct,-72.67361,41.87108,11739,5,12,7,140
06096,ct,-72.65707,41.92751,4366,5,12,7,140
06098,ct,-73.08728,41.95691,5011,1,3,2,200
06103,ct,-72.67333,41.76749,327,4,10,6,150
06105,ct,-72.70504,41.77471,1997,4,10,6,150
06106,ct,-72.69492,41.74871,6056,4,10,6,150
06107,ct,-72.75895,41.75414,6985,4,10,6,150
06108,ct,-72.62156,41.78086,5982,4,10,6,150
06109,ct,-72.67033,41.70132,9868,4,10,6,150
06110,ct,-72.7336,41.73268,4330,4,10,6,150
06111,ct,-72.73084,41.687,9935,4,10,6,150
06112,ct,-72.69649,41.7931,4120,4,11,7,175
06114,ct,-72.6695,41.73936,4430,4,10,6,150
06117,ct,-72.76203,41.7869,4926,4,10,6,150
06118,ct,-72.60994,41.74873,8084,3,9,6,200
06119,ct,-72.72721,41.76342,3755,4,10,6,150
06120,ct,-72.66542,41.78936,2146,4,11,7,175
06160,ct,-72.69115,41.76661,2,4,10,6,150
06226,ct,-72.20726,41.70842,3972,3,8,5,166.7
06231,ct,-72.37029,41.62553,1692,2,7,5,250
06232,ct,-72.37604,41.73312,1663,1,5,4,400
06234,ct,-71.95268,41.7894,2915,3,8,5,166.7
06235,ct,-72.1275,41.79292,1191,2,6,4,200
06237,ct,-72.30727,41.69421,2585,2,6,4,200
06238,ct,-72.33956,41.78309,6391,1,5,4,400
06239,ct,-71.85658,41.79151,4073,2,7,5,250
06241,ct,-71.84842,41.85632,3036,2,7,5,250
06242,ct,-72.0952,41.89312,985,1,5,4,400
06243,ct,-71.80265,41.84523,16,2,5,3,150
06247,ct,-72.06623,41.76708,1537,2,6,4,200
06248,ct,-72.40575,41.68491,2053,2,6,4,200
06249,ct,-72.24018,41.63128,3967,2,7,5,250
06250,ct,-72.1973,41.77334,1757,2,7,5,250
06254,ct,-72.14321,41.61528,1080,3,9,6,200
06255,ct,-71.90253,41.98825,2338,2,6,4,200
06256,ct,-72.1573,41.73706,731,2,7,5,250
06259,ct,-71.99074,41.87007,2240,2,6,4,200
06260,ct,-71.87209,41.90903,3457,2,7,5,250
06262,ct,-71.94815,42.02034,282,2,6,4,200
06263,ct,-71.90602,41.84038,107,3,9,6,200
06264,ct,-72.10037,41.69421,63,3,8,5,166.7
06266,ct,-72.17021,41.67275,252,3,9,6,200
06268,ct,-72.24778,41.79969,2477,2,6,4,200
06269,ct,-72.26979,41.80833,21,1,5,4,400
06277,ct,-71.83967,41.96886,2715,2,6,4,200
06278,ct,-72.16989,41.89103,2379,1,5,4,400
06279,ct,-72.25934,41.88955,2419,1,4,3,300
06280,ct,-72.14032,41.69272,1383,3,8,5,166.7
06281,ct,-72.01528,41.97248,4035,2,5,3,150
06282,ct,-72.07955,41.94243,791,1,4,3,300
06320,ct,-72.10189,41.34791,6337,2,6,4,200
06330,ct,-72.07525,41.64288,1417,4,9,5,125
06331,ct,-71.99978,41.69789,2555,3,8,5,166.7
06332,ct,-71.90213,41.73127,104,3,8,5,166.7
06333,ct,-72.24505,41.38591,2969,2,8,6,300
06334,ct,-72.17419,41.5443,1293,3,9,6,200
06335,ct,-72.06161,41.43117,2641,3,8,5,166.7
06336,ct,-72.19493,41.57935,73,3,9,6,200
06339,ct,-71.99577,41.44459,3413,2,7,5,250
06340,ct,-72.04364,41.35475,7019,2,5,3,150
06350,ct,-72.06845,41.64851,34,4,10,6,150
06351,ct,-71.94936,41.58915,6544,4,10,6,150
06353,ct,-72.14161,41.45851,47,3,9,6,200
06354,ct,-71.85619,41.70276,2398,2,7,5,250
06355,ct,-71.97424,41.36652,5775,1,3,2,200
06357,ct,-72.21565,41.32337,6296,2,7,5,250
06359,ct,-71.87546,41.46966,3011,2,6,4,200
06360,ct,-72.08929,41.54883,11124,4,11,7,175
06365,ct,-72.00103,41.52231,2386,4,9,5,125
06370,ct,-72.18795,41.46476,2998,3,7,4,133.3
06371,ct,-72.32671,41.36275,6919,2,6,4,200
06373,ct,-71.7991,41.67046,202,2,7,5,250
06374,ct,-71.91421,41.6804,3535,3,7,4,133.3
06375,ct,-72.12489,41.40513,1638,3,7,4,133.3
06376,ct,-72.25395,41.29406,283,2,7,5,250
06377,ct,-71.81754,41.72623,1377,2,6,4,200
06378,ct,-71.91383,41.37902,2946,1,3,2,200
06379,ct,-71.85853,41.36498,3800,0,2,2,NA
06380,ct,-72.0531,41.56548,687,4,11,7,175
06382,ct,-72.11768,41.46232,4059,3,9,6,200
06384,ct,-71.83174,41.5813,1494,3,7,4,133.3
06385,ct,-72.15545,41.35632,6977,2,7,5,250
06387,ct,-71.91054,41.74275,63,3,8,5,166.7
06389,ct,-72.12916,41.56418,30,4,11,7,175
06390,ny,-71.98859,41.27029,939,0,2,2,NA
06401,ct,-73.0689,41.34426,5777,5,11,6,120
06403,ct,-73.05677,41.43902,1945,3,9,6,200
06405,ct,-72.79666,41.2797,8926,2,6,4,200
06409,ct,-72.42021,41.35118,442,1,4,3,300
06410,ct,-72.90426,41.51172,9194,5,11,6,120
06412,ct,-72.48319,41.40594,1871,2,7,5,250
06413,ct,-72.52962,41.29624,6709,1,3,2,200
06414,ct,-72.55599,41.56644,92,3,8,5,166.7
06415,ct,-72.34737,41.55746,6854,2,7,5,250
06416,ct,-72.6642,41.6141,4092,5,12,7,140
06417,ct,-72.46229,41.36894,2219,1,4,3,300
06418,ct,-73.08331,41.32653,3515,5,11,6,120
06419,ct,-72.57845,41.37922,2860,1,3,2,200
06420,ct,-72.26682,41.48517,1870,2,7,5,250
06422,ct,-72.68288,41.46222,3078,2,6,4,200
06423,ct,-72.38798,41.46709,3187,2,7,5,250
06424,ct,-72.50564,41.55891,5776,2,7,5,250
06426,ct,-72.39876,41.35299,1824,1,4,3,300
06437,ct,-72.70033,41.33206,9670,1,4,3,300
06438,ct,-72.50355,41.4571,1291,2,7,5,250
06441,ct,-72.5774,41.46501,2707,2,5,3,150
06442,ct,-72.44546,41.34301,1174,1,4,3,300
06443,ct,-72.6268,41.33765,8372,1,3,2,200
06444,ct,-72.93324,41.56268,149,5,11,6,120
06447,ct,-72.45469,41.63307,2684,2,7,5,250
06450,ct,-72.77399,41.53333,9217,5,11,6,120
06451,ct,-72.82351,41.54208,7129,6,13,7,116.7
06455,ct,-72.71719,41.515,1707,3,9,6,200
06456,ct,-72.55018,41.53977,169,2,7,5,250
06457,ct,-72.65488,41.54764,13452,5,11,6,120
06460,ct,-73.05077,41.21382,14134,4,9,5,125
06461,ct,-73.07519,41.23952,5193,4,11,7,175
06467,ct,-72.89976,41.56785,52,5,12,7,140
06468,ct,-73.22501,41.33791,7460,4,11,7,175
06469,ct,-72.44748,41.50871,1665,2,6,4,200
06470,ct,-73.31936,41.39436,6335,5,12,7,140
06471,ct,-72.77473,41.33056,3125,2,6,4,200
06472,ct,-72.77885,41.38023,2621,2,7,5,250
06473,ct,-72.85598,41.38066,9155,3,9,6,200
06475,ct,-72.38355,41.29995,6306,1,4,3,300
06477,ct,-73.02717,41.2827,5894,5,11,6,120
06478,ct,-73.13503,41.43129,5077,4,10,6,150
06479,ct,-72.90455,41.57698,3522,5,12,7,140
06480,ct,-72.58906,41.59883,4715,5,11,6,120
06481,ct,-72.70034,41.53356,566,5,12,7,140
06482,ct,-73.24495,41.40666,4518,5,12,7,140
06483,ct,-73.08724,41.38099,5958,4,10,6,150
06484,ct,-73.13828,41.30599,13148,5,11,6,120
06488,ct,-73.23293,41.47454,6936,5,11,6,120
06489,ct,-72.87254,41.6133,10777,4,11,7,175
06492,ct,-72.80457,41.45926,13638,4,10,6,150
06498,ct,-72.46642,41.30354,4589,1,4,3,300
06510,ct,-72.92601,41.3065,335,7,14,7,100
06511,ct,-72.92678,41.31623,8758,6,14,8,133.3
06512,ct,-72.87525,41.27826,10800,3,9,6,200
06513,ct,-72.86823,41.31963,7754,4,11,7,175
06514,ct,-72.94115,41.37351,7155,6,13,7,116.7
06515,ct,-72.96958,41.32793,3631,6,13,7,116.7
06516,ct,-72.96491,41.27242,14368,5,11,6,120
06517,ct,-72.90504,41.34834,4751,6,13,7,116.7
06518,ct,-72.91345,41.42765,4786,5,12,7,140
06519,ct,-72.93284,41.29351,3038,6,14,8,133.3
06524,ct,-72.99308,41.42606,2394,3,9,6,200
06525,ct,-73.01018,41.3566,3587,5,11,6,120
06604,ct,-73.20001,41.16918,4414,4,9,5,125
06605,ct,-73.21831,41.16197,4193,4,10,6,150
06606,ct,-73.20804,41.21174,11179,4,9,5,125
06607,ct,-73.16821,41.17068,1827,4,9,5,125
06608,ct,-73.18097,41.1868,2396,4,9,5,125
06610,ct,-73.16947,41.20465,4519,4,9,5,125
06611,ct,-73.20948,41.26009,13325,4,10,6,150
06612,ct,-73.30099,41.26505,3534,5,11,6,120
06614,ct,-73.1279,41.23011,10732,4,9,5,125
06615,ct,-73.13282,41.16909,6050,4,9,5,125
06702,ct,-73.04568,41.55723,630,3,9,6,200
06704,ct,-73.03303,41.58653,7115,3,8,5,166.7
06705,ct,-72.9931,41.54879,5919,3,8,5,166.7
06706,ct,-73.0233,41.53251,4090,3,9,6,200
06708,ct,-73.06722,41.54962,9050,3,9,6,200
06710,ct,-73.04582,41.56915,2198,3,8,5,166.7
06712,ct,-72.97614,41.49926,3840,3,8,5,166.7
06716,ct,-72.97335,41.60065,6870,3,7,4,133.3
06750,ct,-73.26416,41.72319,756,1,4,3,300
06751,ct,-73.2123,41.6379,1960,2,6,4,200
06752,ct,-73.35964,41.52085,984,4,9,5,125
06754,ct,-73.35798,41.77183,1249,1,4,3,300
06755,ct,-73.48119,41.65033,644,3,9,6,200
06756,ct,-73.23613,41.84733,2192,1,2,1,100
06757,ct,-73.45861,41.74117,1400,2,6,4,200
06758,ct,-73.24203,41.67545,172,1,4,3,300
06759,ct,-73.21404,41.75755,2923,1,4,3,300
06762,ct,-73.12309,41.5277,3498,3,8,5,166.7
06763,ct,-73.20197,41.69215,1115,1,4,3,300
06770,ct,-73.05309,41.48924,9900,3,9,6,200
06776,ct,-73.41569,41.60178,12743,4,9,5,125
06777,ct,-73.33976,41.69287,1256,2,5,3,150
06778,ct,-73.10962,41.70961,646,2,6,4,200
06779,ct,-73.08166,41.59469,3120,3,9,6,200
06782,ct,-73.04757,41.65467,1143,2,6,4,200
06783,ct,-73.29999,41.554,1511,3,8,5,166.7
06784,ct,-73.49575,41.5784,2640,3,9,6,200
06785,ct,-73.44448,41.69947,594,2,7,5,250
06786,ct,-73.01502,41.6692,3762,2,5,3,150
06787,ct,-73.08585,41.6702,2989,2,7,5,250
06790,ct,-73.12879,41.83777,12794,1,4,3,300
06791,ct,-73.05838,41.75506,105,2,5,3,150
06793,ct,-73.28843,41.62956,877,2,5,3,150
06794,ct,-73.32355,41.64946,743,2,6,4,200
06795,ct,-73.12281,41.61863,6130,2,7,5,250
06796,ct,-73.33285,41.87041,1051,1,3,2,200
06798,ct,-73.20702,41.56149,3849,3,8,5,166.7
06801,ct,-73.39283,41.37472,7669,6,13,7,116.7
06804,ct,-73.39226,41.46741,7358,5,12,7,140
06807,ct,-73.59197,41.06117,2312,5,12,7,140
06810,ct,-73.45919,41.3763,9777,6,13,7,116.7
06811,ct,-73.48162,41.4244,9233,5,12,7,140
06812,ct,-73.48826,41.488,6374,4,10,6,150
06820,ct,-73.48115,41.07599,7178,6,13,7,116.7
06824,ct,-73.28052,41.17398,11442,4,11,7,175
06825,ct,-73.24227,41.19718,6543,4,10,6,150
06830,ct,-73.62432,41.03746,6633,5,12,7,140
06831,ct,-73.66094,41.0878,5309,5,11,6,120
06840,ct,-73.49916,41.15921,7276,6,14,8,133.3
06850,ct,-73.44312,41.12651,5176,6,13,7,116.7
06851,ct,-73.40411,41.13942,7518,6,13,7,116.7
06853,ct,-73.43853,41.06753,1524,5,12,7,140
06854,ct,-73.42615,41.08458,5554,5,13,8,160
06855,ct,-73.39647,41.08372,2233,5,12,7,140
06870,ct,-73.56993,41.02354,2554,5,12,7,140
06877,ct,-73.50222,41.30645,9496,5,11,6,120
06878,ct,-73.58351,41.03044,2678,5,12,7,140
06880,ct,-73.34953,41.13372,10507,5,12,7,140
06883,ct,-73.37253,41.22839,4011,6,13,7,116.7
06890,ct,-73.28952,41.14581,1571,5,11,6,120
06896,ct,-73.39154,41.30515,4197,5,12,7,140
06897,ct,-73.44003,41.20702,6433,6,13,7,116.7
06901,ct,-73.53817,41.05359,363,5,12,7,140
06902,ct,-73.54353,41.05497,9846,5,12,7,140
06903,ct,-73.57216,41.13557,5699,7,14,7,100
06905,ct,-73.54349,41.08884,5261,6,13,7,116.7
06906,ct,-73.52262,41.07102,2041,6,13,7,116.7
06907,ct,-73.52015,41.10092,2331,6,14,8,133.3
07001,nj,-74.26993,40.58343,3242,8,16,8,100
07002,nj,-74.10907,40.66428,13954,6,14,8,133.3
07003,nj,-74.18683,40.80992,12128,8,16,8,100
07004,nj,-74.30418,40.88281,3654,6,13,7,116.7
07005,nj,-74.42099,40.92947,5819,5,11,6,120
07006,nj,-74.28168,40.85216,8194,6,13,7,116.7
07008,nj,-74.22736,40.58377,5926,6,13,7,116.7
07009,nj,-74.22876,40.8565,4116,6,14,8,133.3
07010,nj,-73.98794,40.82205,7448,6,13,7,116.7
07011,nj,-74.1448,40.87848,8391,8,16,8,100
07012,nj,-74.15983,40.84744,3399,8,16,8,100
07013,nj,-74.17274,40.86906,9269,8,16,8,100
07014,nj,-74.13547,40.83149,2047,8,16,8,100
07016,nj,-74.30359,40.65641,8261,10,19,9,90
07017,nj,-74.20707,40.77211,6055,8,16,8,100
07018,nj,-74.21782,40.75583,4282,8,16,8,100
07020,nj,-73.97406,40.82362,4419,6,14,8,133.3
07021,nj,-74.27977,40.8269,839,6,12,6,100
07022,nj,-74.00223,40.81821,2822,6,14,8,133.3
07023,nj,-74.38569,40.6417,2664,11,20,9,81.8
07024,nj,-73.9713,40.85081,8880,6,13,7,116.7
07026,nj,-74.10813,40.87864,6771,8,16,8,100
07027,nj,-74.32314,40.65135,1562,11,20,9,81.8
07028,nj,-74.20438,40.80398,2370,8,16,8,100
07029,nj,-74.15394,40.74372,3038,7,15,8,114.3
07030,nj,-74.03211,40.7453,18029,5,12,7,140
07031,nj,-74.12726,40.78747,4264,7,15,8,114.3
07032,nj,-74.12031,40.75375,9108,7,15,8,114.3
07033,nj,-74.28895,40.67815,3062,10,19,9,90
07034,nj,-74.37993,40.8797,2749,7,15,8,114.3
07035,nj,-74.30493,40.92542,4242,6,14,8,133.3
07036,nj,-74.23844,40.62504,12964,8,16,8,100
07039,nj,-74.32904,40.78547,10693,7,15,8,114.3
07040,nj,-74.26962,40.73058,7502,9,18,9,100
07041,nj,-74.30073,40.72292,2292,10,19,9,90
07042,nj,-74.21768,40.81361,6760,8,16,8,100
07043,nj,-74.20043,40.84427,4156,7,15,8,114.3
07044,nj,-74.24285,40.83221,5260,6,13,7,116.7
07045,nj,-74.36768,40.91074,3955,6,13,7,116.7
07046,nj,-74.44057,40.89064,1734,6,13,7,116.7
07047,nj,-74.02617,40.79362,11603,6,13,7,116.7
07050,nj,-74.23478,40.76823,5328,8,16,8,100
07052,nj,-74.26281,40.7893,14968,8,16,8,100
07054,nj,-74.40225,40.85566,7231,7,14,7,100
07055,nj,-74.12817,40.85751,8218,8,16,8,100
07057,nj,-74.10669,40.85352,2519,7,15,8,114.3
07058,nj,-74.34276,40.86731,1404,7,15,8,114.3
07059,nj,-74.51463,40.63237,6238,9,17,8,88.9
07060,nj,-74.42158,40.61633,9109,11,20,9,81.8
07062,nj,-74.40332,40.63161,3672,11,21,10,90.9
07063,nj,-74.44603,40.60516,3307,11,20,9,81.8
07064,nj,-74.24728,40.56782,1393,6,13,7,116.7
07065,nj,-74.28075,40.60769,8386,9,17,8,88.9
07066,nj,-74.31342,40.62028,5393,10,19,9,90
07067,nj,-74.31486,40.59264,6327,9,18,9,100
07068,nj,-74.30865,40.82074,2260,6,13,7,116.7
07069,nj,-74.4395,40.64246,2538,11,20,9,81.8
07070,nj,-74.10575,40.82029,5603,7,15,8,114.3
07071,nj,-74.10994,40.79639,5980,7,15,8,114.3
07072,nj,-74.06119,40.82473,2368,7,15,8,114.3
07073,nj,-74.08534,40.81789,2472,7,15,8,114.3
07074,nj,-74.05676,40.83988,848,7,14,7,100
07075,nj,-74.08778,40.85071,3313,7,15,8,114.3
07076,nj,-74.37389,40.63304,8066,11,20,9,81.8
07077,nj,-74.25323,40.55346,1034,6,13,7,116.7
07078,nj,-74.33379,40.74207,4341,9,18,9,100
07079,nj,-74.26016,40.74909,4895,8,17,9,112.5
07080,nj,-74.41531,40.5748,8896,10,20,10,100
07081,nj,-74.32546,40.69945,5367,10,19,9,90
07082,nj,-74.34532,40.92641,2110,6,13,7,116.7
07083,nj,-74.26898,40.69421,16709,10,18,8,80
07086,nj,-74.0208,40.76812,2457,6,13,7,116.7
07087,nj,-74.03231,40.76735,11231,6,13,7,116.7
07088,nj,-74.28502,40.71784,1121,10,19,9,90
07090,nj,-74.34321,40.65155,10065,11,20,9,81.8
07092,nj,-74.36026,40.68105,2786,10,20,10,100
07093,nj,-74.01144,40.7881,9172,6,14,8,133.3
07094,nj,-74.06606,40.78102,3493,6,13,7,116.7
07095,nj,-74.28637,40.55378,5967,8,16,8,100
07102,nj,-74.17359,40.73589,2203,7,15,8,114.3
07103,nj,-74.19553,40.73873,6031,8,16,8,100
07104,nj,-74.16831,40.76732,6990,7,15,8,114.3
07105,nj,-74.13886,40.7229,7313,7,15,8,114.3
07106,nj,-74.23038,40.7418,6213,8,16,8,100
07107,nj,-74.18652,40.76188,5824,8,16,8,100
07108,nj,-74.2002,40.72311,4144,8,17,9,112.5
07109,nj,-74.16168,40.79498,9855,8,16,8,100
07110,nj,-74.15715,40.81927,9173,8,16,8,100
07111,nj,-74.23175,40.72426,9979,9,17,8,88.9
07112,nj,-74.20955,40.70941,5106,8,17,9,112.5
07114,nj,-74.16403,40.69996,2690,8,16,8,100
07201,nj,-74.17655,40.67204,4551,8,16,8,100
07202,nj,-74.21639,40.65285,5732,8,16,8,100
07203,nj,-74.25994,40.6527,5929,9,17,8,88.9
07204,nj,-74.26657,40.66531,3707,9,18,9,100
07205,nj,-74.22856,40.69618,6420,9,17,8,88.9
07206,nj,-74.18369,40.6516,4346,7,15,8,114.3
07208,nj,-74.22512,40.67431,4755,9,17,8,88.9
07302,nj,-74.04688,40.71982,11306,6,13,7,116.7
07304,nj,-74.07366,40.7165,8341,6,13,7,116.7
07305,nj,-74.08029,40.69843,13911,6,13,7,116.7
07306,nj,-74.07179,40.73457,10354,6,13,7,116.7
07307,nj,-74.05633,40.75173,8843,5,12,7,140
07310,nj,-74.03774,40.7306,1377,6,13,7,116.7
07311,nj,-74.03261,40.71908,16,6,13,7,116.7
07401,nj,-74.13329,41.03318,2506,6,13,7,116.7
07403,nj,-74.33187,41.02125,2745,5,11,6,120
07405,nj,-74.38308,40.98646,6322,4,9,5,125
07407,nj,-74.12005,40.90494,5407,8,16,8,100
07410,nj,-74.1177,40.93583,15789,8,16,8,100
07416,nj,-74.59775,41.11592,2374,3,8,5,166.7
07417,nj,-74.20834,41.00859,4225,4,10,6,150
07418,nj,-74.48744,41.23865,953,4,9,5,125
07419,nj,-74.56815,41.15325,4856,3,8,5,166.7
07420,nj,-74.30122,41.03264,2053,4,11,7,175
07421,nj,-74.36329,41.1657,4016,3,7,4,133.3
07422,nj,-74.44899,41.18176,3724,2,5,3,150
07423,nj,-74.09718,41.00006,1632,7,15,8,114.3
07424,nj,-74.2059,40.88371,9858,7,14,7,100
07430,nj,-74.18566,41.08163,11755,5,11,6,120
07432,nj,-74.14103,40.99518,2482,7,14,7,100
07435,nj,-74.45002,41.036,1301,3,7,4,133.3
07436,nj,-74.24079,41.03136,5034,4,10,6,150
07438,nj,-74.51968,41.03025,4650,2,6,4,200
07439,nj,-74.59772,41.07614,1091,2,6,4,200
07440,nj,-74.29418,40.94669,1758,6,13,7,116.7
07442,nj,-74.28581,41.00252,3451,5,12,7,140
07444,nj,-74.30727,40.96785,3510,6,13,7,116.7
07446,nj,-74.14546,41.05945,5667,5,12,7,140
07450,nj,-74.11264,40.98216,8176,7,15,8,114.3
07452,nj,-74.12492,40.96006,4166,8,16,8,100
07456,nj,-74.27487,41.10653,4867,4,9,5,125
07457,nj,-74.31245,40.9921,1111,5,12,7,140
07458,nj,-74.09708,41.04587,4312,5,12,7,140
07460,nj,-74.49503,41.11217,1721,2,6,4,200
07461,nj,-74.60641,41.24102,9721,5,10,5,100
07462,nj,-74.48849,41.19901,4334,2,6,4,200
07463,nj,-74.12585,41.01332,3721,7,15,8,114.3
07465,nj,-74.29777,41.05103,1975,4,10,6,150
07470,nj,-74.24524,40.94803,18557,6,13,7,116.7
07480,nj,-74.37739,41.0875,7081,3,7,4,133.3
07481,nj,-74.16759,40.99896,5923,6,13,7,116.7
07495,nj,-74.16336,41.10447,1,5,11,6,120
07501,nj,-74.17121,40.91266,5320,8,15,7,87.5
07502,nj,-74.19415,40.91858,3060,7,14,7,100
07503,nj,-74.15338,40.89767,3579,8,16,8,100
07504,nj,-74.14129,40.91219,2227,8,16,8,100
07505,nj,-74.17164,40.91633,549,8,16,8,100
07506,nj,-74.15816,40.95797,6184,8,16,8,100
07508,nj,-74.18443,40.95444,6849,7,15,8,114.3
07512,nj,-74.2212,40.90391,3880,7,14,7,100
07513,nj,-74.14859,40.90573,1738,8,16,8,100
07514,nj,-74.14448,40.92615,2746,8,16,8,100
07522,nj,-74.1785,40.92504,3320,7,15,8,114.3
07524,nj,-74.15683,40.93221,2134,8,16,8,100
07601,nj,-74.04611,40.88899,12977,7,15,8,114.3
07603,nj,-74.02933,40.87505,2290,7,15,8,114.3
07604,nj,-74.07409,40.86182,3850,7,15,8,114.3
07605,nj,-73.98982,40.8638,2721,6,13,7,116.7
07606,nj,-74.04669,40.85743,841,7,15,8,114.3
07607,nj,-74.06328,40.9026,3044,8,16,8,100
07608,nj,-74.06121,40.85367,107,7,15,8,114.3
07620,nj,-73.91984,40.96168,805,7,15,8,114.3
07621,nj,-73.99856,40.92384,7517,7,14,7,100
07624,nj,-73.96056,40.9733,3354,7,14,7,100
07626,nj,-73.95954,40.9405,5269,6,14,8,133.3
07627,nj,-73.9568,40.95504,1973,7,14,7,100
07628,nj,-73.99232,40.94515,5309,7,15,8,114.3
07630,nj,-74.02389,40.97486,2607,8,16,8,100
07631,nj,-73.97357,40.89174,7900,6,14,8,133.3
07632,nj,-73.94675,40.88225,2191,6,14,8,133.3
07640,nj,-73.98026,40.98989,1738,7,15,8,114.3
07641,nj,-73.99756,40.9622,1335,7,15,8,114.3
07642,nj,-74.0439,41.00732,3672,7,15,8,114.3
07643,nj,-74.03878,40.84636,2649,6,14,8,133.3
07644,nj,-74.08136,40.87845,5234,7,15,8,114.3
07645,nj,-74.04985,41.05293,3100,6,13,7,116.7
07646,nj,-74.01956,40.93368,4476,7,15,8,114.3
07647,nj,-73.94254,41.00677,1882,7,15,8,114.3
07648,nj,-73.95098,40.99333,2281,7,15,8,114.3
07649,nj,-74.03146,40.95621,2841,8,16,8,100
07650,nj,-73.99678,40.84714,4894,6,13,7,116.7
07652,nj,-74.07118,40.94554,9003,8,15,7,87.5
07656,nj,-74.04231,41.03528,3223,6,13,7,116.7
07657,nj,-74.01471,40.83139,3118,6,13,7,116.7
07660,nj,-74.02014,40.85442,3454,7,14,7,100
07661,nj,-74.03873,40.9269,3526,7,15,8,114.3
07662,nj,-74.0794,40.9072,3113,8,16,8,100
07663,nj,-74.09554,40.90319,4569,8,16,8,100
07666,nj,-74.01066,40.88994,12247,7,14,7,100
07670,nj,-73.95372,40.91749,5023,6,14,8,133.3
07675,nj,-74.00419,41.0092,9465,7,15,8,114.3
07676,nj,-74.06354,40.98844,3595,7,15,8,114.3
07677,nj,-74.06023,41.02519,2132,6,14,8,133.3
07701,nj,-74.07746,40.36144,10040,2,6,4,200
07702,nj,-74.06001,40.32489,1541,2,5,3,150
07703,nj,-74.04239,40.31449,12,1,5,4,400
07704,nj,-74.03928,40.36177,2254,2,5,3,150
07711,nj,-74.00836,40.23924,878,2,6,4,200
07712,nj,-74.05429,40.24789,12627,2,6,4,200
07716,nj,-74.03102,40.4015,3498,2,6,4,200
07717,nj,-74.01506,40.19135,968,2,6,4,200
07718,nj,-74.0851,40.42058,2494,2,6,4,200
07719,nj,-74.07206,40.16884,9554,2,6,4,200
07720,nj,-74.0126,40.20174,2216,2,6,4,200
07721,nj,-74.23553,40.43575,1343,5,11,6,120
07722,nj,-74.16952,40.28487,3929,5,11,6,120
07723,nj,-74.00013,40.25029,1256,2,6,4,200
07724,nj,-74.07482,40.29842,8587,2,6,4,200
07726,nj,-74.34243,40.28251,16951,8,16,8,100
07727,nj,-74.16002,40.19829,3629,6,13,7,116.7
07728,nj,-74.28536,40.22546,20460,8,16,8,100
07730,nj,-74.17569,40.42481,5785,4,9,5,125
07731,nj,-74.20007,40.14975,18989,8,15,7,87.5
07732,nj,-73.99004,40.43045,2712,1,5,4,400
07733,nj,-74.17257,40.37667,6198,5,11,6,120
07734,nj,-74.13705,40.44448,4646,2,7,5,250
07735,nj,-74.19946,40.4412,7511,4,9,5,125
07737,nj,-74.06475,40.41007,1715,2,6,4,200
07738,nj,-74.12748,40.33773,2037,3,8,5,166.7
07739,nj,-74.03457,40.33569,2615,2,5,3,150
07740,nj,-73.99016,40.29568,9033,1,4,3,300
07746,nj,-74.24982,40.31809,6779,6,13,7,116.7
07747,nj,-74.25177,40.41322,11091,5,11,6,120
07748,nj,-74.11566,40.39436,9639,3,7,4,133.3
07750,nj,-73.98582,40.3363,1686,1,4,3,300
07751,nj,-74.25905,40.36262,6970,6,14,8,133.3
07753,nj,-74.07856,40.21494,14553,2,6,4,200
07755,nj,-74.02283,40.26367,2765,2,6,4,200
07756,nj,-74.0072,40.212,2191,2,6,4,200
07757,nj,-74.01608,40.31622,2223,1,4,3,300
07758,nj,-74.10371,40.43088,2109,2,6,4,200
07760,nj,-74.00423,40.36886,4375,1,5,4,400
07762,nj,-74.03456,40.15267,4494,2,6,4,200
07764,nj,-74.01852,40.28831,2683,1,4,3,300
07801,nj,-74.55417,40.91887,6305,3,7,4,133.3
07803,nj,-74.60045,40.87765,1528,2,6,4,200
07820,nj,-74.81139,40.92707,28,2,5,3,150
07821,nj,-74.74991,40.96468,5025,3,6,3,100
07822,nj,-74.70542,41.14014,485,5,10,5,100
07823,nj,-75.03653,40.82796,3641,4,9,5,125
07825,nj,-74.96001,40.97752,4801,4,9,5,125
07826,nj,-74.76868,41.19264,3977,4,8,4,100
07827,nj,-74.73939,41.29227,3466,2,6,4,200
07828,nj,-74.75144,40.885,4136,1,4,3,300
07830,nj,-74.80744,40.72102,2940,4,9,5,125
07832,nj,-75.05709,40.96058,2109,4,9,5,125
07833,nj,-75.06772,40.89182,97,5,11,6,120
07834,nj,-74.4865,40.88846,7592,4,10,6,150
07836,nj,-74.70328,40.84527,3939,2,6,4,200
07838,nj,-74.91439,40.88923,1833,3,7,4,133.3
07840,nj,-74.83573,40.85409,10634,2,5,3,150
07842,nj,-74.51015,40.94116,80,3,8,5,166.7
07843,nj,-74.65979,40.93957,6032,2,6,4,200
07846,nj,-74.87707,40.96594,46,4,9,5,125
07847,nj,-74.62578,40.88468,751,2,6,4,200
07848,nj,-74.68408,41.10341,2055,4,9,5,125
07849,nj,-74.60999,40.9662,4350,2,6,4,200
07850,nj,-74.66399,40.90606,2584,2,6,4,200
07851,nj,-74.84678,41.22985,437,4,8,4,100
07852,nj,-74.66268,40.88223,1433,3,7,4,133.3
07853,nj,-74.78548,40.78499,5139,2,6,4,200
07856,nj,-74.63347,40.91864,1979,3,7,4,133.3
07857,nj,-74.69985,40.89715,1034,2,5,3,150
07860,nj,-74.8134,41.06023,12389,4,8,4,100
07863,nj,-74.96041,40.8129,2153,4,8,4,100
07865,nj,-74.89873,40.78471,1914,3,7,4,133.3
07866,nj,-74.49018,40.95379,9022,4,9,5,125
07869,nj,-74.58098,40.84492,8147,3,7,4,133.3
07870,nj,-74.81965,40.80398,11,2,6,4,200
07871,nj,-74.62793,41.0471,9707,2,6,4,200
07874,nj,-74.73629,40.92157,4344,2,5,3,150
07876,nj,-74.65575,40.8533,3851,2,6,4,200
07878,nj,-74.47629,40.87171,489,4,10,6,150
07880,nj,-74.88957,40.87298,60,3,6,3,100
07881,nj,-74.91085,41.1251,337,3,6,3,100
07882,nj,-75.01118,40.75174,6480,5,10,5,100
07885,nj,-74.57841,40.93515,4014,3,7,4,133.3
07901,nj,-74.36586,40.7147,7359,9,18,9,100
07920,nj,-74.56297,40.6784,10417,8,16,8,100
07921,nj,-74.67753,40.65694,4450,7,15,8,114.3
07922,nj,-74.4282,40.67519,4533,9,18,9,100
07924,nj,-74.58964,40.72703,3024,6,13,7,116.7
07926,nj,-74.5703,40.80125,38,4,10,6,150
07927,nj,-74.45338,40.8213,1134,7,14,7,100
07928,nj,-74.41252,40.72619,6949,9,17,8,88.9
07930,nj,-74.68677,40.77993,3372,3,8,5,166.7
07931,nj,-74.65266,40.70947,1400,6,13,7,116.7
07932,nj,-74.39289,40.77709,3463,9,17,8,88.9
07933,nj,-74.46494,40.69198,1456,9,17,8,88.9
07934,nj,-74.67817,40.72065,621,7,15,8,114.3
07935,nj,-74.44406,40.73657,221,9,17,8,88.9
07936,nj,-74.36375,40.81922,4674,8,16,8,100
07939,nj,-74.55391,40.66738,5,9,17,8,88.9
07940,nj,-74.41794,40.75983,4746,9,17,8,88.9
07945,nj,-74.59796,40.78135,3649,4,9,5,125
07946,nj,-74.51112,40.67754,1183,9,17,8,88.9
07950,nj,-74.48236,40.84452,7049,6,13,7,116.7
07960,nj,-74.49957,40.78339,13928,7,14,7,100
07970,nj,-74.57293,40.80808,38,4,10,6,150
07974,nj,-74.40306,40.69732,4084,9,17,8,88.9
07976,nj,-74.48648,40.72288,397,8,17,9,112.5
07977,nj,-74.66372,40.70641,258,8,15,7,87.5
07979,nj,-74.72756,40.70261,222,7,15,8,114.3
07980,nj,-74.49386,40.67866,965,9,17,8,88.9
07981,nj,-74.41909,40.82209,3521,7,15,8,114.3
08001,nj,-75.34981,39.55074,399,11,22,11,100
08002,nj,-75.02539,39.93134,8549,15,26,11,73.3
08003,nj,-74.97225,39.88324,11693,14,25,11,78.6
08004,nj,-74.87001,39.76464,5586,15,26,11,73.3
08005,nj,-74.31526,39.76364,19501,7,14,7,100
08006,nj,-74.10666,39.75275,1335,2,5,3,150
08007,nj,-75.05375,39.86579,1960,14,25,11,78.6
08008,nj,-74.2186,39.62177,20061,2,6,4,200
08009,nj,-74.93264,39.76518,5917,14,25,11,78.6
08010,nj,-74.91424,40.05331,3879,15,26,11,73.3
08011,nj,-74.71293,39.97277,24,14,25,11,78.6
08012,nj,-75.05531,39.78425,14129,13,24,11,84.6
08014,nj,-75.35812,39.81778,345,15,26,11,73.3
08015,nj,-74.53756,39.93296,36216,13,22,9,69.2
08016,nj,-74.82989,40.06936,14828,14,25,11,78.6
08019,nj,-74.53087,39.77671,20367,13,24,11,84.6
08020,nj,-75.22408,39.79741,1099,13,24,11,84.6
08021,nj,-75.0006,39.80669,15772,13,24,11,84.6
08022,nj,-74.70867,40.06607,3356,13,23,10,76.9
08023,nj,-75.49757,39.6874,301,13,24,11,84.6
08026,nj,-74.96571,39.83321,1398,14,24,10,71.4
08027,nj,-75.28745,39.82997,2591,14,25,11,78.6
08028,nj,-75.12052,39.6944,10131,12,23,11,91.7
08029,nj,-75.06769,39.84069,2054,14,25,11,78.6
08030,nj,-75.11774,39.88977,5705,14,25,11,78.6
08031,nj,-75.09452,39.86665,3842,14,25,11,78.6
08033,nj,-75.03698,39.89319,6137,14,25,11,78.6
08034,nj,-74.9993,39.90605,7315,15,26,11,73.3
08035,nj,-75.06446,39.87909,3125,14,25,11,78.6
08036,nj,-74.8373,39.97627,3062,16,27,11,68.8
08037,nj,-74.77278,39.63801,13936,14,25,11,78.6
08038,nj,-75.49025,39.4716,162,10,20,10,100
08039,nj,-75.27216,39.68799,81,15,27,12,80
08041,nj,-74.68387,40.03789,448,13,23,10,76.9
08042,nj,-74.66229,40.01539,85,14,24,10,71.4
08043,nj,-74.95484,39.84503,9891,14,25,11,78.6
08045,nj,-75.02977,39.8672,1375,14,25,11,78.6
08046,nj,-74.88608,40.02773,11554,15,26,11,73.3
08048,nj,-74.80402,39.95732,4615,16,27,11,68.8
08049,nj,-75.03847,39.85441,2396,14,25,11,78.6
08050,nj,-74.24832,39.70639,14267,5,12,7,140
08051,nj,-75.17883,39.78539,4356,13,23,10,76.9
08052,nj,-74.99502,39.95198,5534,17,28,11,64.7
08053,nj,-74.89466,39.8605,18404,15,26,11,73.3
08054,nj,-74.90473,39.94836,18270,16,27,11,68.8
08055,nj,-74.82251,39.86376,14946,16,27,11,68.8
08056,nj,-75.25157,39.78291,1943,13,24,11,84.6
08057,nj,-74.94116,39.97938,8600,16,28,12,75
08059,nj,-75.09296,39.88442,2930,14,25,11,78.6
08060,nj,-74.78951,40.00857,10204,15,26,11,73.3
08061,nj,-75.20709,39.80458,1100,13,23,10,76.9
08062,nj,-75.22259,39.71519,5990,13,23,10,76.9
08063,nj,-75.18517,39.8676,2539,14,25,11,78.6
08064,nj,-74.63361,39.95753,107,13,24,11,84.6
08065,nj,-75.03581,40.00235,3437,15,26,11,73.3
08066,nj,-75.22495,39.83451,3365,13,24,11,84.6
08067,nj,-75.41264,39.73824,1253,15,27,12,80
08068,nj,-74.66295,39.95943,2973,14,24,10,71.4
08069,nj,-75.44949,39.69942,5296,14,26,12,85.7
08070,nj,-75.50901,39.62416,6357,11,22,11,100
08071,nj,-75.13389,39.73231,3700,12,22,10,83.3
08072,nj,-75.41663,39.54423,100,11,22,11,100
08073,nj,-74.86682,40.00955,97,16,27,11,68.8
08074,nj,-75.16403,39.71564,33,12,22,10,83.3
08075,nj,-74.94993,40.02932,10279,15,26,11,73.3
08077,nj,-74.99528,40.00189,6973,16,27,11,68.8
08078,nj,-75.07446,39.85208,3096,14,25,11,78.6
08079,nj,-75.43036,39.54198,6433,11,22,11,100
08080,nj,-75.11891,39.75583,14696,12,23,11,91.7
08081,nj,-74.97551,39.73666,18328,13,24,11,84.6
08083,nj,-75.02863,39.84126,3783,14,25,11,78.6
08084,nj,-75.01553,39.82898,2361,14,25,11,78.6
08085,nj,-75.33191,39.75937,8104,14,25,11,78.6
08086,nj,-75.19421,39.84568,3899,13,24,11,84.6
08087,nj,-74.37526,39.59259,15903,6,12,6,100
08088,nj,-74.69269,39.84923,19868,14,25,11,78.6
08089,nj,-74.82435,39.71827,2653,15,27,12,80
08090,nj,-75.15064,39.79753,3411,13,24,11,84.6
08091,nj,-74.92546,39.80534,2639,14,25,11,78.6
08092,nj,-74.28434,39.65483,2934,6,12,6,100
08093,nj,-75.13578,39.86413,3891,14,25,11,78.6
08094,nj,-74.96719,39.6535,16758,14,25,11,78.6
08095,nj,-74.8603,39.64845,152,15,27,12,80
08096,nj,-75.12678,39.82663,15797,13,24,11,84.6
08097,nj,-75.15087,39.81522,1581,13,24,11,84.6
08098,nj,-75.32937,39.63889,4200,15,27,12,80
08102,nj,-75.12044,39.95239,2892,15,27,12,80
08103,nj,-75.11364,39.93578,7356,15,26,11,73.3
08104,nj,-75.11243,39.91637,8685,15,26,11,73.3
08105,nj,-75.09125,39.95158,8887,15,26,11,73.3
08106,nj,-75.07401,39.89125,3378,14,25,11,78.6
08107,nj,-75.08339,39.90764,4603,14,25,11,78.6
08108,nj,-75.06176,39.91428,6902,15,26,11,73.3
08109,nj,-75.05057,39.95032,8091,15,27,12,80
08110,nj,-75.06073,39.97225,6857,15,26,11,73.3
08201,nj,-74.49506,39.42232,3931,4,10,6,150
08202,nj,-74.73546,39.09872,12883,2,7,5,250
08203,nj,-74.37658,39.41066,9144,2,5,3,150
08204,nj,-74.9214,38.97108,18186,3,8,5,166.7
08205,nj,-74.45745,39.47458,13688,6,13,7,116.7
08210,nj,-74.82588,39.11715,11925,3,9,6,200
08212,nj,-74.95681,38.93391,1836,3,9,6,200
08215,nj,-74.58153,39.58254,13822,11,20,9,81.8
08217,nj,-74.71847,39.57534,32,12,22,10,83.3
08221,nj,-74.57072,39.34337,2789,5,11,6,120
08223,nj,-74.65705,39.27017,5986,4,10,6,150
08224,nj,-74.45977,39.59857,443,9,19,10,111.1
08225,nj,-74.5408,39.36394,4323,5,11,6,120
08226,nj,-74.60096,39.26687,21293,3,8,5,166.7
08230,nj,-74.71742,39.21268,4000,5,11,6,120
08232,nj,-74.51488,39.38767,5991,5,10,5,100
08234,nj,-74.62377,39.38659,20535,7,15,8,114.3
08240,nj,-74.53175,39.4873,8,9,18,9,100
08241,nj,-74.48504,39.53291,899,8,16,8,100
08242,nj,-74.8888,39.01805,1738,2,7,5,250
08243,nj,-74.69558,39.15053,13734,3,8,5,166.7
08244,nj,-74.58802,39.31817,4592,5,11,6,120
08246,nj,-74.76581,39.18096,156,5,13,8,160
08247,nj,-74.78103,39.04924,6732,2,7,5,250
08248,nj,-74.65699,39.19543,1435,3,8,5,166.7
08251,nj,-74.92996,39.02797,12742,3,8,5,166.7
08260,nj,-74.83793,38.99498,23091,2,7,5,250
08270,nj,-74.79666,39.2716,15846,7,16,9,128.6
08302,nj,-75.26088,39.43949,18442,10,21,11,110
08310,nj,-74.89545,39.52712,2416,14,25,11,78.6
08311,nj,-75.21026,39.32745,2404,10,21,11,110
08312,nj,-75.08026,39.6613,3143,13,24,11,84.6
08314,nj,-74.94236,39.21734,754,7,15,8,114.3
08316,nj,-74.96124,39.27318,489,8,18,10,125
08317,nj,-74.82828,39.4041,943,11,22,11,100
08318,nj,-75.17638,39.5563,6012,14,25,11,78.6
08319,nj,-74.81688,39.36866,1112,10,20,10,100
08320,nj,-75.1606,39.38508,1,9,19,10,111.1
08321,nj,-75.14036,39.21888,599,9,20,11,122.2
08322,nj,-75.03517,39.61418,4784,14,25,11,78.6
08323,nj,-75.36608,39.3955,630,10,21,11,110
08324,nj,-74.99662,39.21676,781,7,16,9,128.6
08326,nj,-74.92827,39.53768,1000,14,25,11,78.6
08327,nj,-74.98493,39.24785,690,8,17,9,112.5
08328,nj,-75.05921,39.57843,873,15,26,11,73.3
08329,nj,-75.00192,39.27731,162,11,22,11,100
08330,nj,-74.74148,39.4761,33035,11,22,11,100
08332,nj,-75.02426,39.37703,22725,11,21,10,90.9
08340,nj,-74.87302,39.43609,2540,12,22,10,83.3
08341,nj,-74.95259,39.52549,767,13,24,11,84.6
08343,nj,-75.17052,39.64133,2571,14,25,11,78.6
08344,nj,-74.98482,39.56751,6656,14,26,12,85.7
08345,nj,-75.16528,39.28099,998,10,21,11,110
08346,nj,-74.85609,39.56302,1149,14,26,12,85.7
08348,nj,-74.97528,39.30748,220,11,22,11,100
08349,nj,-75.07128,39.27281,2030,10,20,10,100
08350,nj,-74.87832,39.49173,583,12,23,11,91.7
08352,nj,-75.12798,39.47573,210,11,21,10,90.9
08353,nj,-75.29696,39.45955,249,9,19,10,111.1
08360,nj,-75.00642,39.49428,14221,13,24,11,84.6
08361,nj,-74.95956,39.4489,6968,12,23,11,91.7
08401,nj,-74.45153,39.37808,12210,2,5,3,150
08402,nj,-74.50447,39.32682,6660,2,6,4,200
08403,nj,-74.53558,39.31936,1435,4,9,5,125
08406,nj,-74.48086,39.34196,4934,2,5,3,150
08501,nj,-74.55445,40.15563,2776,10,19,9,90
08502,nj,-74.6556,40.44826,3793,9,18,9,100
08505,nj,-74.73937,40.10462,6204,12,22,10,83.3
08510,nj,-74.42144,40.1905,2170,9,17,8,88.9
08511,nj,-74.55393,40.04304,371,12,21,9,75
08512,nj,-74.5266,40.32026,3306,9,17,8,88.9
08514,nj,-74.4964,40.13303,2093,10,18,8,80
08515,nj,-74.64588,40.11628,2009,11,21,10,90.9
08518,nj,-74.80269,40.11531,1350,12,22,10,83.3
08520,nj,-74.53161,40.25528,9526,9,17,8,88.9
08525,nj,-74.78328,40.39623,2365,8,16,8,100
08527,nj,-74.34995,40.10477,21948,10,18,8,80
08528,nj,-74.6187,40.3865,156,9,17,8,88.9
08530,nj,-74.89665,40.37145,3742,9,17,8,88.9
08533,nj,-74.49363,40.07114,2939,10,19,9,90
08534,nj,-74.79292,40.33009,5443,9,17,8,88.9
08535,nj,-74.43933,40.23565,2150,8,16,8,100
08536,nj,-74.58231,40.33429,4695,9,18,9,100
08540,nj,-74.65564,40.36331,16531,9,17,8,88.9
08542,nj,-74.66034,40.35295,1369,9,18,9,100
08550,nj,-74.61756,40.28105,6667,9,18,9,100
08551,nj,-74.8401,40.44174,2359,8,16,8,100
08553,nj,-74.64055,40.40014,330,8,17,9,112.5
08554,nj,-74.77807,40.11652,1250,12,22,10,83.3
08555,nj,-74.47186,40.21993,364,8,16,8,100
08558,nj,-74.70392,40.41355,2937,9,17,8,88.9
08559,nj,-74.97096,40.4375,2681,9,17,8,88.9
08560,nj,-74.8593,40.31348,1757,9,17,8,88.9
08561,nj,-74.5808,40.24946,163,9,17,8,88.9
08562,nj,-74.59485,40.06654,1579,11,21,10,90.9
08608,nj,-74.7677,40.2189,541,11,21,10,90.9
08609,nj,-74.74086,40.22588,4561,11,20,9,81.8
08610,nj,-74.7158,40.19243,12133,11,20,9,81.8
08611,nj,-74.74462,40.19315,9204,11,20,9,81.8
08618,nj,-74.78766,40.24824,13947,11,20,9,81.8
08619,nj,-74.69606,40.24119,9646,10,19,9,90
08620,nj,-74.64872,40.16698,4233,11,21,10,90.9
08628,nj,-74.82335,40.26624,3376,10,19,9,90
08629,nj,-74.7312,40.22067,4431,11,20,9,81.8
08638,nj,-74.76303,40.25676,12246,10,19,9,90
08640,nj,-74.5893,40.00349,34,13,23,10,76.9
08641,nj,-74.58806,40.02698,6,12,22,10,83.3
08648,nj,-74.72186,40.2849,12780,10,19,9,90
08690,nj,-74.66033,40.22499,7538,10,19,9,90
08691,nj,-74.59376,40.20979,6847,10,18,8,80
08701,nj,-74.20321,40.07643,28237,10,18,8,80
08720,nj,-74.10105,40.13874,340,3,8,5,166.7
08721,nj,-74.1552,39.90418,33770,5,11,6,120
08722,nj,-74.20229,39.92848,4331,8,16,8,100
08723,nj,-74.11091,40.03886,24952,5,10,5,100
08724,nj,-74.11452,40.08984,27892,4,10,6,150
08730,nj,-74.06369,40.10485,2275,3,7,4,133.3
08731,nj,-74.26971,39.86218,39992,6,13,7,116.7
08732,nj,-74.14486,39.94173,932,5,11,6,120
08733,nj,-74.3254,40.02631,883,11,21,10,90.9
08734,nj,-74.17054,39.86403,8908,5,11,6,120
08735,nj,-74.07019,39.98199,7682,2,6,4,200
08736,nj,-74.06122,40.11768,6659,3,7,4,133.3
08738,nj,-74.05814,40.02371,3131,2,5,3,150
08740,nj,-74.13377,39.92822,1204,3,8,5,166.7
08741,nj,-74.1682,39.93703,3402,6,13,7,116.7
08742,nj,-74.0595,40.08057,13629,3,7,4,133.3
08750,nj,-74.04146,40.1329,2167,2,6,4,200
08751,nj,-74.08156,39.94654,6387,2,6,4,200
08752,nj,-74.09367,39.84712,3758,2,6,4,200
08753,nj,-74.15558,39.97938,33724,5,11,6,120
08755,nj,-74.22457,40.00963,11550,10,19,9,90
08757,nj,-74.25618,39.94573,35871,10,19,9,90
08758,nj,-74.23007,39.78929,8975,5,11,6,120
08759,nj,-74.35624,39.97836,24034,11,21,10,90.9
08801,nj,-74.88658,40.62392,3128,7,15,8,114.3
08802,nj,-75.02429,40.67648,1928,6,12,6,100
08804,nj,-75.0953,40.64551,1382,6,13,7,116.7
08805,nj,-74.537,40.57165,3545,10,19,9,90
08807,nj,-74.62029,40.59275,14065,9,18,9,100
08808,nj,-75.04903,40.73213,28,6,12,6,100
08809,nj,-74.92233,40.65126,2356,8,16,8,100
08810,nj,-74.49382,40.37271,3014,9,17,8,88.9
08812,nj,-74.48066,40.59977,4987,11,20,9,81.8
08816,nj,-74.41621,40.42854,18814,9,17,8,88.9
08817,nj,-74.39444,40.51551,15584,9,18,9,100
08820,nj,-74.3659,40.57725,14379,10,19,9,90
08821,nj,-74.68566,40.52004,232,9,17,8,88.9
08822,nj,-74.86362,40.52111,11842,10,19,9,90
08823,nj,-74.56502,40.44152,3391,9,18,9,100
08824,nj,-74.55167,40.42251,4503,9,17,8,88.9
08825,nj,-75.02493,40.51301,2131,7,13,6,85.7
08826,nj,-74.90501,40.71953,2403,4,10,6,150
08827,nj,-74.97391,40.6648,2054,6,12,6,100
08828,nj,-74.42379,40.37765,1015,9,18,9,100
08829,nj,-74.8942,40.66803,1607,7,14,7,100
08830,nj,-74.31703,40.56967,5499,9,18,9,100
08831,nj,-74.42966,40.32664,35667,9,17,8,88.9
08832,nj,-74.30769,40.51722,396,6,14,8,133.3
08833,nj,-74.82049,40.64499,3778,8,15,7,87.5
08835,nj,-74.58921,40.54205,11492,10,19,9,90
08836,nj,-74.55467,40.59605,1576,10,19,9,90
08837,nj,-74.3446,40.51363,6053,9,17,8,88.9
08840,nj,-74.35841,40.54363,8368,9,18,9,100
08844,nj,-74.67287,40.4985,15023,9,18,9,100
08846,nj,-74.50107,40.57445,4999,11,20,9,81.8
08848,nj,-75.09574,40.59454,3744,7,14,7,100
08850,nj,-74.44016,40.44725,3859,9,18,9,100
08852,nj,-74.54816,40.38791,5643,9,17,8,88.9
08853,nj,-74.7401,40.52931,1788,9,18,9,100
08854,nj,-74.4636,40.54674,14995,10,19,9,90
08857,nj,-74.32982,40.39163,12790,8,16,8,100
08858,nj,-74.73708,40.67939,92,9,18,9,100
08859,nj,-74.3042,40.4595,6931,7,15,8,114.3
08861,nj,-74.27239,40.5204,14888,6,14,8,133.3
08863,nj,-74.31559,40.52711,3837,8,17,9,112.5
08865,nj,-75.15077,40.7078,12858,7,15,8,114.3
08867,nj,-74.96579,40.57361,2147,6,12,6,100
08869,nj,-74.64317,40.57305,2247,10,19,9,90
08872,nj,-74.33718,40.46431,7320,8,16,8,100
08873,nj,-74.53286,40.49836,22762,9,18,9,100
08876,nj,-74.68745,40.58798,7622,10,18,8,80
08879,nj,-74.27738,40.46554,10173,6,13,7,116.7
08880,nj,-74.52773,40.55357,1505,10,19,9,90
08882,nj,-74.37835,40.44551,5416,8,16,8,100
08884,nj,-74.39144,40.39514,3121,9,17,8,88.9
08886,nj,-75.10521,40.69316,2817,7,14,7,100
08887,nj,-74.79448,40.52361,623,10,20,10,100
08889,nj,-74.75957,40.60761,4237,9,18,9,100
08890,nj,-74.57393,40.53937,2,10,19,9,90
08901,nj,-74.44272,40.48411,7848,9,18,9,100
08902,nj,-74.48629,40.44071,12295,9,18,9,100
08904,nj,-74.4283,40.50057,4997,9,18,9,100
10001,ny,-73.99718,40.75064,975,6,13,7,116.7
10002,ny,-73.98621,40.71578,1689,6,13,7,116.7
10003,ny,-73.98918,40.73183,1877,6,13,7,116.7
10004,ny,-74.01599,40.69409,112,6,13,7,116.7
10005,ny,-74.00879,40.706,68,6,13,7,116.7
10006,ny,-74.01297,40.70963,66,6,13,7,116.7
10007,ny,-74.00778,40.71386,207,6,13,7,116.7
10009,ny,-73.97863,40.7264,1327,6,13,7,116.7
10010,ny,-73.98246,40.7391,591,6,13,7,116.7
10011,ny,-74.00061,40.74201,2050,6,13,7,116.7
10012,ny,-73.99808,40.72558,1212,6,13,7,116.7
10013,ny,-74.0049,40.7201,1576,6,13,7,116.7
10014,ny,-74.00696,40.73361,1936,6,13,7,116.7
10016,ny,-73.97829,40.74522,1382,6,13,7,116.7
10017,ny,-73.97249,40.75236,484,6,13,7,116.7
10018,ny,-73.99326,40.7554,605,6,13,7,116.7
10019,ny,-73.98734,40.76583,1094,6,13,7,116.7
10020,ny,-73.98004,40.75921,9,6,13,7,116.7
10021,ny,-73.95874,40.76922,1153,6,13,7,116.7
10022,ny,-73.96795,40.75863,984,6,13,7,116.7
10023,ny,-73.9826,40.77592,1228,6,14,8,133.3
10024,ny,-73.97486,40.79219,1754,6,14,8,133.3
10025,ny,-73.96662,40.7986,1584,6,14,8,133.3
10026,ny,-73.95268,40.80238,1026,6,14,8,133.3
10027,ny,-73.9532,40.8118,2210,6,14,8,133.3
10028,ny,-73.95351,40.77644,1184,6,14,8,133.3
10029,ny,-73.94397,40.79176,1522,6,14,8,133.3
10030,ny,-73.94286,40.81827,1174,6,14,8,133.3
10031,ny,-73.95005,40.82529,1614,6,14,8,133.3
10032,ny,-73.94283,40.83879,1007,6,14,8,133.3
10033,ny,-73.93405,40.85048,770,6,14,8,133.3
10034,ny,-73.92407,40.8672,564,6,14,8,133.3
10035,ny,-73.92957,40.79546,1493,6,14,8,133.3
10036,ny,-73.98983,40.75925,987,6,13,7,116.7
10037,ny,-73.93738,40.81296,324,6,14,8,133.3
10038,ny,-74.00254,40.70934,338,6,13,7,116.7
10039,ny,-73.93622,40.83087,294,6,14,8,133.3
10040,ny,-73.93049,40.85831,460,6,14,8,133.3
10044,ny,-73.94997,40.76191,22,6,13,7,116.7
10065,ny,-73.96314,40.76463,1141,6,13,7,116.7
10069,ny,-73.99034,40.77596,42,6,14,8,133.3
10075,ny,-73.95622,40.77336,642,6,13,7,116.7
10103,ny,-73.97767,40.76078,6,6,13,7,116.7
10110,ny,-73.98226,40.7545,7,6,13,7,116.7
10112,ny,-73.97967,40.75917,3,6,13,7,116.7
10115,ny,-73.96374,40.81085,1,6,14,8,133.3
10119,ny,-73.99298,40.75031,3,6,13,7,116.7
10128,ny,-73.95001,40.78143,1315,6,14,8,133.3
10152,ny,-73.97203,40.7584,3,6,13,7,116.7
10153,ny,-73.97244,40.76362,1,6,13,7,116.7
10154,ny,-73.97249,40.75778,1,6,13,7,116.7
10162,ny,-73.94992,40.76931,4,6,13,7,116.7
10165,ny,-73.97872,40.75213,6,6,13,7,116.7
10167,ny,-73.97477,40.75465,1,6,13,7,116.7
10168,ny,-73.9771,40.75145,4,6,13,7,116.7
10169,ny,-73.9761,40.75439,2,6,13,7,116.7
10170,ny,-73.97588,40.75263,5,6,13,7,116.7
10171,ny,-73.97386,40.7559,2,6,13,7,116.7
10172,ny,-73.97431,40.75527,1,6,13,7,116.7
10173,ny,-73.97936,40.75413,8,6,13,7,116.7
10174,ny,-73.975,40.75144,4,6,13,7,116.7
10177,ny,-73.97593,40.75514,1,6,13,7,116.7
10199,ny,-73.99715,40.75138,2,6,13,7,116.7
10271,ny,-74.01054,40.70824,1,6,13,7,116.7
10278,ny,-74.00372,40.71514,4,6,13,7,116.7
10279,ny,-74.00867,40.71263,4,6,13,7,116.7
10280,ny,-74.01686,40.70918,25,6,13,7,116.7
10282,ny,-74.01528,40.71666,20,6,13,7,116.7
10301,ny,-74.09618,40.62836,7471,4,10,6,150
10302,ny,-74.13773,40.63072,4568,4,10,6,150
10303,ny,-74.169,40.63236,5537,6,13,7,116.7
10304,ny,-74.09424,40.60603,9438,4,10,6,150
10305,ny,-74.07539,40.59568,11035,4,10,6,150
10306,ny,-74.12546,40.57152,17153,4,10,6,150
10307,ny,-74.23921,40.50766,4220,4,10,6,150
10308,ny,-74.15041,40.55151,8412,5,12,7,140
10309,ny,-74.2206,40.53136,10394,5,12,7,140
10310,ny,-74.11615,40.63265,6205,4,10,6,150
10311,ny,-74.17953,40.60523,5,6,13,7,116.7
10312,ny,-74.18169,40.54509,19426,5,12,7,140
10314,ny,-74.16645,40.59932,20850,5,11,6,120
10451,ny,-73.92384,40.82072,1160,6,14,8,133.3
10452,ny,-73.92344,40.83739,1526,6,14,8,133.3
10453,ny,-73.91351,40.85232,2102,6,14,8,133.3
10454,ny,-73.91661,40.80551,1726,6,13,7,116.7
10455,ny,-73.90859,40.81471,1808,6,13,7,116.7
10456,ny,-73.90812,40.82989,2930,6,14,8,133.3
10457,ny,-73.89866,40.84716,3034,6,14,8,133.3
10458,ny,-73.88816,40.86253,2696,6,13,7,116.7
10459,ny,-73.89294,40.82586,2592,6,14,8,133.3
10460,ny,-73.87958,40.84177,2968,6,13,7,116.7
10461,ny,-73.84058,40.84739,7639,6,12,6,100
10462,ny,-73.85864,40.8428,4500,6,13,7,116.7
10463,ny,-73.90664,40.88083,2433,6,14,8,133.3
10464,ny,-73.80051,40.86803,1556,5,11,6,120
10465,ny,-73.8231,40.82387,8170,5,12,7,140
10466,ny,-73.84594,40.89095,9233,6,13,7,116.7
10467,ny,-73.87394,40.8809,4763,6,13,7,116.7
10468,ny,-73.90006,40.86806,1657,6,14,8,133.3
10469,ny,-73.84813,40.86861,11251,6,13,7,116.7
10470,ny,-73.86816,40.8959,2337,6,13,7,116.7
10471,ny,-73.90176,40.89944,2363,7,14,7,100
10472,ny,-73.86931,40.82956,4332,6,13,7,116.7
10473,ny,-73.85873,40.81817,4867,6,13,7,116.7
10474,ny,-73.88459,40.81058,1242,6,13,7,116.7
10475,ny,-73.8247,40.86873,818,6,13,7,116.7
10501,ny,-73.76074,41.29447,448,5,12,7,140
10502,ny,-73.84127,41.01167,2203,7,14,7,100
10503,ny,-73.87531,41.02656,1,7,15,8,114.3
10504,ny,-73.70595,41.13115,3131,4,10,6,150
10505,ny,-73.74544,41.34212,273,5,11,6,120
10506,ny,-73.63391,41.18876,2393,5,12,7,140
10507,ny,-73.68634,41.22841,1479,6,13,7,116.7
10509,ny,-73.59434,41.41182,7328,4,11,7,175
10510,ny,-73.83437,41.14096,3250,6,13,7,116.7
10511,ny,-73.94371,41.26298,855,8,17,9,112.5
10512,ny,-73.7121,41.44921,11124,4,10,6,150
10514,ny,-73.77085,41.17303,4084,5,12,7,140
10516,ny,-73.90237,41.45335,2606,6,14,8,133.3
10517,ny,-73.86199,41.29824,170,5,12,7,140
10518,ny,-73.59988,41.26773,538,6,13,7,116.7
10519,ny,-73.65566,41.35018,170,5,12,7,140
10520,ny,-73.87154,41.2205,4313,6,14,8,133.3
10522,ny,-73.86471,41.01224,2773,7,15,8,114.3
10523,ny,-73.81891,41.06005,2326,6,13,7,116.7
10524,ny,-73.92196,41.37067,2347,7,15,8,114.3
10526,ny,-73.66797,41.29124,769,5,13,8,160
10527,ny,-73.76455,41.31919,330,5,12,7,140
10528,ny,-73.72295,40.97836,3356,5,11,6,120
10530,ny,-73.80775,41.0234,2715,6,13,7,116.7
10532,ny,-73.80005,41.09918,1866,5,11,6,120
10533,ny,-73.85559,41.03836,2016,7,14,7,100
10535,ny,-73.7993,41.33521,223,4,11,7,175
10536,ny,-73.68702,41.26975,4059,6,13,7,116.7
10537,ny,-73.88514,41.33788,1318,6,13,7,116.7
10538,ny,-73.75683,40.93775,4943,5,11,6,120
10541,ny,-73.7512,41.37976,9826,4,10,6,150
10543,ny,-73.73568,40.95212,4992,5,12,7,140
10545,ny,-73.83547,41.17857,2,6,13,7,116.7
10546,ny,-73.79998,41.19538,376,6,13,7,116.7
10547,ny,-73.84621,41.31168,2307,5,12,7,140
10548,ny,-73.93499,41.24712,1190,8,16,8,100
10549,ny,-73.72071,41.20029,4931,5,13,8,160
10550,ny,-73.83517,40.90635,5551,6,13,7,116.7
10552,ny,-73.82503,40.92383,3300,6,13,7,116.7
10553,ny,-73.82163,40.9086,2023,6,13,7,116.7
10560,ny,-73.60224,41.33205,2213,5,12,7,140
10562,ny,-73.83071,41.19242,6701,6,14,8,133.3
10566,ny,-73.91837,41.28928,6445,6,14,8,133.3
10567,ny,-73.89808,41.28902,7591,6,13,7,116.7
10570,ny,-73.7871,41.13003,4312,5,11,6,120
10573,ny,-73.67726,41.01682,8325,5,12,7,140
10576,ny,-73.57342,41.21331,2500,6,13,7,116.7
10577,ny,-73.71363,41.038,1017,5,11,6,120
10578,ny,-73.67458,41.3174,433,5,12,7,140
10579,ny,-73.8361,41.39384,4133,5,12,7,140
10580,ny,-73.6931,40.97896,5061,5,11,6,120
10583,ny,-73.79309,40.98929,11980,6,13,7,116.7
10588,ny,-73.82192,41.33543,785,5,11,6,120
10589,ny,-73.69511,41.32994,1628,6,13,7,116.7
10590,ny,-73.53725,41.25398,3485,5,12,7,140
10591,ny,-73.84417,41.08587,4345,7,15,8,114.3
10594,ny,-73.77263,41.11643,1874,4,11,7,175
10595,ny,-73.78191,41.08648,2113,4,11,7,175
10596,ny,-73.95918,41.25599,641,8,17,9,112.5
10597,ny,-73.5968,41.29402,479,5,12,7,140
10598,ny,-73.79307,41.28177,9828,5,11,6,120
10601,ny,-73.76506,41.03295,495,5,12,7,140
10603,ny,-73.7795,41.05446,3277,5,12,7,140
10604,ny,-73.7394,41.05923,2823,5,11,6,120
10605,ny,-73.74612,41.00925,4756,5,12,7,140
10606,ny,-73.77588,41.02077,2707,6,13,7,116.7
10607,ny,-73.81105,41.03957,2403,6,13,7,116.7
10701,ny,-73.8805,40.94547,8040,7,14,7,100
10703,ny,-73.88025,40.95984,3966,7,14,7,100
10704,ny,-73.86179,40.9189,6705,6,13,7,116.7
10705,ny,-73.88971,40.91924,4557,6,14,8,133.3
10706,ny,-73.86751,40.98984,2621,7,15,8,114.3
10707,ny,-73.82273,40.9605,2731,6,14,8,133.3
10708,ny,-73.8306,40.93817,4052,6,13,7,116.7
10709,ny,-73.8092,40.95455,2607,6,14,8,133.3
10710,ny,-73.84709,40.96736,6549,6,14,8,133.3
10801,ny,-73.78457,40.91755,6458,5,12,7,140
10803,ny,-73.80657,40.90021,3505,5,12,7,140
10804,ny,-73.78627,40.94916,4935,6,12,6,100
10805,ny,-73.78021,40.89665,1971,5,11,6,120
10901,ny,-74.11611,41.13879,7766,4,11,7,175
10910,ny,-74.13536,41.27698,14,3,7,4,133.3
10911,ny,-74.00321,41.3168,7,7,14,7,100
10913,ny,-73.95547,41.06887,1793,7,15,8,114.3
10914,ny,-74.19951,41.41604,214,5,12,7,140
10915,ny,-74.35819,41.54228,32,5,12,7,140
10916,ny,-74.24872,41.44213,1865,5,12,7,140
10917,ny,-74.1172,41.32429,802,4,9,5,125
10918,ny,-74.25871,41.3477,4803,4,10,6,150
10919,ny,-74.38316,41.52856,469,5,12,7,140
10920,ny,-73.94057,41.15287,3074,6,14,8,133.3
10921,ny,-74.36397,41.32975,2117,4,11,7,175
10922,ny,-73.99468,41.33363,644,7,15,8,114.3
10923,ny,-73.99988,41.20238,2237,6,14,8,133.3
10924,ny,-74.34665,41.37948,5290,5,12,7,140
10925,ny,-74.30379,41.20971,2580,2,7,5,250
10926,ny,-74.12453,41.30157,813,3,8,5,166.7
10927,ny,-73.96709,41.19257,2424,7,15,8,114.3
10928,ny,-73.99771,41.35342,1268,7,15,8,114.3
10930,ny,-74.11538,41.36481,3456,4,9,5,125
10931,ny,-74.16456,41.1474,441,5,11,6,120
10932,ny,-74.46444,41.48212,39,5,12,7,140
10933,ny,-74.51417,41.36524,200,5,13,8,160
10940,ny,-74.47015,41.45119,15863,6,13,7,116.7
10941,ny,-74.34499,41.48861,4234,6,13,7,116.7
10950,ny,-74.19883,41.31841,11852,3,8,5,166.7
10952,ny,-74.07943,41.11372,7925,4,10,6,150
10953,ny,-74.07747,41.40502,166,4,10,6,150
10954,ny,-74.01279,41.0999,7384,5,12,7,140
10956,ny,-73.99441,41.15693,10602,6,13,7,116.7
10958,ny,-74.43042,41.3734,1569,6,14,8,133.3
10960,ny,-73.92581,41.09191,4344,8,16,8,100
10962,ny,-73.95902,41.04912,1814,7,15,8,114.3
10963,ny,-74.5443,41.46331,1332,4,9,5,125
10964,ny,-73.91432,41.01635,623,8,16,8,100
10965,ny,-74.0128,41.06177,5159,6,13,7,116.7
10968,ny,-73.91769,41.03941,1085,8,17,9,112.5
10969,ny,-74.48866,41.29265,824,5,12,7,140
10970,ny,-74.07781,41.18793,3598,5,11,6,120
10973,ny,-74.47611,41.38493,894,6,13,7,116.7
10974,ny,-74.17811,41.16809,1750,4,9,5,125
10975,ny,-74.1741,41.2579,119,3,7,4,133.3
10976,ny,-73.92619,41.02859,458,8,17,9,112.5
10977,ny,-74.04813,41.11767,11099,5,11,6,120
10979,ny,-74.31551,41.18249,168,3,9,6,200
10980,ny,-74.04648,41.23607,4718,7,14,7,100
10983,nj,-73.94826,41.0275,2059,7,16,8,121.45
10984,ny,-74.01758,41.20842,914,6,13,7,116.7
10985,ny,-74.37319,41.58352,30,5,12,7,140
10986,ny,-73.99504,41.28159,880,8,16,8,100
10987,ny,-74.23208,41.20397,1741,3,9,6,200
10988,ny,-74.54273,41.30173,455,5,11,6,120
10989,ny,-73.93615,41.12463,3589,6,14,8,133.3
10990,ny,-74.36588,41.2644,7803,3,9,6,200
10992,ny,-74.16591,41.42554,2947,4,9,5,125
10993,ny,-73.97561,41.2101,1312,7,14,7,100
10994,ny,-73.97265,41.09755,2662,6,13,7,116.7
10996,ny,-73.97269,41.38971,17,7,15,8,114.3
10998,ny,-74.53889,41.33513,1327,5,12,7,140
11001,ny,-73.70446,40.72352,8178,4,10,6,150
11003,ny,-73.70797,40.70139,10483,4,10,6,150
11004,ny,-73.71148,40.74621,2484,4,10,6,150
11005,ny,-73.71424,40.75664,7,4,10,6,150
11010,ny,-73.67502,40.70059,7544,4,10,6,150
11020,ny,-73.71276,40.77105,2020,4,10,6,150
11021,ny,-73.72897,40.78646,3570,4,10,6,150
11023,ny,-73.73336,40.7992,2879,4,10,6,150
11024,ny,-73.74157,40.81707,2495,4,10,6,150
11030,ny,-73.68883,40.79338,5951,5,11,6,120
11040,ny,-73.67973,40.7456,13494,4,10,6,150
11042,ny,-73.6972,40.75855,54,4,10,6,150
11050,ny,-73.69261,40.84074,9319,4,10,6,150
11096,ny,-73.75302,40.62119,1890,1,5,4,400
11101,ny,-73.93889,40.74677,3245,6,13,7,116.7
11102,ny,-73.92593,40.7725,2887,6,13,7,116.7
11103,ny,-73.91346,40.76258,4606,6,13,7,116.7
11104,ny,-73.9202,40.74465,1672,6,13,7,116.7
11105,ny,-73.90625,40.77897,5657,6,13,7,116.7
11106,ny,-73.9318,40.76185,3172,6,13,7,116.7
11109,ny,-73.95747,40.74593,21,6,13,7,116.7
11201,ny,-73.98966,40.69468,3486,6,13,7,116.7
11203,ny,-73.93437,40.64959,11105,5,11,6,120
11204,ny,-73.98483,40.61878,9731,4,9,5,125
11205,ny,-73.96624,40.69466,3161,6,13,7,116.7
11206,ny,-73.94236,40.70195,4812,6,13,7,116.7
11207,ny,-73.89421,40.67076,11514,6,13,7,116.7
11208,ny,-73.87099,40.66855,11663,6,13,7,116.7
11209,ny,-74.03013,40.62199,8569,4,10,6,150
11210,ny,-73.94632,40.62814,8346,4,9,5,125
11211,ny,-73.9531,40.71242,7001,6,13,7,116.7
11212,ny,-73.91302,40.66293,6499,6,13,7,116.7
11213,ny,-73.93634,40.67108,5162,6,13,7,116.7
11214,ny,-73.99622,40.59868,9592,4,9,5,125
11215,ny,-73.98688,40.66252,8912,6,13,7,116.7
11216,ny,-73.94931,40.68077,6112,6,13,7,116.7
11217,ny,-73.97938,40.68241,4071,6,13,7,116.7
11218,ny,-73.97604,40.64348,6918,4,10,6,150
11219,ny,-73.99667,40.63267,8906,4,9,5,125
11220,ny,-74.01655,40.64109,8951,4,9,5,125
11221,ny,-73.92788,40.69134,9114,6,13,7,116.7
11222,ny,-73.94772,40.72856,5298,6,13,7,116.7
11223,ny,-73.97343,40.59714,10393,4,9,5,125
11224,ny,-73.98869,40.57669,2836,4,9,5,125
11225,ny,-73.95422,40.66305,3896,6,13,7,116.7
11226,ny,-73.95665,40.64645,5242,4,10,6,150
11228,ny,-74.01307,40.6167,8097,4,9,5,125
11229,ny,-73.94394,40.6008,12135,4,9,5,125
11230,ny,-73.96511,40.62216,8240,4,9,5,125
11231,ny,-74.00472,40.67758,4805,6,13,7,116.7
11232,ny,-74.0058,40.65631,2909,5,12,7,140
11233,ny,-73.91994,40.6783,8113,6,13,7,116.7
11234,ny,-73.91071,40.60603,19423,3,9,6,200
11235,ny,-73.94879,40.58395,7883,4,9,5,125
11236,ny,-73.90103,40.63956,14714,3,9,6,200
11237,ny,-73.92107,40.70433,4402,6,13,7,116.7
11238,ny,-73.9638,40.67917,4732,6,13,7,116.7
11239,ny,-73.8797,40.64849,191,4,10,6,150
11354,ny,-73.82723,40.76864,5358,6,13,7,116.7
11355,ny,-73.821,40.75146,7003,6,13,7,116.7
11356,ny,-73.84155,40.78492,4831,6,13,7,116.7
11357,ny,-73.81093,40.78639,9726,5,12,7,140
11358,ny,-73.79637,40.76047,8663,6,13,7,116.7
11359,ny,-73.77672,40.79161,3,5,12,7,140
11360,ny,-73.78155,40.78035,2499,5,12,7,140
11361,ny,-73.77242,40.76375,6356,5,12,7,140
11362,ny,-73.73688,40.7565,3474,4,9,5,125
11363,ny,-73.74652,40.7726,2182,4,10,6,150
11364,ny,-73.76058,40.74529,5957,4,10,6,150
11365,ny,-73.79479,40.73977,6435,6,13,7,116.7
11366,ny,-73.78502,40.72816,3567,6,13,7,116.7
11367,ny,-73.82627,40.7304,4718,6,13,7,116.7
11368,ny,-73.85258,40.74962,7893,6,14,8,133.3
11369,ny,-73.87233,40.76344,5455,6,14,8,133.3
11370,ny,-73.8874,40.77568,4112,6,13,7,116.7
11371,ny,-73.87327,40.77441,3,6,13,7,116.7
11372,ny,-73.88367,40.75167,2584,6,14,8,133.3
11373,ny,-73.87854,40.73884,7224,6,14,8,133.3
11374,ny,-73.86152,40.72647,3237,6,13,7,116.7
11375,ny,-73.84614,40.72096,6924,6,13,7,116.7
11377,ny,-73.90516,40.74482,8366,6,13,7,116.7
11378,ny,-73.90968,40.72473,8256,6,13,7,116.7
11379,ny,-73.8796,40.71675,8711,6,13,7,116.7
11385,ny,-73.89012,40.70105,14632,6,13,7,116.7
11411,ny,-73.73622,40.69403,5299,4,10,6,150
11412,ny,-73.75899,40.6981,8707,4,10,6,150
11413,ny,-73.75085,40.66987,9994,4,9,5,125
11414,ny,-73.84497,40.65812,6016,5,12,7,140
11415,ny,-73.8283,40.7079,1402,6,13,7,116.7
11416,ny,-73.84958,40.68462,3953,6,12,6,100
11417,ny,-73.84447,40.67643,5887,5,12,7,140
11418,ny,-73.83601,40.7002,5153,6,13,7,116.7
11419,ny,-73.82294,40.68864,7651,5,12,7,140
11420,ny,-73.81783,40.67356,9202,5,12,7,140
11421,ny,-73.85863,40.69406,6257,6,13,7,116.7
11422,ny,-73.73617,40.66046,6816,4,9,5,125
11423,ny,-73.76849,40.71561,5296,5,12,7,140
11424,ny,-73.82724,40.71432,2,6,13,7,116.7
11426,ny,-73.72236,40.73644,4521,4,10,6,150
11427,ny,-73.74562,40.73092,4344,4,10,6,150
11428,ny,-73.74225,40.72101,4358,4,10,6,150
11429,ny,-73.73873,40.70978,5806,4,10,6,150
11430,ny,-73.7862,40.64739,40,5,11,6,120
11432,ny,-73.79307,40.71536,6670,6,13,7,116.7
11433,ny,-73.78691,40.69815,6516,6,13,7,116.7
11434,ny,-73.77622,40.67681,10933,5,12,7,140
11435,ny,-73.80964,40.70123,6223,6,13,7,116.7
11436,ny,-73.79666,40.67582,4372,6,12,6,100
11451,ny,-73.79594,40.70119,11,6,13,7,116.7
11501,ny,-73.6389,40.74629,5607,3,9,6,200
11507,ny,-73.65225,40.77085,2572,4,10,6,150
11509,ny,-73.72848,40.58874,1517,2,5,3,150
11510,ny,-73.60803,40.65028,10505,2,6,4,200
11514,ny,-73.61248,40.74989,1576,3,8,5,166.7
11516,ny,-73.72667,40.62577,1994,1,5,4,400
11518,ny,-73.66683,40.63755,3377,2,5,3,150
11520,ny,-73.58288,40.65,10513,2,5,3,150
11530,ny,-73.63724,40.72736,9104,4,9,5,125
11542,ny,-73.62879,40.87088,7893,4,9,5,125
11545,ny,-73.58896,40.82706,4651,4,9,5,125
11547,ny,-73.64423,40.83077,329,4,10,6,150
11548,ny,-73.60689,40.81462,546,4,11,7,175
11549,ny,-73.60277,40.71729,2,3,7,4,133.3
11550,ny,-73.6201,40.70171,9807,3,7,4,133.3
11552,ny,-73.65131,40.69226,7648,4,10,6,150
11553,ny,-73.59205,40.70675,5896,2,7,5,250
11554,ny,-73.56021,40.71959,10786,2,6,4,200
11556,ny,-73.58386,40.71968,2,2,7,5,250
11557,ny,-73.69207,40.63741,2615,1,5,4,400
11558,ny,-73.64926,40.60481,3102,2,5,3,150
11559,ny,-73.71733,40.6065,2487,1,5,4,400
11560,ny,-73.59015,40.88055,2619,4,9,5,125
11561,ny,-73.64804,40.58932,9578,1,5,4,400
11563,ny,-73.67372,40.65726,6670,3,9,6,200
11565,ny,-73.67167,40.67506,3345,4,9,5,125
11566,ny,-73.5541,40.6631,12297,2,5,3,150
11568,ny,-73.59649,40.78693,1434,4,10,6,150
11569,ny,-73.58229,40.58977,986,1,4,3,300
11570,ny,-73.63856,40.6657,7657,3,7,4,133.3
11572,ny,-73.63683,40.63233,10404,1,5,4,400
11575,ny,-73.58523,40.68044,4188,2,6,4,200
11576,ny,-73.64769,40.79838,4108,5,11,6,120
11577,ny,-73.63888,40.78326,3764,5,11,6,120
11579,ny,-73.64401,40.84402,1964,4,10,6,150
11580,ny,-73.7036,40.67498,11198,4,9,5,125
11581,ny,-73.71651,40.65159,6382,3,8,5,166.7
11590,ny,-73.57462,40.75541,12081,3,8,5,166.7
11596,ny,-73.64231,40.75967,3535,4,9,5,125
11598,ny,-73.71157,40.63093,4020,1,5,4,400
11691,ny,-73.76126,40.60147,6799,2,6,4,200
11692,ny,-73.79211,40.59356,2516,3,7,4,133.3
11693,ny,-73.81671,40.59658,1983,3,7,4,133.3
11694,ny,-73.84444,40.57763,3798,3,8,5,166.7
11697,ny,-73.90721,40.55908,53,3,8,5,166.7
11701,ny,-73.41261,40.68195,7895,2,5,3,150
11702,ny,-73.31707,40.65563,6064,1,5,4,400
11703,ny,-73.3256,40.73296,5118,1,5,4,400
11704,ny,-73.35901,40.71694,11759,1,5,4,400
11705,ny,-73.05506,40.74515,2940,1,3,2,200
11706,ny,-73.25109,40.7217,19407,1,4,3,300
11709,ny,-73.55892,40.90689,2739,5,11,6,120
11710,ny,-73.53287,40.67213,11964,2,6,4,200
11713,ny,-72.94324,40.77516,4448,0,2,2,NA
11714,ny,-73.48607,40.74257,7307,2,6,4,200
11715,ny,-73.03521,40.75002,1939,1,3,2,200
11716,ny,-73.12696,40.77127,3465,1,3,2,200
11717,ny,-73.25228,40.78381,11621,2,6,4,200
11718,ny,-73.26383,40.71881,1240,1,4,3,300
11719,ny,-72.91072,40.78077,2360,0,2,2,NA
11720,ny,-73.08211,40.87033,9336,1,4,3,300
11721,ny,-73.37159,40.89735,2718,5,11,6,120
11722,ny,-73.19491,40.78306,8564,2,6,4,200
11724,ny,-73.45329,40.86543,1239,4,10,6,150
11725,ny,-73.28081,40.8405,9890,4,10,6,150
11726,ny,-73.39567,40.67886,5523,2,5,3,150
11727,ny,-73.00402,40.88207,8432,1,4,3,300
11729,ny,-73.32181,40.76278,9085,2,6,4,200
11730,ny,-73.17483,40.71755,4669,1,4,3,300
11731,ny,-73.31693,40.86264,10341,5,11,6,120
11732,ny,-73.53688,40.84474,1177,4,9,5,125
11733,ny,-73.11155,40.94261,7659,2,6,4,200
11735,ny,-73.43269,40.73155,10514,2,5,3,150
11738,ny,-73.03818,40.83821,5287,1,4,3,300
11739,ny,-73.16028,40.72933,444,1,4,3,300
11740,ny,-73.3613,40.8654,3130,5,11,6,120
11741,ny,-73.07033,40.7949,8628,1,4,3,300
11742,ny,-73.04141,40.81008,4269,1,5,4,400
11743,ny,-73.42678,40.88332,16524,4,10,6,150
11746,ny,-73.36093,40.81434,21314,5,11,6,120
11747,ny,-73.40981,40.78416,7187,4,10,6,150
11749,ny,-73.17093,40.80677,1295,2,7,5,250
11751,ny,-73.21431,40.72999,4615,1,4,3,300
11752,ny,-73.17482,40.75669,3059,1,4,3,300
11753,ny,-73.54018,40.7899,3489,5,11,6,120
11754,ny,-73.24722,40.88945,6791,3,8,5,166.7
11755,ny,-73.11725,40.85819,4230,1,4,3,300
11756,ny,-73.51658,40.72545,13398,2,6,4,200
11757,ny,-73.37351,40.68879,15010,1,5,4,400
11758,ny,-73.45862,40.66825,18707,2,5,3,150
11762,ny,-73.44674,40.682,7717,2,5,3,150
11763,ny,-72.9833,40.82581,10473,1,3,2,200
11764,ny,-72.97848,40.93974,5756,1,4,3,300
11765,ny,-73.55759,40.88343,387,4,9,5,125
11766,ny,-73.01908,40.94037,4788,1,5,4,400
11767,ny,-73.14481,40.84393,5239,2,5,3,150
11768,ny,-73.34221,40.91967,8974,5,11,6,120
11769,ny,-73.13071,40.7363,3423,1,3,2,200
11770,ny,-73.1565,40.64587,1371,0,2,2,NA
11771,ny,-73.52568,40.87269,3660,4,10,6,150
11772,ny,-72.98713,40.76101,15937,1,3,2,200
11776,ny,-73.04636,40.91357,7985,2,6,4,200
11777,ny,-73.06572,40.95527,3768,2,6,4,200
11778,ny,-72.93063,40.94735,5400,1,3,2,200
11779,ny,-73.1154,40.81278,12732,1,4,3,300
11780,ny,-73.1733,40.89765,6240,2,7,5,250
11782,ny,-73.08112,40.73767,6266,0,3,3,NA
11783,ny,-73.49066,40.6777,7590,1,5,4,400
11784,ny,-73.04125,40.86894,7554,1,5,4,400
11786,ny,-72.88596,40.94974,2201,1,3,2,200
11787,ny,-73.21036,40.85336,12534,2,7,5,250
11788,ny,-73.21321,40.81808,5662,2,7,5,250
11789,ny,-72.97113,40.96229,3369,1,3,2,200
11790,ny,-73.12766,40.90682,5410,2,5,3,150
11791,ny,-73.5042,40.82868,8750,4,10,6,150
11792,ny,-72.8281,40.95335,3485,1,3,2,200
11793,ny,-73.51416,40.6508,10894,2,5,3,150
11794,ny,-73.12525,40.91361,11,2,6,4,200
11795,ny,-73.29826,40.70788,8593,1,5,4,400
11796,ny,-73.0997,40.73128,1195,0,3,3,NA
11797,ny,-73.47007,40.81723,2085,4,10,6,150
11798,ny,-73.37606,40.75228,4643,2,5,3,150
11801,ny,-73.52396,40.7624,13307,3,8,5,166.7
11803,ny,-73.47345,40.78181,9481,4,9,5,125
11804,ny,-73.45701,40.75866,1698,2,6,4,200
11901,ny,-72.64683,40.92645,11882,0,2,2,NA
11930,ny,-72.0959,40.98948,2837,0,0,0,NA
11931,ny,-72.61366,40.93494,120,0,1,1,NA
11932,ny,-72.3077,40.93388,2578,0,1,1,NA
11933,ny,-72.75407,40.92759,3333,0,3,3,NA
11934,ny,-72.79361,40.80007,3222,0,1,1,NA
11935,ny,-72.49071,41.01984,2697,0,1,1,NA
11937,ny,-72.17712,41.01848,15332,0,1,1,NA
11939,ny,-72.32708,41.12792,1218,0,1,1,NA
11940,ny,-72.75707,40.81034,3119,0,1,1,NA
11941,ny,-72.72831,40.82969,973,0,1,1,NA
11942,ny,-72.58248,40.85028,3424,0,1,1,NA
11944,ny,-72.37248,41.1034,2639,0,1,1,NA
11946,ny,-72.5241,40.87134,7915,0,1,1,NA
11947,ny,-72.57714,40.95513,233,0,1,1,NA
11948,ny,-72.55805,40.96604,836,0,1,1,NA
11949,ny,-72.80134,40.86545,6821,0,2,2,NA
11950,ny,-72.84738,40.80782,6167,0,2,2,NA
11951,ny,-72.83064,40.76335,7102,0,1,1,NA
11952,ny,-72.54692,41.00184,3250,0,1,1,NA
11953,ny,-72.95059,40.88588,5229,1,3,2,200
11954,ny,-71.94633,41.04733,4846,0,0,0,NA
11955,ny,-72.81986,40.80883,847,0,1,1,NA
11956,ny,-72.46896,40.9816,371,0,1,1,NA
11957,ny,-72.22746,41.16285,1140,0,1,1,NA
11958,ny,-72.4667,41.03942,593,0,1,1,NA
11959,ny,-72.60118,40.82258,1747,0,1,1,NA
11960,ny,-72.70638,40.8086,1072,0,1,1,NA
11961,ny,-72.88747,40.90389,6689,1,3,2,200
11962,ny,-72.27069,40.93056,1164,0,1,1,NA
11963,ny,-72.3208,40.99428,6561,0,1,1,NA
11964,ny,-72.3185,41.05466,2465,0,1,1,NA
11965,ny,-72.32545,41.08411,1102,0,1,1,NA
11967,ny,-72.8749,40.79511,9854,0,2,2,NA
11968,ny,-72.41272,40.90131,11660,0,1,1,NA
11970,ny,-72.57743,40.93914,557,0,1,1,NA
11971,ny,-72.42997,41.06461,5093,0,1,1,NA
11972,ny,-72.70683,40.83369,780,0,1,1,NA
11973,ny,-72.88214,40.86788,3,1,3,2,200
11975,ny,-72.24246,40.93961,863,0,1,1,NA
11976,ny,-72.34736,40.92537,2954,0,1,1,NA
11977,ny,-72.67915,40.82756,2403,0,1,1,NA
11978,ny,-72.64736,40.82948,5248,0,1,1,NA
11980,ny,-72.92232,40.83143,3143,1,3,2,200
12007,ny,-73.92765,42.45614,40,1,4,3,300
12008,ny,-73.90797,42.85304,217,3,8,5,166.7
12009,ny,-74.03185,42.69823,3495,2,7,5,250
12010,ny,-74.17386,42.93797,13188,2,6,4,200
12015,ny,-73.82716,42.28262,2425,6,14,8,133.3
12017,ny,-73.4622,42.32121,482,0,2,2,NA
12018,ny,-73.52589,42.62949,3943,1,4,3,300
12019,ny,-73.88633,42.93073,6590,3,9,6,200
12020,ny,-73.86801,43.00246,12489,4,10,6,150
12022,ny,-73.34565,42.67078,568,0,1,1,NA
12023,ny,-74.16741,42.60997,1524,1,2,1,100
12024,ny,-73.53328,42.47679,33,1,3,2,200
12025,ny,-74.13608,43.08332,3628,1,4,3,300
12027,ny,-73.90721,42.92248,1659,3,8,5,166.7
12028,ny,-73.44319,42.93996,692,2,5,3,150
12029,ny,-73.4267,42.40671,970,1,2,1,100
12031,ny,-74.45692,42.76476,102,1,3,2,200
12032,ny,-74.55079,43.23368,2353,0,1,1,NA
12033,ny,-73.70712,42.53756,3284,3,9,6,200
12035,ny,-74.35151,42.73177,398,2,5,3,150
12036,ny,-74.67723,42.54079,242,0,1,1,NA
12037,ny,-73.56853,42.34515,2072,2,5,3,150
12040,ny,-73.35072,42.63735,57,0,1,1,NA
12041,ny,-73.96424,42.58329,219,2,6,4,200
12042,ny,-73.92013,42.40204,203,3,7,4,133.3
12043,ny,-74.52274,42.70456,3412,1,2,1,100
12045,ny,-73.79527,42.47691,218,5,11,6,120
12046,ny,-73.91915,42.4918,466,1,5,4,400
12047,ny,-73.72656,42.78402,7301,4,11,7,175
12051,ny,-73.8452,42.34408,2697,6,13,7,116.7
12052,ny,-73.47865,42.754,1148,1,2,1,100
12053,ny,-74.1923,42.75364,2643,1,4,3,300
12054,ny,-73.86581,42.60874,6509,4,10,6,150
12056,ny,-74.09023,42.76659,1173,2,5,3,150
12057,ny,-73.34464,42.96978,1092,1,4,3,300
12058,ny,-73.92449,42.34962,975,3,8,5,166.7
12059,ny,-74.05895,42.61212,1248,1,2,1,100
12060,ny,-73.4942,42.4168,1219,1,3,2,200
12061,ny,-73.65568,42.5982,3196,3,8,5,166.7
12062,ny,-73.50805,42.53099,1093,1,4,3,300
12063,ny,-73.63757,42.56505,198,2,6,4,200
12064,ny,-74.65731,42.61432,445,0,0,0,NA
12065,ny,-73.78648,42.85318,15022,3,9,6,200
12066,ny,-74.31053,42.78056,1345,1,4,3,300
12067,ny,-73.92633,42.55612,857,2,7,5,250
12068,ny,-74.40911,42.95545,1705,3,8,5,166.7
12069,ny,-74.27901,42.94513,115,3,8,5,166.7
12070,ny,-74.25384,42.98464,798,2,7,5,250
12071,ny,-74.42266,42.55267,258,1,2,1,100
12072,ny,-74.36231,42.88465,1776,2,6,4,200
12074,ny,-74.04453,43.05039,2128,2,5,3,150
12075,ny,-73.63382,42.29983,1900,3,7,4,133.3
12076,ny,-74.38857,42.41006,2392,0,1,1,NA
12077,ny,-73.78407,42.59432,2665,5,11,6,120
12078,ny,-74.36367,43.12377,11863,1,4,3,300
12083,ny,-74.02668,42.43029,2371,2,5,3,150
12084,ny,-73.90102,42.70418,685,4,10,6,150
12085,ny,-73.96326,42.70331,57,3,9,6,200
12086,ny,-74.10667,42.99721,1098,2,5,3,150
12087,ny,-73.89774,42.43246,667,2,7,5,250
12089,ny,-73.31275,42.86749,38,1,4,3,300
12090,ny,-73.35525,42.88013,3007,1,4,3,300
12092,ny,-74.3766,42.70126,712,1,4,3,300
12093,ny,-74.62679,42.49678,1906,0,1,1,NA
12094,ny,-73.48834,42.89329,1022,2,5,3,150
12095,ny,-74.40417,43.02702,5895,2,5,3,150
12106,ny,-73.71127,42.38893,1146,4,10,6,150
12108,ny,-74.44925,43.57411,1065,0,1,1,NA
12110,ny,-73.77674,42.75318,7358,4,9,5,125
12115,ny,-73.58071,42.47254,160,2,6,4,200
12116,ny,-74.91526,42.53724,1644,1,3,2,200
12117,ny,-74.25466,43.1687,2491,1,4,3,300
12118,ny,-73.72138,42.91682,6472,4,10,6,150
12120,ny,-74.14424,42.4514,528,1,4,3,300
12121,ny,-73.60207,42.84593,951,2,6,4,200
12122,ny,-74.31658,42.54809,3707,0,1,1,NA
12123,ny,-73.60783,42.52267,2568,2,6,4,200
12124,ny,-73.79278,42.44903,330,5,11,6,120
12125,ny,-73.4048,42.47601,819,1,2,1,100
12130,ny,-73.65938,42.44222,525,3,8,5,166.7
12131,ny,-74.46803,42.45965,209,0,2,2,NA
12132,ny,-73.63003,42.47052,167,3,8,5,166.7
12134,ny,-74.22877,43.26618,4465,1,3,2,200
12136,ny,-73.5584,42.43617,654,1,5,4,400
12137,ny,-74.1277,42.8561,987,1,4,3,300
12138,ny,-73.37209,42.74716,2479,1,2,1,100
12139,ny,-74.56478,43.53736,1179,0,1,1,NA
12140,ny,-73.56273,42.69177,820,1,5,4,400
12143,ny,-73.85209,42.48579,1994,3,9,6,200
12144,ny,-73.7181,42.62977,7967,4,9,5,125
12147,ny,-74.15545,42.51463,490,0,2,2,NA
12148,ny,-73.84739,42.83451,2030,3,8,5,166.7
12149,ny,-74.56495,42.6183,1929,0,1,1,NA
12150,ny,-74.05357,42.87854,402,3,7,4,133.3
12151,ny,-73.78883,42.92522,690,3,9,6,200
12153,ny,-73.46869,42.64047,594,1,2,1,100
12154,ny,-73.60064,42.93769,1464,2,7,5,250
12155,ny,-74.82459,42.59556,1875,0,2,2,NA
12156,ny,-73.74355,42.47718,516,4,10,6,150
12157,ny,-74.29885,42.66588,2196,1,3,2,200
12158,ny,-73.82092,42.54057,2803,4,11,7,175
12159,ny,-73.88602,42.64238,3128,4,10,6,150
12160,ny,-74.36717,42.75886,579,2,5,3,150
12161,ny,-73.85472,42.53604,80,4,10,6,150
12164,ny,-74.35814,43.55381,752,0,1,1,NA
12165,ny,-73.50765,42.31054,145,1,2,1,100
12166,ny,-74.45278,42.83869,1055,1,4,3,300
12167,ny,-74.58406,42.42076,2048,0,1,1,NA
12168,ny,-73.38078,42.56102,1100,1,2,1,100
12169,ny,-73.44278,42.58644,227,1,2,1,100
12170,ny,-73.66309,42.99679,2284,4,10,6,150
12172,ny,-73.73944,42.28915,132,5,12,7,140
12173,ny,-73.76028,42.38739,884,5,12,7,140
12174,ny,-73.72844,42.35345,159,5,12,7,140
12175,ny,-74.55284,42.5515,721,0,1,1,NA
12176,ny,-73.96701,42.38015,138,2,6,4,200
12177,ny,-74.28711,42.95094,284,3,8,5,166.7
12180,ny,-73.60217,42.75064,16415,3,8,5,166.7
12182,ny,-73.6329,42.80038,5006,2,7,5,250
12183,ny,-73.69257,42.74742,853,5,11,6,120
12184,ny,-73.65422,42.4205,3218,3,9,6,200
12185,ny,-73.53123,42.90339,945,2,6,4,200
12186,ny,-73.97068,42.62753,3225,3,8,5,166.7
12187,ny,-74.46224,42.62197,638,0,1,1,NA
12188,ny,-73.6958,42.81987,4232,4,10,6,150
12189,ny,-73.71767,42.7363,5417,4,10,6,150
12190,ny,-74.27331,43.47351,1449,0,1,1,NA
12192,ny,-73.82829,42.40286,966,5,12,7,140
12193,ny,-74.04496,42.51571,1234,1,3,2,200
12194,ny,-74.45967,42.52443,275,0,2,2,NA
12195,ny,-73.47088,42.48666,101,1,3,2,200
12196,ny,-73.61696,42.63162,1246,2,5,3,150
12197,ny,-74.72776,42.61134,1926,0,1,1,NA
12198,ny,-73.63405,42.67677,3393,2,7,5,250
12202,ny,-73.76322,42.63373,3437,4,11,7,175
12203,ny,-73.84816,42.68107,9592,4,10,6,150
12204,ny,-73.72852,42.68805,1955,5,11,6,120
12205,ny,-73.82938,42.71897,11081,3,9,6,200
12206,ny,-73.78246,42.67444,4759,5,11,6,120
12207,ny,-73.7461,42.65719,623,5,11,6,120
12208,ny,-73.81023,42.65327,6894,4,11,7,175
12209,ny,-73.78992,42.63807,3541,5,12,7,140
12210,ny,-73.75801,42.65997,2978,5,11,6,120
12211,ny,-73.76416,42.70586,4767,4,10,6,150
12222,ny,-73.82536,42.68537,3,4,10,6,150
12302,ny,-73.98202,42.88185,11114,3,8,5,166.7
12303,ny,-73.9246,42.74955,11652,3,8,5,166.7
12304,ny,-73.89724,42.77406,7701,3,8,5,166.7
12305,ny,-73.95024,42.81219,1439,3,8,5,166.7
12306,ny,-74.02857,42.80482,11105,3,8,5,166.7
12307,ny,-73.93357,42.80507,2114,3,8,5,166.7
12308,ny,-73.91998,42.82161,4199,3,8,5,166.7
12309,ny,-73.86955,42.79919,11594,3,8,5,166.7
12401,ny,-74.05277,41.93561,14478,6,13,7,116.7
12404,ny,-74.23593,41.81463,2317,5,11,6,120
12405,ny,-74.08994,42.32139,532,1,5,4,400
12406,ny,-74.5524,42.10202,962,0,0,0,NA
12407,ny,-74.35815,42.31764,231,0,0,0,NA
12409,ny,-74.16684,42.04367,750,2,5,3,150
12410,ny,-74.44976,42.06989,603,0,0,0,NA
12411,ny,-74.04557,41.87606,231,5,12,7,140
12412,ny,-74.27959,42.01273,462,2,5,3,150
12413,ny,-74.02126,42.31252,1787,3,8,5,166.7
12414,ny,-73.92038,42.22397,5584,6,13,7,116.7
12416,ny,-74.28873,42.10067,370,0,1,1,NA
12417,ny,-73.98985,41.90689,145,6,13,7,116.7
12418,ny,-74.16168,42.35876,602,1,3,2,200
12419,ny,-74.10344,41.85969,355,6,14,8,133.3
12420,ny,-74.37929,41.67115,317,2,5,3,150
12421,ny,-74.54302,42.24863,924,0,0,0,NA
12422,ny,-74.20334,42.39259,342,1,2,1,100
12423,ny,-74.10975,42.37922,876,2,6,4,200
12424,ny,-74.13526,42.24686,543,0,0,0,NA
12427,ny,-74.13729,42.14077,675,0,1,1,NA
12428,ny,-74.44494,41.73905,3134,2,5,3,150
12429,ny,-73.97496,41.82909,165,6,12,6,100
12430,ny,-74.49959,42.20344,1640,0,0,0,NA
12431,ny,-74.02071,42.36029,989,3,7,4,133.3
12432,ny,-73.94443,42.04438,187,7,15,8,114.3
12433,ny,-74.15856,42.00337,363,3,7,4,133.3
12434,ny,-74.50072,42.36051,655,0,1,1,NA
12435,ny,-74.51874,41.72881,405,1,5,4,400
12436,ny,-74.07411,42.19556,618,0,0,0,NA
12438,ny,-74.60122,42.20788,65,0,1,1,NA
12439,ny,-74.18385,42.29607,554,0,0,0,NA
12440,ny,-74.17724,41.77874,1329,6,13,7,116.7
12441,ny,-74.50869,42.1353,295,0,0,0,NA
12442,ny,-74.23673,42.21524,1868,0,0,0,NA
12443,ny,-74.0854,41.93391,2070,5,12,7,140
12444,ny,-74.29672,42.26318,1074,0,1,1,NA
12446,ny,-74.32557,41.80598,3363,3,7,4,133.3
12448,ny,-74.18293,42.07924,386,1,3,2,200
12449,ny,-73.99303,41.99353,1021,6,13,7,116.7
12450,ny,-74.24428,42.13325,329,0,0,0,NA
12451,ny,-73.95014,42.30527,941,4,11,7,175
12452,ny,-74.36121,42.25764,371,0,0,0,NA
12453,ny,-73.93628,42.09339,197,7,15,8,114.3
12454,ny,-74.15096,42.28668,404,0,0,0,NA
12455,ny,-74.65987,42.13971,2424,0,1,1,NA
12456,ny,-73.99706,42.03312,247,6,13,7,116.7
12457,ny,-74.2525,42.04407,715,1,3,2,200
12458,ny,-74.41992,41.81563,1264,2,6,4,200
12459,ny,-74.6802,42.23651,245,0,0,0,NA
12460,ny,-74.15614,42.41077,184,2,5,3,150
12461,ny,-74.26929,41.9089,1172,2,7,5,250
12463,ny,-74.01728,42.19996,978,4,9,5,125
12464,ny,-74.35128,42.03512,1036,1,2,1,100
12465,ny,-74.46733,42.15307,346,0,0,0,NA
12466,ny,-73.97903,41.90434,1155,6,13,7,116.7
12468,ny,-74.42301,42.29896,1378,0,1,1,NA
12469,ny,-74.23914,42.44714,944,1,2,1,100
12470,ny,-74.07733,42.2959,356,2,6,4,200
12471,ny,-74.04113,41.84163,120,4,11,7,175
12472,ny,-74.07876,41.84604,722,6,14,8,133.3
12473,ny,-74.04101,42.25817,722,1,4,3,300
12474,ny,-74.57933,42.29728,1511,0,0,0,NA
12475,ny,-74.01481,42.01466,218,6,13,7,116.7
12477,ny,-73.99984,42.0858,9464,6,13,7,116.7
12480,ny,-74.37743,42.1363,749,0,1,1,NA
12481,ny,-74.22475,41.98297,854,3,7,4,133.3
12482,ny,-73.95545,42.26814,216,4,10,6,150
12483,ny,-74.42141,41.67551,160,2,6,4,200
12484,ny,-74.17495,41.87107,1851,5,12,7,140
12485,ny,-74.14375,42.2032,1241,0,0,0,NA
12486,ny,-74.06258,41.83381,709,6,14,8,133.3
12487,ny,-73.99538,41.85938,1555,5,12,7,140
12489,ny,-74.35548,41.75062,269,2,5,3,150
12490,ny,-73.92599,42.12467,69,6,14,8,133.3
12491,ny,-74.13695,41.96748,910,3,8,5,166.7
12492,ny,-74.33579,42.18493,566,0,0,0,NA
12493,ny,-73.97681,41.79621,259,5,12,7,140
12494,ny,-74.2929,41.9566,640,1,4,3,300
12495,ny,-74.24068,42.08492,332,1,2,1,100
12496,ny,-74.27379,42.32646,3347,0,0,0,NA
12498,ny,-74.10639,42.0485,3261,3,7,4,133.3
12501,ny,-73.55863,41.85965,1378,3,7,4,133.3
12502,ny,-73.65507,42.08516,1043,2,7,5,250
12503,ny,-73.58039,42.03851,624,2,6,4,200
12504,ny,-73.9161,42.02973,35,5,12,7,140
12507,ny,-73.92068,42.00379,63,5,12,7,140
12508,ny,-73.95383,41.49674,5870,6,13,7,116.7
12512,ny,-73.96613,41.55178,90,7,15,8,114.3
12513,ny,-73.72789,42.21756,364,4,9,5,125
12514,ny,-73.7629,41.87288,1664,4,10,6,150
12515,ny,-74.06265,41.68296,572,3,8,5,166.7
12516,ny,-73.56531,42.11174,1270,2,6,4,200
12517,ny,-73.51213,42.1182,302,1,3,2,200
12518,ny,-74.03948,41.4161,1949,4,10,6,150
12520,ny,-74.00606,41.43295,1291,6,14,8,133.3
12521,ny,-73.6503,42.1701,1651,2,6,4,200
12522,ny,-73.59681,41.72043,1919,3,8,5,166.7
12523,ny,-73.75329,42.08682,1216,3,8,5,166.7
12524,ny,-73.89257,41.52965,6004,6,13,7,116.7
12525,ny,-74.18566,41.68635,1512,5,11,6,120
12526,ny,-73.85885,42.12182,2058,5,13,8,160
12527,ny,-73.93567,41.51943,57,5,12,7,140
12528,ny,-74.00443,41.71888,5357,5,11,6,120
12529,ny,-73.53721,42.21552,2563,1,4,3,300
12530,ny,-73.68775,42.20746,58,2,7,5,250
12531,ny,-73.66962,41.53688,1687,3,8,5,166.7
12533,ny,-73.79393,41.56035,10147,5,12,7,140
12534,ny,-73.75162,42.22274,7638,5,11,6,120
12538,ny,-73.89308,41.79248,5033,5,12,7,140
12540,ny,-73.72516,41.6708,3149,4,10,6,150
12542,ny,-73.99716,41.60742,2516,6,13,7,116.7
12543,ny,-74.17583,41.49324,1067,4,10,6,150
12545,ny,-73.674,41.79054,2164,3,7,4,133.3
12546,ny,-73.53452,41.9678,1883,2,5,3,150
12547,ny,-73.98514,41.65597,1305,6,13,7,116.7
12548,ny,-74.10744,41.65987,530,3,9,6,200
12549,ny,-74.25873,41.53005,3970,5,12,7,140
12550,ny,-74.05258,41.53718,16827,6,14,8,133.3
12553,ny,-74.07566,41.45713,7848,6,14,8,133.3
12561,ny,-74.0975,41.75499,5685,5,11,6,120
12563,ny,-73.58751,41.49455,2909,4,9,5,125
12564,ny,-73.58678,41.5775,3400,3,8,5,166.7
12565,ny,-73.6463,42.24853,638,2,7,5,250
12566,ny,-74.33124,41.62103,4630,5,12,7,140
12567,ny,-73.64952,41.98247,1805,3,7,4,133.3
12569,ny,-73.79586,41.73434,3499,4,10,6,150
12570,ny,-73.6723,41.61943,2944,3,8,5,166.7
12571,ny,-73.80904,42.00569,5219,4,9,5,125
12572,ny,-73.87201,41.92527,4792,4,10,6,150
12574,ny,-73.94566,41.91769,220,7,14,7,100
12575,ny,-74.15402,41.47855,958,4,10,6,150
12577,ny,-74.12291,41.42581,783,4,10,6,150
12578,ny,-73.79486,41.80844,1178,4,10,6,150
12580,ny,-73.87226,41.85425,1892,4,10,6,150
12581,ny,-73.69344,41.90697,1492,3,8,5,166.7
12582,ny,-73.73508,41.54452,1651,3,9,6,200
12583,ny,-73.86653,42.06129,1094,5,12,7,140
12585,ny,-73.70081,41.72484,409,3,8,5,166.7
12586,ny,-74.17333,41.56503,4559,4,10,6,150
12589,ny,-74.15893,41.62665,5357,4,9,5,125
12590,ny,-73.88777,41.59493,12788,6,14,8,133.3
12592,ny,-73.55413,41.79145,666,2,7,5,250
12594,ny,-73.55013,41.66843,1646,3,8,5,166.7
12601,ny,-73.91165,41.70352,10785,6,13,7,116.7
12603,ny,-73.8655,41.67822,14828,6,13,7,116.7
12604,ny,-73.89212,41.68831,1,5,12,7,140
12701,ny,-74.70027,41.64915,6563,1,2,1,100
12719,ny,-74.91192,41.48857,1207,2,5,3,150
12720,ny,-74.90423,41.65848,215,1,2,1,100
12721,ny,-74.42892,41.56747,3510,5,12,7,140
12722,ny,-74.3743,41.59063,54,5,12,7,140
12723,ny,-75.02827,41.77568,1494,1,3,2,200
12724,ny,-74.93392,41.8541,267,0,1,1,NA
12725,ny,-74.54538,41.96002,728,0,0,0,NA
12726,ny,-74.97731,41.69411,1200,1,3,2,200
12729,ny,-74.62441,41.47624,1246,3,8,5,166.7
12732,ny,-74.874,41.56253,895,1,3,2,200
12733,ny,-74.60983,41.73184,979,1,3,2,200
12734,ny,-74.75092,41.73306,780,1,3,2,200
12736,ny,-75.03206,41.85535,201,0,2,2,NA
12737,ny,-74.80052,41.50467,2407,1,5,4,400
12738,ny,-74.57106,41.65613,305,1,3,2,200
12740,ny,-74.4699,41.89425,1756,1,2,1,100
12741,ny,-75.08106,41.84158,314,1,3,2,200
12742,ny,-74.72191,41.71929,194,1,2,1,100
12743,ny,-74.84772,41.54279,481,1,3,2,200
12745,ny,-75.02465,41.78343,97,1,3,2,200
12746,ny,-74.66427,41.4414,629,3,7,4,133.3
12747,ny,-74.66465,41.76741,925,1,2,1,100
12748,ny,-74.92351,41.77546,1508,1,2,1,100
12749,ny,-74.83671,41.69465,628,1,3,2,200
12750,ny,-74.95708,41.73215,193,1,2,1,100
12751,ny,-74.66429,41.69364,562,1,3,2,200
12752,ny,-74.98833,41.68245,311,1,3,2,200
12754,ny,-74.73688,41.79842,3687,0,2,2,NA
12758,ny,-74.74554,41.94578,4027,0,1,1,NA
12759,ny,-74.65337,41.7791,1227,1,2,1,100
12760,ny,-75.10883,41.90026,971,1,2,1,100
12762,ny,-74.79155,41.66889,589,1,3,2,200
12763,ny,-74.52307,41.67984,796,1,4,3,300
12764,ny,-74.98458,41.5953,2348,1,3,2,200
12765,ny,-74.6194,41.85539,542,0,2,2,NA
12766,ny,-74.9803,41.81155,360,1,2,1,100
12767,ny,-75.00259,41.8414,126,1,2,1,100
12768,ny,-74.71584,41.87131,1513,0,1,1,NA
12769,ny,-74.46727,41.65794,277,3,7,4,133.3
12770,ny,-74.85457,41.4479,308,2,5,3,150
12771,ny,-74.62458,41.37437,5627,3,8,5,166.7
12775,ny,-74.59275,41.61564,2515,1,3,2,200
12776,ny,-74.93462,41.96089,3234,0,1,1,NA
12777,ny,-74.69616,41.54833,1454,1,4,3,300
12778,ny,-74.8093,41.64227,2404,1,3,2,200
12779,ny,-74.63178,41.70278,1417,1,3,2,200
12780,ny,-74.72132,41.44431,1235,2,7,5,250
12781,ny,-74.46638,41.61967,293,3,8,5,166.7
12783,ny,-74.83631,41.74098,1992,1,2,1,100
12784,ny,-74.62603,41.66983,76,1,3,2,200
12785,ny,-74.56987,41.52531,677,3,8,5,166.7
12786,ny,-74.85503,41.64041,1563,1,3,2,200
12787,ny,-74.83533,41.79789,283,0,2,2,NA
12788,ny,-74.58839,41.78945,1742,1,3,2,200
12789,ny,-74.57041,41.70682,1948,1,3,2,200
12790,ny,-74.51577,41.59144,4466,3,7,4,133.3
12791,ny,-74.88999,41.81225,459,1,2,1,100
12792,ny,-74.94761,41.51836,324,2,5,3,150
12801,ny,-73.64481,43.31145,5650,3,8,5,166.7
12803,ny,-73.62996,43.28938,3193,3,9,6,200
12804,ny,-73.68409,43.33891,11899,3,7,4,133.3
12808,ny,-73.72806,43.75117,890,1,3,2,200
12809,ny,-73.46334,43.23831,2301,2,5,3,150
12810,ny,-74.01047,43.49699,646,0,1,1,NA
12811,ny,-74.02833,43.60546,99,0,0,0,NA
12812,ny,-74.41182,43.8721,436,0,0,0,NA
12814,ny,-73.64707,43.61041,2498,3,7,4,133.3
12815,ny,-73.69708,43.69032,1497,1,2,1,100
12816,ny,-73.37474,43.04807,2833,1,4,3,300
12817,ny,-73.82514,43.63356,3082,1,2,1,100
12819,ny,-73.47914,43.59844,334,2,5,3,150
12821,ny,-73.41288,43.45869,167,3,7,4,133.3
12822,ny,-73.88802,43.24208,3912,1,4,3,300
12823,ny,-73.4076,43.18174,216,2,5,3,150
12824,ny,-73.70975,43.51635,1241,2,5,3,150
12827,ny,-73.51224,43.44842,2970,2,6,4,200
12828,ny,-73.56402,43.25506,4076,3,9,6,200
12831,ny,-73.68824,43.19522,7060,4,9,5,125
12832,ny,-73.31799,43.37079,4096,1,4,3,300
12833,ny,-73.83977,43.14008,2130,2,7,5,250
12834,ny,-73.503,43.09469,3535,2,6,4,200
12835,ny,-74.00372,43.3321,3952,1,2,1,100
12836,ny,-73.56839,43.74965,1142,2,5,3,150
12837,ny,-73.26701,43.50863,527,1,4,3,300
12838,ny,-73.4081,43.34242,298,1,3,2,200
12839,ny,-73.55348,43.3472,5055,3,9,6,200
12841,ny,-73.50159,43.63582,478,0,1,1,NA
12842,ny,-74.29207,43.75924,2414,0,0,0,NA
12843,ny,-74.00428,43.57506,820,0,1,1,NA
12844,ny,-73.62119,43.4894,427,1,2,1,100
12845,ny,-73.71329,43.42412,4849,2,5,3,150
12846,ny,-73.80805,43.34418,2928,1,4,3,300
12847,ny,-74.58743,43.99908,1787,0,1,1,NA
12849,ny,-73.29859,43.44756,251,1,5,4,400
12850,ny,-73.98353,43.10698,1980,2,5,3,150
12851,ny,-74.0417,43.85581,828,0,1,1,NA
12852,ny,-74.16091,43.94565,964,0,1,1,NA
12853,ny,-74.00857,43.68129,2273,0,1,1,NA
12855,ny,-73.79651,44.00199,851,0,2,2,NA
12856,ny,-74.14883,43.65072,560,0,0,0,NA
12857,ny,-73.90997,43.82271,882,0,1,1,NA
12858,ny,-73.67288,43.90273,472,1,2,1,100
12859,ny,-73.90978,43.167,1075,1,5,4,400
12860,ny,-73.80776,43.72554,706,1,3,2,200
12861,ny,-73.41913,43.74973,1040,2,6,4,200
12862,ny,-73.91147,43.67949,77,1,2,1,100
12863,ny,-73.93191,43.06036,297,3,8,5,166.7
12864,ny,-74.30539,43.72737,113,0,0,0,NA
12865,ny,-73.34097,43.2142,2492,1,4,3,300
12866,ny,-73.7408,43.07079,16266,4,11,7,175
12870,ny,-73.75412,43.84237,2805,1,3,2,200
12871,ny,-73.6135,43.08915,1947,4,10,6,150
12872,ny,-73.7298,43.87713,58,1,3,2,200
12873,ny,-73.30672,43.11856,547,1,3,2,200
12874,ny,-73.54804,43.6905,588,1,3,2,200
12878,ny,-74.02675,43.4291,829,0,1,1,NA
12883,ny,-73.50593,43.8523,3287,2,6,4,200
12884,ny,-73.59129,43.0884,223,3,9,6,200
12885,ny,-73.81682,43.52947,3073,1,2,1,100
12886,ny,-73.93,43.66529,372,0,2,2,NA
12887,ny,-73.37121,43.53957,3163,3,9,6,200
12901,ny,-73.47385,44.70386,11143,1,4,3,300
12903,ny,-73.44693,44.68051,562,1,5,4,400
12910,ny,-73.64077,44.8561,1320,1,3,2,200
12911,ny,-73.46505,44.51911,22,1,4,3,300
12912,ny,-73.74692,44.46222,1600,1,3,2,200
12913,ny,-74.02089,44.42202,767,0,1,1,NA
12914,ny,-74.59971,44.92719,669,2,5,3,150
12916,ny,-74.5159,44.83518,1470,1,3,2,200
12917,ny,-74.17893,44.92767,1059,1,2,1,100
12918,ny,-73.6835,44.69039,1361,1,3,2,200
12919,ny,-73.4492,44.96794,1989,1,3,2,200
12920,ny,-74.06218,44.87653,2392,1,2,1,100
12921,ny,-73.43793,44.89115,1366,1,4,3,300
12922,ny,-74.71791,44.28807,178,0,1,1,NA
12923,ny,-73.93899,44.95459,632,1,2,1,100
12924,ny,-73.58426,44.47774,111,1,3,2,200
12926,ny,-74.32488,44.95332,1456,1,4,3,300
12927,ny,-74.82122,44.19934,677,0,1,1,NA
12928,ny,-73.53004,43.95157,1622,2,6,4,200
12929,ny,-73.71923,44.72003,505,1,3,2,200
12930,ny,-74.54135,44.72337,731,1,2,1,100
12932,ny,-73.6126,44.21216,1274,1,3,2,200
12933,ny,-73.84534,44.89099,6,1,2,1,100
12934,ny,-73.884,44.86615,743,1,2,1,100
12935,ny,-73.78751,44.83469,1532,1,2,1,100
12936,ny,-73.39871,44.27793,718,2,6,4,200
12937,ny,-74.48088,44.96097,1047,2,5,3,150
12939,ny,-74.16692,44.42775,169,0,1,1,NA
12941,ny,-73.71655,44.35507,1803,1,3,2,200
12942,ny,-73.79983,44.26023,951,0,1,1,NA
12943,ny,-73.81828,44.13923,874,0,1,1,NA
12944,ny,-73.51229,44.45069,2680,1,4,3,300
12945,ny,-74.23811,44.33748,590,0,1,1,NA
12946,ny,-73.98411,44.22896,4119,0,1,1,NA
12950,ny,-73.5851,44.32015,644,1,4,3,300
12952,ny,-73.90566,44.70832,450,0,1,1,NA
12953,ny,-74.26331,44.74094,6580,1,2,1,100
12955,ny,-73.95707,44.79082,564,0,2,2,NA
12956,ny,-73.4954,44.09323,658,1,4,3,300
12957,ny,-74.57458,44.84834,1043,1,4,3,300
12958,ny,-73.57836,44.95941,1141,1,4,3,300
12959,ny,-73.70385,44.96035,912,1,3,2,200
12960,ny,-73.55462,44.02893,742,1,4,3,300
12961,ny,-73.54952,44.05711,116,1,3,2,200
12962,ny,-73.60538,44.70159,2581,1,4,3,300
12964,ny,-73.62574,44.14253,303,0,2,2,NA
12965,ny,-74.68051,44.70305,366,1,3,2,200
12966,ny,-74.41891,44.79439,2281,1,2,1,100
12967,ny,-74.65953,44.77361,825,1,4,3,300
12969,ny,-74.08568,44.703,909,0,1,1,NA
12970,ny,-74.31618,44.48765,367,0,1,1,NA
12972,ny,-73.57342,44.55813,3142,2,5,3,150
12973,ny,-74.59382,44.29862,185,0,1,1,NA
12974,ny,-73.47037,44.05284,922,3,9,6,200
12975,ny,-73.43054,44.52909,253,2,6,4,200
12976,ny,-74.21594,44.50619,463,0,1,1,NA
12977,ny,-74.0795,44.28018,128,0,1,1,NA
12978,ny,-73.80871,44.61636,200,1,2,1,100
12979,ny,-73.3734,44.99161,1008,1,3,2,200
12980,ny,-74.49366,44.5612,1541,0,1,1,NA
12981,ny,-73.84303,44.62648,1613,1,2,1,100
12983,ny,-74.20293,44.32142,4740,0,1,1,NA
12985,ny,-73.74964,44.56302,697,1,3,2,200
12986,ny,-74.4905,44.23202,4028,0,1,1,NA
12987,ny,-73.76705,44.32189,200,1,2,1,100
12989,ny,-74.06294,44.53734,1549,0,1,1,NA
12992,ny,-73.51825,44.81583,2531,1,4,3,300
12993,ny,-73.47217,44.19894,1714,2,6,4,200
12996,ny,-73.43947,44.36022,2261,2,6,4,200
12997,ny,-73.8431,44.37554,1344,1,2,1,100
12998,ny,-73.57896,44.0846,301,1,2,1,100
13020,ny,-76.0745,42.81642,88,1,2,1,100
13021,ny,-76.5589,42.92382,16286,3,7,4,133.3
13024,ny,-76.57423,42.9346,1,3,7,4,133.3
13026,ny,-76.66092,42.74969,1151,3,7,4,133.3
13027,ny,-76.36417,43.16745,12887,3,8,5,166.7
13028,ny,-75.93467,43.29689,1055,2,5,3,150
13029,ny,-76.15005,43.22348,3301,3,8,5,166.7
13030,ny,-75.96074,43.15505,2102,3,7,4,133.3
13031,ny,-76.30833,43.04562,6309,2,6,4,200
13032,ny,-75.76528,43.07806,7008,2,5,3,150
13033,ny,-76.57007,43.18619,2212,3,7,4,133.3
13034,ny,-76.6938,42.91194,1162,3,9,6,200
13035,ny,-75.8257,42.9408,4402,1,2,1,100
13036,ny,-76.17337,43.32378,4007,2,6,4,200
13037,ny,-75.86578,43.06035,4046,2,5,3,150
13039,ny,-76.06918,43.16857,7318,3,8,5,166.7
13040,ny,-75.93222,42.56134,2086,1,3,2,200
13041,ny,-76.19762,43.19067,4942,3,8,5,166.7
13042,ny,-75.85561,43.26755,1673,2,6,4,200
13044,ny,-75.99864,43.29432,1308,2,6,4,200
13045,ny,-76.19206,42.58144,10535,1,4,3,300
13051,ny,-75.90864,42.87673,44,1,3,2,200
13052,ny,-75.86345,42.72236,1524,1,2,1,100
13053,ny,-76.26599,42.47462,1920,1,3,2,200
13054,ny,-75.67212,43.17083,840,2,6,4,200
13057,ny,-76.04007,43.09532,7394,3,7,4,133.3
13060,ny,-76.41883,43.02427,1227,3,7,4,133.3
13061,ny,-75.75684,42.86189,1128,1,2,1,100
13062,ny,-76.3842,42.48506,48,1,3,2,200
13063,ny,-75.97703,42.84628,1189,1,2,1,100
13064,ny,-76.70983,43.32918,165,2,6,4,200
13066,ny,-76.00322,43.03266,5549,2,6,4,200
13068,ny,-76.35868,42.49978,2448,1,3,2,200
13069,ny,-76.37919,43.33216,10300,3,7,4,133.3
13071,ny,-76.54111,42.67795,597,1,4,3,300
13072,ny,-75.76408,42.76325,862,1,2,1,100
13073,ny,-76.39787,42.58517,2890,1,3,2,200
13074,ny,-76.54781,43.30986,2048,2,6,4,200
13076,ny,-76.1526,43.35585,1149,2,5,3,150
13077,ny,-76.19592,42.71389,3489,1,4,3,300
13078,ny,-76.06156,42.96082,4253,2,4,2,100
13080,ny,-76.47894,43.08429,2208,3,8,5,166.7
13081,ny,-76.6212,42.67358,931,2,5,3,150
13082,ny,-75.95326,43.10055,2010,3,7,4,133.3
13083,ny,-75.98121,43.64848,1432,0,1,1,NA
13084,ny,-76.11308,42.88898,2299,1,3,2,200
13087,ny,-76.15586,42.70646,94,1,3,2,200
13088,ny,-76.18713,43.1099,7725,3,8,5,166.7
13090,ny,-76.21357,43.15174,9811,3,8,5,166.7
13092,ny,-76.42341,42.65169,1470,1,3,2,200
13101,ny,-76.06725,42.59852,1355,1,3,2,200
13102,ny,-76.29246,42.55265,39,1,3,2,200
13103,ny,-76.10827,43.32721,41,2,5,3,150
13104,ny,-75.95568,42.96314,6411,1,4,3,300
13108,ny,-76.33097,42.9733,2781,2,4,2,100
13110,ny,-76.28534,42.89314,1920,1,3,2,200
13111,ny,-76.62043,43.2587,888,3,7,4,133.3
13112,ny,-76.41846,43.10145,1234,3,8,5,166.7
13113,ny,-76.53862,43.16265,130,2,6,4,200
13114,ny,-76.24436,43.46446,3390,1,4,3,300
13115,ny,-76.47878,43.39865,109,2,6,4,200
13116,ny,-76.0077,43.07476,1347,3,7,4,133.3
13117,ny,-76.70751,43.0093,98,3,8,5,166.7
13118,ny,-76.39059,42.75087,3462,1,3,2,200
13120,ny,-76.17416,42.93959,1054,1,4,3,300
13122,ny,-75.85944,42.84183,647,1,2,1,100
13123,ny,-75.76907,43.23356,246,2,6,4,200
13124,ny,-75.81796,42.64603,104,1,3,2,200
13126,ny,-76.46129,43.43937,14183,2,5,3,150
13131,ny,-76.09223,43.4212,2093,1,4,3,300
13132,ny,-76.24469,43.26678,1722,3,7,4,133.3
13134,ny,-75.68468,42.96737,53,1,3,2,200
13135,ny,-76.31916,43.2549,2851,3,8,5,166.7
13136,ny,-75.849,42.61466,443,1,3,2,200
13138,ny,-76.01463,42.89909,32,1,2,1,100
13140,ny,-76.65899,43.05985,2314,3,8,5,166.7
13141,ny,-76.18334,42.76294,389,1,3,2,200
13142,ny,-76.13396,43.55322,4247,1,3,2,200
13143,ny,-76.71523,43.2332,1569,3,8,5,166.7
13144,ny,-75.97439,43.56996,1325,0,1,1,NA
13145,ny,-76.12116,43.65061,1426,0,2,2,NA
13146,ny,-76.75789,43.09009,1399,3,7,4,133.3
13147,ny,-76.56441,42.775,766,1,4,3,300
13148,ny,-76.7847,42.91464,4953,4,9,5,125
13152,ny,-76.38476,42.89261,5344,2,4,2,100
13153,ny,-76.45363,42.99656,196,2,6,4,200
13155,ny,-75.78003,42.65493,532,1,2,1,100
13156,ny,-76.66075,43.33396,1780,2,6,4,200
13157,ny,-75.72353,43.20475,850,2,6,4,200
13158,ny,-75.96666,42.71909,1252,1,2,1,100
13159,ny,-76.1135,42.80198,3163,1,2,1,100
13160,ny,-76.65168,42.82793,1056,3,7,4,133.3
13162,ny,-75.71999,43.1841,407,2,6,4,200
13163,ny,-75.71107,43.0807,153,2,5,3,150
13164,ny,-76.31616,43.09409,1305,3,8,5,166.7
13165,ny,-76.87614,42.91189,4749,3,8,5,166.7
13166,ny,-76.55735,43.07094,2398,3,8,5,166.7
13167,ny,-76.06017,43.31408,1569,2,6,4,200
13202,ny,-76.15064,43.04378,885,3,8,5,166.7
13203,ny,-76.13492,43.06111,3969,3,7,4,133.3
13204,ny,-76.17684,43.05069,6530,3,7,4,133.3
13205,ny,-76.14193,43.00527,6062,2,6,4,200
13206,ny,-76.10578,43.07344,6172,3,7,4,133.3
13207,ny,-76.16415,43.01347,5301,3,7,4,133.3
13208,ny,-76.14502,43.07878,7207,3,8,5,166.7
13209,ny,-76.24855,43.08499,5827,3,7,4,133.3
13210,ny,-76.12606,43.0301,4883,2,6,4,200
13211,ny,-76.11962,43.10341,2647,3,8,5,166.7
13212,ny,-76.13105,43.12818,8325,3,8,5,166.7
13214,ny,-76.07426,43.0382,2880,3,7,4,133.3
13215,ny,-76.23044,42.97991,5667,2,5,3,150
13219,ny,-76.22285,43.03979,6568,2,6,4,200
13224,ny,-76.10288,43.03723,3127,3,7,4,133.3
13290,ny,-76.17364,43.07079,12,3,8,5,166.7
13301,ny,-75.2204,43.41743,217,0,2,2,NA
13302,ny,-75.96964,43.49523,1602,1,3,2,200
13303,ny,-75.4649,43.36597,826,1,3,2,200
13304,ny,-75.16456,43.24247,904,1,4,3,300
13305,ny,-75.42117,43.89229,149,1,2,1,100
13308,ny,-75.66616,43.24881,2072,2,6,4,200
13309,ny,-75.34807,43.4737,3941,0,1,1,NA
13310,ny,-75.5727,42.8922,476,1,4,3,300
13312,ny,-75.20765,43.70739,1078,0,1,1,NA
13313,ny,-75.27295,42.8803,171,1,4,3,300
13314,ny,-75.3194,42.8168,264,1,3,2,200
13315,ny,-75.14518,42.7441,1162,1,3,2,200
13316,ny,-75.74262,43.40947,4442,1,4,3,300
13317,ny,-74.58309,42.85504,2020,2,6,4,200
13318,ny,-75.25775,42.91916,722,1,3,2,200
13319,ny,-75.26693,43.02644,361,1,4,3,300
13320,ny,-74.73846,42.77724,1929,0,1,1,NA
13321,ny,-75.37398,43.08789,292,2,6,4,200
13322,ny,-75.20231,42.96516,678,1,3,2,200
13323,ny,-75.37913,43.04174,4190,2,5,3,150
13324,ny,-74.95414,43.32617,2515,0,1,1,NA
13325,ny,-75.52693,43.57632,1095,0,1,1,NA
13326,ny,-74.90442,42.71458,4197,1,3,2,200
13327,ny,-75.27645,43.95981,1845,0,2,2,NA
13328,ny,-75.42903,42.9851,669,1,4,3,300
13329,ny,-74.69819,43.11124,2542,1,4,3,300
13331,ny,-74.90042,43.84297,1270,0,1,1,NA
13332,ny,-75.57553,42.7568,1525,1,4,3,300
13333,ny,-74.82332,42.83364,55,0,1,1,NA
13334,ny,-75.65808,42.82872,1098,1,3,2,200
13335,ny,-75.25048,42.70267,1132,1,3,2,200
13337,ny,-74.9812,42.75392,596,1,3,2,200
13338,ny,-74.97928,43.50142,3032,0,1,1,NA
13339,ny,-74.66673,42.93996,3823,2,6,4,200
13340,ny,-75.11372,43.05085,4305,2,7,5,250
13341,ny,-75.39689,43.03609,50,2,5,3,150
13342,ny,-75.19102,42.65457,176,1,3,2,200
13343,ny,-75.31077,43.75054,1910,0,2,2,NA
13345,ny,-75.3302,43.68855,189,0,2,2,NA
13346,ny,-75.54386,42.81802,2697,1,4,3,300
13348,ny,-75.06767,42.7086,1139,1,3,2,200
13350,ny,-74.9887,43.06185,4216,3,8,5,166.7
13352,ny,-75.11687,43.3126,54,0,2,2,NA
13353,ny,-74.72544,43.46574,797,0,0,0,NA
13354,ny,-75.26969,43.26309,1740,1,4,3,300
13355,ny,-75.42867,42.81267,660,1,3,2,200
13357,ny,-75.08335,42.96706,4545,1,4,3,300
13360,ny,-74.73792,43.72757,1232,0,1,1,NA
13361,ny,-74.86822,42.90374,634,0,2,2,NA
13362,ny,-75.522,42.98218,32,1,3,2,200
13363,ny,-75.51384,43.32736,1126,1,4,3,300
13364,ny,-75.26107,42.80498,152,1,3,2,200
13365,ny,-74.84489,43.12139,5122,2,6,4,200
13367,ny,-75.30585,43.85826,6223,0,2,2,NA
13368,ny,-75.27518,43.63875,1029,0,2,2,NA
13402,ny,-75.50499,42.90118,868,1,3,2,200
13403,ny,-75.27079,43.16921,2086,2,6,4,200
13404,ny,-75.47176,43.73639,142,0,2,2,NA
13406,ny,-74.91786,43.13528,463,1,3,2,200
13407,ny,-74.9445,42.96895,2989,1,4,3,300
13408,ny,-75.66919,42.91979,1453,1,3,2,200
13409,ny,-75.59511,42.97649,1263,1,3,2,200
13410,ny,-74.61259,42.93104,125,2,7,5,250
13411,ny,-75.3116,42.63305,2196,1,4,3,300
13413,ny,-75.27713,43.05901,6644,2,5,3,150
13415,ny,-75.19848,42.5965,70,1,3,2,200
13416,ny,-74.95613,43.18709,1529,1,3,2,200
13417,ny,-75.29381,43.10094,1292,2,7,5,250
13418,ny,-75.38216,42.84506,149,1,3,2,200
13420,ny,-74.99232,43.70795,3813,0,1,1,NA
13421,ny,-75.64466,43.06525,5817,2,5,3,150
13424,ny,-75.36521,43.15237,1108,2,7,5,250
13425,ny,-75.48701,42.96348,1163,1,3,2,200
13428,ny,-74.54059,42.92177,863,3,7,4,133.3
13431,ny,-75.07746,43.21287,1163,1,3,2,200
13433,ny,-75.26497,43.5864,1256,0,2,2,NA
13435,ny,-75.15077,43.30498,143,1,3,2,200
13436,ny,-74.66028,43.81106,582,0,1,1,NA
13437,ny,-75.80363,43.59718,1298,0,2,2,NA
13438,ny,-75.16444,43.34883,3479,0,2,2,NA
13439,ny,-74.99561,42.85611,3197,1,2,1,100
13440,ny,-75.46138,43.216,17224,2,6,4,200
13441,ny,-75.40824,43.22637,65,2,6,4,200
13450,ny,-74.81029,42.70193,95,0,1,1,NA
13452,ny,-74.62848,43.03925,3041,2,5,3,150
13454,ny,-74.75736,43.20988,726,1,3,2,200
13456,ny,-75.25549,43.00003,1965,1,3,2,200
13459,ny,-74.58822,42.77652,1615,1,3,2,200
13460,ny,-75.45422,42.68708,2412,1,4,3,300
13461,ny,-75.59913,43.07047,1264,2,5,3,150
13464,ny,-75.61758,42.68586,987,1,4,3,300
13468,ny,-74.85581,42.84521,335,0,2,2,NA
13469,ny,-75.29956,43.21525,379,1,5,4,400
13470,ny,-74.64134,43.19984,1146,0,1,1,NA
13471,ny,-75.6175,43.42061,1921,1,4,3,300
13472,ny,-75.05938,43.69405,613,0,1,1,NA
13473,ny,-75.46381,43.64443,922,0,1,1,NA
13475,ny,-74.83053,42.89374,19,0,2,2,NA
13476,ny,-75.50962,43.08837,1361,2,5,3,150
13477,ny,-75.51294,43.0329,665,1,3,2,200
13478,ny,-75.58208,43.14925,1560,2,6,4,200
13480,ny,-75.36751,42.91577,1848,1,3,2,200
13483,ny,-75.82557,43.39758,215,1,4,3,300
13484,ny,-75.65919,42.86633,80,1,3,2,200
13485,ny,-75.31491,42.78675,1034,1,3,2,200
13486,ny,-75.34962,43.34666,611,1,3,2,200
13488,ny,-74.74888,42.69099,116,0,1,1,NA
13489,ny,-75.54181,43.46718,621,0,1,1,NA
13490,ny,-75.42651,43.11008,740,2,5,3,150
13491,ny,-75.17636,42.8627,2231,1,3,2,200
13492,ny,-75.32878,43.11987,5130,3,7,4,133.3
13493,ny,-75.89574,43.43415,1812,1,4,3,300
13494,ny,-75.14119,43.53267,950,0,1,1,NA
13495,ny,-75.2775,43.11089,1137,3,8,5,166.7
13501,ny,-75.2264,43.08127,12474,2,6,4,200
13502,ny,-75.1611,43.14101,13425,2,7,5,250
13601,ny,-75.90671,43.96837,15579,1,3,2,200
13602,ny,-75.76507,44.05127,12,1,3,2,200
13603,ny,-75.79782,44.03698,9,1,3,2,200
13605,ny,-76.049,43.80622,2645,0,1,1,NA
13606,ny,-76.01519,43.87206,1249,0,2,2,NA
13607,ny,-75.91902,44.3154,1810,2,5,3,150
13608,ny,-75.62524,44.24029,904,1,4,3,300
13612,ny,-75.77161,43.98821,1157,1,2,1,100
13613,ny,-74.74078,44.86384,1950,2,5,3,150
13614,ny,-75.69117,44.53089,270,2,5,3,150
13615,ny,-75.98508,44.04018,491,1,3,2,200
13616,ny,-75.85864,44.02607,399,1,3,2,200
13617,ny,-75.14932,44.57922,4129,1,4,3,300
13618,ny,-76.27703,44.1184,2442,0,1,1,NA
13619,ny,-75.60119,43.97906,4931,1,2,1,100
13620,ny,-75.45018,43.91036,1222,1,2,1,100
13621,ny,-75.07202,44.83976,524,2,5,3,150
13622,ny,-76.11318,44.09636,1992,1,2,1,100
13623,ny,-75.75246,44.44979,64,2,5,3,150
13624,ny,-76.09417,44.21204,3818,1,4,3,300
13625,ny,-74.92601,44.53797,1698,1,2,1,100
13626,ny,-75.72056,43.84131,1825,0,1,1,NA
13628,ny,-75.68259,44.03184,95,1,3,2,200
13630,ny,-75.31527,44.49743,895,2,4,2,100
13633,ny,-75.48392,44.48692,310,2,5,3,150
13634,ny,-76.07796,44.00936,2738,1,2,1,100
13635,ny,-75.25042,44.30391,895,1,3,2,200
13636,ny,-76.11655,43.74344,170,0,1,1,NA
13637,ny,-75.82998,44.09631,1164,1,4,3,300
13638,ny,-75.74886,44.02031,183,1,2,1,100
13639,ny,-75.13794,44.25412,267,1,2,1,100
13640,ny,-75.99101,44.3223,1283,2,5,3,150
13641,ny,-76.00491,44.27516,211,2,5,3,150
13642,ny,-75.45708,44.3361,5163,2,4,2,100
13643,ny,-75.71709,44.03181,19,1,3,2,200
13646,ny,-75.67848,44.43936,3327,2,5,3,150
13647,ny,-74.98058,44.60588,18,1,3,2,200
13648,ny,-75.31813,44.14916,2766,1,2,1,100
13650,ny,-76.20689,43.80835,2117,0,1,1,NA
13651,ny,-76.1778,43.86903,282,0,1,1,NA
13652,ny,-75.20323,44.44227,1455,1,3,2,200
13654,ny,-75.45569,44.56872,1499,2,5,3,150
13655,ny,-74.65115,44.9781,148,2,5,3,150
13656,ny,-75.94968,44.19134,1491,2,4,2,100
13658,ny,-75.27742,44.73789,1600,2,5,3,150
13659,ny,-75.8712,43.73826,633,0,0,0,NA
13660,ny,-75.15855,44.77121,1117,2,5,3,150
13661,ny,-76.10682,43.70996,1265,0,1,1,NA
13662,ny,-74.8845,44.93223,8350,2,5,3,150
13664,ny,-75.64532,44.58425,343,2,4,2,100
13665,ny,-75.44369,44.0477,728,1,2,1,100
13666,ny,-74.9423,44.2177,248,0,2,2,NA
13667,ny,-74.96393,44.83723,1808,2,5,3,150
13668,ny,-74.98606,44.75497,1824,2,4,2,100
13669,ny,-75.49518,44.64408,7786,2,5,3,150
13670,ny,-75.11352,44.16999,663,0,1,1,NA
13672,ny,-74.68523,44.50258,725,1,2,1,100
13673,ny,-75.71872,44.16659,933,1,4,3,300
13674,ny,-76.05507,43.73826,78,0,1,1,NA
13675,ny,-75.8484,44.27902,60,2,4,2,100
13676,ny,-74.92139,44.653,6288,1,4,3,300
13677,ny,-75.17894,44.51138,51,1,3,2,200
13678,ny,-74.98394,44.82076,122,2,5,3,150
13679,ny,-75.76436,44.3244,2078,2,5,3,150
13680,ny,-75.32388,44.59419,761,2,5,3,150
13681,ny,-75.37084,44.42851,537,2,4,2,100
13682,ny,-75.89012,43.84192,575,0,1,1,NA
13684,ny,-75.04069,44.36185,1148,1,2,1,100
13685,ny,-76.18048,43.92411,1404,1,3,2,200
13687,ny,-74.8205,44.42317,891,0,2,2,NA
13690,ny,-75.01032,44.11591,833,0,2,2,NA
13691,ny,-75.78315,44.22543,2162,2,4,2,100
13692,ny,-76.02629,44.28879,13,2,6,4,200
13693,ny,-76.25109,44.02773,1593,0,1,1,NA
13694,ny,-75.1611,44.85096,1142,2,5,3,150
13695,ny,-74.92153,44.1098,229,0,1,1,NA
13696,ny,-74.88805,44.69474,77,1,4,3,300
13697,ny,-74.80951,44.7489,1613,2,5,3,150
13730,ny,-75.53323,42.22932,1958,1,3,2,200
13731,ny,-74.78926,42.12929,2080,0,1,1,NA
13732,ny,-76.16796,42.04408,3583,1,4,3,300
13733,ny,-75.48204,42.3032,3358,1,3,2,200
13734,ny,-76.40766,42.07437,1202,2,5,3,150
13736,ny,-76.19834,42.31851,1518,1,3,2,200
13739,ny,-74.7928,42.36613,963,0,1,1,NA
13740,ny,-74.75078,42.27134,894,0,0,0,NA
13743,ny,-76.33856,42.21613,2069,1,4,3,300
13744,ny,-75.90916,42.23868,645,1,3,2,200
13746,ny,-75.83524,42.27242,1359,1,4,3,300
13748,ny,-75.81706,42.03422,1824,1,4,3,300
13750,ny,-74.84606,42.47129,883,0,2,2,NA
13751,ny,-74.90128,42.4508,109,0,2,2,NA
13752,ny,-74.90133,42.18315,929,0,1,1,NA
13753,ny,-74.92681,42.30734,2769,0,1,1,NA
13754,ny,-75.43582,42.09108,2786,1,2,1,100
13755,ny,-74.99795,42.06286,1429,0,1,1,NA
13756,ny,-75.10094,42.00627,911,0,1,1,NA
13757,ny,-74.9037,42.40899,1003,0,1,1,NA
13760,ny,-76.08469,42.1349,18353,2,5,3,150
13774,ny,-75.15918,41.96546,179,0,1,1,NA
13775,ny,-75.14709,42.33091,1413,1,2,1,100
13776,ny,-75.33297,42.47054,338,1,3,2,200
13777,ny,-75.98958,42.25817,297,1,2,1,100
13778,ny,-75.75479,42.34332,3312,1,4,3,300
13780,ny,-75.4793,42.42484,786,1,2,1,100
13782,ny,-74.982,42.16642,860,0,1,1,NA
13783,ny,-75.26473,41.99142,2967,1,2,1,100
13784,ny,-76.22134,42.42688,53,1,2,1,100
13786,ny,-74.69466,42.4414,477,0,1,1,NA
13787,ny,-75.66759,42.20505,2106,1,3,2,200
13788,ny,-74.65809,42.35103,1155,0,0,0,NA
13790,ny,-75.99799,42.17015,7779,1,4,3,300
13794,ny,-76.01372,42.39324,50,1,4,3,300
13795,ny,-75.77991,42.0606,1790,1,3,2,200
13796,ny,-75.13979,42.55071,827,1,3,2,200
13797,ny,-76.04829,42.33041,1145,1,3,2,200
13801,ny,-75.77964,42.50963,1627,1,3,2,200
13802,ny,-76.04054,42.2494,420,1,3,2,200
13803,ny,-76.06323,42.45651,2477,1,3,2,200
13804,ny,-75.37392,42.21021,356,0,2,2,NA
13806,ny,-74.96504,42.37343,145,0,1,1,NA
13807,ny,-74.98651,42.60874,1005,1,3,2,200
13808,ny,-75.25649,42.52789,1189,1,3,2,200
13809,ny,-75.39555,42.40383,1068,1,3,2,200
13810,ny,-75.11152,42.61167,956,1,3,2,200
13811,ny,-76.17461,42.23178,2366,1,4,3,300
13812,ny,-76.35397,42.03009,1325,1,4,3,300
13813,ny,-75.54751,42.16684,797,1,2,1,100
13815,ny,-75.53118,42.54689,6628,1,3,2,200
13820,ny,-75.04058,42.47467,8276,1,3,2,200
13825,ny,-75.20219,42.4394,2126,1,3,2,200
13826,ny,-75.63994,42.10261,75,1,3,2,200
13827,ny,-76.25457,42.11182,5735,2,4,2,100
13830,ny,-75.62797,42.44002,3305,1,3,2,200
13832,ny,-75.67579,42.65777,537,1,3,2,200
13833,ny,-75.76715,42.19943,1947,1,3,2,200
13834,ny,-74.96283,42.53364,53,1,3,2,200
13835,ny,-76.17118,42.38957,1052,1,3,2,200
13838,ny,-75.39267,42.28581,2053,1,2,1,100
13839,ny,-75.25795,42.26141,1228,0,2,2,NA
13841,ny,-75.8369,42.41373,445,1,3,2,200
13842,ny,-74.724,42.37365,439,0,1,1,NA
13843,ny,-75.3734,42.52442,1467,1,3,2,200
13844,ny,-75.67041,42.61009,551,1,2,1,100
13845,ny,-76.35355,42.05486,46,2,5,3,150
13846,ny,-75.05217,42.36282,216,0,1,1,NA
13847,ny,-75.29062,42.18594,68,1,2,1,100
13849,ny,-75.31145,42.34381,2830,1,3,2,200
13850,ny,-76.02658,42.04877,9295,1,3,2,200
13856,ny,-75.16722,42.16589,5027,0,2,2,NA
13859,ny,-75.24855,42.37091,113,1,4,3,300
13860,ny,-74.93805,42.4514,41,1,2,1,100
13861,ny,-75.14915,42.50538,250,1,4,3,300
13862,ny,-75.9385,42.33634,2349,1,3,2,200
13863,ny,-75.90866,42.44844,535,1,3,2,200
13864,ny,-76.39271,42.28922,686,1,4,3,300
13865,ny,-75.63302,42.06278,4434,1,2,1,100
13901,ny,-75.87987,42.18237,7807,1,4,3,300
13902,ny,-75.96888,42.08882,11,1,3,2,200
13903,ny,-75.89547,42.04728,8818,1,3,2,200
13904,ny,-75.81598,42.1308,4173,1,3,2,200
13905,ny,-75.94471,42.18015,9561,1,3,2,200
14001,ny,-78.51207,43.03298,4333,2,4,2,100
14004,ny,-78.50969,42.8947,4538,1,2,1,100
14005,ny,-78.25032,42.91696,1090,1,4,3,300
14006,ny,-79.02433,42.63375,6460,1,3,2,200
14008,ny,-78.62824,43.31312,746,2,5,3,150
14009,ny,-78.39318,42.57461,3110,0,1,1,NA
14011,ny,-78.29691,42.83224,3176,1,2,1,100
14012,ny,-78.52606,43.33567,1436,2,5,3,150
14013,ny,-78.39763,43.08141,730,2,6,4,200
14020,ny,-78.21265,42.99619,9125,2,5,3,150
14024,ny,-78.24924,42.58014,1592,0,1,1,NA
14025,ny,-78.72704,42.6222,1505,0,1,1,NA
14026,ny,-78.68797,42.94236,337,1,3,2,200
14028,ny,-78.71773,43.31695,927,2,5,3,150
14030,ny,-78.50093,42.56631,1066,0,1,1,NA
14031,ny,-78.61078,42.98718,3855,1,3,2,200
14032,ny,-78.63077,43.04673,3526,1,4,3,300
14033,ny,-78.68685,42.66061,1177,0,1,1,NA
14034,ny,-78.8609,42.49817,953,1,3,2,200
14035,ny,-78.84839,42.49078,65,1,2,1,100
14036,ny,-78.38736,42.97503,2688,2,5,3,150
14037,ny,-78.4551,42.8058,608,0,1,1,NA
14039,ny,-78.16929,42.83625,74,1,2,1,100
14040,ny,-78.38114,42.88924,1041,1,3,2,200
14041,ny,-78.97359,42.40359,155,1,2,1,100
14042,ny,-78.48655,42.46902,2023,0,1,1,NA
14043,ny,-78.70342,42.90197,10364,1,3,2,200
14047,ny,-78.99574,42.68642,2864,1,3,2,200
14048,ny,-79.31671,42.48447,8530,2,5,3,150
14051,ny,-78.69911,43.04217,7353,1,4,3,300
14052,ny,-78.58109,42.7702,7966,0,1,1,NA
14054,ny,-78.12751,42.91515,775,1,3,2,200
14055,ny,-78.60139,42.55467,856,0,1,1,NA
14057,ny,-78.87728,42.64582,3691,1,2,1,100
14058,ny,-78.16269,43.10241,1634,3,7,4,133.3
14059,ny,-78.63604,42.83365,4523,1,2,1,100
14060,ny,-78.30788,42.44659,381,0,1,1,NA
14061,ny,-79.0793,42.59388,206,2,4,2,100
14062,ny,-79.15071,42.44087,2616,1,2,1,100
14063,ny,-79.32647,42.41408,6082,1,3,2,200
14065,ny,-78.31335,42.48718,1065,0,1,1,NA
14066,ny,-78.18043,42.62426,944,0,1,1,NA
14067,ny,-78.56665,43.21572,2516,2,5,3,150
14068,ny,-78.75666,43.02739,2062,1,4,3,300
14069,ny,-78.6338,42.60767,508,0,1,1,NA
14070,ny,-78.92583,42.43611,2437,1,3,2,200
14072,ny,-78.96353,43.01816,8970,1,4,3,300
14075,ny,-78.83294,42.71432,17246,1,2,1,100
14080,ny,-78.54667,42.64403,2498,0,1,1,NA
14081,ny,-79.06399,42.56197,1691,1,4,3,300
14082,ny,-78.38241,42.65654,296,0,1,1,NA
14085,ny,-78.92998,42.71485,3596,1,3,2,200
14086,ny,-78.62906,42.90806,14005,1,3,2,200
14091,ny,-78.88368,42.54239,489,1,2,1,100
14092,ny,-78.99364,43.17355,4515,2,5,3,150
14094,ny,-78.70091,43.16018,19987,2,5,3,150
14098,ny,-78.38061,43.33437,1974,3,7,4,133.3
14101,ny,-78.54355,42.38955,1408,0,1,1,NA
14102,ny,-78.5569,42.83931,545,0,2,2,NA
14103,ny,-78.37665,43.21225,4846,2,6,4,200
14105,ny,-78.48395,43.19784,2196,2,5,3,150
14108,ny,-78.72694,43.26334,2372,2,6,4,200
14109,ny,-79.03413,43.13795,3,2,5,3,150
14111,ny,-78.90082,42.58254,1858,1,3,2,200
14112,ny,-78.93995,42.69796,29,1,3,2,200
14113,ny,-78.33971,42.67164,459,0,1,1,NA
14120,ny,-78.83642,43.07363,18118,2,5,3,150
14125,ny,-78.27838,43.08698,1853,2,6,4,200
14126,ny,-78.72842,43.33689,429,2,5,3,150
14127,ny,-78.74378,42.75174,12338,0,2,2,NA
14129,ny,-79.01042,42.48013,748,1,3,2,200
14130,ny,-78.14765,42.55598,139,0,2,2,NA
14131,ny,-78.89954,43.23721,2346,3,6,3,100
14132,ny,-78.87773,43.14933,2594,2,5,3,150
14134,ny,-78.52398,42.52769,58,0,1,1,NA
14135,ny,-79.2409,42.48769,95,1,4,3,300
14136,ny,-79.173,42.52743,3131,1,4,3,300
14138,ny,-79.05056,42.37023,1290,0,2,2,NA
14139,ny,-78.53478,42.71653,1133,0,1,1,NA
14141,ny,-78.70935,42.52208,3779,0,1,1,NA
14143,ny,-78.07336,42.97557,694,2,5,3,150
14145,ny,-78.42815,42.73005,936,0,1,1,NA
14150,ny,-78.87822,42.99784,17080,1,4,3,300
14167,ny,-78.32489,42.74412,1198,0,1,1,NA
14168,ny,-78.99054,42.52038,24,2,5,3,150
14169,ny,-78.5237,42.76614,43,0,1,1,NA
14170,ny,-78.67088,42.70225,1197,0,1,1,NA
14171,ny,-78.64277,42.42278,1517,0,1,1,NA
14172,ny,-78.8187,43.28585,2038,2,6,4,200
14173,ny,-78.4731,42.52597,200,0,1,1,NA
14174,ny,-79.00343,43.24529,3074,2,6,4,200
14201,ny,-78.88718,42.89667,2441,1,2,1,100
14202,ny,-78.88536,42.88764,781,1,2,1,100
14203,ny,-78.86775,42.86238,611,1,2,1,100
14204,ny,-78.86132,42.88213,3479,1,2,1,100
14206,ny,-78.81134,42.88088,9809,1,3,2,200
14207,ny,-78.89782,42.95172,7141,1,3,2,200
14208,ny,-78.85299,42.91611,4417,1,3,2,200
14209,ny,-78.86602,42.91395,2189,1,2,1,100
14210,ny,-78.82736,42.86353,5853,1,3,2,200
14211,ny,-78.81901,42.90779,11952,1,3,2,200
14212,ny,-78.82017,42.89421,6257,1,3,2,200
14213,ny,-78.89278,42.91799,6725,1,2,1,100
14214,ny,-78.84079,42.93958,6061,1,3,2,200
14215,ny,-78.81068,42.93534,13890,1,3,2,200
14216,ny,-78.86169,42.94845,7167,1,3,2,200
14217,ny,-78.87687,42.97188,8560,1,3,2,200
14218,ny,-78.82973,42.81967,7045,1,3,2,200
14219,ny,-78.82831,42.78887,5228,1,3,2,200
14220,ny,-78.82326,42.84568,8983,1,3,2,200
14221,ny,-78.72286,42.98001,18292,1,3,2,200
14222,ny,-78.87692,42.91983,2946,1,2,1,100
14223,ny,-78.8462,42.97345,9126,1,3,2,200
14224,ny,-78.74802,42.83776,16406,1,3,2,200
14225,ny,-78.75163,42.92898,13475,1,3,2,200
14226,ny,-78.79868,42.97097,10671,1,3,2,200
14227,ny,-78.74607,42.88417,7921,1,3,2,200
14228,ny,-78.78125,43.04091,6016,1,4,3,300
14261,ny,-78.78531,43.00197,7,1,4,3,300
14301,ny,-79.04041,43.09582,5077,2,5,3,150
14302,ny,-79.04919,43.0939,2,2,5,3,150
14303,ny,-79.0384,43.08497,3325,2,5,3,150
14304,ny,-78.95199,43.09941,12975,2,5,3,150
14305,ny,-79.02232,43.11959,7893,2,5,3,150
14411,ny,-78.21196,43.23424,5355,3,7,4,133.3
14414,ny,-77.73515,42.89349,2548,2,5,3,150
14415,ny,-77.01708,42.7555,62,3,6,3,100
14416,ny,-77.98176,43.07904,1919,3,6,3,100
14418,ny,-77.2152,42.60785,1234,1,3,2,200
14420,ny,-77.93458,43.212,6525,3,6,3,100
14422,ny,-78.0657,43.08234,1402,3,7,4,133.3
14423,ny,-77.82756,42.9442,2107,2,6,4,200
14424,ny,-77.30818,42.84814,12643,2,6,4,200
14425,ny,-77.33802,42.99152,3979,3,7,4,133.3
14427,ny,-78.05369,42.62054,1322,1,3,2,200
14428,ny,-77.8595,43.07741,3607,2,6,4,200
14432,ny,-77.14353,42.95741,2165,3,6,3,100
14433,ny,-76.8786,43.08197,2463,3,7,4,133.3
14435,ny,-77.66233,42.71314,1983,1,3,2,200
14437,ny,-77.73825,42.5752,5043,1,4,3,300
14441,ny,-76.95723,42.68521,228,3,8,5,166.7
14445,ny,-77.48986,43.11262,3072,3,7,4,133.3
14450,ny,-77.41705,43.09164,15415,3,6,3,100
14454,ny,-77.77386,42.7969,2876,2,4,2,100
14456,ny,-77.00125,42.84589,8516,3,7,4,133.3
14462,ny,-77.75112,42.68654,354,2,5,3,150
14464,ny,-77.93623,43.32778,2617,3,7,4,133.3
14466,ny,-77.58105,42.77652,844,1,3,2,200
14467,ny,-77.61012,43.04166,3335,2,6,4,200
14468,ny,-77.80425,43.29304,7855,2,6,4,200
14469,ny,-77.46597,42.87754,2897,1,4,3,300
14470,ny,-78.05347,43.21054,3624,3,6,3,100
14471,ny,-77.49219,42.75379,2137,1,3,2,200
14472,ny,-77.57913,42.96728,3599,3,6,3,100
14475,ny,-77.4983,42.93782,122,2,5,3,150
14476,ny,-78.04463,43.3292,1326,4,9,5,125
14477,ny,-78.13586,43.33362,1157,5,10,5,100
14478,ny,-77.12632,42.57785,854,2,4,2,100
14479,ny,-78.31377,43.23626,115,3,6,3,100
14480,ny,-77.70684,42.83945,428,2,5,3,150
14481,ny,-77.92144,42.76181,953,3,7,4,133.3
14482,ny,-77.97232,42.97704,3872,2,5,3,150
14485,ny,-77.60055,42.87989,1665,2,5,3,150
14486,ny,-77.92158,42.89428,160,2,5,3,150
14487,ny,-77.63601,42.81176,2912,1,4,3,300
14489,ny,-76.99002,43.08496,3373,3,7,4,133.3
14502,ny,-77.33548,43.09727,2182,3,7,4,133.3
14504,ny,-77.23152,42.96901,524,3,7,4,133.3
14505,ny,-77.17323,43.16056,2440,3,7,4,133.3
14506,ny,-77.507,43.00178,611,3,7,4,133.3
14507,ny,-77.27026,42.69783,1177,1,3,2,200
14510,ny,-77.87462,42.69012,2201,3,7,4,133.3
14511,ny,-77.87807,42.99759,292,3,6,3,100
14512,ny,-77.39155,42.64552,3908,1,2,1,100
14513,ny,-77.09532,43.07279,5486,3,7,4,133.3
14514,ny,-77.79969,43.09996,2030,2,6,4,200
14516,ny,-76.91597,43.20068,1501,4,9,5,125
14517,ny,-77.89585,42.59242,1446,1,3,2,200
14519,ny,-77.31399,43.23258,4698,2,6,4,200
14521,ny,-76.8075,42.6754,1675,2,6,4,200
14522,ny,-77.22123,43.0611,3085,3,7,4,133.3
14525,ny,-78.01247,42.87333,1605,2,4,2,100
14526,ny,-77.44757,43.15106,7852,3,7,4,133.3
14527,ny,-77.06532,42.66712,7376,2,5,3,150
14529,ny,-77.6381,42.53998,38,0,2,2,NA
14530,ny,-78.00477,42.73346,3175,1,3,2,200
14532,ny,-77.0258,42.96448,2069,3,7,4,133.3
14533,ny,-77.88558,42.8444,1011,3,7,4,133.3
14534,ny,-77.52019,43.05587,12638,3,7,4,133.3
14536,ny,-78.08333,42.54193,524,1,2,1,100
14537,ny,-77.1632,43.03581,83,3,7,4,133.3
14539,ny,-77.87475,42.8345,94,3,7,4,133.3
14541,ny,-76.84442,42.75659,1498,3,8,5,166.7
14542,ny,-76.86012,43.14733,54,3,8,5,166.7
14543,ny,-77.6774,42.98756,1612,3,6,3,100
14544,ny,-77.24345,42.75659,1406,1,4,3,300
14545,ny,-77.70101,42.66486,103,1,2,1,100
14546,ny,-77.77347,43.03102,2299,3,6,3,100
14548,ny,-77.24387,42.97607,1807,3,7,4,133.3
14549,ny,-78.01727,42.70003,63,1,2,1,100
14550,ny,-78.09104,42.67783,1007,1,2,1,100
14551,ny,-77.04494,43.21905,2649,3,8,5,166.7
14555,ny,-76.97791,43.25909,1302,4,10,6,150
14559,ny,-77.81797,43.18806,7194,2,6,4,200
14560,ny,-77.57082,42.68377,1415,1,2,1,100
14561,ny,-77.13175,42.82045,1644,2,4,2,100
14564,ny,-77.42406,42.98295,6072,3,7,4,133.3
14568,ny,-77.28382,43.14721,1988,3,7,4,133.3
14569,ny,-78.17137,42.73929,3190,1,2,1,100
14571,ny,-78.25302,43.34252,1161,5,9,4,80
14572,ny,-77.57097,42.56535,2965,0,1,1,NA
14580,ny,-77.44586,43.21985,19077,2,6,4,200
14585,ny,-77.55315,42.90626,1,2,5,3,150
14586,ny,-77.68691,43.04182,4035,2,6,4,200
14588,ny,-76.8708,42.68099,35,2,6,4,200
14589,ny,-77.17251,43.2401,3505,2,6,4,200
14590,ny,-76.82719,43.24225,3802,3,8,5,166.7
14591,ny,-78.09834,42.83194,1116,1,3,2,200
14592,ny,-77.89589,42.87224,48,2,6,4,200
14604,ny,-77.60481,43.15677,355,2,6,4,200
14605,ny,-77.60202,43.16829,3751,3,6,3,100
14606,ny,-77.69849,43.17131,10335,3,6,3,100
14607,ny,-77.58643,43.15078,3513,3,7,4,133.3
14608,ny,-77.62383,43.15355,3808,3,6,3,100
14609,ny,-77.55277,43.17751,15556,3,7,4,133.3
14610,ny,-77.54541,43.14258,4905,3,7,4,133.3
14611,ny,-77.64732,43.14758,5881,3,7,4,133.3
14612,ny,-77.67548,43.2673,12781,3,7,4,133.3
14613,ny,-77.64041,43.18231,4016,3,6,3,100
14614,ny,-77.61491,43.15734,243,2,6,4,200
14615,ny,-77.65599,43.20343,5325,3,7,4,133.3
14616,ny,-77.65766,43.23463,9760,3,7,4,133.3
14617,ny,-77.59359,43.22594,9463,3,7,4,133.3
14618,ny,-77.55535,43.11297,7715,3,7,4,133.3
14619,ny,-77.6489,43.1361,4931,3,7,4,133.3
14620,ny,-77.60517,43.12891,6345,3,7,4,133.3
14621,ny,-77.60372,43.1897,9739,2,6,4,200
14622,ny,-77.55437,43.21522,5533,3,7,4,133.3
14623,ny,-77.6424,43.08846,7495,3,6,3,100
14624,ny,-77.73234,43.1274,14051,3,6,3,100
14625,ny,-77.50531,43.149,4015,3,7,4,133.3
14626,ny,-77.71382,43.21428,10416,3,7,4,133.3
14627,ny,-77.62915,43.12866,13,3,7,4,133.3
14701,ny,-79.25736,42.07889,22346,1,2,1,100
14706,ny,-78.52577,42.11331,2975,0,1,1,NA
14707,ny,-78.06052,42.07734,194,0,1,1,NA
14708,ny,-78.06411,42.01637,255,0,1,1,NA
14709,ny,-77.98558,42.35237,1403,0,1,1,NA
14710,ny,-79.42201,42.09019,3389,1,2,1,100
14711,ny,-78.12149,42.32606,1297,0,2,2,NA
14712,ny,-79.3672,42.18104,2880,1,2,1,100
14714,ny,-78.23322,42.28997,398,0,1,1,NA
14715,ny,-78.14922,42.06759,2079,0,1,1,NA
14716,ny,-79.44572,42.39076,1191,1,3,2,200
14717,ny,-78.18398,42.36403,1495,0,1,1,NA
14718,ny,-79.28728,42.34482,1664,0,1,1,NA
14719,ny,-78.87925,42.33848,2444,0,1,1,NA
14720,ny,-79.2812,42.10859,549,1,2,1,100
14721,ny,-78.26644,42.01392,188,0,1,1,NA
14722,ny,-79.46835,42.2095,1016,1,2,1,100
14723,ny,-79.13985,42.3104,1174,0,1,1,NA
14724,ny,-79.66878,42.05266,2589,0,1,1,NA
14726,ny,-79.02124,42.2516,962,0,1,1,NA
14727,ny,-78.29184,42.20784,4043,0,1,1,NA
14728,ny,-79.41959,42.26294,1405,0,1,1,NA
14729,ny,-78.74341,42.40351,941,0,1,1,NA
14731,ny,-78.65039,42.30049,2948,0,1,1,NA
14732,ny,-79.11641,42.23186,133,0,1,1,NA
14733,ny,-79.1746,42.14917,2400,1,2,1,100
14735,ny,-78.09769,42.45148,2029,0,2,2,NA
14736,ny,-79.74612,42.14082,392,0,1,1,NA
14737,ny,-78.43046,42.33513,3295,0,1,1,NA
14738,ny,-79.06036,42.04557,2605,0,1,1,NA
14739,ny,-78.14759,42.19166,2349,0,1,1,NA
14740,ny,-79.18407,42.21957,878,0,1,1,NA
14741,ny,-78.59825,42.21772,1750,0,1,1,NA
14742,ny,-79.30687,42.1201,184,1,2,1,100
14743,ny,-78.40513,42.20293,1265,0,1,1,NA
14744,ny,-78.2107,42.42232,595,1,2,1,100
14747,ny,-79.09132,42.15413,1436,0,2,2,NA
14748,ny,-78.63735,42.1371,369,0,1,1,NA
14750,ny,-79.32925,42.07975,3969,0,1,1,NA
14752,ny,-79.31986,42.35172,269,0,2,2,NA
14753,ny,-78.64559,42.05058,908,0,1,1,NA
14754,ny,-78.2059,42.02571,513,0,1,1,NA
14755,ny,-78.813,42.23647,2207,0,1,1,NA
14756,ny,-79.42127,42.19804,176,0,1,1,NA
14757,ny,-79.50419,42.23673,3596,1,2,1,100
14760,ny,-78.41386,42.07346,9145,0,1,1,NA
14767,ny,-79.51175,42.05183,1361,0,1,1,NA
14769,ny,-79.47645,42.36814,757,1,3,2,200
14770,ny,-78.30419,42.04238,1628,0,1,1,NA
14772,ny,-78.95334,42.15502,2601,0,1,1,NA
14774,ny,-78.14909,42.08837,70,0,1,1,NA
14775,ny,-79.69524,42.2344,1990,0,2,2,NA
14777,ny,-78.2615,42.3918,818,0,1,1,NA
14778,ny,-78.48324,42.07758,8,0,1,1,NA
14779,ny,-78.77776,42.1065,3668,0,1,1,NA
14781,ny,-79.60183,42.16117,1794,0,1,1,NA
14782,ny,-79.26038,42.26664,1729,0,1,1,NA
14783,ny,-78.88408,42.078,186,0,1,1,NA
14784,ny,-79.3808,42.31541,988,0,2,2,NA
14787,ny,-79.57134,42.31484,4006,1,3,2,200
14788,ny,-78.38011,42.06199,73,0,1,1,NA
14801,ny,-77.28862,42.0969,3130,1,4,3,300
14802,ny,-77.7893,42.25338,399,0,1,1,NA
14803,ny,-77.78685,42.25432,785,0,1,1,NA
14804,ny,-77.84886,42.31718,1323,0,1,1,NA
14805,ny,-76.72419,42.35885,738,1,3,2,200
14806,ny,-77.77933,42.15997,1685,0,1,1,NA
14807,ny,-77.71196,42.41921,1895,1,2,1,100
14808,ny,-77.46686,42.55964,286,0,1,1,NA
14809,ny,-77.44607,42.41971,1595,1,2,1,100
14810,ny,-77.34275,42.34871,5396,1,3,2,200
14812,ny,-76.99555,42.29324,2066,1,3,2,200
14813,ny,-77.99106,42.24792,1853,0,1,1,NA
14814,ny,-76.95272,42.15003,912,2,5,3,150
14815,ny,-77.09277,42.37462,996,1,3,2,200
14816,ny,-76.73129,42.19532,270,1,4,3,300
14817,ny,-76.3427,42.36484,1385,1,3,2,200
14818,ny,-76.81888,42.4481,1388,1,4,3,300
14819,ny,-77.43862,42.22046,586,1,2,1,100
14820,ny,-77.35934,42.19226,533,1,3,2,200
14821,ny,-77.21434,42.23412,1695,1,3,2,200
14822,ny,-77.84963,42.43088,1140,0,1,1,NA
14823,ny,-77.55375,42.24858,2331,1,2,1,100
14824,ny,-76.70087,42.26709,492,1,3,2,200
14825,ny,-76.62114,42.05503,509,2,5,3,150
14826,ny,-77.49695,42.49153,1693,0,2,2,NA
14827,ny,-77.14289,42.18065,80,2,5,3,150
14830,ny,-77.03315,42.12985,8751,2,5,3,150
14836,ny,-77.91783,42.51631,778,0,1,1,NA
14837,ny,-77.01723,42.49726,3576,2,4,2,100
14838,ny,-76.66607,42.18735,1152,1,3,2,200
14839,ny,-77.64479,42.13947,708,0,1,1,NA
14840,ny,-77.18835,42.44213,3820,1,4,3,300
14841,ny,-76.84091,42.52534,903,1,4,3,300
14842,ny,-76.96503,42.59463,605,3,7,4,133.3
14843,ny,-77.64549,42.31833,6471,1,2,1,100
14845,ny,-76.83564,42.20496,8979,2,6,4,200
14846,ny,-78.00103,42.53466,660,0,1,1,NA
14847,ny,-76.7398,42.60394,1587,2,6,4,200
14850,ny,-76.49957,42.431,18040,1,4,3,300
14853,ny,-76.47976,42.44773,11,2,5,3,150
14854,ny,-76.61477,42.5058,16,1,3,2,200
14855,ny,-77.50282,42.14204,495,1,2,1,100
14856,ny,-77.36651,42.37672,88,1,4,3,300
14858,ny,-77.1355,42.03001,836,2,4,2,100
14859,ny,-76.53529,42.11992,731,1,4,3,300
14860,ny,-76.8362,42.59359,973,1,4,3,300
14861,ny,-76.68477,42.08985,827,2,5,3,150
14864,ny,-76.84164,42.27829,721,2,5,3,150
14865,ny,-76.83401,42.34859,1348,2,5,3,150
14867,ny,-76.61417,42.34408,2577,1,3,2,200
14869,ny,-76.77188,42.36503,863,1,3,2,200
14870,ny,-77.1346,42.16765,3903,2,5,3,150
14871,ny,-76.91158,42.04028,2585,2,4,2,100
14872,ny,-76.86774,42.24234,273,3,6,3,100
14873,ny,-77.29834,42.52239,2223,1,2,1,100
14874,ny,-77.17549,42.53018,279,2,4,2,100
14877,ny,-77.68591,42.05664,544,0,1,1,NA
14878,ny,-76.9434,42.45026,616,2,6,4,200
14879,ny,-77.19008,42.31619,1287,1,3,2,200
14880,ny,-77.97068,42.17742,1399,0,1,1,NA
14881,ny,-76.35672,42.40053,92,1,2,1,100
14882,ny,-76.55494,42.58012,1964,2,6,4,200
14883,ny,-76.48118,42.23926,2526,1,4,3,300
14884,ny,-77.8885,42.48017,444,0,1,1,NA
14885,ny,-77.57034,42.04652,623,0,2,2,NA
14886,ny,-76.68976,42.50469,3782,2,4,2,100
14889,ny,-76.58136,42.21529,1233,1,4,3,300
14891,ny,-76.94576,42.37721,2703,2,6,4,200
14892,ny,-76.52706,42.04833,3641,3,7,4,133.3
14893,ny,-77.10772,42.46771,29,1,3,2,200
14894,ny,-76.76901,42.02241,668,2,4,2,100
14895,ny,-77.93705,42.07695,5883,0,1,1,NA
14897,ny,-77.79243,42.02908,676,0,1,1,NA
14898,ny,-77.43903,42.05709,1019,1,2,1,100
14901,ny,-76.74422,42.08199,5627,3,7,4,133.3
14903,ny,-76.87558,42.12527,3854,3,7,4,133.3
14904,ny,-76.79986,42.06985,6831,3,7,4,133.3
14905,ny,-76.84393,42.08825,3906,3,8,5,166.7
15001,pa,-80.31974,40.5921,18341,3,10,7,233.3
15003,pa,-80.21389,40.60109,6052,4,11,7,175
15004,pa,-80.3813,40.3451,146,2,7,5,250
15005,pa,-80.17588,40.64461,4561,4,10,6,150
15006,pa,-79.87689,40.63359,147,4,11,7,175
15007,pa,-79.93169,40.65228,175,4,10,6,150
15009,pa,-80.36544,40.69795,7130,4,10,6,150
15010,pa,-80.35919,40.7687,14245,4,10,6,150
15012,pa,-79.81217,40.15888,8190,5,13,8,160
15014,pa,-79.74102,40.60794,1527,4,12,8,200
15015,pa,-80.0811,40.63725,561,3,9,6,200
15017,pa,-80.12807,40.34037,7980,4,11,7,175
15018,pa,-79.79376,40.27335,593,5,13,8,160
15019,pa,-80.32922,40.40672,910,3,8,5,166.7
15020,pa,-79.94555,40.23016,170,4,12,8,200
15021,pa,-80.43513,40.39427,5126,3,8,5,166.7
15022,pa,-79.93576,40.13236,6518,5,13,8,160
15024,pa,-79.84369,40.57854,4435,4,11,7,175
15025,pa,-79.92192,40.29902,10029,4,11,7,175
15026,pa,-80.35997,40.51078,1943,3,9,6,200
15027,pa,-80.23945,40.66683,1148,4,11,7,175
15028,pa,-79.79884,40.302,132,4,11,7,175
15030,pa,-79.78094,40.58748,729,5,14,9,180
15031,pa,-80.16115,40.34822,427,3,10,7,233.3
15033,pa,-79.86457,40.17925,3547,5,14,9,180
15034,pa,-79.89061,40.35085,898,4,11,7,175
15035,pa,-79.80743,40.38482,1218,3,10,7,233.3
15037,pa,-79.85083,40.25742,6238,4,11,7,175
15038,pa,-79.92631,40.25071,242,4,10,6,150
15042,pa,-80.20526,40.68788,3949,3,10,7,233.3
15043,pa,-80.48906,40.55466,1383,3,9,6,200
15044,pa,-79.94995,40.63904,13313,4,10,6,150
15045,pa,-79.8862,40.32617,2519,4,11,7,175
15046,pa,-80.22855,40.55626,1373,3,10,7,233.3
15047,pa,-79.80003,40.31572,117,4,11,7,175
15049,pa,-79.80557,40.55611,506,4,11,7,175
15050,pa,-80.43878,40.56218,1309,3,8,5,166.7
15051,pa,-79.86702,40.56246,325,5,13,8,160
15052,pa,-80.43963,40.66992,2099,3,9,6,200
15053,pa,-80.35989,40.381,91,3,8,5,166.7
15054,pa,-80.40768,40.36238,232,3,8,5,166.7
15055,pa,-80.12264,40.30642,811,3,10,7,233.3
15056,pa,-80.2138,40.56485,699,4,11,7,175
15057,pa,-80.24821,40.35595,8048,3,9,6,200
15059,pa,-80.4908,40.67928,2373,3,9,6,200
15060,pa,-80.29213,40.36685,386,3,8,5,166.7
15061,pa,-80.31809,40.65877,6305,3,10,7,233.3
15062,pa,-79.88048,40.15034,5051,6,14,8,133.3
15063,pa,-79.9243,40.19503,7219,5,13,8,160
15064,pa,-80.14993,40.35634,280,4,10,6,150
15065,pa,-79.72746,40.64206,5953,4,11,7,175
15066,pa,-80.25308,40.75198,6193,4,10,6,150
15067,pa,-79.96205,40.20862,1172,5,14,9,180
15068,pa,-79.71299,40.56171,18678,4,10,6,150
15071,pa,-80.18781,40.41211,5532,4,11,7,175
15072,pa,-79.85633,40.13924,125,6,15,9,150
15074,pa,-80.21832,40.72786,4673,4,11,7,175
15075,pa,-79.82691,40.58604,54,4,11,7,175
15076,pa,-79.83471,40.60744,427,4,11,7,175
15077,pa,-80.42193,40.62419,192,3,8,5,166.7
15078,pa,-80.38498,40.35591,495,3,8,5,166.7
15081,pa,-80.23631,40.57453,313,4,11,7,175
15082,pa,-80.21295,40.37779,217,3,10,7,233.3
15083,pa,-79.7875,40.25423,596,5,14,9,180
15084,pa,-79.80289,40.63012,5606,4,11,7,175
15085,pa,-79.72245,40.38571,3817,3,10,7,233.3
15086,pa,-80.09516,40.66549,428,3,9,6,200
15087,pa,-79.85309,40.18949,223,4,12,8,200
15088,pa,-79.89574,40.27222,335,4,10,6,150
15089,pa,-79.74045,40.22036,3309,4,11,7,175
15090,pa,-80.06884,40.62567,9256,3,9,6,200
15101,pa,-79.95439,40.58048,9938,4,11,7,175
15102,pa,-80.03661,40.32129,12167,3,9,6,200
15104,pa,-79.86265,40.40373,6146,4,11,7,175
15106,pa,-80.11421,40.41012,9886,4,11,7,175
15108,pa,-80.19954,40.49994,18116,4,10,6,150
15110,pa,-79.8502,40.37318,3513,4,11,7,175
15112,pa,-79.83771,40.40448,1807,4,10,6,150
15116,pa,-79.95048,40.53908,6425,4,12,8,200
15120,pa,-79.90682,40.39603,9796,4,10,6,150
15122,pa,-79.90521,40.36021,9535,4,11,7,175
15126,pa,-80.28436,40.46254,3964,3,9,6,200
15129,pa,-79.99605,40.29315,4965,3,10,7,233.3
15131,pa,-79.8002,40.33599,4305,4,11,7,175
15132,pa,-79.84315,40.3398,12464,4,11,7,175
15133,pa,-79.86335,40.32714,3445,4,11,7,175
15135,pa,-79.81536,40.30158,2361,4,12,8,200
15136,pa,-80.10437,40.46789,11286,5,13,8,160
15137,pa,-79.80905,40.378,6090,3,10,7,233.3
15139,pa,-79.83485,40.52192,2853,3,10,7,233.3
15140,pa,-79.77635,40.40777,1498,4,11,7,175
15142,pa,-80.12206,40.38545,597,5,13,8,160
15143,pa,-80.14657,40.57319,9900,4,11,7,175
15144,pa,-79.78283,40.54926,2129,4,11,7,175
15145,pa,-79.82408,40.41526,3645,4,11,7,175
15146,pa,-79.76043,40.42625,11575,3,10,7,233.3
15147,pa,-79.82732,40.49713,8255,3,10,7,233.3
15148,pa,-79.79514,40.39346,1804,3,10,7,233.3
15201,pa,-79.9528,40.47521,6978,4,12,8,200
15202,pa,-80.06853,40.5053,7833,5,14,9,180
15203,pa,-79.97632,40.42632,5990,4,10,6,150
15204,pa,-80.06085,40.45599,4770,5,14,9,180
15205,pa,-80.09909,40.43808,9987,4,12,8,200
15206,pa,-79.91323,40.47226,12085,4,11,7,175
15207,pa,-79.93376,40.4003,7440,4,11,7,175
15208,pa,-79.89949,40.45319,6248,4,11,7,175
15209,pa,-79.97396,40.49991,6169,5,13,8,160
15210,pa,-79.9839,40.40718,13879,3,10,7,233.3
15211,pa,-80.01562,40.43032,5995,3,10,7,233.3
15212,pa,-80.00753,40.47078,15686,5,13,8,160
15213,pa,-79.95525,40.44404,6344,4,12,8,200
15214,pa,-80.01403,40.4865,8290,5,13,8,160
15215,pa,-79.91382,40.50484,5735,5,13,8,160
15216,pa,-80.03485,40.40263,10488,3,10,7,233.3
15217,pa,-79.92054,40.43077,9231,4,11,7,175
15218,pa,-79.89005,40.42364,6342,4,11,7,175
15219,pa,-79.9832,40.44224,6607,4,11,7,175
15220,pa,-80.04899,40.4197,7943,4,11,7,175
15221,pa,-79.86548,40.43461,14938,4,11,7,175
15222,pa,-79.99328,40.44765,1617,4,12,8,200
15223,pa,-79.95284,40.50505,3393,5,13,8,160
15224,pa,-79.9448,40.46423,4932,4,11,7,175
15225,pa,-80.1115,40.50634,731,4,12,8,200
15226,pa,-80.01395,40.39505,6735,3,9,6,200
15227,pa,-79.97058,40.37571,11736,3,9,6,200
15228,pa,-80.04413,40.37067,6382,3,9,6,200
15229,pa,-80.03705,40.52035,6466,4,11,7,175
15232,pa,-79.93194,40.45252,3170,4,11,7,175
15233,pa,-80.0348,40.46085,2133,6,14,8,133.3
15234,pa,-80.01779,40.36814,6283,3,9,6,200
15235,pa,-79.82242,40.45978,17114,3,10,7,233.3
15236,pa,-79.97547,40.34743,12515,3,9,6,200
15237,pa,-80.04746,40.54884,18322,4,11,7,175
15238,pa,-79.8805,40.53464,6256,4,12,8,200
15239,pa,-79.73806,40.48369,8789,3,10,7,233.3
15241,pa,-80.08245,40.33303,8132,3,9,6,200
15243,pa,-80.07308,40.37482,5187,3,10,7,233.3
15260,pa,-79.95314,40.44323,18,4,12,8,200
15290,pa,-80.01929,40.45733,3,6,14,8,133.3
15301,pa,-80.25282,40.16204,22657,3,8,5,166.7
15310,pa,-80.48219,39.79273,289,3,10,7,233.3
15311,pa,-80.18393,40.04592,766,3,9,6,200
15312,pa,-80.43837,40.25415,2381,3,8,5,166.7
15313,pa,-80.02371,40.06796,225,4,11,7,175
15314,pa,-80.01811,40.14567,2200,4,10,6,150
15315,pa,-79.98278,39.75809,447,5,14,9,180
15316,pa,-80.25376,39.72446,141,3,9,6,200
15317,pa,-80.16679,40.27063,18642,3,9,6,200
15320,pa,-79.99371,39.8769,4376,5,14,9,180
15321,pa,-80.18786,40.3234,925,3,9,6,200
15322,pa,-80.05013,39.97654,1468,5,12,7,140
15323,pa,-80.40682,40.10715,2553,2,7,5,250
15324,pa,-80.06572,40.10078,508,3,9,6,200
15325,pa,-79.96337,39.94943,311,5,13,8,160
15327,pa,-79.96437,39.74939,1383,6,15,9,150
15329,pa,-80.27552,40.03058,1355,3,8,5,166.7
15330,pa,-80.09451,40.18026,3076,3,9,6,200
15331,pa,-80.02164,40.10742,663,3,10,7,233.3
15332,pa,-79.99293,40.24147,4400,4,11,7,175
15333,pa,-80.01505,40.027,1569,5,12,7,140
15334,pa,-79.96794,39.80831,68,6,16,10,166.7
15337,pa,-80.37594,39.95293,518,2,7,5,250
15338,pa,-79.96736,39.80989,1270,6,16,10,166.7
15340,pa,-80.31749,40.28323,899,3,8,5,166.7
15341,pa,-80.34412,39.82527,735,3,9,6,200
15342,pa,-80.22118,40.24423,2629,3,8,5,166.7
15344,pa,-80.05856,39.92034,1334,3,10,7,233.3
15345,pa,-80.10505,40.02263,1361,4,12,8,200
15346,pa,-80.07535,39.93543,417,3,9,6,200
15347,pa,-80.22686,40.2174,388,3,8,5,166.7
15348,pa,-79.99607,39.98829,236,4,12,8,200
15349,pa,-80.08406,39.75808,1518,4,12,8,200
15350,pa,-80.20081,40.29331,223,3,10,7,233.3
15351,pa,-79.92804,39.88099,560,5,14,9,180
15352,pa,-80.39527,39.75339,956,3,10,7,233.3
15353,pa,-80.31095,39.96212,29,2,8,6,300
15357,pa,-79.98576,39.94152,2267,5,13,8,160
15358,pa,-80.00301,40.05539,593,5,13,8,160
15359,pa,-80.27577,39.87649,84,2,8,6,300
15360,pa,-80.08239,40.08491,980,3,10,7,233.3
15361,pa,-80.25841,40.32901,87,3,9,6,200
15362,pa,-80.21674,39.76231,685,3,10,7,233.3
15363,pa,-80.19805,40.2518,396,3,8,5,166.7
15364,pa,-80.2906,39.9415,605,2,8,6,300
15366,pa,-79.97303,40.15955,114,4,11,7,175
15367,pa,-80.05559,40.26524,3639,3,9,6,200
15368,pa,-79.9889,40.01438,288,4,12,8,200
15370,pa,-80.17564,39.87577,7742,3,9,6,200
15376,pa,-80.48692,40.10458,1035,2,8,6,300
15377,pa,-80.4516,39.9814,1098,2,7,5,250
15378,pa,-80.27508,40.27838,68,3,9,6,200
15379,pa,-80.42518,40.24319,114,2,8,6,300
15380,pa,-80.46638,39.87174,680,3,8,5,166.7
15401,pa,-79.74735,39.90106,15512,3,8,5,166.7
15410,pa,-79.90524,39.91458,744,4,12,8,200
15411,pa,-79.34538,39.7476,1520,1,4,3,300
15412,pa,-79.85651,40.09229,408,5,13,8,160
15413,pa,-79.87109,39.98528,384,4,11,7,175
15417,pa,-79.91902,40.01356,5525,4,12,8,200
15419,pa,-79.89446,40.05561,1320,5,13,8,160
15420,pa,-79.86523,39.96014,210,4,11,7,175
15421,pa,-79.5972,39.84585,139,0,2,2,NA
15422,pa,-79.81159,39.98118,128,3,10,7,233.3
15423,pa,-79.92712,40.08767,1292,5,14,9,180
15424,pa,-79.36022,39.81913,2529,1,5,4,400
15425,pa,-79.55655,40.02649,10042,2,6,4,200
15427,pa,-79.97482,40.06995,799,5,12,7,140
15428,pa,-79.68168,40.08097,1179,4,11,7,175
15429,pa,-79.93992,40.00162,184,4,12,8,200
15430,pa,-79.65538,40.04024,177,4,11,7,175
15431,pa,-79.59684,39.9503,2658,2,5,3,150
15432,pa,-79.86162,40.11508,274,6,15,9,150
15433,pa,-79.95819,39.97032,522,5,12,7,140
15434,pa,-79.88116,40.08065,192,5,14,9,180
15435,pa,-79.84994,39.94364,322,4,11,7,175
15436,pa,-79.72478,39.81781,1416,1,3,2,200
15437,pa,-79.60847,39.79059,1716,0,2,2,NA
15438,pa,-79.84247,40.07553,1394,4,12,8,200
15440,pa,-79.61694,39.73526,276,1,3,2,200
15442,pa,-79.8407,40.01739,1497,4,11,7,175
15443,pa,-79.88075,39.91967,227,4,11,7,175
15444,pa,-79.90879,40.01198,362,5,13,8,160
15445,pa,-79.65687,39.87283,1578,1,2,1,100
15446,pa,-79.39918,40.0335,232,1,2,1,100
15447,pa,-79.93689,39.94382,149,5,13,8,160
15448,pa,-79.73395,40.13569,154,4,11,7,175
15449,pa,-79.78335,39.96433,115,3,10,7,233.3
15450,pa,-79.97423,40.00363,339,4,12,8,200
15451,pa,-79.83796,39.73866,593,4,12,8,200
15454,pa,-79.87184,39.86315,140,4,12,8,200
15455,pa,-79.64228,40.0033,179,3,9,6,200
15456,pa,-79.65428,39.92558,1628,1,3,2,200
15458,pa,-79.8512,39.89012,1485,4,11,7,175
15459,pa,-79.46618,39.76664,1174,1,3,2,200
15460,pa,-79.91219,39.81199,87,6,16,10,166.7
15461,pa,-79.90029,39.84235,2482,6,15,9,150
15462,pa,-79.39015,40.05689,163,0,2,2,NA
15463,pa,-79.89983,39.96556,63,4,11,7,175
15464,pa,-79.43694,39.9244,994,1,2,1,100
15466,pa,-79.89204,40.07538,331,6,15,9,150
15467,pa,-79.91788,39.78529,103,6,16,10,166.7
15468,pa,-79.83004,39.95611,1409,3,10,7,233.3
15469,pa,-79.42365,40.01395,1417,1,3,2,200
15470,pa,-79.53352,39.86863,876,1,2,1,100
15472,pa,-79.71685,39.91937,148,3,9,6,200
15473,pa,-79.76973,40.06983,2206,3,9,6,200
15474,pa,-79.90061,39.74958,1347,6,15,9,150
15475,pa,-79.87755,39.95165,1096,4,11,7,175
15476,pa,-79.92061,39.86973,92,5,14,9,180
15477,pa,-79.86367,40.07817,467,5,14,9,180
15478,pa,-79.80317,39.78777,3380,3,10,7,233.3
15479,pa,-79.7144,40.15303,1230,3,10,7,233.3
15480,pa,-79.77201,39.98676,1196,4,11,7,175
15482,pa,-79.76572,40.06074,331,2,7,5,250
15483,pa,-79.85065,40.08333,291,5,13,8,160
15484,pa,-79.784,39.89261,172,4,11,7,175
15486,pa,-79.70471,40.02532,1383,3,9,6,200
15489,pa,-79.69605,39.96638,215,4,11,7,175
15490,pa,-79.45449,40.07237,373,1,2,1,100
15492,pa,-79.76232,40.11942,80,4,12,8,200
15501,pa,-79.12873,40.03594,8701,0,1,1,NA
15502,pa,-79.24607,40.03578,844,0,1,1,NA
15510,pa,-79.04004,39.96697,6,0,1,1,NA
15520,pa,-79.06054,40.10637,154,0,1,1,NA
15521,pa,-78.63501,40.19917,1122,2,6,4,200
15522,pa,-78.55184,39.94935,7756,2,7,5,250
15530,pa,-78.90937,39.94798,2996,0,1,1,NA
15531,pa,-79.07962,40.18447,2912,0,2,2,NA
15532,pa,-79.0608,39.76204,81,0,1,1,NA
15533,pa,-78.24053,39.98277,1012,2,5,3,150
15534,pa,-78.69695,39.89838,767,1,4,3,300
15535,pa,-78.45197,39.82448,2022,3,8,5,166.7
15536,pa,-78.2081,39.95169,346,1,5,4,400
15537,pa,-78.36501,40.00172,5255,2,7,5,250
15538,pa,-78.83624,39.86797,944,1,2,1,100
15539,pa,-78.59138,40.12841,232,3,8,5,166.7
15540,pa,-79.23892,39.79444,459,0,1,1,NA
15541,pa,-78.97721,40.04809,2277,0,1,1,NA
15542,pa,-79.07153,39.8757,811,0,1,1,NA
15544,pa,-79.09344,40.13564,119,0,1,1,NA
15545,pa,-78.77384,39.78414,1965,3,8,5,166.7
15546,pa,-79.04799,40.13662,222,0,1,1,NA
15547,pa,-79.07171,40.16215,307,0,2,2,NA
15550,pa,-78.64393,39.9868,1385,2,5,3,150
15551,pa,-79.27781,39.88566,656,1,2,1,100
15552,pa,-78.99182,39.79392,4007,0,1,1,NA
15554,pa,-78.61844,40.12544,1652,3,7,4,133.3
15555,pa,-79.08225,40.09241,66,0,1,1,NA
15557,pa,-79.21536,39.93035,3163,0,2,2,NA
15558,pa,-79.1115,39.75009,1276,0,1,1,NA
15559,pa,-78.68144,40.05543,1492,3,8,5,166.7
15560,pa,-78.90714,40.01656,110,0,1,1,NA
15561,pa,-79.08767,40.0956,104,0,1,1,NA
15562,pa,-79.13642,39.73901,97,0,1,1,NA
15563,pa,-78.93806,40.09782,2497,0,1,1,NA
15564,pa,-78.8378,39.73001,71,3,9,6,200
15601,pa,-79.53554,40.31518,26322,3,8,5,166.7
15610,pa,-79.41487,40.14157,3442,1,2,1,100
15611,pa,-79.65264,40.30652,236,3,8,5,166.7
15612,pa,-79.59972,40.13735,274,3,9,6,200
15613,pa,-79.56424,40.55381,7005,3,9,6,200
15615,pa,-79.73416,40.36531,212,3,10,7,233.3
15616,pa,-79.55822,40.22463,24,3,8,5,166.7
15617,pa,-79.6578,40.26907,204,3,9,6,200
15618,pa,-79.44519,40.56211,1660,4,10,6,150
15620,pa,-79.33869,40.32354,467,2,6,4,200
15621,pa,-79.48346,40.21386,15,3,8,5,166.7
15622,pa,-79.32285,40.04177,2136,0,1,1,NA
15623,pa,-79.62034,40.3672,432,2,8,6,300
15624,pa,-79.4702,40.36487,219,3,9,6,200
15625,pa,-79.67975,40.26951,76,3,9,6,200
15626,pa,-79.57616,40.40699,2164,2,8,6,300
15627,pa,-79.30596,40.35128,3330,1,4,3,300
15628,pa,-79.37337,40.10055,267,1,3,2,200
15629,pa,-79.5631,40.59726,434,4,10,6,150
15631,pa,-79.58535,40.08748,583,3,10,7,233.3
15632,pa,-79.60687,40.43898,4563,3,9,6,200
15633,pa,-79.52391,40.35732,171,3,9,6,200
15634,pa,-79.60492,40.32394,307,2,7,5,250
15635,pa,-79.49901,40.34906,156,2,7,5,250
15636,pa,-79.65708,40.36547,1615,3,10,7,233.3
15637,pa,-79.71182,40.26496,1129,3,10,7,233.3
15638,pa,-79.39896,40.26432,149,1,5,4,400
15639,pa,-79.59383,40.20815,1188,3,8,5,166.7
15640,pa,-79.72926,40.22463,199,4,10,6,150
15641,pa,-79.58907,40.6317,286,4,11,7,175
15642,pa,-79.72048,40.31919,20916,3,10,7,233.3
15644,pa,-79.61125,40.34739,10196,2,8,6,300
15646,pa,-79.33555,40.08991,160,0,1,1,NA
15647,pa,-79.72363,40.34549,176,3,9,6,200
15650,pa,-79.39321,40.27575,13847,2,7,5,250
15655,pa,-79.17503,40.20149,292,1,2,1,100
15656,pa,-79.62208,40.64635,5829,4,10,6,150
15658,pa,-79.22324,40.25045,6431,1,4,3,300
15660,pa,-79.77439,40.2446,205,5,14,9,180
15661,pa,-79.36013,40.32217,287,3,9,6,200
15662,pa,-79.47833,40.33432,85,2,7,5,250
15663,pa,-79.67927,40.25185,276,3,9,6,200
15665,pa,-79.66069,40.3359,738,3,9,6,200
15666,pa,-79.51441,40.15619,8582,2,7,5,250
15668,pa,-79.67126,40.46202,6058,3,9,6,200
15670,pa,-79.43005,40.40694,2067,3,10,7,233.3
15671,pa,-79.3218,40.35629,404,2,5,3,150
15672,pa,-79.63113,40.24366,1504,3,8,5,166.7
15673,pa,-79.5563,40.59383,672,3,9,6,200
15675,pa,-79.63707,40.3353,553,3,8,5,166.7
15676,pa,-79.46571,40.24083,276,3,8,5,166.7
15677,pa,-79.23732,40.14313,351,1,2,1,100
15678,pa,-79.72623,40.28722,267,4,11,7,175
15679,pa,-79.65086,40.17519,1620,2,7,5,250
15680,pa,-79.49928,40.52078,47,4,12,8,200
15681,pa,-79.43849,40.50095,3845,4,11,7,175
15683,pa,-79.60724,40.10771,4019,3,9,6,200
15684,pa,-79.52066,40.4607,589,3,9,6,200
15686,pa,-79.43272,40.61945,555,2,8,6,300
15687,pa,-79.3209,40.13244,981,1,3,2,200
15688,pa,-79.58466,40.16873,296,2,7,5,250
15689,pa,-79.49144,40.22142,105,3,8,5,166.7
15690,pa,-79.53994,40.64175,4708,3,10,7,233.3
15691,pa,-79.68614,40.29538,43,3,10,7,233.3
15692,pa,-79.67891,40.33176,504,3,9,6,200
15693,pa,-79.4077,40.25315,84,1,5,4,400
15695,pa,-79.69324,40.19728,169,3,9,6,200
15696,pa,-79.36617,40.28011,226,2,6,4,200
15697,pa,-79.5797,40.24066,1468,3,9,6,200
15698,pa,-79.68948,40.21638,506,3,9,6,200
15701,pa,-79.14963,40.62827,11995,2,7,5,250
15710,pa,-78.87242,40.64011,178,0,2,2,NA
15711,pa,-78.96219,41.00816,293,1,3,2,200
15712,pa,-78.84788,40.79045,154,1,3,2,200
15713,pa,-79.26168,40.56976,151,2,7,5,250
15714,pa,-78.82315,40.64535,3614,1,3,2,200
15715,pa,-78.87627,40.97012,387,1,3,2,200
15716,pa,-79.18807,40.46683,335,1,3,2,200
15717,pa,-79.24301,40.45266,5711,2,6,4,200
15721,pa,-78.79243,40.8146,224,1,4,3,300
15722,pa,-78.72063,40.59489,1827,0,1,1,NA
15723,pa,-79.15919,40.70019,44,2,7,5,250
15724,pa,-78.81777,40.7391,1600,1,3,2,200
15725,pa,-79.34144,40.51988,824,3,9,6,200
15727,pa,-79.30975,40.55801,126,3,8,5,166.7
15728,pa,-78.96694,40.67546,2376,1,5,4,400
15729,pa,-78.92032,40.70462,880,1,4,3,300
15730,pa,-79.09353,41.05476,59,1,3,2,200
15731,pa,-79.17637,40.50377,185,1,4,3,300
15732,pa,-79.2136,40.72711,871,2,7,5,250
15733,pa,-78.96074,40.98685,100,1,3,2,200
15734,pa,-79.00126,40.7248,237,1,4,3,300
15736,pa,-79.36645,40.70125,360,3,8,5,166.7
15737,pa,-78.75784,40.60515,66,0,1,1,NA
15738,pa,-78.78512,40.69155,271,1,3,2,200
15739,pa,-79.16802,40.67612,245,2,7,5,250
15741,pa,-78.88961,40.80658,85,1,3,2,200
15742,pa,-78.86301,40.81441,873,1,3,2,200
15744,pa,-79.08313,40.92327,137,1,4,3,300
15745,pa,-78.91519,40.623,223,1,2,1,100
15746,pa,-78.88587,40.75876,95,1,3,2,200
15747,pa,-79.14811,40.76789,1067,2,6,4,200
15748,pa,-79.08429,40.52447,4044,2,5,3,150
15750,pa,-79.18092,40.48479,79,2,6,4,200
15752,pa,-79.28325,40.54059,36,3,8,5,166.7
15753,pa,-78.65143,40.78764,656,1,3,2,200
15754,pa,-79.15151,40.55667,259,2,5,3,150
15756,pa,-79.29771,40.56871,160,2,7,5,250
15757,pa,-78.73534,40.88747,1726,1,3,2,200
15759,pa,-79.03038,40.77111,1653,1,5,4,400
15760,pa,-78.80029,40.6483,119,1,2,1,100
15761,pa,-78.88981,40.63225,79,0,2,2,NA
15762,pa,-78.82981,40.59719,589,1,2,1,100
15764,pa,-79.02907,40.99262,118,1,3,2,200
15765,pa,-78.9961,40.5976,1207,1,4,3,300
15767,pa,-78.96754,40.96005,9087,1,4,3,300
15770,pa,-79.15636,40.996,148,1,3,2,200
15771,pa,-78.98918,40.83084,771,1,4,3,300
15772,pa,-78.89661,40.87482,1152,1,3,2,200
15773,pa,-78.73544,40.62677,394,0,1,1,NA
15774,pa,-79.32668,40.65692,1739,3,8,5,166.7
15775,pa,-78.78168,40.62747,565,0,2,2,NA
15776,pa,-79.11398,41.01335,61,1,3,2,200
15777,pa,-78.96544,40.69376,200,1,4,3,300
15778,pa,-79.19718,40.96753,131,1,3,2,200
15779,pa,-79.21769,40.39924,141,1,3,2,200
15780,pa,-79.05676,40.91613,126,1,4,3,300
15781,pa,-78.98685,40.9638,96,1,4,3,300
15783,pa,-79.34801,40.60686,94,3,8,5,166.7
15784,pa,-79.13892,41.02455,56,1,3,2,200
15801,pa,-78.72554,41.12497,16714,1,2,1,100
15821,pa,-78.36766,41.35537,731,1,2,1,100
15823,pa,-78.7095,41.2584,1019,0,1,1,NA
15824,pa,-78.8426,41.24987,3314,0,2,2,NA
15825,pa,-79.04038,41.1753,6634,1,2,1,100
15827,pa,-78.52166,41.31916,183,1,3,2,200
15828,pa,-79.13648,41.35265,860,1,2,1,100
15829,pa,-79.19758,41.17619,997,1,3,2,200
15832,pa,-78.1916,41.35648,1158,1,3,2,200
15834,pa,-78.27786,41.5122,3541,1,2,1,100
15840,pa,-78.82608,41.17202,1328,1,2,1,100
15841,pa,-78.52989,41.26294,223,1,2,1,100
15845,pa,-78.69574,41.50048,2125,0,1,1,NA
15846,pa,-78.56785,41.34041,2746,0,1,1,NA
15847,pa,-79.03243,41.08931,206,1,2,1,100
15848,pa,-78.71904,41.03161,723,0,2,2,NA
15849,pa,-78.55935,41.17936,1275,1,2,1,100
15851,pa,-78.90273,41.09964,4329,1,3,2,200
15853,pa,-78.79403,41.39402,4610,0,1,1,NA
15856,pa,-78.62461,41.09282,852,0,2,2,NA
15857,pa,-78.53424,41.45706,7561,0,1,1,NA
15860,pa,-79.04806,41.34779,2697,0,2,2,NA
15861,pa,-78.07797,41.31855,560,1,2,1,100
15863,pa,-78.83974,41.01439,139,1,3,2,200
15864,pa,-79.19803,41.10216,1342,1,4,3,300
15865,pa,-78.82741,41.04523,699,1,3,2,200
15866,pa,-78.79118,41.02534,145,1,2,1,100
15868,pa,-78.38336,41.2814,1515,1,2,1,100
15870,pa,-78.57458,41.58323,1615,0,1,1,NA
15901,pa,-78.9141,40.32841,2981,2,5,3,150
15902,pa,-78.88035,40.31981,6779,1,4,3,300
15904,pa,-78.8449,40.30343,7825,1,2,1,100
15905,pa,-78.97839,40.28713,10803,2,5,3,150
15906,pa,-78.94604,40.37271,6730,2,6,4,200
15909,pa,-78.87127,40.40955,3409,1,3,2,200
15920,pa,-79.05146,40.46604,479,1,4,3,300
15921,pa,-78.70086,40.31734,154,0,1,1,NA
15922,pa,-78.87668,40.5176,113,1,2,1,100
15923,pa,-79.16406,40.35559,1129,2,5,3,150
15924,pa,-78.77534,40.10666,838,0,1,1,NA
15925,pa,-78.64071,40.40856,142,0,1,1,NA
15926,pa,-78.82423,40.05191,2618,0,1,1,NA
15927,pa,-78.77865,40.54,725,0,1,1,NA
15928,pa,-78.91724,40.24021,925,1,3,2,200
15929,pa,-79.0056,40.46768,45,1,4,3,300
15930,pa,-78.71868,40.2949,216,0,1,1,NA
15931,pa,-78.75702,40.51599,4758,0,2,2,NA
15934,pa,-78.80399,40.27906,145,0,1,1,NA
15935,pa,-78.96631,40.20377,1696,1,2,1,100
15936,pa,-78.89445,40.16338,1122,0,1,1,NA
15937,pa,-78.98472,40.20533,394,1,2,1,100
15938,pa,-78.6117,40.42023,1771,0,1,1,NA
15940,pa,-78.62885,40.52173,1328,0,1,1,NA
15942,pa,-78.81232,40.40345,1463,1,3,2,200
15943,pa,-78.8396,40.47468,2609,0,2,2,NA
15944,pa,-79.07967,40.36351,2155,1,4,3,300
15945,pa,-78.86694,40.35788,139,1,3,2,200
15946,pa,-78.63278,40.37237,4443,0,1,1,NA
15948,pa,-78.76465,40.48996,298,0,1,1,NA
15949,pa,-79.12416,40.39557,386,2,5,3,150
15951,pa,-78.77105,40.33185,311,1,2,1,100
15952,pa,-78.77614,40.30351,636,0,1,1,NA
15953,pa,-78.88824,40.20921,62,0,2,2,NA
15954,pa,-78.99976,40.42186,1425,2,5,3,150
15955,pa,-78.69728,40.3224,1893,0,1,1,NA
15956,pa,-78.78561,40.34731,1727,1,3,2,200
15957,pa,-78.89734,40.55658,453,1,3,2,200
15958,pa,-78.73207,40.38933,1462,1,2,1,100
15960,pa,-78.88905,40.49844,295,1,2,1,100
15961,pa,-78.9377,40.46676,656,1,2,1,100
15962,pa,-78.71511,40.38806,107,0,2,2,NA
15963,pa,-78.76301,40.22053,6811,0,2,2,NA
16001,pa,-79.94379,40.9095,19128,2,6,4,200
16002,pa,-79.85734,40.81578,7760,2,6,4,200
16020,pa,-79.89855,41.11534,1029,1,4,3,300
16022,pa,-79.73369,41.05413,230,2,7,5,250
16023,pa,-79.75051,40.78549,1842,3,8,5,166.7
16024,pa,-80.03854,40.74272,99,3,9,6,200
16025,pa,-79.75639,40.94469,3261,2,7,5,250
16027,pa,-80.01918,40.82015,143,2,7,5,250
16028,pa,-79.63701,40.9579,1590,3,9,6,200
16029,pa,-79.84617,40.87915,403,2,6,4,200
16030,pa,-79.79697,41.1364,203,1,4,3,300
16033,pa,-80.04532,40.79161,4950,3,8,5,166.7
16034,pa,-79.72978,40.86142,987,2,7,5,250
16035,pa,-80.00994,41.10672,76,2,6,4,200
16036,pa,-79.66916,41.13541,279,2,7,5,250
16037,pa,-80.12821,40.85313,2839,3,8,5,166.7
16038,pa,-79.95132,41.16002,2306,2,5,3,150
16040,pa,-79.84303,41.09254,749,1,4,3,300
16041,pa,-79.71492,41.00532,1413,3,7,4,133.3
16045,pa,-79.91671,40.85281,640,2,6,4,200
16046,pa,-80.02979,40.70091,7991,3,9,6,200
16048,pa,-79.81843,41.0532,92,2,5,3,150
16049,pa,-79.67259,41.09663,2926,2,7,5,250
16050,pa,-79.77174,41.04332,1125,2,6,4,200
16051,pa,-80.13858,40.94666,1702,2,7,5,250
16052,pa,-80.06136,40.90467,1394,2,6,4,200
16053,pa,-79.98315,40.81188,2377,2,7,5,250
16054,pa,-79.65737,41.15702,318,2,6,4,200
16055,pa,-79.74814,40.71562,4290,3,9,6,200
16056,pa,-79.841,40.72305,2199,3,8,5,166.7
16057,pa,-80.05682,41.03454,6003,2,7,5,250
16059,pa,-79.92845,40.70406,4246,3,9,6,200
16061,pa,-79.887,41.00661,1712,2,6,4,200
16063,pa,-80.12744,40.76487,3854,3,9,6,200
16066,pa,-80.10577,40.7111,11697,3,9,6,200
16101,pa,-80.28712,40.98531,20841,3,9,6,200
16102,pa,-80.42074,40.96068,4435,3,9,6,200
16105,pa,-80.33817,41.05353,8156,3,9,6,200
16110,pa,-80.38477,41.50604,243,2,7,5,250
16111,pa,-80.28257,41.52039,682,1,4,3,300
16112,pa,-80.50178,40.96822,1177,3,9,6,200
16113,pa,-80.42502,41.28143,202,3,9,6,200
16114,pa,-80.18545,41.40411,340,1,5,4,400
16115,pa,-80.46338,40.79346,2080,3,9,6,200
16116,pa,-80.45214,41.03628,1949,4,10,6,150
16117,pa,-80.25595,40.87287,10534,4,10,6,150
16120,pa,-80.47287,40.89168,1254,3,9,6,200
16121,pa,-80.49721,41.21122,3540,4,11,7,175
16123,pa,-80.19817,40.81957,1268,3,9,6,200
16124,pa,-80.26583,41.33183,1062,2,5,3,150
16125,pa,-80.37338,41.40596,8764,2,7,5,250
16127,pa,-80.07283,41.17287,6096,2,6,4,200
16130,pa,-80.21528,41.44323,1090,2,5,3,150
16131,pa,-80.37757,41.55043,597,2,5,3,150
16132,pa,-80.50565,41.00586,312,3,9,6,200
16133,pa,-80.11537,41.27176,926,1,4,3,300
16134,pa,-80.46407,41.50589,4599,2,6,4,200
16136,pa,-80.32371,40.83429,528,4,10,6,150
16137,pa,-80.23845,41.23012,6532,2,6,4,200
16140,pa,-80.51403,41.09532,67,3,9,6,200
16141,pa,-80.39623,40.87037,1139,3,9,6,200
16142,pa,-80.33904,41.14057,2386,3,8,5,166.7
16143,pa,-80.453,41.10549,1765,3,9,6,200
16145,pa,-80.07182,41.38525,1718,1,4,3,300
16146,pa,-80.49968,41.23412,6932,4,10,6,150
16148,pa,-80.43196,41.23116,7340,3,8,5,166.7
16150,pa,-80.4439,41.28551,3504,3,9,6,200
16151,pa,-80.20694,41.44373,42,1,5,4,400
16153,pa,-80.08106,41.31812,1549,1,4,3,300
16154,pa,-80.42083,41.32447,1228,3,8,5,166.7
16155,pa,-80.51073,41.06773,16,3,9,6,200
16156,pa,-80.21801,41.09562,1953,2,7,5,250
16157,pa,-80.33561,40.88882,2269,4,10,6,150
16159,pa,-80.46834,41.1586,2300,3,9,6,200
16160,pa,-80.36355,40.92778,1179,4,12,8,200
16161,pa,-80.49582,41.19701,523,4,11,7,175
16201,pa,-79.4729,40.80912,9418,3,9,6,200
16210,pa,-79.51387,40.89805,820,3,9,6,200
16211,pa,-79.20256,40.79444,93,2,6,4,200
16212,pa,-79.58468,40.75313,232,4,11,7,175
16213,pa,-79.55768,41.12574,127,2,6,4,200
16214,pa,-79.35753,41.20314,3845,1,3,2,200
16217,pa,-79.1847,41.33648,270,1,2,1,100
16218,pa,-79.59201,40.92681,890,3,8,5,166.7
16222,pa,-79.26088,40.87378,1649,2,5,3,150
16223,pa,-79.36395,40.97599,140,2,7,5,250
16224,pa,-79.29394,41.06234,783,1,4,3,300
16226,pa,-79.48684,40.71097,4874,4,10,6,150
16228,pa,-79.53577,40.76081,187,4,11,7,175
16229,pa,-79.64512,40.71791,2685,4,10,6,150
16230,pa,-79.27817,41.02098,285,1,4,3,300
16232,pa,-79.54864,41.22119,2484,1,4,3,300
16233,pa,-79.27202,41.36618,1826,1,2,1,100
16235,pa,-79.35434,41.3176,938,1,3,2,200
16236,pa,-79.52313,40.78487,162,4,11,7,175
16238,pa,-79.52079,40.78758,190,4,11,7,175
16239,pa,-79.13586,41.49187,3207,0,2,2,NA
16240,pa,-79.22467,41.0335,1212,1,4,3,300
16242,pa,-79.36042,41.00749,3316,2,5,3,150
16244,pa,-79.27666,40.79218,190,2,7,5,250
16245,pa,-79.29837,41.00672,151,1,4,3,300
16246,pa,-79.18215,40.79172,187,2,6,4,200
16248,pa,-79.50536,41.03489,2188,2,7,5,250
16249,pa,-79.31509,40.76653,1197,2,7,5,250
16250,pa,-79.23978,40.76827,249,2,7,5,250
16253,pa,-79.34276,40.95117,91,2,6,4,200
16254,pa,-79.45737,41.26838,1990,1,4,3,300
16255,pa,-79.46444,41.12752,1301,2,5,3,150
16256,pa,-79.13757,40.86664,844,2,5,3,150
16258,pa,-79.27798,41.23343,1491,1,3,2,200
16259,pa,-79.455,40.9268,1610,2,7,5,250
16260,pa,-79.22658,41.39567,385,0,2,2,NA
16262,pa,-79.65232,40.8389,1611,3,8,5,166.7
16263,pa,-79.33506,40.79741,208,2,7,5,250
16301,pa,-79.63534,41.45555,9906,1,3,2,200
16311,pa,-80.03447,41.45677,369,1,4,3,300
16312,pa,-79.30321,41.93214,14,0,1,1,NA
16313,pa,-79.12152,41.73428,1577,0,1,1,NA
16314,pa,-80.06623,41.51705,3885,1,4,3,300
16316,pa,-80.30334,41.6018,5181,1,4,3,300
16317,pa,-79.85371,41.53255,996,1,3,2,200
16319,pa,-79.63169,41.31975,905,1,4,3,300
16321,pa,-79.39959,41.57106,127,1,2,1,100
16322,pa,-79.37357,41.59885,197,1,2,1,100
16323,pa,-79.82922,41.41269,8984,1,4,3,300
16326,pa,-79.43181,41.36733,235,1,2,1,100
16327,pa,-79.9607,41.63244,1935,1,2,1,100
16328,pa,-79.72554,41.65323,62,1,2,1,100
16329,pa,-79.26446,41.80991,467,0,2,2,NA
16331,pa,-79.5655,41.29259,48,1,3,2,200
16332,pa,-79.36798,41.35694,57,1,2,1,100
16333,pa,-78.92846,41.70339,256,0,1,1,NA
16334,pa,-79.45523,41.29105,199,1,4,3,300
16335,pa,-80.15631,41.63094,13645,1,3,2,200
16340,pa,-79.41765,41.80241,1823,0,1,1,NA
16341,pa,-79.54935,41.56608,1807,0,2,2,NA
16342,pa,-79.93082,41.32265,1622,1,4,3,300
16343,pa,-79.75228,41.42207,377,1,3,2,200
16344,pa,-79.68455,41.47039,347,1,3,2,200
16345,pa,-79.072,41.95203,2373,0,1,1,NA
16346,pa,-79.67197,41.3785,1656,1,3,2,200
16347,pa,-79.06087,41.6471,2071,0,1,1,NA
16350,pa,-79.33433,41.96564,1360,0,1,1,NA
16351,pa,-79.35978,41.67818,2673,0,2,2,NA
16352,pa,-79.03836,41.76727,237,0,1,1,NA
16353,pa,-79.37714,41.50093,6459,1,2,1,100
16354,pa,-79.70642,41.61372,6894,1,2,1,100
16360,pa,-79.88968,41.68418,924,0,2,2,NA
16361,pa,-79.34275,41.38595,76,1,2,1,100
16362,pa,-79.96236,41.45034,853,1,3,2,200
16364,pa,-79.51592,41.36406,887,1,3,2,200
16365,pa,-79.1583,41.84174,9255,1,2,1,100
16370,pa,-79.44026,41.57141,789,1,2,1,100
16371,pa,-79.31889,41.8668,1646,0,1,1,NA
16372,pa,-79.87306,41.19992,223,1,4,3,300
16373,pa,-79.69936,41.20719,3048,2,5,3,150
16374,pa,-79.81383,41.26213,2977,1,4,3,300
16401,pa,-80.40489,41.88109,2498,1,3,2,200
16402,pa,-79.46564,41.95796,519,0,1,1,NA
16403,pa,-80.02019,41.79277,3630,1,2,1,100
16404,pa,-79.78913,41.72561,2474,1,2,1,100
16405,pa,-79.53469,41.94689,520,0,1,1,NA
16406,pa,-80.36277,41.74951,2243,1,4,3,300
16407,pa,-79.66325,41.91965,5810,0,1,1,NA
16410,pa,-80.30602,41.92107,922,0,2,2,NA
16411,pa,-80.44719,41.98318,861,1,3,2,200
16412,pa,-80.16634,41.88325,4662,0,1,1,NA
16415,pa,-80.23166,42.03193,4221,0,2,2,NA
16416,pa,-79.4727,41.82573,97,0,1,1,NA
16417,pa,-80.31331,41.97085,3812,0,2,2,NA
16420,pa,-79.54729,41.69633,734,0,1,1,NA
16421,pa,-79.93278,42.1712,1187,0,1,1,NA
16422,pa,-80.31446,41.66554,185,1,4,3,300
16423,pa,-80.34318,42.02013,1787,0,2,2,NA
16424,pa,-80.442,41.65919,6168,2,5,3,150
16426,pa,-80.14224,41.97966,1607,0,1,1,NA
16427,pa,-79.96791,41.87737,81,0,1,1,NA
16428,pa,-79.82874,42.17375,6150,0,1,1,NA
16433,pa,-80.14297,41.73521,2837,1,3,2,200
16434,pa,-79.66501,41.7938,1623,0,1,1,NA
16435,pa,-80.38409,41.81822,1333,1,3,2,200
16436,pa,-79.50646,41.85371,760,0,1,1,NA
16438,pa,-79.84416,41.89226,5627,1,2,1,100
16440,pa,-80.12753,41.7876,603,1,3,2,200
16441,pa,-79.98762,41.95585,5619,0,1,1,NA
16442,pa,-79.82604,42.04032,1607,0,1,1,NA
16443,pa,-80.48025,41.93882,742,1,3,2,200
16444,pa,-80.12178,41.87068,4,0,2,2,NA
16501,pa,-80.08917,42.12132,483,0,2,2,NA
16502,pa,-80.10148,42.11069,5591,0,2,2,NA
16503,pa,-80.06112,42.12702,5706,0,2,2,NA
16504,pa,-80.04903,42.10908,6226,0,1,1,NA
16505,pa,-80.14553,42.11895,7350,0,2,2,NA
16506,pa,-80.1527,42.06375,8422,0,2,2,NA
16507,pa,-80.08465,42.13727,3473,0,2,2,NA
16508,pa,-80.09343,42.09658,6531,0,1,1,NA
16509,pa,-80.04256,42.05875,10249,0,1,1,NA
16510,pa,-79.95455,42.11288,10509,0,1,1,NA
16511,pa,-79.99289,42.16948,4706,0,2,2,NA
16546,pa,-80.05343,42.10491,7,0,1,1,NA
16563,pa,-79.98655,42.11922,5,0,1,1,NA
16601,pa,-78.37016,40.55566,17082,2,5,3,150
16602,pa,-78.3722,40.51242,14583,1,4,3,300
16611,pa,-78.10768,40.56739,1351,4,9,5,125
16613,pa,-78.53757,40.54804,1184,0,1,1,NA
16616,pa,-78.44552,40.76826,156,1,3,2,200
16617,pa,-78.33054,40.60365,1388,1,2,1,100
16619,pa,-78.44165,40.66203,329,0,1,1,NA
16620,pa,-78.35115,40.83956,331,1,3,2,200
16621,pa,-78.12518,40.2323,526,1,3,2,200
16622,pa,-78.06641,40.32864,129,2,6,4,200
16623,pa,-78.05223,40.27159,490,2,6,4,200
16624,pa,-78.60048,40.57043,147,0,1,1,NA
16625,pa,-78.50832,40.28209,2773,1,4,3,300
16627,pa,-78.49757,40.75578,2004,1,3,2,200
16630,pa,-78.57645,40.45618,2222,0,1,1,NA
16631,pa,-78.3456,40.27277,50,1,4,3,300
16633,pa,-78.23493,40.15739,104,2,5,3,150
16634,pa,-78.17275,40.21095,250,0,2,2,NA
16635,pa,-78.48931,40.41512,5763,2,6,4,200
16636,pa,-78.50331,40.60245,662,0,2,2,NA
16637,pa,-78.46724,40.3411,1412,2,5,3,150
16638,pa,-78.20362,40.3366,53,4,9,5,125
16639,pa,-78.45395,40.69471,1286,0,1,1,NA
16640,pa,-78.57686,40.70691,1857,1,4,3,300
16641,pa,-78.54074,40.50098,1628,0,1,1,NA
16645,pa,-78.49903,40.79893,147,1,4,3,300
16646,pa,-78.7144,40.6807,1617,0,1,1,NA
16647,pa,-78.10075,40.39907,800,3,8,5,166.7
16648,pa,-78.33669,40.43805,7231,2,6,4,200
16650,pa,-78.28901,40.11794,1496,2,6,4,200
16651,pa,-78.38025,40.84907,2840,1,2,1,100
16652,pa,-77.95688,40.51476,8739,4,9,5,125
16655,pa,-78.55153,40.24864,957,2,5,3,150
16656,pa,-78.56418,40.80683,1084,1,3,2,200
16657,pa,-78.17793,40.32181,1581,3,8,5,166.7
16659,pa,-78.38972,40.16158,161,2,6,4,200
16661,pa,-78.45657,40.83601,936,1,4,3,300
16662,pa,-78.29615,40.31356,2685,2,5,3,150
16664,pa,-78.42431,40.17966,1276,1,4,3,300
16665,pa,-78.43424,40.3887,162,2,7,5,250
16666,pa,-78.32337,40.8769,1908,1,2,1,100
16667,pa,-78.5311,40.17991,809,2,5,3,150
16668,pa,-78.62042,40.65204,2518,0,2,2,NA
16669,pa,-77.90711,40.65652,1530,3,8,5,166.7
16670,pa,-78.50795,40.26238,35,1,4,3,300
16671,pa,-78.402,40.79414,389,1,3,2,200
16672,pa,-78.24209,40.17227,168,2,5,3,150
16673,pa,-78.39148,40.31246,2762,2,5,3,150
16674,pa,-78.08827,40.1894,601,2,6,4,200
16677,pa,-78.2436,40.81184,270,0,1,1,NA
16678,pa,-78.23814,40.22382,1940,2,5,3,150
16679,pa,-78.19728,40.15716,615,1,3,2,200
16680,pa,-78.40118,40.75066,403,0,2,2,NA
16682,pa,-78.45782,40.26606,56,1,4,3,300
16683,pa,-78.08321,40.6478,345,2,6,4,200
16685,pa,-78.08263,40.28749,338,2,6,4,200
16686,pa,-78.25085,40.66832,7005,2,6,4,200
16689,pa,-78.0963,40.10467,328,3,9,6,200
16691,pa,-78.14593,40.0775,251,2,6,4,200
16692,pa,-78.72005,40.75602,587,1,2,1,100
16693,pa,-78.21442,40.47273,2317,2,6,4,200
16694,pa,-78.14857,40.15621,167,1,3,2,200
16695,pa,-78.36082,40.20859,691,1,4,3,300
16699,pa,-78.5605,40.44721,1,0,1,1,NA
16701,pa,-78.763,41.91791,10181,0,1,1,NA
16720,pa,-78.03704,41.58412,2673,0,2,2,NA
16724,pa,-78.37114,41.73332,99,0,1,1,NA
16725,pa,-78.65288,41.90646,119,0,1,1,NA
16726,pa,-78.57299,41.80768,379,0,1,1,NA
16727,pa,-78.53006,41.98118,146,0,1,1,NA
16728,pa,-78.92418,41.56576,41,0,1,1,NA
16729,pa,-78.47611,41.96248,536,0,1,1,NA
16730,pa,-78.42247,41.81663,80,0,1,1,NA
16731,pa,-78.375,41.94575,1803,0,1,1,NA
16732,pa,-78.61683,41.85706,171,0,1,1,NA
16733,pa,-78.595,41.70283,246,0,1,1,NA
16734,pa,-78.84055,41.61854,212,0,1,1,NA
16735,pa,-78.81382,41.64096,4845,0,1,1,NA
16738,pa,-78.71893,41.80806,1149,0,1,1,NA
16740,pa,-78.5711,41.70403,927,0,1,1,NA
16743,pa,-78.26203,41.78896,2455,0,1,1,NA
16744,pa,-78.56706,41.8671,191,0,1,1,NA
16745,pa,-78.4837,41.92221,380,0,1,1,NA
16746,pa,-78.13636,41.79397,883,0,1,1,NA
16748,pa,-78.15276,41.94447,2157,0,1,1,NA
16749,pa,-78.43656,41.76563,2775,0,1,1,NA
16750,pa,-78.29395,41.88608,277,0,1,1,NA
16801,pa,-77.84136,40.7789,10941,1,4,3,300
16802,pa,-77.86064,40.80261,14,2,5,3,150
16803,pa,-77.89963,40.80166,6655,2,5,3,150
16820,pa,-77.39247,40.89568,728,2,5,3,150
16821,pa,-78.20179,40.96283,181,1,3,2,200
16822,pa,-77.70398,41.15516,1756,2,6,4,200
16823,pa,-77.77302,40.93768,11947,2,5,3,150
16825,pa,-78.3119,40.98637,155,1,2,1,100
16826,pa,-77.59497,41.06421,327,3,7,4,133.3
16827,pa,-77.7656,40.76093,2312,1,3,2,200
16828,pa,-77.68794,40.81302,2657,1,3,2,200
16829,pa,-77.89328,41.08392,686,1,2,1,100
16830,pa,-78.43607,41.08445,7702,1,4,3,300
16832,pa,-77.46914,40.84162,434,2,4,2,100
16833,pa,-78.57434,40.94065,3623,1,4,3,300
16834,pa,-78.10391,41.03917,330,1,3,2,200
16835,pa,-77.8774,40.90743,124,2,5,3,150
16836,pa,-78.2706,41.14531,1819,1,3,2,200
16837,pa,-78.47498,40.94581,131,1,4,3,300
16838,pa,-78.64027,40.99372,1450,1,3,2,200
16839,pa,-78.11043,41.00361,328,1,3,2,200
16840,pa,-78.20372,40.92302,323,1,2,1,100
16841,pa,-77.69914,41.03833,3302,2,5,3,150
16843,pa,-78.46603,41.0022,410,1,4,3,300
16844,pa,-77.93203,40.90908,1699,2,5,3,150
16845,pa,-78.03221,41.15068,879,1,4,3,300
16847,pa,-78.16467,40.99925,216,1,3,2,200
16848,pa,-77.5364,41.01126,159,1,3,2,200
16849,pa,-78.11436,40.96045,251,0,2,2,NA
16851,pa,-77.78713,40.82188,401,2,4,2,100
16852,pa,-77.51867,40.93703,177,2,4,2,100
16853,pa,-77.78706,40.93921,157,2,6,4,200
16854,pa,-77.4731,40.89802,529,2,6,4,200
16855,pa,-78.37704,40.99733,219,1,3,2,200
16858,pa,-78.20035,41.00051,2708,1,3,2,200
16859,pa,-78.02323,41.04076,483,1,2,1,100
16860,pa,-78.17072,40.94677,361,1,3,2,200
16861,pa,-78.5237,40.86517,360,1,3,2,200
16863,pa,-78.47493,40.91036,667,1,3,2,200
16865,pa,-77.99599,40.71019,916,1,4,3,300
16866,pa,-78.17474,40.86697,5127,1,2,1,100
16868,pa,-77.8805,40.73197,222,1,4,3,300
16870,pa,-78.06025,40.80005,3663,1,4,3,300
16871,pa,-78.02613,41.18599,261,1,4,3,300
16872,pa,-77.35833,40.96744,886,2,4,2,100
16874,pa,-77.95745,40.99795,950,1,2,1,100
16875,pa,-77.5718,40.84726,2486,1,4,3,300
16876,pa,-78.29085,40.9664,206,1,3,2,200
16877,pa,-78.06112,40.73863,929,2,5,3,150
16878,pa,-78.32865,40.94828,1208,1,2,1,100
16879,pa,-78.15072,40.96982,410,1,3,2,200
16881,pa,-78.31397,41.02621,1519,1,3,2,200
16882,pa,-77.32344,40.91245,312,2,4,2,100
16901,pa,-77.32718,41.73083,6209,0,2,2,NA
16911,pa,-77.12536,41.65675,309,0,2,2,NA
16912,pa,-77.04331,41.67765,1036,0,2,2,NA
16914,pa,-76.78248,41.86376,1377,1,3,2,200
16915,pa,-77.96435,41.78308,4602,0,1,1,NA
16917,pa,-77.05972,41.72842,1100,1,2,1,100
16920,pa,-77.28832,41.98211,930,1,4,3,300
16921,pa,-77.55888,41.71168,830,0,1,1,NA
16922,pa,-77.69776,41.66895,2460,0,1,1,NA
16923,pa,-77.87251,41.94009,1215,0,1,1,NA
16925,pa,-76.79175,41.95164,2056,1,3,2,200
16926,pa,-76.69835,41.72064,499,1,4,3,300
16927,pa,-77.6587,41.95868,401,0,1,1,NA
16928,pa,-77.43451,41.95341,816,1,2,1,100
16929,pa,-77.14882,41.97085,1247,2,4,2,100
16930,pa,-77.14515,41.57392,966,0,2,2,NA
16932,pa,-76.94238,41.77609,494,1,2,1,100
16933,pa,-77.06668,41.81907,3017,1,3,2,200
16935,pa,-77.31277,41.86637,992,1,2,1,100
16936,pa,-76.9603,41.94602,1244,1,3,2,200
16937,pa,-77.71111,41.9656,162,0,1,1,NA
16938,pa,-77.35365,41.57617,1033,1,2,1,100
16939,pa,-77.0223,41.67098,240,0,1,1,NA
16940,pa,-77.23825,41.98536,129,1,3,2,200
16941,pa,-77.75805,41.98829,49,0,1,1,NA
16942,pa,-77.35224,41.96255,522,1,3,2,200
16943,pa,-77.61546,41.84083,637,0,1,1,NA
16946,pa,-77.13778,41.90894,1385,1,3,2,200
16947,pa,-76.79509,41.76855,2876,1,3,2,200
16948,pa,-77.75802,41.84887,1485,0,1,1,NA
16950,pa,-77.53336,41.90102,2653,0,2,2,NA
17002,pa,-77.83922,40.50754,448,2,6,4,200
17003,pa,-76.5649,40.36396,4285,8,15,7,87.5
17004,pa,-77.73047,40.60068,2046,3,8,5,166.7
17005,pa,-76.8097,40.60285,203,6,13,7,116.7
17006,pa,-77.54374,40.28561,862,3,8,5,166.7
17007,pa,-77.11821,40.13084,2562,8,16,8,100
17009,pa,-77.5658,40.63604,970,5,12,7,140
17010,pa,-76.58171,40.27769,56,7,15,8,114.3
17011,pa,-76.92915,40.23516,12136,8,16,8,100
17013,pa,-77.19825,40.24174,12381,10,19,9,90
17015,pa,-77.23118,40.1772,8912,8,17,9,112.5
17016,pa,-76.40229,40.27747,191,6,13,7,116.7
17017,pa,-76.88255,40.64334,1152,6,13,7,116.7
17018,pa,-76.88117,40.40247,2482,7,14,7,100
17019,pa,-77.02254,40.09009,7815,8,17,9,112.5
17020,pa,-77.04341,40.41182,4065,7,14,7,100
17021,pa,-77.65933,40.33956,916,3,8,5,166.7
17022,pa,-76.60866,40.16634,10062,9,18,9,100
17023,pa,-76.81626,40.58427,1850,4,9,5,125
17024,pa,-77.31208,40.40961,1029,5,12,7,140
17025,pa,-76.97601,40.29507,6873,9,17,8,88.9
17026,pa,-76.42848,40.46204,1615,7,14,7,100
17027,pa,-76.99598,40.15615,174,8,16,8,100
17028,pa,-76.65823,40.39419,1404,8,15,7,87.5
17029,pa,-77.622,40.55452,154,2,5,3,150
17030,pa,-76.72561,40.60923,467,4,8,4,100
17032,pa,-76.82064,40.49314,4547,6,12,6,100
17033,pa,-76.6354,40.2732,5153,8,16,8,100
17034,pa,-76.78529,40.20874,1018,10,19,9,90
17035,pa,-77.57482,40.41636,676,4,10,6,150
17036,pa,-76.69871,40.28546,9087,8,16,8,100
17037,pa,-77.42032,40.4339,768,5,11,6,120
17038,pa,-76.54609,40.46928,3365,7,14,7,100
17039,pa,-76.24105,40.29072,18,6,13,7,116.7
17040,pa,-77.31612,40.3169,1464,5,12,7,140
17041,pa,-76.5396,40.21663,86,8,17,9,112.5
17042,pa,-76.42496,40.29454,15094,7,14,7,100
17043,pa,-76.90012,40.24691,2322,8,17,9,112.5
17044,pa,-77.59428,40.57844,10576,3,8,5,166.7
17045,pa,-77.00344,40.58872,1778,7,14,7,100
17046,pa,-76.43006,40.38265,10580,7,14,7,100
17047,pa,-77.41817,40.36378,1157,5,11,6,120
17048,pa,-76.72604,40.60781,2188,3,7,4,133.3
17049,pa,-77.25609,40.65304,1850,6,12,6,100
17050,pa,-77.0263,40.24854,13459,9,17,8,88.9
17051,pa,-77.77507,40.45875,3001,4,10,6,150
17052,pa,-77.98104,40.31687,1184,2,5,3,150
17053,pa,-77.03152,40.32556,2314,8,15,7,87.5
17055,pa,-77.00358,40.17896,12930,8,16,8,100
17056,pa,-77.35426,40.53729,68,7,15,8,114.3
17057,pa,-76.72519,40.19379,8254,9,19,10,111.1
17058,pa,-77.55433,40.49618,899,6,13,7,116.7
17059,pa,-77.38458,40.59169,3735,6,14,8,133.3
17060,pa,-77.89671,40.46786,749,2,5,3,150
17061,pa,-76.91224,40.56662,3698,7,13,6,85.7
17062,pa,-77.16722,40.55206,2216,6,13,7,116.7
17063,pa,-77.47578,40.76197,2113,3,8,5,166.7
17064,pa,-76.4762,40.24226,644,7,14,7,100
17065,pa,-77.19019,40.11146,1813,7,14,7,100
17066,pa,-77.8619,40.356,3054,6,13,7,116.7
17067,pa,-76.31538,40.38703,5629,7,14,7,100
17068,pa,-77.17702,40.40981,1741,6,12,6,100
17069,pa,-76.97004,40.45399,65,7,15,8,114.3
17070,pa,-76.86591,40.20303,6750,8,15,7,87.5
17071,pa,-77.60072,40.29928,127,3,8,5,166.7
17072,pa,-77.08173,40.23373,79,9,18,9,100
17073,pa,-76.25604,40.30317,2321,5,10,5,100
17074,pa,-77.14453,40.48041,3588,6,12,6,100
17075,pa,-77.83364,40.39437,100,4,9,5,125
17076,pa,-77.31176,40.61619,23,6,14,8,133.3
17077,pa,-76.53594,40.40301,9,7,15,8,114.3
17078,pa,-76.58352,40.28595,8276,8,15,7,87.5
17080,pa,-76.8031,40.64068,176,6,12,6,100
17081,pa,-77.28345,40.20102,174,9,18,9,100
17082,pa,-77.42765,40.49839,1914,5,10,5,100
17083,pa,-76.43759,40.2776,48,6,13,7,116.7
17084,pa,-77.62788,40.68506,1977,3,9,6,200
17086,pa,-77.12443,40.69059,1471,6,12,6,100
17087,pa,-76.26225,40.40517,1089,6,12,6,100
17088,pa,-76.29422,40.30068,432,6,13,7,116.7
17090,pa,-77.18197,40.32928,2205,7,15,8,114.3
17093,pa,-76.93119,40.30776,338,9,18,9,100
17094,pa,-77.21767,40.58322,1278,5,11,6,120
17097,pa,-76.67743,40.5801,653,3,7,4,133.3
17098,pa,-76.63233,40.58896,1440,2,6,4,200
17099,pa,-77.57573,40.64516,631,6,13,7,116.7
17101,pa,-76.88764,40.25915,987,9,17,8,88.9
17102,pa,-76.89673,40.27151,3693,9,17,8,88.9
17103,pa,-76.86633,40.27596,4960,8,17,9,112.5
17104,pa,-76.86252,40.25494,7091,9,17,8,88.9
17109,pa,-76.8243,40.28995,7652,8,16,8,100
17110,pa,-76.88558,40.31559,10841,8,17,9,112.5
17111,pa,-76.78488,40.26895,12309,8,17,9,112.5
17112,pa,-76.77648,40.37311,16098,8,16,8,100
17113,pa,-76.8275,40.22552,4616,8,16,8,100
17120,pa,-76.8828,40.26519,5,9,17,8,88.9
17201,pa,-77.65617,39.96106,10007,7,16,9,128.6
17202,pa,-77.67751,39.9214,14294,7,15,8,114.3
17210,pa,-77.66124,40.19636,205,2,6,4,200
17211,pa,-78.40704,39.75267,515,5,11,6,120
17212,pa,-78.06452,39.81271,410,5,13,8,160
17213,pa,-77.7706,40.2536,579,3,9,6,200
17214,pa,-77.47122,39.74794,539,4,10,6,150
17215,pa,-77.89398,40.07781,229,4,9,5,125
17217,pa,-77.72156,40.23863,105,3,7,4,133.3
17219,pa,-77.6856,40.23129,466,2,5,3,150
17220,pa,-77.74113,40.18487,286,3,9,6,200
17221,pa,-77.81671,40.06662,602,3,8,5,166.7
17222,pa,-77.49226,39.89528,6044,4,10,6,150
17223,pa,-77.95321,40.07799,209,3,9,6,200
17224,pa,-77.89746,39.96797,1532,6,13,7,116.7
17225,pa,-77.75933,39.78641,8819,8,16,8,100
17228,pa,-78.09335,39.98711,691,4,11,7,175
17229,pa,-78.01133,40.07831,880,4,10,6,150
17233,pa,-78.0017,39.95526,2763,4,9,5,125
17235,pa,-77.69805,39.85719,302,7,15,8,114.3
17236,pa,-77.94518,39.79807,4734,8,17,9,112.5
17237,pa,-77.5418,39.83861,656,4,9,5,125
17238,pa,-78.13093,39.85816,975,6,14,8,133.3
17239,pa,-77.83677,40.1318,169,4,9,5,125
17240,pa,-77.5831,40.15424,1771,9,18,9,100
17241,pa,-77.40337,40.17782,5176,8,16,8,100
17243,pa,-77.81971,40.27762,1198,3,9,6,200
17244,pa,-77.66269,40.0849,1357,8,17,9,112.5
17246,pa,-77.66081,40.05439,100,8,17,9,112.5
17247,pa,-77.57935,39.79878,2,6,14,8,133.3
17249,pa,-77.89946,40.24138,253,5,12,7,140
17250,pa,-77.5243,39.73714,44,5,11,6,120
17251,pa,-77.68097,40.13108,135,7,15,8,114.3
17252,pa,-77.81844,39.91341,1779,8,17,9,112.5
17253,pa,-78.00691,40.21331,166,5,11,6,120
17254,pa,-77.59036,39.97023,50,6,14,8,133.3
17255,pa,-77.86248,40.16128,770,3,8,5,166.7
17256,pa,-77.67731,39.78292,31,7,14,7,100
17257,pa,-77.49136,40.04912,10115,7,14,7,100
17260,pa,-77.89589,40.29452,832,5,11,6,120
17261,pa,-77.50816,39.86091,18,3,7,4,133.3
17262,pa,-77.73626,40.14602,868,4,9,5,125
17263,pa,-77.71786,39.72722,220,8,17,9,112.5
17264,pa,-77.99371,40.17995,1757,5,11,6,120
17265,pa,-77.78669,40.02814,612,5,11,6,120
17266,pa,-77.41205,40.08745,243,6,12,6,100
17267,pa,-78.24064,39.80257,1760,6,13,7,116.7
17268,pa,-77.5738,39.77564,13057,6,13,7,116.7
17270,pa,-77.79781,39.85473,61,9,18,9,100
17271,pa,-77.80309,40.09775,281,4,10,6,150
17272,pa,-77.62183,39.76953,141,8,16,8,100
17301,pa,-76.9803,39.89066,1626,10,19,9,90
17302,pa,-76.40929,39.81559,1619,7,15,8,114.3
17304,pa,-77.23068,39.97678,1398,8,16,8,100
17306,pa,-77.2494,39.98058,140,8,16,8,100
17307,pa,-77.32218,39.95081,2626,8,16,8,100
17309,pa,-76.45013,39.87132,1051,6,13,7,116.7
17311,pa,-76.84247,39.81655,96,8,17,9,112.5
17313,pa,-76.65658,39.88613,3963,8,17,9,112.5
17314,pa,-76.3295,39.75475,3023,9,19,10,111.1
17315,pa,-76.86498,40.02324,10469,12,22,10,83.3
17316,pa,-77.00425,39.9669,3589,11,21,10,90.9
17317,pa,-76.52319,39.97071,283,8,16,8,100
17318,pa,-76.72305,40.02213,159,11,22,11,100
17319,pa,-76.7941,40.16044,4236,9,18,9,100
17320,pa,-77.38763,39.7685,5623,9,18,9,100
17321,pa,-76.44716,39.75472,1091,7,15,8,114.3
17322,pa,-76.53265,39.85593,2674,7,15,8,114.3
17324,pa,-77.22833,40.03485,2317,6,13,7,116.7
17325,pa,-77.22677,39.82784,10682,10,20,10,100
17327,pa,-76.75322,39.77952,3376,8,16,8,100
17329,pa,-76.85111,39.76185,1193,8,16,8,100
17331,pa,-76.97831,39.79015,21763,10,19,9,90
17339,pa,-76.88374,40.1351,3357,8,16,8,100
17340,pa,-77.1126,39.7555,4572,10,19,9,90
17343,pa,-77.33397,39.87036,85,9,18,9,100
17344,pa,-77.01922,39.80569,1174,11,20,9,81.8
17345,pa,-76.73542,40.07752,2926,10,19,9,90
17347,pa,-76.68892,40.05527,2634,9,18,9,100
17349,pa,-76.68021,39.75429,3316,7,15,8,114.3
17350,pa,-77.07991,39.88902,4612,11,21,10,90.9
17352,pa,-76.49984,39.76121,594,7,14,7,100
17353,pa,-77.38512,39.88897,1833,6,13,7,116.7
17355,pa,-76.69602,39.75987,117,7,14,7,100
17356,pa,-76.58225,39.89659,7929,8,16,8,100
17360,pa,-76.75474,39.85197,2874,9,19,10,111.1
17361,pa,-76.67707,39.76552,2291,7,15,8,114.3
17362,pa,-76.86856,39.85197,5903,10,20,10,100
17363,pa,-76.58639,39.76863,3949,7,15,8,114.3
17364,pa,-76.89932,39.92939,1306,12,23,11,91.7
17365,pa,-76.93789,40.05559,1270,10,19,9,90
17366,pa,-76.55893,39.93234,2122,7,15,8,114.3
17368,pa,-76.51872,39.98388,3223,9,17,8,88.9
17370,pa,-76.77616,40.11845,2379,9,18,9,100
17371,pa,-76.78796,39.90271,118,12,23,11,91.7
17372,pa,-77.10589,40.00129,1740,10,19,9,90
17401,pa,-76.73368,39.95905,5881,11,22,11,100
17402,pa,-76.65922,39.95898,10716,9,19,10,111.1
17403,pa,-76.71336,39.92296,14070,10,20,10,100
17404,pa,-76.77126,40.00232,13311,12,22,10,83.3
17406,pa,-76.63845,40.01098,8777,10,19,9,90
17407,pa,-76.71194,39.88325,948,10,19,9,90
17408,pa,-76.80293,39.93371,8230,13,24,11,84.6
17501,pa,-76.20416,40.15727,1495,9,17,8,88.9
17502,pa,-76.66637,40.10007,1092,10,20,10,100
17505,pa,-76.19131,40.06037,491,9,17,8,88.9
17507,pa,-76.01624,40.19805,22,6,12,6,100
17508,pa,-76.21757,40.12397,170,9,17,8,88.9
17509,pa,-76.03008,39.90967,1510,8,15,7,87.5
17512,pa,-76.48598,40.03935,6749,9,18,9,100
17516,pa,-76.3756,39.94011,1877,8,16,8,100
17517,pa,-76.13247,40.24448,6060,7,14,7,100
17518,pa,-76.2567,39.80554,495,9,18,9,100
17519,pa,-76.02062,40.14156,2370,7,14,7,100
17520,pa,-76.34898,40.09796,1990,9,18,9,100
17522,pa,-76.17075,40.17222,11430,8,16,8,100
17527,pa,-75.99487,40.01346,1835,7,14,7,100
17529,pa,-76.10019,40.03978,1424,8,16,8,100
17532,pa,-76.29621,39.85353,1350,6,12,6,100
17535,pa,-76.04057,40.00654,714,8,15,7,87.5
17536,pa,-76.073,39.8444,999,12,23,11,91.7
17538,pa,-76.41565,40.08919,2446,9,17,8,88.9
17540,pa,-76.18707,40.09652,3121,9,17,8,88.9
17543,pa,-76.30153,40.1846,15390,9,17,8,88.9
17545,pa,-76.43143,40.17339,8307,9,18,9,100
17547,pa,-76.5855,40.07047,2839,10,19,9,90
17550,pa,-76.58343,40.07592,254,10,20,10,100
17551,pa,-76.37373,39.97849,3381,9,18,9,100
17552,pa,-76.51035,40.10825,7701,10,19,9,90
17554,pa,-76.42603,40.03957,2464,9,18,9,100
17555,pa,-75.9642,40.12132,2451,6,12,6,100
17557,pa,-76.07287,40.10114,4779,8,16,8,100
17560,pa,-76.22736,39.91082,1600,6,13,7,116.7
17562,pa,-76.09111,39.97597,1506,7,14,7,100
17563,pa,-76.18657,39.76421,1455,14,25,11,78.6
17565,pa,-76.33184,39.89864,1215,6,12,6,100
17566,pa,-76.14818,39.86968,4312,8,16,8,100
17569,pa,-76.09564,40.26891,2358,6,13,7,116.7
17570,pa,-76.56885,40.12994,90,10,19,9,90
17572,pa,-76.15298,40.00858,1123,8,16,8,100
17576,pa,-76.19685,40.03755,46,9,17,8,88.9
17578,pa,-76.16305,40.22178,2703,7,15,8,114.3
17579,pa,-76.17993,39.95756,2281,7,14,7,100
17581,pa,-76.04958,40.15851,383,8,15,7,87.5
17582,pa,-76.44665,39.97445,839,9,18,9,100
17584,pa,-76.26503,39.95879,3148,8,16,8,100
17601,pa,-76.31447,40.07357,18416,9,18,9,100
17602,pa,-76.24598,40.01501,15935,9,18,9,100
17603,pa,-76.35229,40.01298,21519,9,18,9,100
17701,pa,-76.90229,41.33756,16397,4,9,5,125
17702,pa,-77.07837,41.18345,4765,2,5,3,150
17721,pa,-77.3184,41.18363,1303,2,6,4,200
17723,pa,-77.45617,41.43197,123,1,3,2,200
17724,pa,-76.80391,41.64175,2791,1,3,2,200
17727,pa,-77.49167,41.52995,315,1,2,1,100
17728,pa,-77.08531,41.32763,2412,3,7,4,133.3
17729,pa,-77.74751,41.49548,744,1,2,1,100
17730,pa,-76.87841,41.11045,102,6,13,7,116.7
17731,pa,-76.56677,41.42877,637,0,2,2,NA
17737,pa,-76.68823,41.29892,2874,3,8,5,166.7
17739,pa,-77.40857,41.3935,164,1,2,1,100
17740,pa,-77.27063,41.24703,6653,3,8,5,166.7
17742,pa,-76.60498,41.2359,26,2,6,4,200
17744,pa,-77.15991,41.24453,1382,3,7,4,133.3
17745,pa,-77.47637,41.2708,11219,3,6,3,100
17747,pa,-77.3232,41.03857,2231,1,3,2,200
17748,pa,-77.35298,41.1504,88,2,5,3,150
17749,pa,-76.81889,41.07224,113,6,13,7,116.7
17750,pa,-77.47721,41.05524,81,1,3,2,200
17751,pa,-77.53823,41.13675,4669,3,7,4,133.3
17752,pa,-76.92957,41.17894,2194,4,10,6,150
17754,pa,-76.88498,41.31115,5545,3,7,4,133.3
17756,pa,-76.73739,41.20792,5091,4,9,5,125
17758,pa,-76.52848,41.36476,1180,1,3,2,200
17760,pa,-77.66411,41.40825,782,1,3,2,200
17762,pa,-76.70711,41.28319,221,2,6,4,200
17763,pa,-76.97575,41.51533,184,1,2,1,100
17764,pa,-77.81995,41.33449,4184,1,3,2,200
17765,pa,-76.971,41.57368,930,1,2,1,100
17767,pa,-77.46316,41.08387,42,3,8,5,166.7
17768,pa,-76.74965,41.54762,826,1,2,1,100
17771,pa,-77.03942,41.43171,2162,1,3,2,200
17772,pa,-76.71677,41.11836,1076,5,11,6,120
17774,pa,-76.52915,41.27919,869,1,3,2,200
17776,pa,-77.31275,41.40562,550,1,3,2,200
17777,pa,-76.82547,41.10311,3130,6,13,7,116.7
17778,pa,-77.96672,41.28633,499,1,3,2,200
17779,pa,-77.38003,41.20462,151,3,8,5,166.7
17801,pa,-76.7574,40.83463,7654,5,11,6,120
17810,pa,-77.03151,41.11206,1134,5,10,5,100
17812,pa,-77.22813,40.74074,1062,5,11,6,120
17813,pa,-77.17545,40.78286,1446,5,11,6,120
17814,pa,-76.36934,41.27608,3767,2,5,3,150
17815,pa,-76.42383,41.01702,12211,5,10,5,100
17820,pa,-76.40942,40.89886,3440,2,6,4,200
17821,pa,-76.63927,40.98871,8142,5,10,5,100
17822,pa,-76.60514,40.96802,3,5,11,6,120
17823,pa,-76.72413,40.72169,810,4,10,6,150
17824,pa,-76.5004,40.85384,2350,3,7,4,133.3
17827,pa,-76.96203,40.75454,392,6,12,6,100
17829,pa,-77.1558,40.90055,112,9,17,8,88.9
17830,pa,-76.7946,40.68817,1297,5,11,6,120
17832,pa,-76.45902,40.80595,446,2,5,3,150
17834,pa,-76.46843,40.77934,1846,2,5,3,150
17835,pa,-77.20326,40.88169,127,6,13,7,116.7
17836,pa,-76.60147,40.71334,112,4,9,5,125
17837,pa,-76.94855,40.9811,7423,7,15,8,114.3
17840,pa,-76.43312,40.77209,213,2,5,3,150
17841,pa,-77.35288,40.72493,2794,3,7,4,133.3
17842,pa,-77.04171,40.80402,5281,6,13,7,116.7
17844,pa,-77.08629,40.96547,5133,7,15,8,114.3
17845,pa,-77.21115,40.8853,1887,7,14,7,100
17846,pa,-76.51725,41.14531,2072,3,7,4,133.3
17847,pa,-76.80594,41.0057,5390,7,14,7,100
17850,pa,-76.85753,40.96587,306,8,15,7,87.5
17851,pa,-76.43318,40.80428,4836,2,5,3,150
17853,pa,-77.00958,40.69419,1727,7,14,7,100
17855,pa,-76.97231,40.88725,499,6,13,7,116.7
17856,pa,-76.9457,41.06099,1866,7,14,7,100
17857,pa,-76.76738,40.92795,3738,6,12,6,100
17859,pa,-76.39307,41.11782,1892,4,8,4,100
17860,pa,-76.63635,40.8266,1297,3,7,4,133.3
17861,pa,-77.08327,40.77246,139,4,8,4,100
17862,pa,-77.05661,40.86059,224,8,15,7,87.5
17864,pa,-76.90494,40.7037,1295,7,14,7,100
17865,pa,-76.78677,40.99018,44,7,14,7,100
17866,pa,-76.54948,40.78832,4969,2,6,4,200
17867,pa,-76.6886,40.71411,96,4,9,5,125
17868,pa,-76.6338,40.95782,495,5,11,6,120
17870,pa,-76.88659,40.8131,6785,7,15,8,114.3
17872,pa,-76.61235,40.7665,5963,3,6,3,100
17876,pa,-76.82307,40.85469,987,6,12,6,100
17878,pa,-76.3222,41.17212,898,3,8,5,166.7
17880,pa,-77.12175,40.89221,27,7,14,7,100
17881,pa,-76.66955,40.78287,949,2,6,4,200
17884,pa,-76.6687,41.05564,91,3,8,5,166.7
17885,pa,-77.31871,40.85605,272,2,4,2,100
17886,pa,-76.8752,41.01671,366,8,16,8,100
17887,pa,-76.9177,41.11517,113,7,14,7,100
17888,pa,-76.37712,40.81038,221,2,5,3,150
17889,pa,-76.91809,40.88257,1666,6,13,7,116.7
17901,pa,-76.25524,40.69363,13179,3,8,5,166.7
17920,pa,-76.32816,40.81613,304,2,4,2,100
17921,pa,-76.36287,40.75031,4533,2,5,3,150
17922,pa,-76.11423,40.59121,3823,3,8,5,166.7
17923,pa,-76.31853,40.6411,366,3,6,3,100
17925,pa,-76.07016,40.75606,250,2,5,3,150
17929,pa,-76.19404,40.6307,758,4,9,5,125
17930,pa,-76.11535,40.70867,267,2,5,3,150
17931,pa,-76.21513,40.78371,2968,1,3,2,200
17933,pa,-76.24319,40.60448,39,4,9,5,125
17934,pa,-76.21648,40.79774,363,1,3,2,200
17935,pa,-76.28319,40.79602,1215,1,4,3,300
17936,pa,-76.33993,40.75012,403,1,4,3,300
17938,pa,-76.51596,40.6514,1856,3,6,3,100
17941,pa,-76.61426,40.68396,776,4,9,5,125
17943,pa,-76.38779,40.75663,127,2,5,3,150
17944,pa,-76.27918,40.67242,144,2,6,4,200
17945,pa,-76.37524,40.78456,132,2,6,4,200
17946,pa,-76.24905,40.81204,80,1,3,2,200
17948,pa,-76.11387,40.84074,3600,1,3,2,200
17949,pa,-76.24234,40.79393,228,1,3,2,200
17951,pa,-76.24524,40.67856,226,3,6,3,100
17952,pa,-76.05855,40.75544,213,2,5,3,150
17953,pa,-76.12393,40.75186,400,2,6,4,200
17954,pa,-76.25969,40.69042,2272,3,7,4,133.3
17957,pa,-76.51821,40.59182,158,3,7,4,133.3
17959,pa,-76.14466,40.73329,925,2,5,3,150
17960,pa,-75.94579,40.69974,2585,3,7,4,133.3
17961,pa,-76.06157,40.64791,3713,4,9,5,125
17963,pa,-76.38317,40.56122,5375,5,10,5,100
17964,pa,-76.49699,40.71418,614,3,7,4,133.3
17965,pa,-76.16528,40.69861,1125,3,6,3,100
17967,pa,-76.22076,40.85557,1641,2,4,2,100
17968,pa,-76.6123,40.63868,256,2,6,4,200
17970,pa,-76.19195,40.72021,1760,3,8,5,166.7
17972,pa,-76.20538,40.58963,5537,4,9,5,125
17974,pa,-76.23627,40.6957,155,3,7,4,133.3
17976,pa,-76.20971,40.82083,4450,1,3,2,200
17978,pa,-76.61496,40.62545,191,3,6,3,100
17979,pa,-76.1997,40.56159,126,3,6,3,100
17980,pa,-76.60772,40.5406,2114,3,7,4,133.3
17981,pa,-76.3905,40.63431,1715,3,7,4,133.3
17982,pa,-76.0213,40.78593,339,2,5,3,150
17983,pa,-76.54717,40.64262,866,2,6,4,200
17985,pa,-76.21832,40.91351,1900,1,4,3,300
18011,pa,-75.64643,40.47121,2485,5,11,6,120
18013,pa,-75.17176,40.85304,8420,4,8,4,100
18014,pa,-75.40938,40.76507,4729,5,11,6,120
18015,pa,-75.37078,40.59008,10742,7,14,7,100
18016,pa,-75.39309,40.63233,2,6,13,7,116.7
18017,pa,-75.3868,40.65973,13357,7,14,7,100
18018,pa,-75.39527,40.62773,10833,7,14,7,100
18020,pa,-75.32687,40.67227,8554,7,15,8,114.3
18030,pa,-75.66419,40.80223,281,4,8,4,100
18031,pa,-75.65287,40.55399,2950,7,15,8,114.3
18032,pa,-75.46778,40.65698,3694,7,14,7,100
18034,pa,-75.41631,40.54352,3074,7,14,7,100
18035,pa,-75.53869,40.74673,106,6,12,6,100
18036,pa,-75.38592,40.50905,5607,7,15,8,114.3
18037,pa,-75.54496,40.68214,3038,7,14,7,100
18038,pa,-75.48229,40.79594,1584,4,8,4,100
18040,pa,-75.22173,40.74495,7285,7,15,8,114.3
18041,pa,-75.51481,40.4195,2345,12,22,10,83.3
18042,nj,-75.22399,40.65157,15035,8,16,8,107.15
18045,pa,-75.27426,40.69397,11464,7,14,7,100
18046,pa,-75.56035,40.54801,30,8,15,7,87.5
18049,pa,-75.50078,40.51741,7106,6,13,7,116.7
18051,pa,-75.66624,40.59337,1498,6,13,7,116.7
18052,pa,-75.50457,40.6568,9178,7,14,7,100
18053,pa,-75.70698,40.71798,1150,5,10,5,100
18054,pa,-75.43667,40.35417,2228,10,19,9,90
18055,pa,-75.29954,40.58923,5314,6,13,7,116.7
18056,pa,-75.54911,40.44909,151,10,19,9,90
18058,pa,-75.49313,40.89119,5455,2,6,4,200
18059,pa,-75.5364,40.72337,412,6,13,7,116.7
18062,pa,-75.58302,40.50251,7674,7,14,7,100
18063,pa,-75.17218,40.7824,344,6,12,6,100
18064,pa,-75.31795,40.75743,10173,6,13,7,116.7
18066,pa,-75.74495,40.66492,3198,5,10,5,100
18067,pa,-75.47802,40.71691,8037,6,13,7,116.7
18068,pa,-75.52004,40.48483,12,6,12,6,100
18069,pa,-75.61734,40.62593,2840,7,13,6,85.7
18070,pa,-75.53525,40.43214,335,12,22,10,83.3
18071,pa,-75.58125,40.82964,5114,4,9,5,125
18072,pa,-75.25761,40.84556,2975,3,8,5,166.7
18073,pa,-75.47555,40.38414,4661,12,22,10,83.3
18074,pa,-75.51609,40.31951,2731,11,20,9,81.8
18076,pa,-75.48079,40.3748,1130,13,23,10,76.9
18077,pa,-75.24354,40.56685,1318,7,15,8,114.3
18078,pa,-75.61897,40.67321,2939,6,12,6,100
18079,pa,-75.65809,40.74417,201,5,10,5,100
18080,pa,-75.63323,40.73582,5236,5,10,5,100
18081,pa,-75.28402,40.56224,192,7,14,7,100
18083,pa,-75.26728,40.75468,241,7,14,7,100
18085,pa,-75.25516,40.74136,455,7,14,7,100
18086,pa,-75.54826,40.73712,186,6,12,6,100
18087,pa,-75.59485,40.55418,207,8,15,7,87.5
18088,pa,-75.55657,40.76595,3790,5,11,6,120
18091,pa,-75.32006,40.82613,2642,4,9,5,125
18092,pa,-75.51528,40.47046,1557,8,17,9,112.5
18101,pa,-75.46907,40.60264,827,6,12,6,100
18102,pa,-75.47632,40.60825,12970,7,14,7,100
18103,pa,-75.48232,40.57046,15472,6,13,7,116.7
18104,pa,-75.54709,40.61129,16043,7,14,7,100
18105,pa,-75.49394,40.60142,2,7,14,7,100
18106,pa,-75.59615,40.57569,2637,7,15,8,114.3
18109,pa,-75.44048,40.63657,5764,6,13,7,116.7
18195,pa,-75.62479,40.58427,2,7,14,7,100
18201,pa,-75.95598,40.94898,11244,1,2,1,100
18202,pa,-76.04731,40.95118,12896,1,3,2,200
18210,pa,-75.5719,41.00119,11545,1,3,2,200
18211,pa,-75.82538,40.74375,953,3,8,5,166.7
18212,pa,-75.70957,40.77525,98,3,8,5,166.7
18214,pa,-76.08158,40.79882,1615,1,4,3,300
18216,pa,-75.89292,40.94149,629,1,3,2,200
18218,pa,-75.9161,40.81974,1323,2,4,2,100
18219,pa,-76.05776,40.99102,708,2,4,2,100
18220,pa,-76.06043,40.84045,219,1,4,3,300
18221,pa,-75.91691,41.00159,263,1,2,1,100
18222,pa,-75.99978,41.03501,5201,1,3,2,200
18223,pa,-75.95029,40.98235,140,1,2,1,100
18224,pa,-75.87937,41.02239,3103,1,2,1,100
18225,pa,-75.97131,40.98131,82,1,2,1,100
18229,pa,-75.67676,40.93056,7418,2,5,3,150
18230,pa,-75.93453,40.92108,111,1,3,2,200
18231,pa,-76.00804,40.90443,253,1,3,2,200
18232,pa,-75.88482,40.83307,2207,2,4,2,100
18234,pa,-75.96435,40.99259,260,1,2,1,100
18235,pa,-75.69744,40.82987,10062,4,8,4,100
18237,pa,-75.99638,40.88352,1706,1,3,2,200
18239,pa,-75.98237,40.98742,166,1,3,2,200
18240,pa,-75.87029,40.86054,2397,2,5,3,150
18241,pa,-76.14719,40.9451,381,1,4,3,300
18242,pa,-76.12432,40.91139,763,1,3,2,200
18244,pa,-75.73205,40.89907,204,3,6,3,100
18245,pa,-76.03351,40.8532,280,2,4,2,100
18246,pa,-76.19516,40.95716,111,2,5,3,150
18248,pa,-76.10728,40.89323,558,1,3,2,200
18249,pa,-76.1231,40.98704,2576,2,5,3,150
18250,pa,-75.84644,40.82489,1650,2,5,3,150
18251,pa,-76.07738,41.00805,35,2,5,3,150
18252,pa,-75.97615,40.77233,6292,2,5,3,150
18254,pa,-75.96565,40.91591,473,1,3,2,200
18255,pa,-75.83135,40.93279,2735,1,3,2,200
18256,pa,-76.14683,40.94079,265,1,4,3,300
18301,pa,-75.17992,41.03198,11024,5,10,5,100
18302,pa,-75.11883,41.09367,11049,3,7,4,133.3
18321,pa,-75.28963,41.01675,957,3,8,5,166.7
18322,pa,-75.39881,40.92284,1289,2,5,3,150
18323,pa,-75.27347,41.19658,426,0,2,2,NA
18324,pa,-75.00307,41.15198,9485,3,7,4,133.3
18325,pa,-75.22002,41.214,2173,0,2,2,NA
18326,pa,-75.27257,41.15412,2511,1,3,2,200
18327,pa,-75.13871,40.9746,314,4,9,5,125
18328,pa,-75.00363,41.22456,9066,2,6,4,200
18330,pa,-75.4491,40.97069,4141,2,4,2,100
18331,pa,-75.44503,40.91248,436,2,6,4,200
18332,pa,-75.26201,41.08952,1810,2,5,3,150
18333,pa,-75.49172,40.90235,305,3,7,4,133.3
18334,pa,-75.44551,41.06061,2795,0,2,2,NA
18335,pa,-75.10551,41.06557,450,3,8,5,166.7
18336,pa,-74.74173,41.37607,1920,4,9,5,125
18337,pa,-74.87893,41.32715,11551,2,5,3,150
18340,pa,-74.7675,41.4199,152,3,7,4,133.3
18342,pa,-75.2726,41.16694,321,0,2,2,NA
18343,nj,-75.1081,40.89543,2063,4,10,6,125
18344,pa,-75.34098,41.11849,1715,0,2,2,NA
18346,pa,-75.40794,41.13534,2451,0,1,1,NA
18347,pa,-75.55737,41.13378,6580,0,1,1,NA
18349,pa,-75.36813,41.102,227,1,2,1,100
18350,pa,-75.46659,41.12567,3545,0,1,1,NA
18351,pa,-75.0995,40.92283,274,4,10,6,150
18352,pa,-75.35478,41.00787,561,2,5,3,150
18353,pa,-75.36701,40.8965,5648,2,6,4,200
18354,pa,-75.32496,40.92571,508,3,7,4,133.3
18355,pa,-75.35396,41.07599,1336,1,2,1,100
18356,pa,-75.11811,41.01109,502,3,7,4,133.3
18357,pa,-75.21844,41.22769,141,0,1,1,NA
18360,pa,-75.28364,40.97392,12201,4,9,5,125
18370,pa,-75.34142,41.09181,731,1,3,2,200
18371,pa,-75.04167,41.15866,517,1,4,3,300
18372,pa,-75.32447,41.04724,2344,1,4,3,300
18403,pa,-75.52965,41.50042,3935,1,3,2,200
18405,pa,-75.10267,41.593,1982,1,3,2,200
18407,pa,-75.52784,41.59955,8457,0,2,2,NA
18411,pa,-75.74524,41.4542,10575,1,3,2,200
18413,pa,-75.58934,41.64813,95,0,2,2,NA
18414,pa,-75.7403,41.54011,3463,1,3,2,200
18415,pa,-75.11477,41.74424,1385,1,3,2,200
18417,pa,-75.19841,41.80471,2920,0,2,2,NA
18419,pa,-75.79095,41.58577,2625,1,4,3,300
18420,pa,-75.71013,41.60201,18,1,3,2,200
18421,pa,-75.46975,41.6645,2651,0,1,1,NA
18424,pa,-75.51569,41.22515,12413,0,1,1,NA
18425,pa,-75.02051,41.42571,934,1,3,2,200
18426,pa,-75.23551,41.31385,6478,0,1,1,NA
18427,pa,-75.4069,41.40466,118,0,1,1,NA
18428,pa,-75.12314,41.41609,15051,1,3,2,200
18430,pa,-75.47405,41.74801,31,0,0,0,NA
18431,pa,-75.25748,41.62295,8620,1,2,1,100
18433,pa,-75.58818,41.57445,3982,1,3,2,200
18434,pa,-75.54834,41.46147,1999,1,3,2,200
18435,pa,-75.00233,41.48906,1818,1,4,3,300
18436,pa,-75.39302,41.43678,15423,0,2,2,NA
18437,pa,-75.3064,41.86782,304,0,2,2,NA
18438,pa,-75.25098,41.43597,2221,0,2,2,NA
18439,pa,-75.34923,41.82685,757,0,1,1,NA
18441,pa,-75.62824,41.6595,178,1,3,2,200
18443,pa,-75.10114,41.66229,496,1,3,2,200
18444,pa,-75.55113,41.33101,8863,0,1,1,NA
18445,pa,-75.36062,41.2966,5791,0,1,1,NA
18446,pa,-75.757,41.64503,2193,1,4,3,300
18447,pa,-75.61669,41.50841,5345,1,4,3,300
18451,pa,-75.21647,41.40822,763,0,1,1,NA
18452,pa,-75.59028,41.48363,2458,1,4,3,300
18453,pa,-75.36199,41.75456,1327,0,1,1,NA
18454,pa,-75.42666,41.82897,389,0,1,1,NA
18455,pa,-75.35607,41.88678,94,0,1,1,NA
18456,pa,-75.34434,41.62624,316,0,2,2,NA
18457,pa,-75.04849,41.47188,79,1,3,2,200
18458,pa,-74.91635,41.40929,5251,1,3,2,200
18459,pa,-75.42908,41.50492,131,0,2,2,NA
18460,pa,-75.32354,41.25392,202,0,1,1,NA
18461,pa,-75.32819,41.92804,592,1,2,1,100
18462,pa,-75.42229,41.90748,668,0,1,1,NA
18463,pa,-75.40335,41.34922,169,0,1,1,NA
18464,pa,-75.17872,41.40325,1818,0,1,1,NA
18465,pa,-75.51188,41.82945,1654,0,1,1,NA
18466,pa,-75.38562,41.19548,9787,0,1,1,NA
18469,pa,-75.14217,41.70112,307,1,3,2,200
18470,pa,-75.53822,41.72795,2375,0,1,1,NA
18471,pa,-75.69218,41.52832,365,1,3,2,200
18472,pa,-75.39849,41.58376,3220,0,2,2,NA
18473,pa,-75.21089,41.52428,188,1,3,2,200
18503,pa,-75.66746,41.41112,389,2,5,3,150
18504,pa,-75.69987,41.42552,8763,2,6,4,200
18505,pa,-75.65312,41.38784,8580,1,3,2,200
18507,pa,-75.68048,41.35535,2629,2,5,3,150
18508,pa,-75.65793,41.45496,4990,2,6,4,200
18509,pa,-75.64291,41.43084,4775,2,5,3,150
18510,pa,-75.63677,41.40729,3935,2,5,3,150
18512,pa,-75.59458,41.42744,5856,1,4,3,300
18517,pa,-75.71364,41.39464,2032,2,6,4,200
18518,pa,-75.7396,41.375,4152,3,7,4,133.3
18519,pa,-75.63072,41.46194,2307,2,5,3,150
18602,pa,-75.75508,41.18752,235,0,2,2,NA
18603,pa,-76.24878,41.08295,9303,5,11,6,120
18610,pa,-75.5462,41.06308,4136,1,2,1,100
18612,pa,-75.98339,41.34938,8156,1,4,3,300
18614,pa,-76.37807,41.4897,2822,0,2,2,NA
18615,pa,-75.85729,41.46185,1247,2,6,4,200
18616,pa,-76.62376,41.50969,946,1,2,1,100
18617,pa,-76.07709,41.17148,897,2,6,4,200
18618,pa,-76.03483,41.37476,3346,1,3,2,200
18619,pa,-76.71125,41.44804,398,1,3,2,200
18621,pa,-76.09286,41.25332,3441,2,6,4,200
18622,pa,-76.27302,41.20379,140,3,8,5,166.7
18623,pa,-76.14765,41.67036,1671,2,4,2,100
18624,pa,-75.62086,41.05779,1444,0,1,1,NA
18625,pa,-75.85076,41.50964,532,2,5,3,150
18626,pa,-76.51319,41.40441,832,0,2,2,NA
18628,pa,-76.3144,41.43793,405,0,1,1,NA
18629,pa,-76.13826,41.51149,1444,1,3,2,200
18630,pa,-76.02946,41.66739,1996,2,5,3,150
18631,pa,-76.30342,41.02956,623,6,12,6,100
18632,pa,-76.38342,41.46689,316,0,2,2,NA
18634,pa,-76.02149,41.18998,6408,3,8,5,166.7
18635,pa,-76.20123,41.03049,2189,3,8,5,166.7
18636,pa,-76.09754,41.4025,875,1,3,2,200
18640,pa,-75.74027,41.29722,8205,2,6,4,200
18641,pa,-75.73042,41.33604,3292,2,5,3,150
18642,pa,-75.77671,41.35354,2155,2,6,4,200
18643,pa,-75.83622,41.36655,5847,3,8,5,166.7
18644,pa,-75.87856,41.33152,3909,3,8,5,166.7
18651,pa,-75.9619,41.2476,4733,5,10,5,100
18653,pa,-75.82357,41.39334,71,3,7,4,133.3
18655,pa,-76.19609,41.18175,4534,3,8,5,166.7
18656,pa,-76.20957,41.3226,1555,1,4,3,300
18657,pa,-75.95416,41.52526,6576,2,5,3,150
18660,pa,-76.06475,41.10447,2399,2,6,4,200
18661,pa,-75.75321,41.08569,5489,1,2,1,100
18701,pa,-75.88503,41.24365,900,3,7,4,133.3
18702,pa,-75.77407,41.22026,17301,2,6,4,200
18704,pa,-75.89464,41.27663,12974,4,10,6,150
18705,pa,-75.84334,41.27188,6852,2,6,4,200
18706,pa,-75.91147,41.20445,7661,2,5,3,150
18707,pa,-75.92642,41.13365,7771,1,3,2,200
18708,pa,-75.96538,41.29417,4439,2,6,4,200
18709,pa,-75.89652,41.28559,1353,4,10,6,150
18801,pa,-75.93837,41.82975,5101,1,2,1,100
18810,pa,-76.50453,41.93571,2628,2,6,4,200
18812,pa,-75.95761,41.96662,1476,1,2,1,100
18814,pa,-76.60559,41.78173,73,2,5,3,150
18816,pa,-75.9157,41.74986,62,1,3,2,200
18817,pa,-76.62629,41.87008,145,1,3,2,200
18818,pa,-76.04686,41.91032,1026,1,3,2,200
18821,pa,-75.73627,41.98663,506,1,3,2,200
18822,pa,-75.80143,41.94963,1689,1,3,2,200
18823,pa,-75.6935,41.7761,130,1,3,2,200
18824,pa,-75.78348,41.70412,914,1,3,2,200
18825,pa,-75.60105,41.80768,110,0,1,1,NA
18826,pa,-75.74652,41.75104,1300,1,3,2,200
18828,pa,-76.1045,41.79642,193,1,4,3,300
18829,pa,-76.1697,41.83452,571,1,3,2,200
18830,pa,-76.10747,41.95144,627,1,3,2,200
18831,pa,-76.60082,41.89121,578,2,5,3,150
18832,pa,-76.5566,41.67703,1138,1,3,2,200
18833,pa,-76.47898,41.59758,1855,1,3,2,200
18834,pa,-75.71431,41.84352,2554,1,2,1,100
18837,pa,-76.29654,41.92076,1775,1,4,3,300
18840,pa,-76.53583,41.9718,4816,3,7,4,133.3
18842,pa,-75.62107,41.75809,145,0,2,2,NA
18843,pa,-75.89958,41.79446,134,1,2,1,100
18844,pa,-75.91425,41.69516,1010,1,4,3,300
18845,pa,-76.18458,41.78807,253,1,4,3,300
18846,pa,-76.24091,41.60243,612,1,4,3,300
18847,pa,-75.56903,41.92954,4185,1,2,1,100
18848,pa,-76.45413,41.75208,4720,2,5,3,150
18850,pa,-76.49993,41.85294,1310,2,5,3,150
18851,pa,-76.17607,41.93403,660,1,3,2,200
18853,pa,-76.26899,41.72067,2820,2,5,3,150
18854,pa,-76.35535,41.79467,729,2,5,3,150
18901,pa,-75.14889,40.30541,10121,8,16,8,100
18902,pa,-75.09676,40.35307,8404,7,15,8,114.3
18912,pa,-75.05437,40.32376,36,8,16,8,100
18913,pa,-75.05584,40.38165,136,8,15,7,87.5
18914,pa,-75.20983,40.28902,8302,8,16,8,100
18915,pa,-75.25682,40.27211,569,7,15,8,114.3
18917,pa,-75.20408,40.373,595,6,12,6,100
18920,pa,-75.08425,40.49612,255,8,16,8,100
18923,pa,-75.17113,40.35776,423,6,13,7,116.7
18925,pa,-75.05641,40.28621,2644,8,16,8,100
18929,pa,-75.0798,40.25522,3442,9,17,8,88.9
18930,pa,-75.21352,40.52163,1539,7,14,7,100
18932,pa,-75.25583,40.29426,200,8,16,8,100
18935,pa,-75.40145,40.4372,50,9,18,9,100
18936,pa,-75.23096,40.22405,110,8,16,8,100
18938,pa,-74.99754,40.35239,6520,9,17,8,88.9
18940,pa,-74.94755,40.26318,12248,10,18,8,80
18942,pa,-75.15928,40.47017,1649,7,14,7,100
18944,pa,-75.23465,40.39136,10315,7,14,7,100
18947,pa,-75.11448,40.42437,2792,7,14,7,100
18950,pa,-75.07158,40.44299,148,7,15,8,114.3
18951,pa,-75.34461,40.4524,14409,8,16,8,100
18954,pa,-74.99939,40.22261,3420,10,19,9,90
18955,pa,-75.31516,40.47761,603,7,15,8,114.3
18960,pa,-75.32504,40.36404,5241,7,15,8,114.3
18962,pa,-75.27081,40.34592,205,6,13,7,116.7
18964,pa,-75.33331,40.29736,5275,8,16,8,100
18966,pa,-75.00629,40.18766,14491,11,20,9,81.8
18969,pa,-75.37277,40.32631,5759,8,16,8,100
18970,pa,-75.38121,40.412,288,8,16,8,100
18972,pa,-75.11957,40.53338,2047,7,14,7,100
18974,pa,-75.073,40.21595,14660,9,17,8,88.9
18976,pa,-75.14425,40.24786,7609,8,17,9,112.5
18977,pa,-74.88062,40.28722,2146,9,18,9,100
18980,pa,-75.01411,40.26793,288,9,17,8,88.9
19001,pa,-75.12544,40.12592,6534,10,19,9,90
19002,pa,-75.20995,40.18378,12043,9,18,9,100
19003,pa,-75.29893,40.00155,4746,12,23,11,91.7
19004,pa,-75.23003,40.01374,3286,13,24,11,84.6
19006,pa,-75.06151,40.13295,7525,11,20,9,81.8
19007,pa,-74.85863,40.1139,7744,14,24,10,71.4
19008,pa,-75.3608,39.97387,7223,12,22,10,83.3
19009,pa,-75.06424,40.13781,275,11,20,9,81.8
19010,pa,-75.32972,40.02363,6038,11,20,9,81.8
19012,pa,-75.10588,40.05977,2399,14,24,10,71.4
19013,pa,-75.37614,39.84791,14601,15,26,11,73.3
19014,pa,-75.4336,39.86366,8359,14,24,10,71.4
19015,pa,-75.39285,39.86924,5534,14,25,11,78.6
19017,pa,-75.46444,39.89087,219,13,23,10,76.9
19018,pa,-75.29859,39.92306,7853,14,24,10,71.4
19020,pa,-74.93859,40.10454,15721,14,25,11,78.6
19021,pa,-74.89154,40.08906,3640,14,25,11,78.6
19022,pa,-75.33702,39.86144,1446,14,25,11,78.6
19023,pa,-75.26739,39.91714,7875,14,25,11,78.6
19025,pa,-75.16199,40.14644,2218,9,18,9,100
19026,pa,-75.30404,39.95031,10320,13,24,11,84.6
19027,pa,-75.12423,40.07348,5608,12,22,10,83.3
19029,pa,-75.29122,39.86949,2041,14,25,11,78.6
19030,pa,-74.8372,40.18063,4114,12,22,10,83.3
19031,pa,-75.217,40.10916,2007,10,19,9,90
19032,pa,-75.27947,39.89117,2577,14,25,11,78.6
19033,pa,-75.32843,39.89088,2953,14,25,11,78.6
19034,pa,-75.20483,40.13427,2296,10,19,9,90
19035,pa,-75.28151,40.04918,1499,11,21,10,90.9
19036,pa,-75.29335,39.90358,4657,14,25,11,78.6
19038,pa,-75.17241,40.10169,11970,10,19,9,90
19040,pa,-75.1056,40.17688,7257,9,18,9,100
19041,pa,-75.31652,40.00718,1797,12,22,10,83.3
19043,pa,-75.30885,39.90031,1045,14,25,11,78.6
19044,pa,-75.15287,40.18607,5827,9,17,8,88.9
19046,pa,-75.10552,40.10141,6089,12,22,10,83.3
19047,pa,-74.91042,40.18132,12788,12,22,10,83.3
19050,pa,-75.26366,39.93755,9179,14,25,11,78.6
19053,pa,-74.97955,40.1547,10138,12,22,10,83.3
19054,pa,-74.82036,40.17087,5521,12,22,10,83.3
19055,pa,-74.83876,40.14968,4741,12,23,11,91.7
19056,pa,-74.88582,40.14964,4619,13,23,10,76.9
19057,pa,-74.85647,40.14005,5848,13,23,10,76.9
19060,pa,-75.49367,39.84998,4336,11,21,10,90.9
19061,pa,-75.43539,39.82945,7555,15,26,11,73.3
19063,pa,-75.41409,39.92183,12594,13,23,10,76.9
19064,pa,-75.34114,39.9333,8996,13,24,11,84.6
19066,pa,-75.24906,40.00258,1730,14,24,10,71.4
19067,pa,-74.81591,40.2063,18672,11,20,9,81.8
19070,pa,-75.32473,39.90625,2648,13,24,11,84.6
19072,pa,-75.2577,40.0243,3230,13,24,11,84.6
19073,pa,-75.43484,39.98105,7806,11,20,9,81.8
19074,pa,-75.29642,39.88643,2001,14,25,11,78.6
19075,pa,-75.18634,40.11404,2937,10,19,9,90
19076,pa,-75.30765,39.88593,2117,14,25,11,78.6
19078,pa,-75.32189,39.87473,3862,14,25,11,78.6
19079,pa,-75.26667,39.8988,3521,14,25,11,78.6
19081,pa,-75.34716,39.89805,3069,14,25,11,78.6
19082,pa,-75.27042,39.96043,9655,14,25,11,78.6
19083,pa,-75.31207,39.97703,12967,13,23,10,76.9
19085,pa,-75.34957,40.03733,2285,10,18,8,80
19086,pa,-75.37004,39.89064,4178,14,25,11,78.6
19087,pa,-75.39986,40.06115,10543,9,17,8,88.9
19090,pa,-75.12685,40.15673,6954,10,18,8,80
19094,pa,-75.34664,39.87488,1440,14,25,11,78.6
19095,pa,-75.15123,40.08599,1934,11,21,10,90.9
19096,pa,-75.27418,39.99788,4225,13,23,10,76.9
19102,pa,-75.16559,39.95278,354,15,27,12,80
19103,pa,-75.174,39.95283,2826,15,27,12,80
19104,pa,-75.19837,39.95913,11693,15,26,11,73.3
19106,pa,-75.14315,39.94851,2058,15,27,12,80
19107,pa,-75.15865,39.95174,1934,15,27,12,80
19109,pa,-75.16365,39.94965,1,15,27,12,80
19111,pa,-75.08052,40.06021,19075,14,24,10,71.4
19112,pa,-75.16966,39.88986,84,14,25,11,78.6
19113,pa,-75.25331,39.86742,113,14,25,11,78.6
19114,pa,-75.0036,40.06741,8715,14,24,10,71.4
19115,pa,-75.04579,40.09107,8880,12,22,10,83.3
19116,pa,-75.01272,40.11674,9448,12,21,9,75
19118,pa,-75.21246,40.07267,2869,10,19,9,90
19119,pa,-75.19098,40.05383,9656,13,23,10,76.9
19120,pa,-75.11997,40.03369,21649,14,25,11,78.6
19121,pa,-75.17875,39.98218,16313,15,26,11,73.3
19122,pa,-75.1459,39.97775,8176,15,27,12,80
19123,pa,-75.1457,39.96408,4967,15,27,12,80
19124,pa,-75.09309,40.01708,23017,15,26,11,73.3
19125,pa,-75.1248,39.9762,12327,15,27,12,80
19126,pa,-75.13756,40.05539,4742,14,24,10,71.4
19127,pa,-75.22701,40.02814,2770,13,23,10,76.9
19128,pa,-75.22899,40.04882,13125,13,23,10,76.9
19129,pa,-75.18457,40.01361,3903,15,26,11,73.3
19130,pa,-75.1754,39.96778,7533,15,27,12,80
19131,pa,-75.21791,39.98857,14169,14,25,11,78.6
19132,pa,-75.17085,39.99626,20475,15,26,11,73.3
19133,pa,-75.14151,39.99263,14581,15,26,11,73.3
19134,pa,-75.10837,39.98983,25552,15,26,11,73.3
19135,pa,-75.0493,40.02186,12206,15,25,10,66.7
19136,pa,-75.01883,40.03973,11083,14,25,11,78.6
19137,pa,-75.07395,39.99462,3856,15,26,11,73.3
19138,pa,-75.15905,40.056,12731,13,23,10,76.9
19139,pa,-75.22958,39.96144,16597,14,26,12,85.7
19140,pa,-75.14501,40.01233,22590,15,26,11,73.3
19141,pa,-75.14569,40.03758,10257,14,24,10,71.4
19142,pa,-75.23419,39.92267,11255,14,25,11,78.6
19143,pa,-75.22644,39.94287,25244,14,25,11,78.6
19144,pa,-75.17494,40.03308,13401,14,24,10,71.4
19145,pa,-75.19206,39.91486,18354,14,25,11,78.6
19146,pa,-75.18366,39.9394,18255,14,26,12,85.7
19147,pa,-75.15226,39.93582,15128,14,26,12,85.7
19148,pa,-75.1514,39.91165,21118,14,26,12,85.7
19149,pa,-75.06576,40.03772,18451,14,25,11,78.6
19150,pa,-75.17182,40.0725,9257,11,21,10,90.9
19151,pa,-75.25625,39.9756,11120,14,25,11,78.6
19152,pa,-75.04674,40.06077,10106,14,24,10,71.4
19153,pa,-75.22831,39.89329,4303,14,25,11,78.6
19154,pa,-74.98158,40.09507,11094,14,24,10,71.4
19301,pa,-75.48025,40.04113,2580,7,15,8,114.3
19310,pa,-75.96966,39.93539,1132,7,14,7,100
19311,pa,-75.769,39.8227,3210,9,18,9,100
19312,pa,-75.45164,40.0324,4198,8,17,9,112.5
19316,pa,-75.8365,40.05547,118,6,13,7,116.7
19317,pa,-75.60172,39.85788,4196,9,18,9,100
19319,pa,-75.5205,39.92829,79,10,19,9,90
19320,pa,-75.83099,39.96903,20965,8,15,7,87.5
19330,pa,-75.91651,39.87241,2593,8,16,8,100
19333,pa,-75.42325,40.04114,1818,9,17,8,88.9
19335,pa,-75.72016,40.02285,18694,8,16,8,100
19341,pa,-75.63668,40.04106,5563,8,15,7,87.5
19342,pa,-75.49676,39.90575,6245,10,20,10,100
19343,pa,-75.75464,40.10138,3466,7,14,7,100
19344,pa,-75.88153,40.08403,3748,6,11,5,83.3
19345,pa,-75.56529,40.02947,2,7,13,6,85.7
19348,pa,-75.71377,39.86733,8262,9,17,8,88.9
19350,pa,-75.79466,39.76332,4390,10,20,10,100
19352,pa,-75.88925,39.77683,3272,11,21,10,90.9
19355,pa,-75.53096,40.04685,10605,7,15,8,114.3
19358,pa,-75.80265,39.96169,221,8,16,8,100
19362,pa,-76.06809,39.75243,2101,13,25,12,92.3
19363,pa,-75.97454,39.78705,6420,11,22,11,100
19365,pa,-75.92511,39.96408,2984,7,14,7,100
19367,pa,-75.88402,39.96299,85,7,15,8,114.3
19372,pa,-75.75899,39.9984,460,8,15,7,87.5
19373,pa,-75.5339,39.90248,1003,9,18,9,100
19374,pa,-75.75325,39.83346,322,9,17,8,88.9
19375,pa,-75.74027,39.90039,46,8,16,8,100
19380,pa,-75.60719,39.98485,17209,8,16,8,100
19382,pa,-75.61229,39.92808,16319,9,18,9,100
19383,pa,-75.60163,39.95159,2,9,17,8,88.9
19390,pa,-75.84008,39.83289,4921,9,18,9,100
19401,pa,-75.33132,40.13034,13314,11,21,10,90.9
19403,pa,-75.37964,40.14964,17620,10,20,10,100
19405,pa,-75.34065,40.10384,2123,11,20,9,81.8
19406,pa,-75.38241,40.09442,7802,10,19,9,90
19422,pa,-75.27724,40.15736,7305,10,19,9,90
19425,pa,-75.64637,40.10222,6115,7,15,8,114.3
19426,pa,-75.43728,40.19135,14376,9,18,9,100
19428,pa,-75.30083,40.08041,7348,11,21,10,90.9
19435,pa,-75.56917,40.32748,48,12,22,10,83.3
19436,pa,-75.247,40.20151,76,8,16,8,100
19437,pa,-75.25858,40.18241,333,10,18,8,80
19438,pa,-75.39514,40.26979,9150,9,18,9,100
19440,pa,-75.28948,40.28648,7144,8,16,8,100
19442,pa,-75.58314,40.12952,17,9,18,9,100
19444,pa,-75.25316,40.08774,3745,11,20,9,81.8
19446,pa,-75.30368,40.23198,19384,8,16,8,100
19453,pa,-75.50157,40.13921,800,10,20,10,100
19454,pa,-75.24309,40.22346,11951,8,16,8,100
19456,pa,-75.46095,40.13332,291,11,21,10,90.9
19457,pa,-75.58799,40.20459,56,9,18,9,100
19460,pa,-75.53009,40.12704,15973,10,19,9,90
19462,pa,-75.28376,40.11554,5945,11,20,9,81.8
19464,pa,-75.61573,40.25886,18934,10,19,9,90
19465,pa,-75.67292,40.19853,7249,8,16,8,100
19468,pa,-75.53287,40.20755,9980,9,18,9,100
19472,pa,-75.57378,40.33693,27,12,22,10,83.3
19473,pa,-75.47483,40.25898,6485,9,18,9,100
19474,pa,-75.40404,40.22353,357,9,18,9,100
19475,pa,-75.60066,40.17044,4085,9,18,9,100
19477,pa,-75.23268,40.18387,35,10,19,9,90
19492,pa,-75.492,40.28551,198,10,19,9,90
19501,pa,-76.05845,40.24277,442,6,12,6,100
19503,pa,-75.57691,40.40502,498,10,20,10,100
19504,pa,-75.58836,40.40704,2358,10,19,9,90
19505,pa,-75.62131,40.38155,1333,10,19,9,90
19506,pa,-76.12574,40.45958,3674,6,12,6,100
19507,pa,-76.28582,40.49175,1739,6,12,6,100
19508,pa,-75.84165,40.26382,6600,7,14,7,100
19510,pa,-75.88256,40.44781,2781,5,12,7,140
19511,pa,-75.74375,40.48466,105,5,11,6,120
19512,pa,-75.67943,40.34847,7273,9,17,8,88.9
19518,pa,-75.75308,40.26887,5766,8,16,8,100
19519,pa,-75.73339,40.32025,21,8,16,8,100
19520,pa,-75.79712,40.16253,2845,6,11,5,83.3
19522,pa,-75.8185,40.4473,6073,5,11,6,120
19523,pa,-75.84568,40.20274,99,5,11,6,120
19525,pa,-75.58676,40.30761,6321,10,19,9,90
19526,pa,-75.99624,40.5466,4639,6,12,6,100
19529,pa,-75.86455,40.63129,1911,4,10,6,150
19530,pa,-75.77795,40.53823,4407,6,12,6,100
19533,pa,-75.98741,40.42411,2886,7,14,7,100
19534,pa,-75.87454,40.57336,979,5,11,6,120
19535,pa,-75.80416,40.34036,11,8,17,9,112.5
19536,pa,-75.75872,40.48043,198,4,8,4,100
19538,pa,-75.70038,40.54702,35,6,13,7,116.7
19539,pa,-75.68948,40.48985,2048,4,10,6,150
19540,pa,-75.96607,40.23692,4846,5,11,6,120
19541,pa,-76.02546,40.47992,1804,6,13,7,116.7
19542,pa,-75.76719,40.2612,31,6,13,7,116.7
19543,pa,-75.8924,40.17119,2311,5,11,6,120
19544,pa,-76.29618,40.41709,99,6,13,7,116.7
19545,pa,-75.62407,40.34152,166,11,21,10,90.9
19547,pa,-75.76541,40.38114,2020,7,14,7,100
19549,pa,-76.02099,40.58457,183,5,10,5,100
19550,pa,-76.25072,40.45574,177,6,12,6,100
19551,pa,-76.14052,40.35955,2188,5,11,6,120
19554,pa,-76.10373,40.51288,176,6,12,6,100
19555,pa,-75.95134,40.49394,1659,6,13,7,116.7
19559,pa,-76.18253,40.49445,150,5,12,7,140
19560,pa,-75.8943,40.40341,3564,5,11,6,120
19562,pa,-75.70233,40.50499,810,4,9,5,125
19564,pa,-75.87445,40.52151,63,6,13,7,116.7
19565,pa,-76.0864,40.34286,3389,6,13,7,116.7
19567,pa,-76.21162,40.39341,2219,6,12,6,100
19601,pa,-75.94108,40.35264,9495,7,15,8,114.3
19602,pa,-75.91458,40.32868,5942,7,14,7,100
19604,pa,-75.9106,40.35754,8046,7,14,7,100
19605,pa,-75.94364,40.39825,8352,7,14,7,100
19606,pa,-75.85739,40.33714,13140,7,15,8,114.3
19607,pa,-75.9444,40.29164,8051,6,13,7,116.7
19608,pa,-76.03454,40.31133,8540,6,12,6,100
19609,pa,-75.99713,40.32801,4135,7,14,7,100
19610,pa,-75.97605,40.34007,5201,7,14,7,100
19611,pa,-75.94104,40.32479,3289,7,15,8,114.3
19701,de,-75.69936,39.58435,13834,13,25,12,92.3
19702,de,-75.7275,39.62227,16629,13,25,12,92.3
19703,de,-75.45578,39.80268,4539,15,26,11,73.3
19706,de,-75.59561,39.57243,947,12,23,11,91.7
19707,de,-75.68091,39.78602,6202,10,19,9,90
19709,de,-75.67803,39.48967,21298,12,23,11,91.7
19710,de,-75.58809,39.79517,16,10,19,9,90
19711,de,-75.73973,39.71434,15915,13,25,12,92.3
19713,de,-75.7123,39.67078,9138,14,26,12,85.7
19716,de,-75.75839,39.68956,3,15,27,12,80
19717,de,-75.75227,39.67846,9,15,27,12,80
19720,de,-75.60397,39.64641,20501,11,22,11,100
19730,de,-75.65361,39.45918,301,12,24,12,100
19731,de,-75.58333,39.51891,192,11,22,11,100
19732,de,-75.57004,39.7839,16,10,19,9,90
19733,de,-75.65109,39.55583,55,13,25,12,92.3
19734,de,-75.6468,39.38416,6993,12,24,12,100
19736,de,-75.67664,39.80607,23,10,19,9,90
19801,de,-75.54111,39.72661,5921,13,23,10,76.9
19802,de,-75.52893,39.75683,8966,13,24,11,84.6
19803,de,-75.54213,39.80037,8489,11,21,10,90.9
19804,de,-75.61844,39.71683,7148,11,22,11,100
19805,de,-75.5927,39.7447,14584,12,22,10,83.3
19806,de,-75.56422,39.76328,3184,12,22,10,83.3
19807,de,-75.60982,39.79776,3111,10,20,10,100
19808,de,-75.66522,39.73838,13686,11,22,11,100
19809,de,-75.50122,39.75787,5091,14,25,11,78.6
19810,de,-75.5064,39.81878,8647,12,21,9,75
19901,de,-75.47227,39.17173,11358,10,20,10,100
19904,de,-75.59493,39.17026,16334,11,21,10,90.9
19930,de,-75.06219,38.5487,5947,7,18,11,157.1
19931,de,-75.62299,38.57399,220,17,30,13,76.5
19933,de,-75.60957,38.73601,4874,15,28,13,86.7
19934,de,-75.62906,39.08335,6390,12,23,11,91.7
19936,de,-75.58439,39.21911,112,11,22,11,100
19938,de,-75.6992,39.25724,4414,12,24,12,100
19939,de,-75.21065,38.56478,4795,10,22,12,120
19940,de,-75.56884,38.47785,3328,19,33,14,73.7
19941,de,-75.42554,38.79557,2252,13,26,13,100
19943,de,-75.60882,39.0058,8022,12,24,12,100
19944,de,-75.05562,38.47523,1049,8,18,10,125
19945,de,-75.22877,38.50476,6089,10,22,12,120
19946,de,-75.45411,39.03425,2877,10,21,11,110
19947,de,-75.3967,38.67238,9443,13,27,14,107.7
19950,de,-75.59735,38.82014,4090,13,25,12,92.3
19951,de,-75.25449,38.69116,1730,12,25,13,108.3
19952,de,-75.62615,38.91586,5420,13,25,12,92.3
19953,de,-75.698,39.15211,2133,13,25,12,92.3
19954,de,-75.52038,38.89746,833,12,24,12,100
19955,de,-75.66864,39.22593,42,12,24,12,100
19956,de,-75.54075,38.54787,7694,17,31,14,82.4
19958,de,-75.16261,38.73357,17655,10,22,12,120
19960,de,-75.41361,38.84899,3480,12,25,13,108.3
19962,de,-75.49743,39.07015,5942,10,21,11,110
19963,de,-75.3776,38.93748,12301,12,24,12,100
19964,de,-75.72324,39.09059,631,15,27,12,80
19966,de,-75.28156,38.58115,14982,12,25,13,108.3
19967,de,-75.12245,38.53871,1531,7,18,11,157.1
19968,de,-75.28639,38.77768,9134,11,24,13,118.2
19970,de,-75.09658,38.56197,7874,7,18,11,157.1
19971,de,-75.09826,38.68679,11201,8,19,11,137.5
19973,de,-75.6158,38.63928,11931,16,29,13,81.3
19975,de,-75.17489,38.47015,8177,9,21,12,133.3
19977,de,-75.55088,39.2963,12965,11,23,12,109.1
19979,de,-75.57255,39.04885,324,13,25,12,92.3
20001,dc,-77.0179,38.91083,7947,18,32,14,77.8
20002,dc,-76.98439,38.90513,16595,17,31,14,82.4
20003,dc,-76.99061,38.88128,7919,17,30,13,76.5
20004,dc,-77.02864,38.89489,154,17,31,14,82.4
20005,dc,-77.03158,38.90467,815,18,32,14,77.8
20006,dc,-77.04146,38.89861,322,18,31,13,72.2
20007,dc,-77.07849,38.91418,7829,19,33,14,73.7
20008,dc,-77.05932,38.9359,4298,18,32,14,77.8
20009,dc,-77.03758,38.91994,5555,18,32,14,77.8
20010,dc,-77.02999,38.93231,5348,18,32,14,77.8
20011,dc,-77.0227,38.95243,16911,18,31,13,72.2
20012,dc,-77.03196,38.97728,4384,17,30,13,76.5
20015,dc,-77.05841,38.96664,5103,18,31,13,72.2
20016,dc,-77.09144,38.93821,7601,18,32,14,77.8
20017,dc,-76.99316,38.93846,5732,18,32,14,77.8
20018,dc,-76.97274,38.92613,6102,18,32,14,77.8
20019,dc,-76.94275,38.89179,15323,16,28,12,75
20020,dc,-76.97528,38.86163,10421,16,29,13,81.3
20024,dc,-77.02774,38.8783,1190,17,30,13,76.5
20032,dc,-77.00682,38.8342,5382,16,29,13,81.3
20036,dc,-77.04157,38.90702,660,18,32,14,77.8
20037,dc,-77.05607,38.89799,719,18,32,14,77.8
20045,dc,-77.0308,38.89673,10,17,31,14,82.4
20052,dc,-77.04698,38.90013,1,18,32,14,77.8
20053,dc,-77.01122,38.88412,15,17,30,13,76.5
20057,dc,-77.07574,38.90912,23,19,33,14,73.7
20064,dc,-76.99919,38.93636,44,18,32,14,77.8
20105,va,-77.61003,38.96274,10197,14,27,13,92.9
20106,va,-78.01171,38.68699,2844,20,35,15,75
20109,va,-77.52658,38.79285,9844,19,33,14,73.7
20110,va,-77.48597,38.74704,19508,17,31,14,82.4
20111,va,-77.43013,38.74931,10745,17,31,14,82.4
20112,va,-77.42478,38.66648,13604,16,29,13,81.3
20115,va,-77.9001,38.82159,3759,15,28,13,86.7
20117,va,-77.74337,38.99205,1659,15,27,12,80
20118,va,-77.737,38.96834,19,14,27,13,92.9
20119,va,-77.62493,38.61839,2303,17,31,14,82.4
20120,va,-77.47714,38.85432,12966,17,30,13,76.5
20121,va,-77.46032,38.81766,7636,17,31,14,82.4
20124,va,-77.39165,38.7815,5269,16,29,13,81.3
20129,va,-77.60184,39.16222,286,17,30,13,76.5
20130,va,-77.9491,39.02749,256,9,19,10,111.1
20132,va,-77.72708,39.16776,7694,16,30,14,87.5
20135,va,-77.87127,39.09526,3172,9,19,10,111.25
20136,va,-77.55375,38.73804,9761,18,33,15,83.3
20137,va,-77.72106,38.8101,901,15,28,13,86.7
20139,va,-77.69721,38.65635,114,17,31,14,82.4
20141,va,-77.78901,39.11353,3088,16,29,13,81.3
20143,va,-77.5676,38.86,530,16,30,14,87.5
20144,va,-77.94242,38.91355,763,13,25,12,92.3
20147,va,-77.47953,39.04153,17802,15,27,12,80
20148,va,-77.52736,38.9961,16591,14,27,13,92.9
20151,va,-77.44486,38.89573,6373,14,26,12,85.7
20152,va,-77.50412,38.91759,11317,15,27,12,80
20155,va,-77.61838,38.81016,13351,17,31,14,82.4
20158,va,-77.65446,39.13858,1940,16,30,14,87.5
20164,va,-77.39567,39.01265,9865,13,24,11,84.6
20165,va,-77.38857,39.05064,10028,14,26,12,85.7
20166,va,-77.45526,38.98577,3517,13,25,12,92.3
20169,va,-77.6454,38.87343,10097,16,29,13,81.3
20170,va,-77.38036,38.98078,11043,12,23,11,91.7
20171,va,-77.39824,38.92359,12773,13,24,11,84.6
20175,va,-77.60072,39.0593,11826,16,30,14,87.5
20176,va,-77.53592,39.18207,14365,16,30,14,87.5
20180,va,-77.63878,39.26842,3575,15,28,13,86.7
20181,va,-77.57079,38.68693,4284,17,31,14,82.4
20184,va,-77.88267,39.00275,590,14,26,12,85.7
20186,va,-77.8444,38.70161,6724,16,29,13,81.3
20187,va,-77.74272,38.72259,7593,15,28,13,86.7
20190,va,-77.33686,38.95977,3433,13,24,11,84.6
20191,va,-77.35087,38.93385,8960,13,24,11,84.6
20194,va,-77.34302,38.98033,4258,12,24,12,100
20197,va,-77.62634,39.19498,993,16,29,13,81.3
20198,va,-77.75758,38.88034,1513,13,25,12,92.3
20202,dc,-77.02101,38.88707,5,17,31,14,82.4
20204,dc,-77.01443,38.88556,1,17,30,13,76.5
20228,dc,-77.03028,38.88641,2,17,31,14,82.4
20230,dc,-77.0328,38.89379,1,17,31,14,82.4
20240,dc,-77.0426,38.89446,2,17,31,14,82.4
20245,dc,-77.04446,38.89334,9,17,31,14,82.4
20260,dc,-77.02504,38.88367,7,17,31,14,82.4
20307,dc,-77.03047,38.97497,40,17,31,14,82.4
20317,dc,-77.01234,38.93629,2,18,32,14,77.8
20319,dc,-77.01779,38.86548,1,17,31,14,82.4
20373,dc,-77.00813,38.85822,6,16,29,13,81.3
20390,dc,-76.9937,38.87902,4,17,30,13,76.5
20405,dc,-77.04259,38.89638,2,17,31,14,82.4
20418,dc,-77.04776,38.8928,2,17,31,14,82.4
20427,dc,-77.04756,38.90206,5,18,32,14,77.8
20506,dc,-77.03873,38.89707,1,17,31,14,82.4
20510,dc,-77.00689,38.89278,1,17,30,13,76.5
20520,dc,-77.04841,38.89476,9,17,31,14,82.4
20535,dc,-77.02484,38.89447,1,17,31,14,82.4
20540,dc,-77.00471,38.88793,3,17,30,13,76.5
20551,dc,-77.0458,38.8928,3,17,31,14,82.4
20553,dc,-77.02297,38.88695,2,17,31,14,82.4
20565,dc,-77.01921,38.89063,3,17,31,14,82.4
20566,dc,-77.05513,38.89557,1,17,31,14,82.4
20593,dc,-77.01019,38.86671,23,17,30,13,76.5
20601,md,-76.85084,38.6137,9951,15,27,12,80
20602,md,-76.89423,38.58396,9034,15,27,12,80
20603,md,-76.97694,38.62939,11847,14,26,12,85.7
20606,md,-76.73697,38.2595,341,15,28,13,86.7
20607,md,-77.02015,38.67226,5997,14,26,12,85.7
20608,md,-76.70692,38.58625,1378,15,28,13,86.7
20609,md,-76.75846,38.27104,785,17,31,14,82.4
20611,md,-76.98455,38.46079,523,15,28,13,86.7
20612,md,-76.67798,38.50707,154,13,26,13,100
20613,md,-76.80881,38.67247,8593,14,26,12,85.7
20615,md,-76.54788,38.42023,271,13,26,13,100
20616,md,-77.08847,38.6541,3206,14,26,12,85.7
20617,md,-76.85246,38.54125,434,14,26,12,85.7
20618,md,-76.79229,38.28041,476,20,35,15,75
20619,md,-76.52631,38.2913,5206,10,22,12,120
20620,md,-76.5233,38.23159,632,10,22,12,120
20621,md,-76.79838,38.32945,1951,20,35,15,75
20622,md,-76.84488,38.45393,2046,15,27,12,80
20623,md,-76.83727,38.74246,1038,14,27,13,92.9
20624,md,-76.73783,38.33642,609,15,28,13,86.7
20625,md,-76.84812,38.26227,685,21,37,16,76.2
20626,md,-76.77056,38.23029,486,15,29,14,93.3
20628,md,-76.34876,38.15833,605,11,24,13,118.2
20629,md,-76.45236,38.33637,519,10,22,12,120
20630,md,-76.47231,38.16245,231,10,23,13,130
20632,md,-76.952,38.43207,238,18,32,14,77.8
20634,md,-76.49522,38.24384,2120,9,21,12,133.3
20636,md,-76.57028,38.35215,5133,11,23,12,109.1
20637,md,-76.77615,38.52625,2594,13,26,13,100
20639,md,-76.60717,38.60752,6228,12,25,13,108.3
20640,md,-77.1636,38.55888,4574,14,27,13,92.9
20645,md,-76.90584,38.29261,680,26,42,16,61.5
20646,md,-77.00019,38.52262,10594,13,26,13,100
20650,md,-76.63435,38.26911,6850,13,26,13,100
20653,md,-76.43259,38.23221,8290,9,21,12,133.3
20657,md,-76.44195,38.38036,11095,10,22,12,120
20658,md,-77.16132,38.56345,479,14,27,13,92.9
20659,md,-76.73424,38.4182,10552,14,27,13,92.9
20660,md,-76.70663,38.37022,51,12,25,13,108.3
20662,md,-77.20453,38.43378,1857,18,32,14,77.8
20664,md,-76.92628,38.35415,2075,23,38,15,65.2
20667,md,-76.44291,38.21768,160,10,22,12,120
20670,md,-76.41707,38.28754,5,10,21,11,110
20674,md,-76.50856,38.13563,730,11,24,13,118.2
20675,md,-77.02248,38.58093,784,12,24,12,100
20676,md,-76.54419,38.49084,2162,12,24,12,100
20677,md,-77.04101,38.49998,1376,14,26,12,85.7
20678,md,-76.60142,38.52225,5468,12,24,12,100
20680,md,-76.37298,38.1134,821,11,24,13,118.2
20684,md,-76.40795,38.14245,665,11,23,12,109.1
20685,md,-76.52845,38.43486,3310,11,24,13,118.2
20686,md,-76.43056,38.17911,71,10,23,13,130
20687,md,-76.34611,38.07387,543,11,25,14,127.3
20688,md,-76.46512,38.32927,1007,10,22,12,120
20689,md,-76.58233,38.66283,792,12,24,12,100
20690,md,-76.52824,38.16183,503,11,24,13,118.2
20692,md,-76.50065,38.18458,673,10,23,13,130
20693,md,-77.08806,38.45631,543,17,30,13,76.5
20695,md,-76.97332,38.59134,3426,13,25,12,92.3
20701,md,-76.78428,39.12633,119,16,28,12,75
20705,md,-76.90129,39.048,8083,16,28,12,75
20706,md,-76.85097,38.9656,12460,16,28,12,75
20707,md,-76.88181,39.09804,9117,16,29,13,81.3
20708,md,-76.82662,39.04654,4791,16,29,13,81.3
20710,md,-76.92614,38.94208,1227,17,31,14,82.4
20711,md,-76.65195,38.80512,2033,13,25,12,92.3
20712,md,-76.96512,38.94308,1385,18,32,14,77.8
20714,md,-76.54179,38.72156,2320,14,27,13,92.9
20715,md,-76.74009,38.98829,10056,14,25,11,78.6
20716,md,-76.71504,38.92725,7223,13,25,12,92.3
20720,md,-76.78265,38.98226,8638,15,28,13,86.7
20721,md,-76.78875,38.92108,10344,14,26,12,85.7
20722,md,-76.94944,38.93508,2081,18,32,14,77.8
20723,md,-76.86663,39.13693,9561,16,29,13,81.3
20724,md,-76.804,39.10108,4879,16,29,13,81.3
20732,md,-76.53778,38.65653,4636,14,26,12,85.7
20733,md,-76.53177,38.80457,1325,15,28,13,86.7
20735,md,-76.90583,38.75015,16469,15,28,13,86.7
20736,md,-76.62804,38.69038,3759,13,24,11,84.6
20737,md,-76.91365,38.96509,4574,17,31,14,82.4
20740,md,-76.93096,39.00271,6540,17,30,13,76.5
20742,md,-76.9457,38.98962,10,17,30,13,76.5
20743,md,-76.89345,38.88393,15351,15,27,12,80
20744,md,-76.98403,38.75404,19155,15,28,13,86.7
20745,md,-76.99418,38.80648,6237,16,29,13,81.3
20746,md,-76.91811,38.83682,6122,14,27,13,92.9
20747,md,-76.88378,38.85442,10129,13,25,12,92.3
20748,md,-76.94061,38.8169,10771,15,28,13,86.7
20751,md,-76.55844,38.79404,1397,15,28,13,86.7
20754,md,-76.65283,38.73661,2817,13,25,12,92.3
20755,md,-76.74676,39.10576,10,14,26,12,85.7
20758,md,-76.59315,38.73337,360,13,25,12,92.3
20759,md,-76.92857,39.15476,2203,16,28,12,75
20762,md,-76.87483,38.8073,63,14,26,12,85.7
20763,md,-76.81659,39.13491,547,16,28,12,75
20764,md,-76.5083,38.8343,2499,15,28,13,86.7
20765,md,-76.54561,38.84457,251,16,29,13,81.3
20769,md,-76.81992,38.99346,2659,16,28,12,75
20770,md,-76.87944,39.0043,2877,16,28,12,75
20772,md,-76.76624,38.7798,20239,14,26,12,85.7
20774,md,-76.77388,38.87527,18003,13,25,12,92.3
20776,md,-76.60472,38.8705,1226,14,26,12,85.7
20777,md,-76.96791,39.17485,1367,14,26,12,85.7
20778,md,-76.56511,38.83718,997,16,28,12,75
20779,md,-76.57545,38.76537,680,14,26,12,85.7
20781,md,-76.93646,38.94318,3500,18,31,13,72.2
20782,md,-76.96488,38.96472,6114,18,32,14,77.8
20783,md,-76.96879,38.9991,6385,17,31,14,82.4
20784,md,-76.89044,38.95103,7502,16,29,13,81.3
20785,md,-76.88198,38.91808,10376,15,28,13,86.7
20794,md,-76.78898,39.15012,3778,15,27,12,80
20812,md,-77.14347,38.96678,144,19,33,14,73.7
20814,md,-77.10203,39.00489,6820,16,29,13,81.3
20815,md,-77.07867,38.98361,7680,17,31,14,82.4
20816,md,-77.11846,38.95604,5445,19,33,14,73.7
20817,md,-77.14865,38.99816,12993,17,30,13,76.5
20818,md,-77.16235,38.9737,790,19,33,14,73.7
20832,md,-77.07253,39.15115,8461,11,21,10,90.9
20833,md,-77.05531,39.20524,3143,11,22,11,100
20837,md,-77.40676,39.1127,2978,14,27,13,92.9
20838,md,-77.37231,39.22621,154,12,24,12,100
20839,md,-77.42256,39.18354,153,14,25,11,78.6
20841,md,-77.32334,39.19022,5154,12,24,12,100
20842,md,-77.42573,39.21066,1478,13,25,12,92.3
20850,md,-77.18094,39.09129,13268,12,23,11,91.7
20851,md,-77.12177,39.07839,3777,12,23,11,91.7
20852,md,-77.12458,39.05149,7789,13,25,12,92.3
20853,md,-77.09518,39.10233,9222,12,22,10,83.3
20854,md,-77.22048,39.03374,18756,13,25,12,92.3
20855,md,-77.13237,39.13708,6192,12,22,10,83.3
20860,md,-77.02844,39.14849,913,11,22,11,100
20861,md,-76.99756,39.15239,891,12,23,11,91.7
20862,md,-77.01946,39.18355,160,12,22,10,83.3
20866,md,-76.93352,39.10943,4607,15,27,12,80
20868,md,-76.96836,39.12584,374,13,24,11,84.6
20871,md,-77.28324,39.26093,6527,11,21,10,90.9
20872,md,-77.21771,39.29151,4919,10,20,10,100
20874,md,-77.29751,39.12974,15063,13,24,11,84.6
20876,md,-77.23296,39.2079,7795,12,23,11,91.7
20877,md,-77.18827,39.14089,6177,12,22,10,83.3
20878,md,-77.25145,39.11252,18389,12,24,12,100
20879,md,-77.17592,39.16919,7331,12,23,11,91.7
20880,md,-77.1736,39.13974,279,12,22,10,83.3
20882,md,-77.14524,39.23309,5797,11,21,10,90.9
20886,md,-77.19351,39.17984,10114,12,22,10,83.3
20895,md,-77.07756,39.02675,7124,14,26,12,85.7
20896,md,-77.09341,39.03619,415,13,25,12,92.3
20899,md,-77.21613,39.14371,20,12,22,10,83.3
20901,md,-77.00912,39.02141,9886,15,28,13,86.7
20902,md,-77.04216,39.04375,12541,14,25,11,78.6
20903,md,-76.98125,39.0206,3410,16,29,13,81.3
20904,md,-76.97971,39.06663,11876,13,25,12,92.3
20905,md,-76.99292,39.11195,6876,13,23,10,76.9
20906,md,-77.05664,39.08674,14362,12,23,11,91.7
20910,md,-77.03629,39.00226,7575,16,29,13,81.3
20912,md,-77.00119,38.98212,5348,17,31,14,82.4
21001,md,-76.20197,39.50824,9402,16,28,12,75
21005,md,-76.11917,39.47456,1,16,28,12,75
21009,md,-76.2924,39.46993,12172,17,29,12,70.6
21012,md,-76.49708,39.04531,7788,16,29,13,81.3
21013,md,-76.48654,39.50908,2157,18,32,14,77.8
21014,md,-76.35168,39.53662,14800,19,32,13,68.4
21015,md,-76.29606,39.54687,11357,17,30,13,76.5
21017,md,-76.23697,39.47623,2690,16,28,12,75
21028,md,-76.24247,39.568,1480,16,29,13,81.3
21029,md,-76.95296,39.20559,3920,15,27,12,80
21030,md,-76.6677,39.49191,6435,17,29,12,70.6
21031,md,-76.65801,39.48721,136,16,29,13,81.3
21032,md,-76.6041,39.03377,4610,16,29,13,81.3
21034,md,-76.22117,39.65066,1486,17,30,13,76.5
21035,md,-76.63737,38.93688,3420,15,27,12,80
21036,md,-77.00259,39.23373,830,13,24,11,84.6
21037,md,-76.54236,38.91494,9674,17,30,13,76.5
21040,md,-76.29402,39.43331,7656,16,29,13,81.3
21042,md,-76.89279,39.27032,14006,15,27,12,80
21043,md,-76.79791,39.25755,12653,14,26,12,85.7
21044,md,-76.88385,39.21034,9954,16,28,12,75
21045,md,-76.82744,39.20617,11224,15,27,12,80
21046,md,-76.84188,39.17357,4801,16,28,12,75
21047,md,-76.43917,39.52798,5235,19,32,13,68.4
21048,md,-76.91034,39.49529,4703,14,25,11,78.6
21050,md,-76.39228,39.58569,7100,19,32,13,68.4
21051,md,-76.45401,39.47208,139,18,32,14,77.8
21052,md,-76.44655,39.20728,152,15,27,12,80
21053,md,-76.71558,39.69255,1970,7,15,8,114.3
21054,md,-76.67327,39.02178,4891,15,27,12,80
21056,md,-76.43265,39.0727,242,16,29,13,81.3
21057,md,-76.50649,39.45049,1989,18,31,13,72.2
21060,md,-76.58376,39.16798,12578,14,26,12,85.7
21061,md,-76.62974,39.16177,14117,14,25,11,78.6
21071,md,-76.81095,39.48166,279,14,26,12,85.7
21074,md,-76.84364,39.61739,6877,9,19,10,111.1
21075,md,-76.75183,39.20351,8254,14,26,12,85.7
21076,md,-76.72165,39.16685,7287,13,25,12,92.3
21077,md,-76.69769,39.15614,279,14,25,11,78.6
21078,md,-76.14193,39.56557,8771,16,29,13,81.3
21082,md,-76.47712,39.47921,368,18,32,14,77.8
21084,md,-76.4641,39.61636,3253,15,27,12,80
21085,md,-76.35467,39.44774,7767,17,30,13,76.5
21087,md,-76.41566,39.44768,2823,18,31,13,72.2
21090,md,-76.66808,39.20924,4114,14,25,11,78.6
21093,md,-76.64086,39.43979,14346,16,29,13,81.3
21102,md,-76.8467,39.68683,5800,8,17,9,112.5
21104,md,-76.90654,39.34961,2318,15,28,13,86.7
21105,md,-76.65128,39.71395,31,7,15,8,114.3
21108,md,-76.62208,39.08954,6499,14,26,12,85.7
21111,md,-76.58175,39.57724,2739,13,24,11,84.6
21113,md,-76.71657,39.05358,10868,14,25,11,78.6
21114,md,-76.68423,39.00963,7231,15,27,12,80
21117,md,-76.77709,39.42712,15859,15,27,12,80
21120,md,-76.67896,39.64492,3931,8,16,8,100
21122,md,-76.49502,39.12059,24410,15,27,12,80
21128,md,-76.44627,39.40772,5085,17,30,13,76.5
21130,md,-76.19418,39.47732,65,16,29,13,81.3
21131,md,-76.57378,39.50468,3472,17,30,13,76.5
21132,md,-76.42923,39.69604,1200,11,20,9,81.8
21133,md,-76.81248,39.37479,10051,15,27,12,80
21136,md,-76.80849,39.48901,12653,14,26,12,85.7
21140,md,-76.58486,38.95024,1481,17,30,13,76.5
21144,md,-76.67732,39.12092,10929,13,25,12,92.3
21146,md,-76.55668,39.07757,10542,16,29,13,81.3
21152,md,-76.68191,39.54828,2695,14,26,12,85.7
21153,md,-76.70811,39.41269,212,15,28,13,86.7
21154,md,-76.35623,39.65224,2725,16,28,12,75
21155,md,-76.80592,39.57107,1551,10,20,10,100
21156,md,-76.39656,39.43719,205,17,30,13,76.5
21157,md,-76.98082,39.54933,15823,12,22,10,83.3
21158,md,-77.03249,39.64669,9096,11,21,10,90.9
21160,md,-76.30979,39.70667,1130,13,24,11,84.6
21161,md,-76.56541,39.6604,2867,8,17,9,112.5
21162,md,-76.40377,39.39004,2449,17,29,12,70.6
21163,md,-76.85616,39.33974,2262,15,28,13,86.7
21201,md,-76.62222,39.29482,3184,15,27,12,80
21202,md,-76.60738,39.29648,4984,15,27,12,80
21204,md,-76.63261,39.40259,4986,15,28,13,86.7
21205,md,-76.56448,39.30229,5602,14,26,12,85.7
21206,md,-76.53677,39.33927,16725,15,27,12,80
21207,md,-76.72037,39.3243,15996,14,26,12,85.7
21208,md,-76.72435,39.38486,10613,15,27,12,80
21209,md,-76.66955,39.37394,6854,15,27,12,80
21210,md,-76.63432,39.35809,2770,14,26,12,85.7
21211,md,-76.63942,39.32999,7563,14,26,12,85.7
21212,md,-76.61511,39.36828,12290,14,26,12,85.7
21213,md,-76.57721,39.31513,16214,15,26,11,73.3
21214,md,-76.5644,39.3518,7723,15,27,12,80
21215,md,-76.6837,39.34557,19462,15,26,11,73.3
21216,md,-76.67204,39.31098,12074,15,27,12,80
21217,md,-76.63851,39.30828,14909,15,27,12,80
21218,md,-76.60263,39.33,16655,14,26,12,85.7
21219,md,-76.44381,39.22877,4653,15,27,12,80
21220,md,-76.39321,39.34545,15816,16,29,13,81.3
21221,md,-76.43546,39.29064,15878,16,28,12,75
21222,md,-76.49346,39.26548,22476,14,26,12,85.7
21223,md,-76.65324,39.28425,14386,15,27,12,80
21224,md,-76.54232,39.27497,22840,15,26,11,73.3
21225,md,-76.61526,39.22589,10381,13,25,12,92.3
21226,md,-76.55971,39.21091,3779,14,26,12,85.7
21227,md,-76.67945,39.24049,12958,14,25,11,78.6
21228,md,-76.74745,39.27268,18515,14,25,11,78.6
21229,md,-76.69077,39.28514,16001,14,26,12,85.7
21230,md,-76.62089,39.26604,15554,14,26,12,85.7
21231,md,-76.59232,39.28713,5866,14,26,12,85.7
21234,md,-76.53391,39.39347,24475,16,29,13,81.3
21236,md,-76.48622,39.38835,13842,17,29,12,70.6
21237,md,-76.49523,39.33915,11130,15,28,13,86.7
21239,md,-76.58733,39.36646,8458,15,27,12,80
21240,md,-76.67325,39.17533,19,14,26,12,85.7
21244,md,-76.78033,39.33306,8970,14,26,12,85.7
21250,md,-76.71118,39.25561,5,14,25,11,78.6
21251,md,-76.58072,39.34734,5,15,27,12,80
21252,md,-76.60782,39.39379,12,14,26,12,85.7
21286,md,-76.57441,39.41504,6914,16,28,12,75
21401,md,-76.55012,38.98981,13493,17,30,13,76.5
21402,md,-76.47144,38.98701,11,17,30,13,76.5
21403,md,-76.48945,38.94226,10050,17,30,13,76.5
21405,md,-76.55146,39.03047,396,17,29,12,70.6
21409,md,-76.44327,39.01909,7893,17,30,13,76.5
21502,md,-78.75496,39.64406,22319,10,21,11,110
21520,md,-79.30149,39.62476,1682,0,1,1,NA
21521,md,-79.04041,39.546,918,1,3,2,200
21522,md,-79.22775,39.61024,81,0,1,1,NA
21523,md,-79.07924,39.47986,382,0,2,2,NA
21524,md,-78.80141,39.70763,347,5,13,8,160
21529,md,-78.7686,39.70607,379,5,13,8,160
21530,md,-78.53654,39.68932,1324,5,12,7,140
21531,md,-79.42139,39.64842,2087,1,2,1,100
21532,md,-78.95939,39.65596,7016,1,2,1,100
21536,md,-79.16858,39.6564,2793,0,1,1,NA
21538,md,-79.22109,39.40133,581,0,2,2,NA
21539,md,-79.01342,39.59919,1645,0,2,2,NA
21540,md,-79.05925,39.47658,227,1,4,3,300
21541,md,-79.36813,39.55454,3936,0,1,1,NA
21542,md,-78.94999,39.5961,238,0,1,1,NA
21543,md,-78.95969,39.64929,115,1,2,1,100
21545,md,-78.86374,39.70096,1267,2,7,5,250
21550,md,-79.3909,39.38903,13574,0,1,1,NA
21555,md,-78.55639,39.58935,2039,9,19,10,111.1
21557,md,-78.92292,39.51938,1379,6,14,8,133.3
21561,md,-79.20058,39.49465,4206,0,1,1,NA
21562,md,-79.05059,39.50345,2110,2,7,5,250
21601,md,-76.08672,38.79301,11587,16,29,13,81.3
21607,md,-75.85421,39.13272,364,15,28,13,86.7
21610,md,-76.07701,39.36811,343,17,29,12,70.6
21612,md,-76.27489,38.74882,421,15,28,13,86.7
21613,md,-76.08341,38.50221,11558,16,30,14,87.5
21617,md,-76.04236,39.04951,4908,18,31,13,72.2
21619,md,-76.27597,38.94342,3679,16,29,13,81.3
21620,md,-76.09525,39.20964,7970,17,30,13,76.5
21622,md,-76.17793,38.40685,830,12,25,13,108.3
21623,md,-75.96237,39.12271,1228,17,31,14,82.4
21624,md,-76.27145,38.84396,101,14,27,13,92.9
21625,md,-75.99634,38.8734,1378,18,31,13,72.2
21626,md,-76.09558,38.33673,348,13,27,14,107.7
21627,md,-76.04768,38.23274,64,12,26,14,116.7
21628,md,-75.91889,39.23662,229,15,28,13,86.7
21629,md,-75.82796,38.86272,4971,17,31,14,82.4
21631,md,-75.94549,38.58627,1627,19,34,15,78.9
21632,md,-75.77372,38.7275,3568,18,31,13,72.2
21634,md,-76.2001,38.29037,467,11,24,13,118.2
21635,md,-75.84052,39.33863,1378,14,27,13,92.9
21636,md,-75.80479,39.02405,672,16,28,12,75
21638,md,-76.20636,38.94085,2679,17,30,13,76.5
21639,md,-75.79357,38.96567,2080,16,29,13,81.3
21640,md,-75.81864,39.06955,720,15,28,13,86.7
21641,md,-75.94243,38.91783,54,18,31,13,72.2
21643,md,-75.86998,38.64781,3369,20,34,14,70
21644,md,-75.87352,39.11243,98,16,28,12,75
21645,md,-75.96507,39.3231,797,16,29,13,81.3
21647,md,-76.28074,38.81689,225,15,27,12,80
21648,md,-76.23321,38.48826,350,13,26,13,100
21649,md,-75.77017,39.13459,698,14,26,12,85.7
21650,md,-75.80968,39.31538,167,14,27,13,92.9
21651,md,-75.85338,39.25904,1606,15,27,12,80
21652,md,-76.28218,38.7151,166,15,29,14,93.3
21653,md,-76.17847,38.75104,89,14,27,13,92.9
21654,md,-76.12873,38.68934,1076,16,29,13,81.3
21655,md,-75.9208,38.74524,2653,18,32,14,77.8
21657,md,-75.98485,38.95767,506,17,30,13,76.5
21658,md,-76.1376,38.94351,2059,17,30,13,76.5
21659,md,-75.7819,38.58327,1017,20,35,15,75
21660,md,-75.89034,38.956,2042,17,30,13,76.5
21661,md,-76.22078,39.10587,2323,16,29,13,81.3
21662,md,-76.20971,38.71397,469,15,28,13,86.7
21663,md,-76.2295,38.78908,2439,15,28,13,86.7
21664,md,-75.94522,38.60712,283,19,34,15,78.9
21665,md,-76.33303,38.74685,259,15,28,13,86.7
21666,md,-76.33433,38.93756,6924,16,28,12,75
21667,md,-76.05311,39.34542,212,16,29,13,81.3
21668,md,-75.85256,39.19032,994,15,27,12,80
21669,md,-76.29238,38.46467,329,12,24,12,100
21671,md,-76.33565,38.69391,931,15,29,14,93.3
21672,md,-76.05802,38.27538,391,13,27,14,107.7
21673,md,-76.04784,38.64663,1823,17,31,14,82.4
21675,md,-76.08877,38.28779,170,14,28,14,100
21676,md,-76.33613,38.77725,332,15,28,13,86.7
21677,md,-76.18522,38.4882,361,13,27,14,107.7
21678,md,-76.10107,39.31053,1451,16,29,13,81.3
21679,md,-76.08466,38.91758,280,19,33,14,73.7
21701,md,-77.33496,39.44605,15969,18,32,14,77.8
21702,md,-77.45658,39.47872,15007,20,35,15,75
21703,md,-77.46961,39.36777,13968,19,34,15,78.9
21704,md,-77.37502,39.35411,7804,14,27,13,92.9
21705,md,-77.41001,39.40886,1,21,36,15,71.4
21710,md,-77.44955,39.29817,2136,15,28,13,86.7
21711,md,-78.01628,39.66701,651,9,19,10,111.1
21713,md,-77.67102,39.52485,4495,10,20,10,100
21714,md,-77.50442,39.4193,37,18,33,15,83.3
21716,md,-77.62009,39.31461,2909,16,29,13,81.3
21717,md,-77.43639,39.33706,35,16,30,14,87.5
21718,md,-77.62752,39.39227,87,15,28,13,86.7
21719,md,-77.49657,39.70734,751,4,9,5,125
21722,md,-77.91722,39.66597,2791,11,21,10,90.9
21723,md,-77.01049,39.32531,349,12,23,11,91.7
21727,md,-77.32721,39.68898,2633,11,21,10,90.9
21733,md,-77.75849,39.5493,499,12,24,12,100
21734,md,-77.70784,39.60782,289,11,22,11,100
21737,md,-77.01986,39.2546,735,13,24,11,84.6
21738,md,-77.02592,39.2809,1162,12,23,11,91.7
21740,md,-77.74248,39.63403,22591,11,21,10,90.9
21742,md,-77.6564,39.66979,12450,10,19,9,90
21746,md,-77.71147,39.56506,2,12,24,12,100
21750,md,-78.21652,39.68671,2548,8,17,9,112.5
21754,md,-77.31225,39.33483,3619,12,23,11,91.7
21755,md,-77.56695,39.36055,2976,16,29,13,81.3
21756,md,-77.7006,39.45217,1746,11,21,10,90.9
21757,md,-77.25681,39.59982,1830,12,23,11,91.7
21758,md,-77.66476,39.34815,2842,15,28,13,86.7
21762,md,-77.24709,39.48083,131,13,24,11,84.6
21766,md,-78.39268,39.66147,740,6,15,9,150
21767,md,-77.74747,39.69714,351,8,16,8,100
21769,md,-77.56553,39.445,5809,14,26,12,85.7
21770,md,-77.25682,39.35175,3360,11,21,10,90.9
21771,md,-77.15689,39.39351,13451,10,20,10,100
21773,md,-77.55177,39.53907,3675,8,18,10,125
21774,md,-77.27592,39.4096,6847,13,24,11,84.6
21776,md,-77.10406,39.51618,3124,11,22,11,100
21777,md,-77.52071,39.26827,843,17,31,14,82.4
21778,md,-77.3358,39.61596,763,13,24,11,84.6
21779,md,-77.65163,39.42683,657,11,21,10,90.9
21780,md,-77.46517,39.67667,1235,4,10,6,150
21781,md,-77.75965,39.57107,9,12,23,11,91.7
21782,md,-77.7616,39.45722,2253,12,23,11,91.7
21783,md,-77.55505,39.65158,4627,4,10,6,150
21784,md,-76.97362,39.40106,15931,13,25,12,92.3
21787,md,-77.1698,39.67324,5580,12,22,10,83.3
21788,md,-77.41901,39.59337,6486,13,24,11,84.6
21790,md,-77.49006,39.26181,115,16,29,13,81.3
21791,md,-77.18725,39.53988,2810,13,23,10,76.9
21793,md,-77.34473,39.49103,4170,16,29,13,81.3
21794,md,-76.97271,39.2966,959,14,26,12,85.7
21795,md,-77.82596,39.58218,3867,12,23,11,91.7
21797,md,-77.06992,39.33361,3882,11,22,11,100
21798,md,-77.30131,39.53655,1244,13,24,11,84.6
21801,md,-75.64147,38.38052,12875,18,33,15,83.3
21802,md,-75.5827,38.34477,1,17,32,15,88.2
21804,md,-75.53321,38.31275,15744,17,32,15,88.2
21810,md,-75.70993,38.29822,394,18,33,15,83.3
21811,md,-75.21801,38.32019,17212,11,24,13,118.2
21813,md,-75.16417,38.42618,2117,10,22,12,120
21814,md,-75.89793,38.29596,472,16,31,15,93.8
21817,md,-75.83608,37.98078,4361,10,24,14,140
21821,md,-75.92231,38.16671,1396,12,27,15,125
21822,md,-75.63756,38.27517,1163,16,31,15,93.8
21824,md,-76.0347,37.98346,354,12,27,15,125
21826,md,-75.62696,38.31709,2785,18,32,14,77.8
21829,md,-75.37939,38.09551,407,8,19,11,137.5
21830,md,-75.73244,38.40036,1896,19,34,15,78.9
21835,md,-75.94581,38.53307,192,20,36,16,80
21837,md,-75.76679,38.45904,1960,21,37,16,76.2
21838,md,-75.73224,38.01297,1948,11,24,13,118.2
21840,md,-75.90261,38.24897,579,13,27,14,107.7
21841,md,-75.29536,38.24733,642,10,23,13,130
21842,md,-75.091,38.37317,11073,9,20,11,122.2
21849,md,-75.46148,38.37575,1841,17,32,15,88.2
21850,md,-75.39938,38.36049,1880,18,33,15,83.3
21851,md,-75.54301,38.07936,4733,11,25,14,127.3
21853,md,-75.7216,38.20347,5344,16,32,16,100
21856,md,-75.79539,38.33574,979,17,32,15,88.2
21861,md,-75.72822,38.53528,520,19,34,15,78.9
21862,md,-75.22378,38.39757,86,13,26,13,100
21863,md,-75.39843,38.1924,3084,13,26,13,100
21864,md,-75.40632,38.04203,584,7,17,10,142.9
21865,md,-75.84652,38.28335,698,16,31,15,93.8
21866,md,-76.02137,37.96713,119,13,28,15,115.4
21867,md,-75.79368,38.10967,101,11,25,14,127.3
21869,md,-75.89266,38.43598,1139,21,37,16,76.2
21871,md,-75.73366,38.10353,2195,13,27,14,107.7
21872,md,-75.29456,38.41937,494,16,30,14,87.5
21874,md,-75.35243,38.39168,1377,17,32,15,88.2
21875,md,-75.54924,38.44083,3527,19,34,15,78.9
21901,md,-75.95841,39.58564,8247,16,29,13,81.3
21902,md,-76.06315,39.55197,6,17,29,12,70.6
21903,md,-76.03994,39.573,2712,16,29,13,81.3
21904,md,-76.07804,39.62315,2997,15,27,12,80
21911,md,-76.03799,39.68925,4336,14,26,12,85.7
21912,de,-75.81628,39.42066,682,15,27,12,80
21913,md,-75.86761,39.40451,326,15,28,13,86.7
21914,md,-75.97905,39.57268,568,17,30,13,76.5
21915,md,-75.84404,39.49908,2181,16,28,12,75
21916,md,-75.86156,39.64129,3,16,29,13,81.3
21917,md,-76.09825,39.67136,1060,15,27,12,80
21918,md,-76.16682,39.68365,1840,16,29,13,81.3
21919,md,-75.93547,39.4189,5131,16,29,13,81.3
21920,md,-75.82833,39.6575,134,15,27,12,80
21921,md,-75.85886,39.62635,17785,15,28,13,86.7
21930,md,-75.89002,39.37213,70,15,27,12,80
22003,va,-77.21443,38.83077,14350,15,28,13,86.7
22015,va,-77.28122,38.78814,13746,15,27,12,80
22025,va,-77.34026,38.59933,6857,15,28,13,86.7
22026,va,-77.29205,38.56688,5800,15,28,13,86.7
22027,va,-77.22126,38.89453,900,15,28,13,86.7
22030,va,-77.34168,38.83933,13987,14,26,12,85.7
22031,va,-77.26004,38.86,7297,14,27,13,92.9
22032,va,-77.28993,38.82045,10405,14,27,13,92.9
22033,va,-77.38448,38.87523,9689,14,26,12,85.7
22035,va,-77.35829,38.85521,5,15,27,12,80
22039,va,-77.31751,38.75267,6759,15,28,13,86.7
22041,va,-77.14196,38.84806,3145,16,30,14,87.5
22042,va,-77.19554,38.86443,8489,15,29,14,93.3
22043,va,-77.19736,38.90031,6435,16,29,13,81.3
22044,va,-77.15564,38.8597,2301,16,30,14,87.5
22046,va,-77.18085,38.88714,5110,16,29,13,81.3
22060,va,-77.15636,38.70542,440,18,32,14,77.8
22066,va,-77.30029,39.00894,7070,13,25,12,92.3
22079,va,-77.20856,38.67493,11148,17,31,14,82.4
22101,va,-77.16658,38.93935,11588,18,31,13,72.2
22102,va,-77.22789,38.9481,4363,16,28,12,75
22124,va,-77.33026,38.89057,6112,13,25,12,92.3
22125,va,-77.26079,38.68227,518,18,32,14,77.8
22134,va,-77.38426,38.51854,388,16,28,12,75
22150,va,-77.18602,38.77237,6813,16,30,14,87.5
22151,va,-77.20947,38.80286,5739,16,29,13,81.3
22152,va,-77.23163,38.77577,8877,16,29,13,81.3
22153,va,-77.23465,38.7448,11197,16,30,14,87.5
22172,va,-77.36483,38.56708,3141,15,27,12,80
22180,va,-77.25485,38.89654,7739,14,26,12,85.7
22181,va,-77.29438,38.90635,4730,14,25,11,78.6
22182,va,-77.27194,38.93567,9124,14,26,12,85.7
22185,va,-77.30403,38.8746,2,14,26,12,85.7
22191,va,-77.26337,38.62277,17470,16,30,14,87.5
22192,va,-77.31609,38.68334,18818,15,28,13,86.7
22193,va,-77.34807,38.64307,23813,15,28,13,86.7
22201,va,-77.09524,38.88657,4866,17,31,14,82.4
22202,va,-77.05155,38.85651,2505,18,31,13,72.2
22203,va,-77.11727,38.87373,2908,17,30,13,76.5
22204,va,-77.09895,38.86079,7670,17,31,14,82.4
22205,va,-77.13953,38.88347,6158,16,30,14,87.5
22206,va,-77.08887,38.8441,1582,18,31,13,72.2
22207,va,-77.12376,38.90665,11116,18,31,13,72.2
22209,va,-77.07546,38.89502,807,17,31,14,82.4
22211,va,-77.07079,38.88012,5,17,31,14,82.4
22213,va,-77.16251,38.8951,973,16,30,14,87.5
22214,va,-77.07397,38.86882,2,17,31,14,82.4
22301,va,-77.05963,38.81995,4711,18,31,13,72.2
22302,va,-77.08476,38.8281,3321,18,31,13,72.2
22303,va,-77.07858,38.79339,2598,17,31,14,82.4
22304,va,-77.114,38.81378,5689,17,30,13,76.5
22305,va,-77.06238,38.83644,3235,18,31,13,72.2
22306,va,-77.09291,38.75674,6215,17,30,13,76.5
22307,va,-77.0575,38.77194,3478,17,30,13,76.5
22308,va,-77.05778,38.73141,5172,16,30,14,87.5
22309,va,-77.10728,38.71923,8236,17,31,14,82.4
22310,va,-77.1215,38.78466,9925,16,30,14,87.5
22311,va,-77.12237,38.83442,1560,17,30,13,76.5
22312,va,-77.15365,38.81647,6079,16,30,14,87.5
22314,va,-77.05699,38.80703,9441,17,31,14,82.4
22315,va,-77.15047,38.75607,9214,17,31,14,82.4
22401,va,-77.48714,38.29918,8529,21,37,16,76.2
22405,va,-77.40373,38.31522,14631,21,36,15,71.4
22406,va,-77.55112,38.40023,10779,21,36,15,71.4
22407,va,-77.57532,38.28341,22275,19,33,14,73.7
22408,va,-77.44519,38.22078,12637,19,33,14,73.7
22427,va,-77.27065,38.0923,2259,19,34,15,78.9
22432,va,-76.3491,37.86905,498,15,30,15,100
22433,va,-77.86345,38.35789,167,20,36,16,80
22435,va,-76.57155,37.97232,2264,18,33,15,83.3
22436,va,-77.071,38.04209,644,21,37,16,76.2
22437,va,-76.80351,37.77925,1174,25,42,17,68
22438,va,-76.99116,38.03835,603,23,38,15,65.2
22443,va,-76.9959,38.17916,12078,27,44,17,63
22448,va,-77.032,38.3387,7,27,43,16,59.3
22454,va,-76.83709,37.84394,2406,23,40,17,73.9
22460,va,-76.61154,37.87051,1959,21,37,16,76.2
22469,va,-76.65269,38.0733,4008,15,30,15,100
22473,va,-76.41925,37.88626,8816,15,31,16,106.7
22476,va,-77.07113,38.04283,415,22,37,15,68.2
22480,va,-76.41511,37.66651,757,18,35,17,94.4
22482,va,-76.34814,37.73447,4353,16,33,17,106.3
22485,va,-77.15957,38.27196,14238,22,37,15,68.2
22488,va,-76.58835,38.04589,2479,14,29,15,107.1
22503,va,-76.51299,37.75162,6702,19,35,16,84.2
22504,va,-76.70689,37.77008,360,24,41,17,70.8
22508,va,-77.78726,38.31814,8119,18,33,15,83.3
22509,va,-77.07481,38.12104,43,23,39,16,69.6
22511,va,-76.50439,37.99073,1843,15,30,15,100
22514,va,-77.24637,37.97427,2171,20,35,15,75
22520,va,-76.799,38.11959,8102,19,34,15,78.9
22529,va,-76.68586,38.00965,329,21,37,16,76.2
22530,va,-76.28031,37.90109,304,13,28,15,115.4
22534,va,-77.67174,38.07941,1545,21,37,16,76.2
22535,va,-77.16466,38.15207,495,22,38,16,72.7
22538,va,-77.25116,38.20617,2647,20,35,15,75
22539,va,-76.2863,37.85823,4606,14,29,15,107.1
22542,va,-77.88264,38.29317,1168,21,36,15,71.4
22546,va,-77.4486,37.94191,11121,19,35,16,84.2
22548,va,-76.69806,37.82058,114,24,41,17,70.8
22551,va,-77.70158,38.16841,17160,20,35,15,75
22553,va,-77.64472,38.27098,7765,19,33,14,73.7
22554,va,-77.37704,38.42683,22105,18,32,14,77.8
22556,va,-77.51023,38.47177,9684,18,33,15,83.3
22560,va,-76.95514,37.91709,4548,23,39,16,69.6
22567,va,-77.9237,38.23434,2071,21,37,16,76.2
22572,va,-76.77977,37.97009,5285,22,38,16,72.7
22576,va,-76.44298,37.6814,1838,18,35,17,94.4
22578,va,-76.35536,37.636,3869,16,33,17,106.3
22579,va,-76.31955,37.80358,234,16,32,16,100
22580,va,-77.44634,38.10885,3421,18,33,15,83.3
22601,va,-78.17353,39.1747,10502,10,20,10,100
22602,va,-78.26623,39.14987,17763,9,19,10,111.1
22603,va,-78.20376,39.27924,6917,9,19,10,111.1
22610,va,-78.27939,38.81812,1657,7,15,8,114.3
22611,va,-77.98395,39.16474,4086,12,23,11,91.7
22620,va,-78.0332,39.06587,1671,10,21,11,110
22623,va,-78.13734,38.85154,756,10,20,10,100
22624,va,-78.09194,39.26516,1457,11,23,12,109.1
22625,va,-78.30807,39.37438,2971,7,16,9,128.6
22627,va,-78.11759,38.76416,608,14,27,13,92.9
22630,va,-78.17672,38.92855,21963,11,22,11,100
22637,va,-78.35907,39.25095,2121,6,14,8,133.3
22639,va,-78.02298,38.81492,386,16,29,13,81.3
22640,va,-78.12878,38.80879,409,13,26,13,100
22641,va,-78.39155,39.08061,265,8,18,10,125
22642,va,-78.04201,38.91032,4166,7,16,9,128.6
22643,va,-77.9865,38.88407,138,13,24,11,84.6
22644,va,-78.48928,38.95278,2002,9,20,11,122.2
22645,va,-78.27512,39.02146,2660,13,25,12,92.3
22646,va,-78.04206,39.07132,170,13,24,11,84.6
22650,va,-78.35999,38.75958,1439,7,16,9,128.6
22652,va,-78.42845,38.8399,2031,7,16,9,128.6
22654,va,-78.51984,39.03068,1013,6,14,8,133.3
22655,va,-78.2144,39.06534,9368,10,22,12,120
22656,va,-78.08885,39.21884,1868,11,23,12,109.1
22657,va,-78.3723,39.00547,6621,13,24,11,84.6
22660,va,-78.43201,38.94956,996,12,23,11,91.7
22663,va,-78.1148,39.05633,793,13,25,12,92.3
22664,va,-78.53039,38.88818,5360,8,18,10,125
22701,va,-77.99757,38.43913,15029,23,40,17,73.9
22709,va,-78.21875,38.33177,590,20,35,15,75
22711,va,-78.27032,38.46468,66,19,35,16,84.2
22712,va,-77.75891,38.56058,3347,19,33,14,73.7
22713,va,-78.13121,38.54959,930,20,35,15,75
22714,va,-77.89737,38.52133,634,24,40,16,66.7
22715,va,-78.18339,38.41142,611,20,36,16,80
22716,va,-78.11034,38.62574,643,19,33,14,73.7
22718,va,-77.82241,38.47362,480,20,35,15,75
22719,va,-78.28572,38.53062,440,15,28,13,86.7
22720,va,-77.64536,38.47673,628,18,32,14,77.8
22722,va,-78.22951,38.46161,179,20,35,15,75
22723,va,-78.38698,38.34046,86,16,30,14,87.5
22724,va,-77.90101,38.61642,1045,21,36,15,71.4
22726,va,-77.82226,38.40137,454,19,34,15,78.9
22727,va,-78.29887,38.39837,4062,18,33,15,83.3
22728,va,-77.69397,38.58745,2018,17,31,14,82.4
22729,va,-78.0144,38.37314,126,24,41,17,70.8
22730,va,-78.16275,38.36737,84,22,38,16,72.7
22731,va,-78.25733,38.33656,86,18,33,15,83.3
22732,va,-78.18988,38.31463,118,20,36,16,80
22733,va,-78.04156,38.33044,954,22,38,16,72.7
22734,va,-77.80408,38.52631,1820,21,36,15,71.4
22735,va,-78.17375,38.4775,1352,20,35,15,75
22736,va,-77.70494,38.39738,639,18,32,14,77.8
22737,va,-78.00327,38.59065,1615,22,38,16,72.7
22738,va,-78.27739,38.28821,751,19,34,15,78.9
22740,va,-78.25706,38.64175,1134,14,26,12,85.7
22741,va,-77.87337,38.43524,147,21,37,16,76.2
22742,va,-77.71673,38.46196,906,17,31,14,82.4
22743,va,-78.36908,38.52136,330,10,20,10,100
22747,va,-78.16733,38.71213,1128,15,28,13,86.7
22749,va,-78.18177,38.62024,317,16,30,14,87.5
22801,va,-78.87713,38.40458,12364,8,19,11,137.5
22802,va,-78.86196,38.49948,10603,7,17,10,142.9
22807,va,-78.86723,38.43416,5,7,17,10,142.9
22810,va,-78.79788,38.82937,2627,4,12,8,200
22811,va,-78.9787,38.78992,485,1,5,4,400
22812,va,-79.02619,38.3772,3791,9,21,12,133.3
22815,va,-78.80939,38.63018,5236,8,19,11,137.5
22820,va,-79.01628,38.72811,229,1,4,3,300
22821,va,-79.08511,38.47067,3121,8,19,11,137.5
22824,va,-78.63069,38.83898,4986,6,14,8,133.3
22827,va,-78.59939,38.41141,7641,6,14,8,133.3
22830,va,-78.97466,38.65652,1493,5,13,8,160
22831,va,-79.08852,38.56889,828,5,14,9,180
22832,va,-78.7584,38.45462,749,2,7,5,250
22834,va,-78.86028,38.55865,757,8,19,11,137.5
22835,va,-78.45251,38.67241,11705,10,20,10,100
22840,va,-78.74041,38.37711,3073,8,18,10,125
22841,va,-78.89679,38.33919,1707,10,22,12,120
22842,va,-78.70525,38.77576,4849,7,16,9,128.6
22843,va,-79.16035,38.36851,1529,7,17,10,142.9
22844,va,-78.66019,38.65574,3306,4,11,7,175
22845,va,-78.8151,38.78758,78,3,9,6,200
22846,va,-78.7888,38.37953,1102,8,19,11,137.5
22847,va,-78.72133,38.72008,832,9,20,11,122.2
22849,va,-78.62302,38.5259,6371,8,18,10,125
22850,va,-78.92446,38.56068,540,7,16,9,128.6
22851,va,-78.51162,38.56202,4987,4,10,6,150
22853,va,-78.76401,38.64843,2544,10,21,11,110
22901,va,-78.55616,38.08845,12324,15,28,13,86.7
22902,va,-78.46997,37.95387,8518,14,27,13,92.9
22903,va,-78.59996,38.00683,11608,14,28,14,100
22904,va,-78.51978,38.03439,18,16,30,14,87.5
22911,va,-78.40757,38.09277,7394,14,27,13,92.9
22920,va,-78.81072,37.97725,3024,12,25,13,108.3
22922,va,-78.9216,37.69405,1851,16,31,15,93.8
22923,va,-78.323,38.18798,2912,15,28,13,86.7
22931,va,-78.70608,37.89783,334,10,23,13,130
22932,va,-78.69428,38.15164,5026,14,28,14,100
22935,va,-78.55556,38.26221,679,12,24,12,100
22936,va,-78.49875,38.16732,2561,14,27,13,92.9
22937,va,-78.61618,37.80526,1203,17,31,14,82.4
22938,va,-78.7945,37.86065,1186,14,28,14,100
22939,va,-78.97416,38.10598,2704,8,20,12,150
22940,va,-78.59262,38.20258,780,13,26,13,100
22942,va,-78.19862,38.10967,6223,19,34,15,78.9
22943,va,-78.77115,38.03674,271,14,28,14,100
22946,va,-78.56993,37.85604,157,17,31,14,82.4
22947,va,-78.32742,38.04551,2744,17,32,15,88.2
22948,va,-78.12293,38.35714,120,23,39,16,69.6
22949,va,-78.87343,37.78719,1083,13,27,14,107.7
22952,va,-78.96513,37.96313,1239,4,10,6,150
22958,va,-78.90042,37.90199,3534,8,18,10,125
22959,va,-78.65373,37.94085,1029,13,26,13,100
22960,va,-78.07208,38.22427,6917,21,37,16,76.2
22963,va,-78.28843,37.84921,9262,18,34,16,88.9
22964,va,-79.00038,37.72095,229,16,31,15,93.8
22967,va,-79.01436,37.79498,2449,11,23,12,109.1
22968,va,-78.39723,38.24105,5021,15,28,13,86.7
22969,va,-78.69453,37.79722,1243,17,31,14,82.4
22971,va,-78.80016,37.7439,1696,15,29,14,93.3
22972,va,-78.23028,38.21614,269,17,31,14,82.4
22973,va,-78.46991,38.33626,4779,14,27,13,92.9
22974,va,-78.27936,37.96119,2592,18,33,15,83.3
22976,va,-79.05927,37.83378,470,7,17,10,142.9
22980,va,-78.88517,38.09564,20451,7,17,10,142.9
22989,va,-78.12247,38.29119,5,20,36,16,80
23002,va,-77.96879,37.35071,7857,20,36,16,80
23004,va,-78.40862,37.68224,816,19,35,16,84.2
23005,va,-77.4822,37.75957,8407,15,29,14,93.3
23009,va,-77.18736,37.81386,3781,22,38,16,72.7
23011,va,-76.8095,37.47682,1309,30,49,19,63.3
23015,va,-77.62554,37.92908,2606,20,35,15,75
23021,va,-76.37268,37.39087,371,14,29,15,107.1
23022,va,-78.26415,37.7342,936,21,37,16,76.2
23023,va,-76.95958,37.77868,401,23,40,17,73.9
23024,va,-77.77923,37.9254,7057,21,37,16,76.2
23025,va,-76.36156,37.41276,230,15,29,14,93.3
23027,va,-78.13391,37.64543,1266,20,36,16,80
23030,va,-77.05561,37.34367,4466,28,46,18,64.3
23032,va,-76.67965,37.65464,363,27,45,18,66.7
23035,va,-76.38629,37.49592,1482,16,32,16,100
23038,va,-78.14779,37.75546,2285,21,37,16,76.2
23039,va,-77.80631,37.65578,819,20,35,15,75
23040,va,-78.24754,37.50349,4068,19,35,16,84.2
23043,va,-76.34722,37.56164,3383,14,30,16,114.3
23045,va,-76.26288,37.42958,190,14,28,14,100
23047,va,-77.4736,37.84227,1386,17,32,15,88.2
23050,va,-76.43592,37.50051,432,19,35,16,84.2
23055,va,-78.22124,37.77494,650,20,37,17,85
23056,va,-76.37083,37.40675,558,15,30,15,100
23059,va,-77.56244,37.70489,13385,16,30,14,87.5
23060,va,-77.53344,37.65988,13212,15,29,14,93.3
23061,va,-76.54075,37.42738,14456,22,39,17,77.3
23062,va,-76.50184,37.25521,1626,17,33,16,94.1
23063,va,-78.00164,37.71651,3946,21,37,16,76.2
23064,va,-76.29995,37.49609,187,15,30,15,100
23065,va,-77.93211,37.80388,1441,20,36,16,80
23066,va,-76.28375,37.4946,967,15,30,15,100
23068,va,-76.33408,37.50155,254,15,30,15,100
23069,va,-77.32082,37.77173,1738,18,33,15,83.3
23070,va,-76.38997,37.55244,360,16,32,16,100
23071,va,-76.45144,37.54294,1975,18,35,17,94.4
23072,va,-76.44817,37.29059,7662,19,35,16,84.2
23075,va,-77.31767,37.54867,4107,21,37,16,76.2
23076,va,-76.30892,37.47655,723,15,30,15,100
23079,va,-76.67965,37.73062,672,24,42,18,75
23083,va,-78.121,37.31388,1429,20,36,16,80
23084,va,-78.11011,37.8846,1531,20,35,15,75
23085,va,-76.8413,37.70648,589,26,44,18,69.2
23086,va,-77.05337,37.6628,2378,24,41,17,70.8
23089,va,-76.90374,37.46308,3463,28,47,19,67.9
23091,va,-76.80508,37.64795,443,29,47,18,62.1
23092,va,-76.51352,37.60187,553,20,37,17,85
23093,va,-78.04076,38.00244,10580,22,39,17,77.3
23102,va,-77.83151,37.71258,1776,20,36,16,80
23103,va,-77.72554,37.65064,3610,19,34,15,78.9
23106,va,-77.20176,37.71614,763,22,39,17,77.3
23108,va,-76.72773,37.64846,227,29,47,18,62.1
23109,va,-76.32874,37.43528,1926,15,30,15,100
23110,va,-76.77014,37.58216,759,32,51,19,59.4
23111,va,-77.24694,37.61146,15836,21,36,15,71.4
23112,va,-77.66205,37.43499,21474,20,36,16,80
23113,va,-77.67757,37.53843,10072,17,31,14,82.4
23114,va,-77.65938,37.48216,6566,18,33,15,83.3
23115,va,-76.91447,37.81099,120,23,39,16,69.6
23116,va,-77.33456,37.67951,13197,18,33,15,83.3
23117,va,-77.87499,37.98,9807,22,39,17,77.3
23119,va,-76.27661,37.44873,407,15,31,16,106.7
23120,va,-77.785,37.40974,5992,20,36,16,80
23123,va,-78.29893,37.6547,1559,20,36,16,80
23124,va,-77.05233,37.5535,2554,25,43,18,72
23125,va,-76.27932,37.33051,615,15,30,15,100
23126,va,-77.14489,37.92259,508,22,38,16,72.7
23128,va,-76.42377,37.44012,1149,17,33,16,94.1
23129,va,-77.77531,37.68648,257,19,34,15,78.9
23130,va,-76.268,37.39534,621,14,29,15,107.1
23138,va,-76.31053,37.34498,1250,15,30,15,100
23139,va,-77.93375,37.54973,14199,19,35,16,84.2
23140,va,-77.04429,37.43859,4225,26,44,18,69.2
23141,va,-77.1554,37.52996,4739,24,41,17,70.8
23146,va,-77.70738,37.72648,2032,18,33,15,83.3
23148,va,-77.05503,37.84791,1689,23,39,16,69.6
23149,va,-76.61253,37.57188,2402,25,44,19,76
23150,va,-77.25357,37.50693,5506,22,38,16,72.7
23153,va,-77.94485,37.76977,805,20,36,16,80
23156,va,-76.70988,37.52126,1492,29,48,19,65.5
23160,va,-77.85099,37.62945,6,20,35,15,75
23161,va,-76.93073,37.71656,233,25,42,17,68
23163,va,-76.30792,37.35542,354,15,30,15,100
23168,va,-76.82729,37.4,3665,27,46,19,70.4
23169,va,-76.45751,37.60086,1445,18,35,17,94.4
23173,va,-77.53884,37.57707,117,17,32,15,88.2
23175,va,-76.61584,37.65123,2412,24,41,17,70.8
23176,va,-76.41177,37.57858,594,18,34,16,88.9
23177,va,-77.01392,37.738,706,24,41,17,70.8
23180,va,-76.60641,37.70138,477,23,40,17,73.9
23181,va,-76.88953,37.59891,9223,32,51,19,59.4
23185,va,-76.71004,37.23514,20141,24,42,18,75
23188,va,-76.75553,37.33938,21163,25,43,18,72
23192,va,-77.68153,37.82069,3782,18,33,15,83.3
23219,va,-77.43527,37.54016,1426,22,38,16,72.7
23220,va,-77.46042,37.54899,9480,22,38,16,72.7
23221,va,-77.49393,37.55336,5284,21,36,15,71.4
23222,va,-77.41906,37.58261,10062,20,36,16,80
23223,va,-77.37886,37.55586,16570,21,38,17,81
23224,va,-77.46621,37.49783,11247,22,39,17,77.3
23225,va,-77.51105,37.51845,11730,21,37,16,76.2
23226,va,-77.52386,37.57792,7094,17,32,15,88.2
23227,va,-77.44252,37.61462,7795,18,33,15,83.3
23228,va,-77.49202,37.62535,11285,17,31,14,82.4
23229,va,-77.57285,37.58728,11520,17,32,15,88.2
23230,va,-77.49099,37.58621,3371,18,33,15,83.3
23231,va,-77.31868,37.44104,15484,23,40,17,73.9
23233,va,-77.62665,37.64551,10089,18,32,14,77.8
23234,va,-77.46967,37.45212,15024,24,41,17,70.8
23235,va,-77.56452,37.51331,12933,19,34,15,78.9
23236,va,-77.5863,37.47438,11038,19,35,16,84.2
23237,va,-77.45237,37.40216,10052,25,43,18,72
23238,va,-77.6463,37.59736,8251,18,32,14,77.8
23250,va,-77.32094,37.50515,26,21,38,17,81
23294,va,-77.54233,37.63041,3718,16,30,14,87.5
23301,va,-75.6348,37.68149,2304,12,27,15,125
23302,va,-75.51711,37.8636,135,8,18,10,125
23303,va,-75.50887,37.90729,694,6,16,10,166.7
23304,va,-76.57107,36.99653,84,23,40,17,73.9
23306,va,-75.87615,37.5701,941,13,29,16,123.1
23307,va,-75.87307,37.43366,767,11,26,15,136.4
23308,va,-75.6566,37.83849,1761,11,24,13,118.2
23310,va,-75.96174,37.25888,7072,11,25,14,127.3
23313,va,-75.94524,37.20272,109,11,25,14,127.3
23314,va,-76.52091,36.96149,4236,22,39,17,77.3
23315,va,-76.84268,36.73869,1072,26,44,18,69.2
23316,va,-75.98208,37.29875,446,11,25,14,127.3
23320,va,-76.21833,36.75194,21293,22,38,16,72.7
23321,va,-76.42295,36.80123,13690,22,38,16,72.7
23322,va,-76.22884,36.63213,24896,23,41,18,78.3
23323,va,-76.39174,36.67478,15045,23,40,17,73.9
23324,va,-76.27515,36.79992,8180,20,36,16,80
23325,va,-76.23892,36.81494,6004,19,35,16,84.2
23336,va,-75.34228,37.9461,5609,6,15,9,150
23337,va,-75.48325,37.9234,342,6,15,9,150
23347,va,-75.97602,37.3525,695,11,25,14,127.3
23350,va,-75.87287,37.5187,3885,12,28,16,133.3
23354,va,-75.90474,37.47638,222,12,27,15,125
23356,va,-75.39222,37.99046,5232,7,17,10,142.9
23357,va,-75.67552,37.7555,487,11,25,14,127.3
23358,va,-75.86937,37.64463,218,13,29,16,123.1
23359,va,-75.58985,37.88316,749,9,21,12,133.3
23389,va,-75.83469,37.66205,155,14,30,16,114.3
23395,va,-75.46748,37.97583,3305,6,16,10,166.7
23398,va,-75.94344,37.51269,401,11,26,15,136.4
23401,va,-75.7794,37.62749,222,13,29,16,123.1
23405,va,-75.91665,37.41224,1466,11,26,15,136.4
23407,va,-75.55413,37.83755,321,10,22,12,120
23408,va,-75.84731,37.45563,79,11,26,15,136.4
23409,va,-75.64638,37.87995,193,11,23,12,109.1
23410,va,-75.7396,37.63346,1955,14,30,16,114.3
23413,va,-75.85799,37.47284,800,12,26,14,116.7
23414,va,-75.5774,37.80619,83,11,24,13,118.2
23415,va,-75.53604,37.96899,1311,7,17,10,142.9
23416,va,-75.56335,37.93377,331,7,17,10,142.9
23417,va,-75.77493,37.75893,4107,14,30,16,114.3
23418,va,-75.6814,37.66648,883,13,29,16,123.1
23420,va,-75.81481,37.58465,2338,13,28,15,115.4
23421,va,-75.61308,37.76595,3104,11,25,14,127.3
23422,va,-75.82548,37.63674,360,13,29,16,123.1
23423,va,-75.70266,37.52144,870,11,27,16,145.5
23426,va,-75.66986,37.92426,339,9,21,12,133.3
23427,va,-75.73205,37.92173,367,10,22,12,120
23430,va,-76.65277,36.99941,10145,23,40,17,73.9
23432,va,-76.55076,36.87177,1013,22,38,16,72.7
23433,va,-76.47151,36.91475,661,21,37,16,76.2
23434,va,-76.59165,36.70124,22980,25,43,18,72
23435,va,-76.4762,36.84347,12009,21,38,17,81
23436,va,-76.50857,36.89529,595,21,38,17,81
23437,va,-76.8029,36.6356,2952,27,45,18,66.7
23438,va,-76.69654,36.58149,1276,29,48,19,65.5
23440,va,-75.98959,37.83104,489,14,31,17,121.4
23441,va,-75.69968,37.71027,174,14,29,15,107.1
23442,va,-75.5725,37.90642,1076,8,19,11,137.5
23451,va,-76.00571,36.86742,13250,12,25,13,108.3
23452,va,-76.09251,36.84671,18910,16,30,14,87.5
23453,va,-76.07574,36.78555,11259,17,32,15,88.2
23454,va,-76.02465,36.82647,18494,14,28,14,100
23455,va,-76.14641,36.89328,15335,16,30,14,87.5
23456,va,-76.03601,36.73407,20489,17,32,15,88.2
23457,va,-76.01917,36.61596,2544,15,31,16,106.7
23459,va,-76.01923,36.92465,3,11,24,13,118.2
23462,va,-76.1517,36.83726,18374,17,33,16,94.1
23464,va,-76.1792,36.79726,23829,20,36,16,80
23480,va,-75.69052,37.61398,484,12,27,15,125
23486,va,-75.81122,37.51348,163,11,26,15,136.4
23487,va,-76.72256,36.85199,3207,24,41,17,70.8
23488,va,-75.61228,37.95225,188,8,20,12,150
23502,va,-76.2099,36.86284,7271,18,34,16,88.9
23503,va,-76.26714,36.94868,8911,16,31,15,93.8
23504,va,-76.26572,36.85679,6926,19,34,15,78.9
23505,va,-76.28837,36.91585,6512,17,32,15,88.2
23507,va,-76.30306,36.86446,1787,19,35,16,84.2
23508,va,-76.31038,36.88552,5973,19,34,15,78.9
23509,va,-76.26206,36.88217,5244,18,34,16,88.9
23510,va,-76.29163,36.85191,850,19,35,16,84.2
23511,va,-76.3139,36.93232,16,17,33,16,94.1
23513,va,-76.23857,36.88989,9853,18,33,15,83.3
23517,va,-76.29257,36.86968,1594,19,34,15,78.9
23518,va,-76.21596,36.91629,10005,16,30,14,87.5
23523,va,-76.27198,36.83255,2875,19,35,16,84.2
23601,va,-76.47821,37.03702,8360,18,34,16,88.9
23602,va,-76.5178,37.1133,12907,20,36,16,80
23603,va,-76.56632,37.19286,977,21,38,17,81
23604,va,-76.58578,37.12829,5,21,37,16,76.2
23605,va,-76.43571,37.01812,3997,19,35,16,84.2
23606,va,-76.51983,37.06413,7582,19,35,16,84.2
23607,va,-76.42428,36.97189,8054,20,36,16,80
23608,va,-76.54325,37.15109,12332,20,37,17,85
23651,va,-76.30438,37.00617,27,17,33,16,94.1
23661,va,-76.38677,37.00799,6768,19,34,15,78.9
23662,va,-76.355,37.13313,5386,15,30,15,100
23663,va,-76.31429,37.03295,5698,17,31,14,82.4
23664,va,-76.28975,37.07622,5141,16,31,15,93.8
23665,va,-76.3645,37.09044,18,17,32,15,88.2
23666,va,-76.40731,37.05912,16855,18,33,15,83.3
23669,va,-76.33944,37.04979,15950,17,31,14,82.4
23690,va,-76.51636,37.22257,1850,19,35,16,84.2
23691,va,-76.55202,37.25171,1,20,36,16,80
23692,va,-76.45739,37.19133,8517,17,33,16,94.1
23693,va,-76.44671,37.12557,8701,17,33,16,94.1
23696,va,-76.42156,37.19184,1895,17,32,15,88.2
23701,va,-76.37079,36.81181,9523,21,38,17,81
23702,va,-76.32897,36.80318,3831,22,38,16,72.7
23703,va,-76.37101,36.89372,9403,20,36,16,80
23704,va,-76.31008,36.82404,7531,20,36,16,80
23707,va,-76.33988,36.84263,5927,20,36,16,80
23708,va,-76.30642,36.84815,4,19,35,16,84.2
23709,va,-76.30546,36.81275,4,21,37,16,76.2
23801,va,-77.33528,37.23538,7,31,50,19,61.3
23803,va,-77.48141,37.2123,21116,29,48,19,65.5
23805,va,-77.39781,37.12903,8479,30,49,19,63.3
23806,va,-77.41824,37.23861,11,31,51,20,64.5
23821,va,-77.9204,36.88065,1851,21,38,17,81
23824,va,-77.96732,37.08969,8030,18,33,15,83.3
23827,va,-77.2012,36.61061,1870,33,53,20,60.6
23828,va,-77.28596,36.58213,624,33,53,20,60.6
23829,va,-77.22214,36.73032,1199,32,52,20,62.5
23830,va,-77.3959,37.02014,1225,32,50,18,56.3
23831,va,-77.44973,37.34536,13438,28,47,19,67.9
23832,va,-77.5926,37.39466,14126,22,39,17,77.3
23833,va,-77.67269,37.2077,1569,23,40,17,73.9
23834,va,-77.40365,37.28975,11331,32,52,20,62.5
23836,va,-77.34476,37.34423,5632,33,53,20,60.6
23837,va,-77.08504,36.75243,3298,32,52,20,62.5
23838,va,-77.63394,37.31846,8308,24,42,18,75
23839,va,-76.91887,37.0798,755,25,43,18,72
23840,va,-77.66519,37.05934,1822,25,42,17,68
23841,va,-77.55182,37.05232,2747,28,47,19,67.9
23842,va,-77.22383,37.1334,4239,28,47,19,67.9
23843,va,-77.81514,36.84664,717,23,40,17,73.9
23844,va,-77.33702,36.66982,717,31,51,20,64.5
23845,va,-77.98891,36.57219,538,24,41,17,70.8
23846,va,-76.83779,37.05702,757,25,43,18,72
23847,va,-77.55067,36.67039,11110,29,47,18,62.1
23850,va,-77.7417,37.17355,857,23,40,17,73.9
23851,va,-76.9539,36.65547,8623,28,47,19,67.9
23856,va,-77.70181,36.78385,1374,25,43,18,72
23857,nc,-77.88355,36.5856,766,24,41,18,74.55
23860,va,-77.21726,37.27985,13043,34,53,19,55.9
23866,va,-76.86692,36.91865,1849,26,44,18,69.2
23867,va,-77.48272,36.81697,2986,30,49,19,63.3
23868,va,-77.80481,36.71344,4908,23,41,18,78.3
23872,va,-77.71818,36.98778,2323,24,41,17,70.8
23874,va,-77.08603,36.60222,929,30,49,19,63.3
23875,va,-77.26304,37.22828,4201,31,51,20,64.5
23876,va,-77.8377,36.95656,470,22,39,17,77.3
23878,va,-77.02398,36.83195,1090,30,49,19,63.3
23879,va,-77.5968,36.59295,870,27,45,18,66.7
23881,va,-76.97773,37.18981,1969,26,43,17,65.4
23882,va,-77.41509,36.92568,2575,31,50,19,61.3
23883,va,-76.73878,37.13342,1966,24,42,18,75
23884,va,-77.27944,36.91723,12,31,50,19,61.3
23885,va,-77.57842,37.1864,1807,27,45,18,66.7
23887,va,-77.80836,36.57105,926,23,41,18,78.3
23888,va,-76.98247,36.95688,2035,25,42,17,68
23889,va,-77.73767,36.8961,655,24,42,18,75
23890,va,-77.11937,37.00342,3676,26,43,17,65.4
23891,va,-77.21243,37.05082,40,26,43,17,65.4
23893,va,-77.92791,36.63633,498,22,39,17,77.3
23894,va,-77.81795,37.1262,591,20,36,16,80
23897,va,-77.28375,36.83174,657,30,50,20,66.7
23898,va,-76.85598,36.82731,1500,26,44,18,69.2
23899,va,-76.96275,37.23045,512,25,43,18,72
23901,va,-78.41608,37.31622,8731,20,36,16,80
23909,va,-78.39664,37.30058,1,21,37,16,76.2
23915,va,-78.28676,36.70153,691,22,38,16,72.7
23917,va,-78.34241,36.62445,4420,22,39,17,77.3
23919,va,-78.13497,36.59512,4589,23,41,18,78.3
23920,va,-77.97675,36.72431,3439,22,39,17,77.3
23921,va,-78.61977,37.59076,1940,17,32,15,88.2
23922,va,-78.21481,37.18706,2398,18,33,15,83.3
23923,va,-78.64395,37.09234,2964,17,32,15,88.2
23924,va,-78.43195,36.80742,5323,21,38,17,81
23927,va,-78.51213,36.61073,7542,21,37,16,76.2
23930,va,-78.09938,37.17242,5752,19,34,15,78.9
23934,va,-78.62198,37.17387,701,17,32,15,88.2
23936,va,-78.47872,37.52777,5243,18,33,15,83.3
23937,va,-78.5261,36.94483,2114,19,34,15,78.9
23938,va,-77.99616,36.90655,434,19,34,15,78.9
23942,va,-78.30326,37.13543,1051,17,32,15,88.2
23943,va,-78.45581,37.24367,56,20,36,16,80
23944,va,-78.13427,36.90667,5409,19,34,15,78.9
23947,va,-78.45023,37.02835,4507,17,31,14,82.4
23950,va,-78.07537,36.66126,2770,22,39,17,77.3
23952,va,-78.29145,36.92912,219,19,35,16,84.2
23954,va,-78.38362,37.10638,1856,17,31,14,82.4
23958,va,-78.65974,37.2665,2673,16,31,15,93.8
23959,va,-78.7932,37.10568,1855,16,31,15,93.8
23960,va,-78.56054,37.31377,1397,19,34,15,78.9
23962,va,-78.70256,36.93448,729,19,35,16,84.2
23963,va,-78.80214,37.19454,420,14,29,15,107.1
23964,va,-78.62881,36.77455,1866,20,37,17,85
23966,va,-78.27276,37.29265,1676,19,35,16,84.2
23967,va,-78.63344,36.918,1374,20,36,16,80
23968,va,-78.52207,36.72525,769,21,38,17,81
23970,va,-78.188,36.75081,6221,21,38,17,81
23974,va,-78.25671,36.97094,5710,18,33,15,83.3
23976,va,-78.58412,36.84704,216,20,36,16,80
24011,va,-79.94119,37.27053,319,8,19,11,137.5
24012,va,-79.9028,37.31527,13572,10,22,12,120
24013,va,-79.9224,37.26648,4147,10,22,12,120
24014,va,-79.91287,37.22289,8309,8,19,11,137.5
24015,va,-79.97971,37.25643,6309,8,20,12,150
24016,va,-79.95409,37.27292,4860,9,21,12,133.3
24017,va,-79.99183,37.29471,9903,11,24,13,118.2
24018,va,-80.04234,37.21062,16960,7,17,10,142.9
24019,va,-79.95222,37.34623,12359,8,20,12,150
24020,va,-79.94418,37.35822,8,8,19,11,137.5
24053,va,-80.53365,36.60866,3098,5,14,9,180
24054,va,-79.70511,36.67392,5499,13,27,14,107.7
24055,va,-79.99955,36.75708,10547,13,28,15,115.4
24058,va,-80.61574,37.18409,280,2,7,5,250
24059,va,-80.13584,37.15457,860,1,4,3,300
24060,va,-80.42108,37.25675,15774,2,7,5,250
24064,va,-79.77646,37.37195,3047,6,15,9,150
24065,va,-79.9709,37.11659,4680,7,18,11,157.1
24066,va,-79.6792,37.53846,3741,8,19,11,137.5
24067,va,-80.06896,37.03368,1758,6,15,9,150
24069,va,-79.63477,36.58328,1528,16,31,15,93.8
24070,va,-80.20872,37.36705,837,2,8,6,300
24072,va,-80.23289,37.03636,1125,1,4,3,300
24073,va,-80.42214,37.12852,16140,1,6,5,500
24076,va,-80.42009,36.5974,1177,6,16,10,166.7
24077,va,-79.90377,37.36638,446,7,17,10,142.9
24078,va,-79.9109,36.72505,3480,13,27,14,107.7
24079,va,-80.15718,37.05422,1725,2,6,4,200
24082,va,-80.12311,36.61972,405,14,29,15,107.1
24083,va,-79.92314,37.40605,1385,6,16,10,166.7
24084,va,-80.7932,37.11584,7455,1,6,5,500
24085,va,-79.82378,37.6775,2507,9,22,13,144.4
24086,va,-80.63427,37.27426,241,1,6,5,500
24087,va,-80.24845,37.22568,2042,3,11,8,266.7
24088,va,-80.0787,36.89692,3678,8,19,11,137.5
24089,va,-79.97278,36.7092,2251,14,29,15,107.1
24090,va,-79.88823,37.52295,3147,7,18,11,157.1
24091,va,-80.32859,36.91752,6785,1,4,3,300
24092,va,-79.76709,37.00337,1932,10,22,12,120
24093,va,-80.85651,37.38783,185,1,5,4,400
24095,va,-79.73811,37.22327,3169,10,23,13,130
24101,va,-79.7996,37.17623,4618,10,22,12,120
24102,va,-79.99676,36.83955,1561,10,22,12,120
24104,va,-79.48842,37.13605,4481,11,23,12,109.1
24105,va,-80.60011,36.89908,617,0,2,2,NA
24112,va,-79.8443,36.72729,22852,13,28,15,115.4
24120,va,-80.41392,36.71684,3154,1,3,2,200
24121,va,-79.63978,37.17232,10774,11,23,12,109.1
24122,va,-79.6936,37.42514,1237,6,16,10,166.7
24124,va,-80.85815,37.31271,3712,1,3,2,200
24127,va,-80.19047,37.4863,1,0,1,1,NA
24128,va,-80.46941,37.34332,1152,1,4,3,300
24130,va,-79.9964,37.61249,29,8,19,11,137.5
24132,va,-80.64985,37.21018,355,2,8,6,300
24133,va,-80.13443,36.66971,2517,12,26,14,116.7
24134,va,-80.77995,37.24522,4527,1,6,5,500
24136,va,-80.59754,37.33123,2743,1,6,5,500
24137,va,-79.65251,36.92886,2905,10,22,12,120
24138,va,-80.31824,37.04845,1194,1,4,3,300
24139,va,-79.47874,37.01145,1249,11,24,13,118.2
24141,va,-80.56832,37.09487,10758,2,7,5,250
24142,va,-80.5509,37.13796,1,2,7,5,250
24147,va,-80.82595,37.40046,901,1,5,4,400
24148,va,-79.87262,36.58168,6162,15,29,14,93.3
24149,va,-80.43581,37.02437,2421,1,4,3,300
24150,va,-80.60585,37.4058,740,1,4,3,300
24151,va,-79.86454,36.95741,11323,8,20,12,150
24153,va,-80.11063,37.30012,18147,8,19,11,137.5
24161,va,-79.54436,36.97846,610,11,25,14,127.3
24162,va,-80.25775,37.13787,1704,3,9,6,200
24165,va,-80.05192,36.5849,1713,14,29,15,107.1
24167,va,-80.73438,37.24905,253,1,5,4,400
24168,va,-79.94646,36.73475,188,14,28,14,100
24171,va,-80.23864,36.67196,8977,8,20,12,150
24174,va,-79.66869,37.35161,1688,9,21,12,133.3
24175,va,-79.93959,37.42847,4992,5,15,10,200
24176,va,-79.69177,37.00933,2234,11,23,12,109.1
24179,va,-79.80115,37.28727,9626,10,22,12,120
24184,va,-79.78135,37.08814,3279,10,22,12,120
24185,va,-80.26923,36.8116,1308,6,16,10,166.7
24201,va,-82.16983,36.61086,12923,3,12,9,300
24202,va,-82.21264,36.66093,9520,2,9,7,350
24210,va,-82.02233,36.77249,10721,2,7,5,250
24211,va,-81.95746,36.6539,7419,2,8,6,300
24216,va,-82.7976,36.94377,2409,1,6,5,500
24217,va,-82.17206,37.08413,128,1,6,5,500
24219,va,-82.75815,36.84877,5675,1,6,5,500
24221,va,-82.99523,36.63368,404,6,16,10,166.7
24224,va,-82.28195,36.86231,4871,1,6,5,500
24225,va,-82.13604,36.98143,1701,1,6,5,500
24230,va,-82.46444,36.96104,5456,1,4,3,300
24236,va,-81.74468,36.6424,2719,0,2,2,NA
24237,va,-82.25597,37.0358,385,1,5,4,400
24239,va,-82.15014,37.11344,74,2,7,5,250
24244,va,-82.78921,36.7157,3801,4,13,9,225
24245,va,-82.49915,36.83615,966,2,9,7,350
24246,va,-82.74529,36.8669,196,2,9,7,350
24250,va,-82.5974,36.75663,1267,3,10,7,233.3
24251,va,-82.60645,36.65881,7191,6,17,11,183.3
24256,va,-82.28187,37.22071,462,2,9,7,350
24258,va,-82.42029,36.6481,1317,4,13,9,225
24260,va,-82.02464,37.03951,3766,1,4,3,300
24266,va,-82.11865,36.86438,6560,1,3,2,200
24270,va,-82.25083,36.72713,714,3,11,8,266.7
24271,va,-82.41695,36.74669,2206,2,7,5,250
24273,va,-82.65646,36.96169,5769,0,1,1,NA
24279,va,-82.61833,37.10261,3598,1,5,4,400
24280,va,-81.93741,36.95608,724,0,2,2,NA
24283,va,-82.34731,36.94302,1415,2,8,6,300
24290,va,-82.56809,36.61194,1205,7,20,13,185.7
24292,va,-81.57777,36.61458,838,0,0,0,NA
24293,va,-82.56079,37.00497,6035,0,2,2,NA
24301,va,-80.79976,37.06048,10538,1,4,3,300
24311,va,-81.40912,36.88174,2240,0,1,1,NA
24312,va,-80.87491,36.83713,2786,1,3,2,200
24313,va,-80.80654,36.90832,624,1,4,3,300
24314,va,-81.2138,37.16733,1680,0,1,1,NA
24315,va,-81.06429,37.13894,3167,0,2,2,NA
24316,va,-81.67288,36.95464,49,1,5,4,400
24317,va,-80.6719,36.60353,4221,5,14,9,180
24318,va,-81.38637,36.99739,941,0,1,1,NA
24319,va,-81.64606,36.748,6093,1,3,2,200
24322,va,-81.11414,36.80646,157,0,2,2,NA
24323,va,-81.19685,36.8676,613,0,2,2,NA
24324,va,-80.77947,36.97563,2258,1,4,3,300
24325,va,-80.59686,36.8053,1721,0,2,2,NA
24326,va,-81.20247,36.73007,1460,0,1,1,NA
24328,va,-80.6946,36.66209,5089,2,7,5,250
24330,va,-81.01995,36.72658,3776,0,2,2,NA
24333,va,-80.9288,36.63835,12912,0,2,2,NA
24340,va,-81.7654,36.76022,4061,1,5,4,400
24343,va,-80.70145,36.76958,9016,1,3,2,200
24347,va,-80.65562,36.96184,2010,1,4,3,300
24348,va,-81.17212,36.64108,4843,0,1,1,NA
24350,va,-81.01965,36.81115,1722,1,4,3,300
24351,va,-80.76586,36.58082,596,5,14,9,180
24352,va,-80.5331,36.71478,1381,0,2,2,NA
24354,va,-81.54323,36.82713,17367,0,2,2,NA
24360,va,-80.89671,36.93371,6218,1,4,3,300
24361,va,-81.8461,36.76673,3611,1,6,5,500
24363,va,-81.39857,36.6136,1860,0,1,1,NA
24366,va,-81.11589,37.25783,784,0,2,2,NA
24368,va,-81.29594,36.88988,5011,0,2,2,NA
24370,va,-81.69239,36.91371,6258,1,4,3,300
24374,va,-81.19616,36.79079,632,0,1,1,NA
24375,va,-81.38818,36.77179,2409,0,1,1,NA
24377,va,-81.5724,37.00082,453,1,3,2,200
24378,va,-81.44406,36.68736,1872,0,0,0,NA
24380,va,-80.50028,36.86007,2757,0,2,2,NA
24381,va,-80.84297,36.72759,3449,0,2,2,NA
24382,va,-81.0997,36.96024,13499,1,4,3,300
24401,va,-79.08588,38.13353,18398,8,19,11,137.5
24411,va,-79.31124,38.10513,82,1,5,4,400
24412,va,-79.82805,38.05508,103,1,2,1,100
24413,va,-79.59335,38.5285,401,0,1,1,NA
24415,va,-79.31705,37.925,45,5,13,8,160
24416,va,-79.3607,37.72231,8108,6,16,10,166.7
24421,va,-79.20079,38.26194,2324,6,16,10,166.7
24422,va,-79.75643,37.82995,6890,8,21,13,162.5
24426,va,-80.07649,37.76842,13525,5,14,9,180
24430,va,-79.35441,38.08803,1230,3,10,7,233.3
24431,va,-78.84031,38.1687,949,5,14,9,180
24432,va,-79.434,38.16221,362,2,6,4,200
24433,va,-79.46289,38.4207,150,0,2,2,NA
24435,va,-79.30305,37.87202,1546,6,16,10,166.7
24437,va,-78.93864,38.22163,587,10,23,13,130
24439,va,-79.48964,37.99291,2687,4,12,8,200
24440,va,-79.16613,37.99463,1643,3,10,7,233.3
24441,va,-78.82185,38.2263,5999,8,19,11,137.5
24442,va,-79.40837,38.33916,299,0,2,2,NA
24445,va,-79.88502,37.95508,2764,1,3,2,200
24448,va,-79.79,37.79837,471,12,26,14,116.7
24450,va,-79.52386,37.78578,10131,11,24,13,118.2
24457,va,-79.92023,37.7706,564,2,6,4,200
24458,va,-79.52495,38.31192,851,1,3,2,200
24459,va,-79.28827,38.02689,743,4,11,7,175
24460,va,-79.65203,38.01892,2209,3,10,7,233.3
24464,va,-79.10379,37.87324,408,1,4,3,300
24465,va,-79.64628,38.38023,2177,0,1,1,NA
24467,va,-78.97223,38.25998,1252,11,24,13,118.2
24471,va,-78.7963,38.30905,843,8,18,10,125
24472,va,-79.21457,37.93756,1573,4,11,7,175
24473,va,-79.41446,37.91696,946,8,19,11,137.5
24474,va,-79.84555,37.80564,1036,6,14,8,133.3
24476,va,-79.22328,37.97045,205,4,12,8,200
24477,va,-79.04235,38.00447,5356,6,15,9,150
24479,va,-79.24143,38.15206,1051,5,13,8,160
24482,va,-78.9955,38.20521,2247,10,23,13,130
24483,va,-79.22927,37.8119,851,1,5,4,400
24484,va,-79.82071,38.14368,1325,1,3,2,200
24485,va,-79.33541,38.27269,491,1,4,3,300
24486,va,-78.93012,38.29298,1857,11,24,13,118.2
24487,va,-79.58785,38.18975,547,1,4,3,300
24501,va,-79.1558,37.35298,12441,11,24,13,118.2
24502,va,-79.22057,37.35808,16725,10,22,12,120
24503,va,-79.24963,37.4533,9569,13,26,13,100
24504,va,-79.05444,37.36103,6816,12,26,14,116.7
24517,va,-79.22976,37.14938,4636,13,27,14,107.7
24520,va,-79.03668,36.58405,2416,19,35,16,84.2
24521,va,-79.09686,37.63439,8679,14,28,14,100
24522,va,-78.78522,37.3737,7076,13,27,14,107.7
24523,va,-79.52211,37.34003,13260,10,22,12,120
24526,va,-79.40241,37.54209,1873,12,25,13,108.3
24527,va,-79.34395,36.73687,2465,15,30,15,100
24528,va,-78.87838,37.07679,4065,16,31,15,93.8
24529,va,-78.64122,36.62442,1850,20,37,17,85
24530,va,-79.61411,36.80402,1118,11,24,13,118.2
24531,va,-79.44816,36.84029,9816,11,25,14,127.3
24534,va,-78.76692,36.87469,1717,19,35,16,84.2
24536,va,-79.32598,37.49298,223,11,24,13,118.2
24538,va,-78.95837,37.33357,3387,12,25,13,108.3
24539,va,-78.91788,36.85133,186,17,33,16,94.1
24540,va,-79.42341,36.64308,21792,18,35,17,94.4
24541,nc,-79.51259,36.59217,18715,20,36,17,87.25
24549,va,-79.50704,36.71497,3229,12,26,14,116.7
24550,va,-79.26001,37.23318,4385,11,24,13,118.2
24551,va,-79.32368,37.35599,11232,10,23,13,130
24553,va,-78.81786,37.54761,2110,15,30,15,100
24554,va,-79.06261,37.13308,3298,14,27,13,92.9
24555,va,-79.47243,37.66876,7976,10,22,12,120
24556,va,-79.39625,37.38281,2086,10,23,13,130
24557,va,-79.30433,36.96662,8135,12,26,14,116.7
24558,va,-78.95416,36.77421,5162,18,33,15,83.3
24562,va,-78.62294,37.69252,590,17,32,15,88.2
24563,va,-79.27633,37.06393,5570,12,26,14,116.7
24565,va,-79.1894,36.84988,1186,16,31,15,93.8
24566,va,-79.25071,36.7275,1237,15,31,16,106.7
24569,va,-79.12174,37.04485,1110,15,29,14,93.3
24570,va,-79.4271,37.34845,19,11,24,13,118.2
24571,va,-79.3793,37.13691,2626,12,26,14,116.7
24572,va,-79.09651,37.46362,11792,13,27,14,107.7
24574,va,-79.25981,37.57697,3425,12,26,14,116.7
24577,va,-78.97196,36.93565,5194,16,32,16,100
24578,va,-79.55755,37.66173,932,11,24,13,118.2
24579,va,-79.50459,37.58707,1421,8,19,11,137.5
24580,va,-78.6832,36.58099,589,19,36,17,89.5
24581,va,-78.80461,37.65749,50,16,31,15,93.8
24586,va,-79.28295,36.60714,4526,20,37,17,85
24588,va,-79.09687,37.26275,5291,11,24,13,118.2
24589,va,-78.75786,36.75872,1979,19,35,16,84.2
24590,va,-78.48481,37.79306,5488,17,32,15,88.2
24592,va,-78.96358,36.67559,11576,18,34,16,88.9
24593,va,-78.91137,37.32794,1412,12,26,14,116.7
24594,va,-79.18777,36.64368,1444,20,37,17,85
24595,va,-79.0825,37.5578,55,13,27,14,107.7
24597,va,-79.10948,36.78529,1275,17,32,15,88.2
24598,va,-78.78344,36.60748,1938,19,34,15,78.9
24599,va,-78.7257,37.63044,693,17,32,15,88.2
24601,va,-81.64924,37.19373,135,1,4,3,300
24602,va,-81.65994,37.18289,1113,1,3,2,200
24603,va,-82.19679,37.35323,698,4,14,10,250
24604,va,-81.54194,37.2101,343,0,2,2,200
24605,va,-81.36639,37.24478,6287,0,1,1,NA
24606,va,-81.39379,37.28768,294,0,2,2,NA
24607,va,-82.26526,37.29077,311,3,10,7,233.3
24609,va,-81.81373,37.0107,6035,0,2,2,NA
24612,va,-81.83814,37.09338,181,1,3,2,200
24613,va,-81.33702,37.26166,736,0,1,1,NA
24614,va,-82.06491,37.31061,6481,3,10,7,233.3
24620,va,-82.01884,37.4299,2200,3,12,9,300
24622,va,-81.79564,37.2094,1048,0,2,2,NA
24628,va,-82.21768,37.28713,216,3,10,7,233.3
24630,va,-81.46742,37.17591,4720,0,1,1,NA
24631,va,-81.99169,37.21375,2309,2,7,5,250
24634,va,-81.90238,37.27464,481,1,4,3,300
24635,va,-81.35131,37.30905,776,0,2,2,NA
24637,va,-81.70321,37.05876,2740,0,1,1,NA
24639,va,-81.89865,37.16696,2345,1,4,3,300
24641,va,-81.80376,37.11585,3490,1,3,2,200
24646,va,-82.02887,37.13639,512,1,3,2,200
24649,va,-81.90937,37.07275,2047,1,4,3,300
24651,va,-81.50411,37.07668,4598,0,1,1,NA
24656,va,-82.12328,37.17393,2575,2,7,5,250
24657,va,-81.86054,37.22513,315,1,4,3,300
24701,wv,-81.20652,37.30098,15783,0,1,1,NA
24712,wv,-81.01392,37.46477,1088,0,3,3,NA
24714,wv,-81.18913,37.47672,242,0,3,3,NA
24715,wv,-81.32864,37.34316,1021,0,2,2,NA
24716,wv,-81.37713,37.48715,455,1,4,3,300
24719,wv,-81.32673,37.48717,149,0,2,2,NA
24724,wv,-81.29976,37.33088,129,0,1,1,NA
24726,wv,-81.35655,37.51968,599,0,2,2,NA
24729,wv,-81.25635,37.44968,163,0,2,2,NA
24731,wv,-81.15106,37.39797,172,0,2,2,NA
24733,wv,-81.2069,37.4481,670,0,2,2,NA
24736,wv,-81.28033,37.44464,1496,0,2,2,NA
24737,wv,-81.24962,37.35304,227,0,1,1,NA
24738,wv,-81.3124,37.30216,281,0,2,2,NA
24740,wv,-81.0188,37.37642,19195,0,2,2,NA
24747,wv,-81.23173,37.39621,2625,0,2,2,NA
24801,wv,-81.57767,37.44261,7988,2,7,5,250
24808,wv,-81.41506,37.33621,2316,1,3,2,200
24811,wv,-81.77856,37.40165,1207,2,9,7,350
24813,wv,-81.71668,37.35741,865,2,7,5,250
24815,wv,-81.67634,37.23753,1203,1,5,4,400
24816,wv,-81.70498,37.46113,446,2,9,7,350
24817,wv,-81.80659,37.35103,1802,2,8,6,300
24818,wv,-81.62637,37.5988,1550,2,9,7,350
24822,wv,-81.68134,37.62718,910,2,10,8,400
24823,wv,-81.73722,37.66122,269,2,9,7,350
24826,wv,-81.63264,37.29067,533,1,6,5,500
24827,wv,-81.66665,37.74224,865,1,6,5,500
24828,wv,-81.64387,37.48835,1566,2,8,6,300
24830,wv,-81.50965,37.32379,294,1,4,3,300
24831,wv,-81.40889,37.39341,520,0,3,3,NA
24834,wv,-81.63047,37.55325,378,2,8,6,300
24836,wv,-81.55347,37.3326,1193,1,6,5,500
24839,wv,-81.75148,37.55261,1237,3,10,7,233.3
24843,wv,-81.70919,37.48366,182,2,9,7,350
24844,wv,-81.80465,37.46243,4264,3,11,8,266.7
24845,wv,-81.80336,37.52357,261,3,11,8,266.7
24846,wv,-81.90852,37.53033,220,5,14,9,180
24847,wv,-81.41533,37.5779,245,1,7,6,600
24848,wv,-81.45104,37.2909,690,0,2,2,NA
24849,wv,-81.55857,37.67064,409,1,6,5,500
24850,wv,-81.8283,37.31165,1221,2,7,5,250
24851,wv,-81.83553,37.59687,470,4,14,10,250
24853,wv,-81.5119,37.43434,1680,1,5,4,400
24854,wv,-81.56744,37.74782,280,1,5,4,400
24857,wv,-81.66077,37.67446,783,2,8,6,300
24860,wv,-81.60695,37.66236,563,1,6,5,500
24861,wv,-81.36575,37.3611,511,0,2,2,NA
24862,wv,-81.95364,37.47929,779,4,13,9,225
24866,wv,-81.58033,37.24813,586,1,5,4,400
24867,wv,-81.4472,37.60297,379,2,7,5,250
24868,wv,-81.40581,37.41936,4957,1,3,2,200
24869,wv,-81.83266,37.55941,297,3,11,8,266.7
24870,wv,-81.54171,37.7353,2140,1,6,5,500
24871,wv,-81.468,37.35698,513,1,4,3,300
24872,wv,-81.89948,37.44921,940,4,12,8,200
24873,wv,-81.87867,37.36596,857,2,7,5,250
24874,wv,-81.52746,37.5624,2732,2,8,6,300
24878,wv,-81.62942,37.43444,764,2,7,5,250
24879,wv,-81.76141,37.32443,696,2,7,5,250
24880,wv,-81.53757,37.64388,292,1,6,5,500
24881,wv,-81.69153,37.43974,1410,2,8,6,300
24882,wv,-81.76627,37.62736,904,3,12,9,300
24884,wv,-81.56473,37.25554,916,1,4,3,300
24887,wv,-81.39985,37.37458,177,0,2,2,NA
24888,wv,-81.49112,37.38455,234,1,5,4,400
24892,wv,-81.68776,37.32664,3218,2,7,5,250
24894,wv,-81.70357,37.2828,442,2,7,5,250
24898,wv,-81.60552,37.59415,156,2,8,6,300
24901,wv,-80.46535,37.84064,6165,3,10,7,233.3
24910,wv,-80.66096,37.7371,4626,2,8,6,300
24915,wv,-79.7763,38.46519,1007,0,0,0,NA
24916,wv,-80.57465,37.83129,427,2,7,5,250
24918,wv,-80.75011,37.52018,1407,2,8,6,300
24920,wv,-79.70139,38.58408,583,0,0,0,NA
24924,wv,-80.18476,38.22764,749,0,2,2,NA
24925,wv,-80.37916,37.72349,1084,1,6,5,500
24927,wv,-79.95146,38.37438,1000,0,2,2,NA
24931,wv,-80.5915,37.91928,1295,1,6,5,500
24934,wv,-79.89163,38.33438,1134,0,1,1,NA
24935,wv,-80.81112,37.56079,1128,1,7,6,600
24938,wv,-80.3782,37.91587,1187,2,9,7,350
24941,wv,-80.35448,37.5945,1648,1,3,2,200
24944,wv,-79.78369,38.38966,708,0,0,0,NA
24945,wv,-80.68476,37.5427,422,2,9,7,350
24946,wv,-80.26632,38.18501,2474,1,2,1,100
24951,wv,-80.63648,37.4812,1284,1,4,3,300
24954,wv,-80.04307,38.22326,5191,0,1,1,NA
24957,wv,-80.41918,37.87651,259,2,9,7,350
24962,wv,-80.7202,37.66205,255,2,9,7,350
24963,wv,-80.76935,37.43602,3025,1,5,4,400
24966,wv,-80.37499,38.06976,1802,2,7,5,250
24970,wv,-80.47893,37.73131,3843,2,9,7,350
24974,wv,-80.44421,37.65901,207,1,5,4,400
24976,wv,-80.51345,37.6609,760,2,7,5,250
24977,wv,-80.67389,37.90546,346,1,5,4,400
24981,wv,-80.73588,37.63108,1037,2,8,6,300
24983,wv,-80.52616,37.58088,2656,1,6,5,500
24984,wv,-80.40378,37.49256,667,1,3,2,200
24986,wv,-80.1934,37.90708,5219,1,5,4,400
24991,wv,-80.49925,37.99918,598,1,6,5,500
25002,wv,-81.24173,38.13576,78,4,13,9,225
25003,wv,-81.78617,38.25113,2355,9,22,13,144.4
25005,wv,-81.26923,38.58086,235,7,19,12,171.4
25007,wv,-81.42862,37.82534,547,1,5,4,400
25008,wv,-81.3442,37.94699,229,1,4,3,300
25009,wv,-81.71205,38.19202,733,8,20,12,150
25011,wv,-81.8394,38.50862,633,10,23,13,130
25015,wv,-81.50236,38.24257,2410,7,19,12,171.4
25019,wv,-81.0868,38.37293,504,3,11,8,266.7
25021,wv,-81.6805,37.92238,291,3,10,7,233.3
25022,wv,-81.81171,37.85868,867,4,13,9,225
25024,wv,-81.61948,38.15596,387,6,17,11,183.3
25025,wv,-81.39832,38.30875,138,4,14,10,250
25028,wv,-81.72332,37.9478,230,4,12,8,200
25030,wv,-81.22556,38.45048,464,6,17,11,183.3
25031,wv,-81.26557,38.1519,552,4,14,10,250
25033,wv,-81.92473,38.61032,1661,10,22,12,120
25035,wv,-81.52153,38.16163,660,7,18,11,157.1
25036,wv,-81.25407,38.22049,240,4,13,9,225
25039,wv,-81.38215,38.24481,710,6,17,11,183.3
25040,wv,-81.23843,38.12703,420,4,13,9,225
25043,wv,-81.00565,38.44173,2068,5,15,10,200
25044,wv,-81.34963,37.89995,415,1,4,3,300
25045,wv,-81.31869,38.44506,4514,7,19,12,171.4
25047,wv,-81.76036,37.92178,454,6,17,11,183.3
25048,wv,-81.43686,37.94389,66,2,9,7,350
25049,wv,-81.56969,38.11634,309,6,17,11,183.3
25051,wv,-81.70918,38.15905,145,8,20,12,150
25053,wv,-81.87306,38.04424,2538,8,19,11,137.5
25054,wv,-81.49161,38.1083,158,4,13,9,225
25057,wv,-81.25327,38.12191,465,4,13,9,225
25059,wv,-81.20768,38.23311,539,5,15,10,200
25060,wv,-81.42987,37.94221,650,2,9,7,350
25061,wv,-81.43745,38.16751,456,5,15,10,200
25062,wv,-81.44116,37.87489,227,1,6,5,500
25063,wv,-80.93415,38.58235,2642,6,16,10,166.7
25064,wv,-81.74851,38.37631,5805,11,25,14,127.3
25067,wv,-81.42896,38.19772,620,6,16,10,166.7
25070,wv,-81.93187,38.5466,870,10,23,13,130
25071,wv,-81.46819,38.47313,7064,8,20,12,150
25075,wv,-81.42275,38.05047,674,3,10,7,233.3
25076,wv,-81.93629,37.86918,47,8,20,12,150
25081,wv,-81.77282,38.08725,808,5,15,10,200
25082,wv,-82.02603,38.6121,1410,10,23,13,130
25083,wv,-81.36249,38.07034,502,4,12,8,200
25085,wv,-81.19571,38.17117,806,4,14,10,250
25086,wv,-81.41232,38.20966,431,7,18,11,157.1
25088,wv,-81.2145,38.3798,188,4,14,10,250
25090,wv,-81.21876,38.15171,138,5,14,9,180
25093,wv,-81.65657,37.9809,75,4,13,9,225
25102,wv,-81.36699,38.18654,235,3,12,9,300
25103,wv,-81.38306,38.18316,320,6,17,11,183.3
25106,wv,-82.08845,38.78317,528,11,23,12,109.1
25107,wv,-81.63441,38.22751,355,6,17,11,183.3
25108,wv,-81.87428,37.9673,437,6,16,10,166.7
25109,wv,-81.85525,38.52786,614,10,23,13,130
25110,wv,-81.3085,38.22567,495,7,18,11,157.1
25111,wv,-81.12693,38.34983,615,3,11,8,266.7
25113,wv,-81.04967,38.56093,1109,6,17,11,183.3
25114,wv,-81.79921,37.97912,436,7,18,11,157.1
25115,wv,-81.18989,38.13065,191,3,11,8,266.7
25118,wv,-81.30259,38.10556,959,3,11,8,266.7
25119,wv,-81.27234,38.04396,487,2,8,6,300
25121,wv,-81.89728,37.91622,938,5,15,10,200
25123,wv,-81.90385,38.73473,3334,9,21,12,133.3
25124,wv,-81.76514,38.62162,915,9,21,12,133.3
25125,wv,-81.19411,38.3136,847,4,13,9,225
25126,wv,-81.37205,38.20232,35,7,18,11,157.1
25130,wv,-81.76325,38.04152,2328,7,18,11,157.1
25132,wv,-81.34034,38.30037,147,5,14,9,180
25133,wv,-81.12926,38.47716,841,6,16,10,166.7
25134,wv,-81.48413,38.16166,332,5,15,10,200
25136,wv,-81.33166,38.16043,1238,5,14,9,180
25139,wv,-81.28627,38.13829,274,4,14,10,250
25140,wv,-81.49652,37.86721,1461,2,7,5,250
25141,wv,-81.03293,38.63015,188,6,16,10,166.7
25142,wv,-81.73208,38.15305,247,8,20,12,150
25143,wv,-81.82153,38.41873,5259,10,23,13,130
25148,wv,-81.56877,38.04917,236,6,16,10,166.7
25149,wv,-81.76708,37.95518,188,6,17,11,183.3
25152,wv,-81.25357,38.05734,293,2,8,6,300
25154,wv,-81.70493,38.11703,573,5,15,10,200
25156,wv,-81.34832,38.1873,80,7,18,11,157.1
25159,wv,-81.78238,38.50347,3058,10,23,13,130
25160,wv,-81.28654,38.28941,144,4,14,10,250
25161,wv,-81.32386,38.05617,331,2,7,5,250
25162,wv,-81.38621,38.20872,323,7,18,11,157.1
25164,wv,-81.20029,38.52499,1361,6,18,12,200
25165,wv,-81.65115,38.14738,477,7,18,11,157.1
25168,wv,-81.8768,38.56469,1661,9,22,13,144.4
25169,wv,-81.78934,38.15254,345,6,17,11,183.3
25173,wv,-81.22006,38.08473,410,2,7,5,250
25174,wv,-81.41203,37.86032,443,1,5,4,400
25177,wv,-81.84704,38.36747,15051,10,23,13,130
25180,wv,-81.43459,37.7901,109,1,4,3,300
25181,wv,-81.62902,38.04707,1067,6,16,10,166.7
25183,wv,-81.81366,37.91739,406,5,15,10,200
25185,wv,-81.23802,38.23519,1,4,12,8,200
25186,wv,-81.27271,38.18186,723,4,13,9,225
25187,wv,-82.02479,38.72745,737,10,22,12,120
25193,wv,-81.51738,38.03467,425,3,11,8,266.7
25201,wv,-81.49046,38.33561,20,6,17,11,183.3
25202,wv,-81.85581,38.31772,999,10,23,13,130
25203,wv,-81.88231,38.01599,63,7,19,12,171.4
25204,wv,-81.61411,37.926,339,2,8,6,300
25205,wv,-81.7829,38.01871,298,6,17,11,183.3
25206,wv,-81.70128,37.97751,467,4,13,9,225
25208,wv,-81.64557,37.84898,682,2,7,5,250
25209,wv,-81.52966,37.96298,1112,3,10,7,233.3
25211,wv,-80.88283,38.4626,205,2,10,8,400
25213,wv,-81.91662,38.50761,3326,10,23,13,130
25214,wv,-81.55638,38.17962,365,6,17,11,183.3
25234,wv,-81.12975,38.81062,1174,8,19,11,137.5
25235,wv,-81.09439,38.66861,724,6,16,10,166.7
25239,wv,-81.84309,38.84049,2188,10,23,13,130
25241,wv,-81.807,38.7839,2188,10,22,12,120
25243,wv,-81.47946,38.68672,950,9,21,12,133.3
25244,wv,-81.54802,38.77214,1165,9,20,11,122.2
25245,wv,-81.74459,38.69736,1212,9,21,12,133.3
25247,wv,-81.99685,39.0047,504,10,21,11,110
25248,wv,-81.61328,38.64096,4791,9,21,12,133.3
25251,wv,-81.23632,38.62053,401,7,18,11,157.1
25252,wv,-81.53256,38.88877,1717,9,21,12,133.3
25253,wv,-81.96952,38.92316,1702,9,21,12,133.3
25259,wv,-81.25174,38.67353,647,7,19,12,171.4
25260,wv,-82.02675,39.01261,1242,9,21,12,133.3
25261,wv,-81.08962,38.82627,294,7,17,10,142.9
25262,wv,-81.82867,38.9066,1360,10,23,13,130
25264,wv,-81.89656,38.85701,575,9,21,12,133.3
25265,wv,-81.95595,38.98676,1073,10,22,12,120
25266,wv,-81.16232,38.60599,774,7,18,11,157.1
25267,wv,-80.94139,38.84772,1090,6,17,11,183.3
25268,wv,-81.09847,38.73254,852,7,17,10,142.9
25270,wv,-81.44066,38.86829,1077,9,21,12,133.3
25271,wv,-81.68575,38.7855,11415,10,22,12,120
25275,wv,-81.61077,38.92154,3102,10,22,12,120
25276,wv,-81.33122,38.78675,6258,8,20,12,150
25285,wv,-81.11142,38.54318,566,6,16,10,166.7
25286,wv,-81.40798,38.6152,1763,8,19,11,137.5
25287,wv,-82.0517,38.95741,619,9,20,11,122.2
25301,wv,-81.62999,38.35104,1527,9,22,13,144.4
25302,wv,-81.59667,38.39113,9555,10,23,13,130
25303,wv,-81.68589,38.35984,4065,10,23,13,130
25304,wv,-81.59319,38.3056,4508,9,21,12,133.3
25305,wv,-81.61274,38.33763,6,9,22,13,144.4
25306,wv,-81.49032,38.31109,3840,7,18,11,157.1
25309,wv,-81.75057,38.30849,7467,9,22,13,144.4
25311,wv,-81.54926,38.36313,6280,9,21,12,133.3
25312,wv,-81.65737,38.45241,10383,10,23,13,130
25313,wv,-81.75648,38.4168,6703,10,22,12,120
25314,wv,-81.65058,38.30583,7702,8,21,13,162.5
25315,wv,-81.56807,38.23045,1865,8,20,12,150
25320,wv,-81.63076,38.53928,3591,9,21,12,133.3
25401,wv,-77.97266,39.45685,5890,12,24,12,100
25403,wv,-78.005,39.48283,6301,11,23,12,109.1
25404,wv,-77.89534,39.48517,9172,12,23,11,91.7
25405,wv,-77.96153,39.40918,5147,11,22,11,100
25411,wv,-78.21892,39.5555,9528,7,15,8,114.3
25413,wv,-78.05294,39.31615,4164,12,23,11,91.7
25414,wv,-77.86895,39.25105,8065,13,25,12,92.3
25419,wv,-77.88514,39.58288,8577,12,23,11,91.7
25420,wv,-78.11503,39.38157,2318,9,19,10,111.1
25422,wv,-78.3613,39.55727,3382,5,12,7,140
25425,wv,-77.78681,39.29509,10361,11,22,11,100
25427,wv,-78.0912,39.52135,10067,10,20,10,100
25428,wv,-78.02707,39.37305,5246,12,23,11,91.7
25430,wv,-77.9383,39.33792,4131,11,22,11,100
25431,wv,-78.56794,39.48344,486,6,14,8,133.3
25432,wv,-77.78429,39.30576,59,11,22,11,100
25434,wv,-78.44815,39.45163,2570,5,13,8,160
25437,wv,-78.57344,39.42444,208,5,12,7,140
25438,wv,-77.86418,39.31961,3127,13,25,12,92.3
25442,wv,-77.8326,39.3702,850,13,24,11,84.6
25443,wv,-77.81446,39.4371,3541,12,24,12,100
25444,wv,-78.51954,39.42008,631,3,9,6,200
25446,wv,-77.95341,39.24159,741,12,24,12,100
25501,wv,-81.95888,38.15718,768,8,20,12,150
25502,wv,-82.10595,38.66382,788,10,23,13,130
25503,wv,-82.12153,38.61255,595,10,23,13,130
25504,wv,-82.26407,38.37331,6473,11,25,14,127.3
25505,wv,-82.03511,38.01183,445,11,25,14,127.3
25506,wv,-82.18601,38.20694,3886,10,23,13,130
25507,wv,-82.55396,38.39673,559,11,24,13,118.2
25508,wv,-82.02164,37.96346,9959,10,23,13,130
25510,wv,-82.06638,38.39337,2773,10,23,13,130
25511,wv,-82.35247,38.02951,1140,7,18,11,157.1
25512,wv,-82.32232,38.18651,1097,9,22,13,144.4
25514,wv,-82.53019,38.10067,2635,10,23,13,130
25515,wv,-82.15359,38.75266,1830,11,23,12,109.1
25517,wv,-82.45709,38.10227,1263,9,22,13,144.4
25520,wv,-82.1774,38.56097,1111,10,23,13,130
25521,wv,-81.99953,38.21971,840,9,22,13,144.4
25523,wv,-82.07363,38.28058,1968,11,25,14,127.3
25524,wv,-82.11243,38.01441,3018,9,21,12,133.3
25526,wv,-81.98475,38.39832,12582,10,23,13,130
25529,wv,-81.8467,38.15172,489,8,20,12,150
25530,wv,-82.5637,38.35476,3947,11,25,14,127.3
25534,wv,-82.275,38.08508,345,8,20,12,150
25535,wv,-82.43103,38.31149,1747,11,24,13,118.2
25537,wv,-82.2718,38.52973,1230,11,24,13,118.2
25540,wv,-82.13971,38.15909,263,10,22,12,120
25541,wv,-82.12835,38.4572,5383,11,24,13,118.2
25545,wv,-82.22502,38.46337,2550,11,24,13,118.2
25547,wv,-81.96051,37.92815,1121,6,17,11,183.3
25550,wv,-82.07573,38.86816,5586,11,24,13,118.2
25555,wv,-82.55692,38.23893,1298,11,24,13,118.2
25557,wv,-82.16328,38.09699,1357,9,22,13,144.4
25559,wv,-82.23171,38.32687,1518,11,24,13,118.2
25560,wv,-81.89792,38.444,5309,10,23,13,130
25564,wv,-81.89913,38.27153,858,9,22,13,144.4
25565,wv,-81.96345,38.10896,485,8,20,12,150
25567,wv,-81.87587,38.21873,791,9,21,12,133.3
25570,wv,-82.42182,38.23108,3853,11,24,13,118.2
25571,wv,-82.15831,38.29312,1541,11,25,14,127.3
25573,wv,-81.94422,38.22333,573,8,20,12,150
25601,wv,-82.00466,37.8591,7657,9,22,13,144.4
25606,wv,-81.82356,37.76254,928,4,12,8,200
25607,wv,-81.78645,37.78668,1462,3,10,7,233.3
25608,wv,-81.88937,37.57411,700,3,11,8,266.7
25611,wv,-81.85319,37.68964,983,5,15,10,200
25617,wv,-81.77907,37.728,1496,3,10,7,233.3
25621,wv,-81.90523,37.62734,2259,6,16,10,166.7
25624,wv,-81.97917,37.9029,681,10,23,13,130
25625,wv,-82.0948,37.82763,1941,8,20,12,150
25628,wv,-81.86215,37.766,424,5,15,10,200
25630,wv,-81.69021,37.79417,937,1,5,4,400
25632,wv,-81.92844,37.75663,777,7,18,11,157.1
25634,wv,-81.8481,37.73095,910,4,14,10,250
25635,wv,-81.89409,37.71762,1813,6,16,10,166.7
25637,wv,-82.02988,37.85615,2167,9,22,13,144.4
25638,wv,-82.01384,37.73175,1477,3,11,8,266.7
25639,wv,-81.95946,37.88915,928,9,21,12,133.3
25644,wv,-82.01852,37.70491,737,3,11,8,266.7
25646,wv,-81.89501,37.83269,1378,8,20,12,150
25647,wv,-81.98474,37.78208,1118,6,16,10,166.7
25649,wv,-82.0819,37.86631,1865,8,21,13,162.5
25650,wv,-81.81503,37.67672,474,4,14,10,250
25651,wv,-81.97219,37.57129,511,5,15,10,200
25652,wv,-82.05339,37.78936,1885,7,19,12,171.4
25653,wv,-81.99836,37.82972,692,9,22,13,144.4
25654,wv,-81.88188,37.80518,291,5,15,10,200
25661,wv,-82.27398,37.73619,8380,13,28,15,115.4
25666,wv,-82.24884,37.92675,489,6,17,11,183.3
25669,wv,-82.43242,37.92927,884,9,22,13,144.4
25670,wv,-82.13835,37.71866,4931,6,17,11,183.3
25671,wv,-82.19193,37.88386,842,6,17,11,183.3
25672,wv,-82.11309,37.58134,447,8,21,13,162.5
25674,wv,-82.35157,37.86884,2315,10,23,13,130
25676,wv,-82.22616,37.82602,1050,9,22,13,144.4
25678,wv,-82.06523,37.59031,1867,8,20,12,150
25688,wv,-82.13792,37.62824,362,9,22,13,144.4
25690,wv,-82.12444,37.68978,177,4,13,9,225
25692,wv,-82.10983,37.63629,670,5,14,9,180
25696,wv,-82.11591,37.67903,275,5,15,10,200
25699,wv,-82.33255,37.96165,106,6,17,11,183.3
25701,wv,-82.40758,38.36864,12028,12,25,13,108.3
25702,wv,-82.3293,38.43823,4790,12,26,14,116.7
25703,wv,-82.4188,38.42393,2159,12,26,14,116.7
25704,wv,-82.50872,38.35359,9786,11,25,14,127.3
25705,wv,-82.36194,38.40562,10372,12,26,14,116.7
25801,wv,-81.25465,37.81449,24703,0,2,2,NA
25810,wv,-81.34451,37.60237,321,1,6,5,500
25811,wv,-81.28916,37.56319,149,1,4,3,300
25812,wv,-81.11246,38.1557,1575,3,11,8,266.7
25813,wv,-81.11546,37.75947,4121,0,2,2,NA
25817,wv,-81.40348,37.75831,636,1,4,3,300
25818,wv,-81.19258,37.86057,343,0,3,3,NA
25820,wv,-81.13941,37.50765,430,1,3,2,200
25823,wv,-81.19961,37.65925,1637,0,2,2,NA
25825,wv,-81.07812,37.65254,1838,0,1,1,NA
25826,wv,-81.35816,37.57668,225,1,6,5,500
25827,wv,-81.25355,37.73846,1948,0,2,2,NA
25831,wv,-80.93786,37.95667,1527,0,1,1,NA
25832,wv,-81.1087,37.72559,3914,0,1,1,NA
25836,wv,-81.27315,37.77734,516,0,2,2,NA
25837,wv,-81.0177,38.05364,368,1,7,6,600
25839,wv,-81.38013,37.78395,562,1,5,4,400
25840,wv,-81.12319,38.03964,7568,1,7,6,600
25841,wv,-81.085,37.55494,643,0,2,2,NA
25843,wv,-81.11999,37.61241,1107,0,1,1,NA
25844,wv,-81.3773,37.81024,1344,1,4,3,300
25845,wv,-81.52435,37.69584,648,1,6,5,500
25846,wv,-81.14786,37.91387,432,1,5,4,400
25848,wv,-81.43514,37.71654,271,1,4,3,300
25849,wv,-81.27971,37.72998,283,0,3,3,NA
25853,wv,-81.31379,37.63752,168,1,6,5,500
25854,wv,-80.98008,38.1367,1319,1,5,4,400
25855,wv,-81.15596,37.93613,84,1,5,4,400
25857,wv,-81.25945,37.62342,475,0,2,2,NA
25862,wv,-81.0588,38.08692,321,2,9,7,350
25864,wv,-81.0282,37.87762,467,1,3,2,200
25865,wv,-81.34891,37.72513,1537,1,3,2,200
25868,wv,-80.95956,38.07201,426,1,4,3,300
25870,wv,-81.38774,37.62543,150,1,7,6,600
25871,wv,-81.21044,37.76982,609,0,2,2,NA
25873,wv,-81.21516,37.75134,580,0,2,2,NA
25875,wv,-81.45655,37.67815,514,1,4,3,300
25876,wv,-81.44923,37.63671,141,1,5,4,400
25878,wv,-81.23141,37.71831,891,0,2,2,NA
25879,wv,-81.10547,37.97966,411,2,7,5,250
25880,wv,-81.20561,37.8782,4984,1,3,2,200
25882,wv,-81.3891,37.62374,2306,1,7,6,600
25901,wv,-81.11278,37.94834,8331,1,6,5,500
25902,wv,-81.20823,37.5727,677,0,1,1,NA
25904,wv,-81.28185,37.91691,416,1,5,4,400
25906,wv,-81.11564,37.83873,204,1,3,2,200
25907,wv,-81.07189,37.85927,206,1,3,2,200
25908,wv,-81.25611,37.67241,291,0,3,3,NA
25911,wv,-81.16788,37.75742,71,0,2,2,NA
25913,wv,-81.48947,37.71406,316,1,5,4,400
25915,wv,-81.2859,37.59905,533,1,4,3,300
25916,wv,-81.49806,37.67561,200,1,5,4,400
25917,wv,-81.25098,37.97808,2229,1,6,5,500
25918,wv,-80.99894,37.74925,4527,0,2,2,NA
25920,wv,-81.33391,37.68713,210,1,4,3,300
25921,wv,-81.30854,37.67018,1659,0,2,2,NA
25922,wv,-81.10469,37.46932,242,1,3,2,200
25928,wv,-81.33257,37.5595,442,1,3,2,200
25932,wv,-81.30925,37.75651,328,1,3,2,200
25936,wv,-81.02807,37.92495,337,1,5,4,400
25938,wv,-81.0437,38.15746,1583,2,8,6,300
25942,wv,-80.98619,38.02628,268,1,4,3,300
25951,wv,-80.86709,37.6595,5904,1,5,4,400
25958,wv,-80.75078,38.02152,953,0,1,1,NA
25962,wv,-80.81165,37.97432,3599,0,1,1,NA
25969,wv,-81.00188,37.61887,929,1,3,2,200
25971,wv,-80.97652,37.47899,1905,1,3,2,200
25972,wv,-80.74159,38.04127,270,0,0,0,NA
25976,wv,-80.8472,37.85055,2634,0,3,3,NA
25977,wv,-80.90293,37.80709,185,2,8,6,300
25978,wv,-80.94577,37.62195,602,1,5,4,400
25979,wv,-80.91951,37.51739,1136,1,5,4,400
25981,wv,-80.70848,38.08471,1159,0,1,1,NA
25984,wv,-80.60318,38.02594,1546,0,2,2,NA
25985,wv,-80.80961,37.77257,654,0,2,2,NA
25989,wv,-81.06993,37.68286,253,0,1,1,NA
26003,wv,-80.65005,40.07397,25261,3,10,7,233.3
26030,wv,-80.65562,40.22652,380,3,8,5,166.7
26031,wv,-80.72262,40.00849,1239,3,10,7,233.3
26032,wv,-80.54318,40.19611,447,3,9,6,200
26033,wv,-80.57738,39.83103,3444,3,9,6,200
26034,wv,-80.55255,40.59397,3799,3,10,7,233.3
26035,wv,-80.55518,40.34828,1815,3,10,7,233.3
26036,wv,-80.54469,39.98485,394,2,8,6,300
26037,wv,-80.58475,40.33432,3900,4,11,7,175
26038,wv,-80.7237,39.96477,1928,4,11,7,175
26039,wv,-80.6712,39.81373,1003,3,9,6,200
26040,wv,-80.72165,39.98749,1291,3,10,7,233.3
26041,wv,-80.70822,39.89944,9675,4,12,8,200
26047,wv,-80.58295,40.53131,4435,4,11,7,175
26050,wv,-80.62591,40.60041,1038,4,12,8,200
26055,wv,-80.77544,39.75482,1986,3,10,7,233.3
26056,wv,-80.57713,40.53127,67,3,10,7,233.3
26059,wv,-80.59116,40.07129,2048,2,8,6,300
26060,wv,-80.54759,40.1048,1167,2,7,5,250
26062,wv,-80.56112,40.4232,13328,4,10,6,150
26070,wv,-80.58405,40.25179,6142,3,10,7,233.3
26074,wv,-80.59267,40.16174,234,2,7,5,250
26075,wv,-80.65909,40.19495,303,3,8,5,166.7
26101,wv,-81.5762,39.23906,20064,9,21,12,133.3
26104,wv,-81.47852,39.27568,10223,9,20,11,122.2
26105,wv,-81.52132,39.32987,7497,8,19,11,137.5
26133,wv,-81.6723,39.12255,1381,9,20,11,122.2
26134,wv,-81.28762,39.36796,575,6,17,11,183.3
26136,wv,-81.13612,38.96628,813,8,19,11,137.5
26137,wv,-81.04468,39.00516,1153,7,18,11,157.1
26138,wv,-81.20436,39.02869,132,8,18,10,125
26141,wv,-81.25209,38.92113,617,9,20,11,122.2
26142,wv,-81.44741,39.21054,1516,9,20,11,122.2
26143,wv,-81.37045,39.05665,5424,9,20,11,122.2
26146,wv,-81.04396,39.45281,1302,5,14,9,180
26147,wv,-81.07292,38.90661,2287,8,19,11,137.5
26148,wv,-81.1864,39.06907,400,7,18,11,157.1
26149,wv,-80.89179,39.46526,2401,5,13,8,160
26150,wv,-81.53656,39.1568,3888,9,20,11,122.2
26151,wv,-81.17295,38.88327,611,7,18,11,157.1
26152,wv,-81.19591,39.01006,35,8,19,11,137.5
26155,wv,-80.76537,39.63218,6661,4,12,8,200
26159,wv,-80.92751,39.60213,1927,4,12,8,200
26160,wv,-81.41284,38.97843,1235,10,21,11,110
26161,wv,-81.25368,39.17261,806,7,18,11,157.1
26164,wv,-81.71709,38.98875,9149,10,22,12,120
26167,wv,-80.73495,39.55723,839,4,13,9,225
26169,wv,-81.57587,39.07253,738,9,20,11,122.2
26170,wv,-81.17231,39.35962,5292,6,16,10,166.7
26175,wv,-80.96454,39.53906,2714,5,13,8,160
26178,wv,-81.03812,39.05892,868,7,17,10,142.9
26180,wv,-81.3658,39.20191,2077,8,19,11,137.5
26181,wv,-81.67208,39.20644,4434,8,19,11,137.5
26184,wv,-81.35136,39.29804,1850,7,17,10,142.9
26187,wv,-81.44835,39.36857,4192,7,18,11,157.1
26201,wv,-80.20389,39.00049,13767,2,8,6,300
26202,wv,-80.61904,38.21808,651,0,2,2,NA
26203,wv,-80.58271,38.54089,319,1,5,4,400
26205,wv,-80.65022,38.32664,2755,1,4,3,300
26206,wv,-80.53943,38.43954,2861,0,3,3,NA
26208,wv,-80.49039,38.33757,1170,0,3,3,NA
26209,wv,-79.99542,38.43392,1172,0,0,0,NA
26215,wv,-80.38798,38.7133,192,1,5,4,400
26217,wv,-80.45619,38.60755,648,1,6,5,500
26218,wv,-80.26625,38.84496,2620,1,5,4,400
26222,wv,-80.36495,38.65493,992,1,5,4,400
26224,wv,-80.18293,38.74033,496,0,1,1,NA
26228,wv,-80.37095,38.75441,163,1,5,4,400
26230,wv,-80.1976,38.65384,484,0,0,0,NA
26234,wv,-80.31514,38.77381,1514,1,4,3,300
26236,wv,-80.22301,38.74813,49,1,3,2,200
26237,wv,-80.15069,38.84542,822,1,3,2,200
26238,wv,-80.1594,39.10309,756,2,8,6,300
26241,wv,-79.78708,38.92946,9460,1,3,2,200
26250,wv,-79.96235,39.03088,4420,1,5,4,400
26253,wv,-79.85931,38.79387,2211,0,2,2,NA
26254,wv,-79.64763,38.89438,575,0,0,0,NA
26257,wv,-80.00365,38.91917,873,0,2,2,NA
26259,wv,-79.89607,38.80288,113,0,2,2,NA
26260,wv,-79.41766,39.07895,3620,0,0,0,NA
26261,wv,-80.5436,38.20362,3185,0,1,1,NA
26263,wv,-79.43726,38.949,742,0,0,0,NA
26264,wv,-79.82701,38.57579,1104,0,1,1,NA
26266,wv,-80.48971,38.4193,192,0,2,2,NA
26267,wv,-80.06514,38.91462,441,1,3,2,200
26268,wv,-79.73891,38.74897,395,0,0,0,NA
26269,wv,-79.61801,39.11126,812,0,2,2,NA
26270,wv,-79.57775,38.86342,1041,0,0,0,NA
26271,wv,-79.58106,39.03294,479,0,1,1,NA
26273,wv,-79.9556,38.63512,1055,0,1,1,NA
26275,wv,-79.95063,38.97676,508,1,3,2,200
26276,wv,-79.76365,39.01764,361,1,3,2,200
26278,wv,-80.03047,38.82537,603,0,1,1,NA
26280,wv,-80.02953,38.72957,1432,0,1,1,NA
26282,wv,-80.16244,38.52172,216,0,0,0,NA
26283,wv,-79.8114,39.06385,1983,1,3,2,200
26285,wv,-79.93752,38.91294,293,0,1,1,NA
26287,wv,-79.69037,39.16583,3520,1,3,2,200
26288,wv,-80.36308,38.49679,4630,0,2,2,NA
26291,wv,-80.15438,38.39461,398,0,0,0,NA
26292,wv,-79.52118,39.15018,891,0,0,0,NA
26293,wv,-79.93581,38.78244,408,0,1,1,NA
26294,wv,-80.0343,38.53146,1204,0,0,0,NA
26296,wv,-79.58186,38.75156,381,0,0,0,NA
26298,wv,-80.25418,38.47484,160,0,1,1,NA
26301,wv,-80.3794,39.28976,23191,4,13,9,225
26320,wv,-80.82262,39.42284,1197,5,13,8,160
26321,wv,-80.68271,39.05152,625,6,16,10,166.7
26323,wv,-80.29061,39.26259,585,4,12,8,200
26325,wv,-80.88038,39.09888,430,5,15,10,200
26327,wv,-80.93882,39.11963,177,6,16,10,166.7
26330,wv,-80.22099,39.28656,9378,4,12,8,200
26335,wv,-80.67304,38.84968,2304,6,17,11,183.3
26337,wv,-81.16263,39.23793,1873,7,17,10,142.9
26338,wv,-80.61268,39.08199,684,6,16,10,166.7
26339,wv,-80.61063,39.41963,355,5,13,8,160
26342,wv,-80.84977,39.03005,827,6,17,11,183.3
26343,wv,-80.40478,38.83114,663,2,8,6,300
26346,wv,-81.06213,39.29694,1141,6,16,10,166.7
26347,wv,-80.12612,39.25656,1920,3,10,7,233.3
26348,wv,-80.56717,39.45824,295,4,12,8,200
26349,wv,-80.13029,39.2357,175,3,9,6,200
26351,wv,-80.85364,38.9337,2895,7,17,10,142.9
26354,wv,-80.03047,39.34664,9740,3,10,7,233.3
26361,wv,-80.3176,39.36675,190,5,14,9,180
26362,wv,-81.05943,39.1497,3464,6,16,10,166.7
26366,wv,-80.33449,39.38126,370,5,14,9,180
26369,wv,-80.33175,39.33396,803,4,13,9,225
26372,wv,-80.37348,38.95858,870,4,12,8,200
26374,wv,-79.87893,39.45056,1034,2,6,4,200
26376,wv,-80.45669,38.77627,792,3,11,8,266.7
26377,wv,-80.63878,39.4924,983,5,13,8,160
26378,wv,-80.43714,39.12154,3092,6,16,10,166.7
26384,wv,-80.71386,38.97584,623,6,17,11,183.3
26385,wv,-80.35537,39.15933,3113,5,14,9,180
26386,wv,-80.40102,39.39208,2414,4,13,9,225
26404,wv,-80.30931,39.33479,353,4,13,9,225
26405,wv,-79.90173,39.22338,1359,2,6,4,200
26408,wv,-80.29785,39.20338,2378,4,13,9,225
26410,wv,-79.8254,39.40416,998,2,6,4,200
26411,wv,-80.70415,39.1741,952,5,14,9,180
26412,wv,-80.58488,38.88623,904,6,16,10,166.7
26415,wv,-80.9377,39.29707,3908,5,14,9,180
26416,wv,-80.02167,39.1617,6240,2,7,5,250
26419,wv,-80.66509,39.55354,1257,5,13,8,160
26421,wv,-80.91593,39.18432,424,6,16,10,166.7
26422,wv,-80.44388,39.29449,464,4,13,9,225
26424,wv,-80.1736,39.26688,298,3,11,8,266.7
26425,wv,-79.69284,39.32038,1332,1,4,3,300
26426,wv,-80.56388,39.28722,6087,4,13,9,225
26430,wv,-80.75532,38.87616,464,7,17,10,142.9
26431,wv,-80.29532,39.39868,4661,4,13,9,225
26435,wv,-80.08955,39.26648,66,3,10,7,233.3
26436,wv,-80.72375,39.2964,168,4,13,9,225
26437,wv,-80.51813,39.52648,852,4,13,9,225
26438,wv,-80.31911,39.3466,116,4,13,9,225
26440,wv,-79.90391,39.32599,1165,2,8,6,300
26443,wv,-80.75829,39.07015,370,6,16,10,166.7
26444,wv,-79.7681,39.36219,2874,1,3,2,200
26447,wv,-80.48568,38.9095,1414,5,14,9,180
26448,wv,-80.49339,39.40677,1221,4,13,9,225
26451,wv,-80.40225,39.20774,456,5,14,9,180
26452,wv,-80.51401,39.03718,8051,6,17,11,183.3
26456,wv,-80.77338,39.2799,4184,4,13,9,225
26501,wv,-80.04139,39.63017,12531,4,12,8,200
26505,wv,-79.94407,39.65049,12894,4,12,8,200
26508,wv,-79.89598,39.60046,18625,2,7,5,250
26519,wv,-79.63507,39.55198,1781,1,3,2,200
26520,wv,-79.82362,39.497,507,1,5,4,400
26521,wv,-80.22656,39.71421,402,3,10,7,233.3
26525,wv,-79.61747,39.65573,9283,0,2,2,NA
26534,wv,-79.99725,39.64776,482,4,12,8,200
26537,wv,-79.71239,39.48736,3800,1,5,4,400
26541,wv,-80.07464,39.68438,2269,4,11,7,175
26542,wv,-79.79064,39.57313,2036,1,3,2,200
26543,wv,-80.00226,39.66535,242,5,14,9,180
26547,wv,-79.81199,39.5127,1477,1,3,2,200
26554,wv,-80.11485,39.46679,27466,4,12,8,200
26559,wv,-80.1683,39.50133,772,5,15,10,200
26560,wv,-80.14522,39.54145,170,5,14,9,180
26562,wv,-80.45539,39.63979,914,4,12,8,200
26563,wv,-80.27427,39.48222,254,5,13,8,160
26568,wv,-80.27781,39.42489,516,4,13,9,225
26570,wv,-80.22829,39.64155,2956,3,11,8,266.7
26571,wv,-80.25539,39.51902,1511,4,12,8,200
26572,wv,-80.30775,39.48518,100,5,13,8,160
26574,wv,-80.18658,39.58114,477,5,13,8,160
26575,wv,-80.45007,39.68201,1103,4,11,7,175
26576,wv,-80.25718,39.49304,319,4,12,8,200
26581,wv,-80.56751,39.66511,1480,4,12,8,200
26582,wv,-80.38166,39.52975,4453,4,13,9,225
26585,wv,-80.4293,39.61492,625,4,12,8,200
26586,wv,-80.10301,39.52311,161,4,13,9,225
26587,wv,-80.29506,39.51767,318,4,12,8,200
26588,wv,-80.14076,39.57265,2092,4,13,9,225
26590,wv,-80.31828,39.67347,813,3,11,8,266.7
26591,wv,-80.28945,39.45854,1282,5,14,9,180
26601,wv,-80.6564,38.62919,6507,5,15,10,200
26610,wv,-80.74808,38.48768,1064,2,8,6,300
26611,wv,-80.8323,38.84515,254,6,17,11,183.3
26615,wv,-80.72414,38.82237,369,6,15,9,150
26617,wv,-80.83615,38.49623,171,2,9,7,350
26619,wv,-80.73754,38.77348,941,6,16,10,166.7
26621,wv,-80.54675,38.71617,1099,5,15,10,200
26623,wv,-80.87741,38.65218,1895,7,18,11,157.1
26624,wv,-80.80469,38.71813,4196,7,18,11,157.1
26627,wv,-80.60115,38.75351,658,6,17,11,183.3
26629,wv,-80.70658,38.56537,412,2,9,7,350
26631,wv,-80.54735,38.79593,715,5,15,10,200
26636,wv,-80.94681,38.74847,605,6,17,11,183.3
26638,wv,-81.00449,38.76171,181,6,16,10,166.7
26651,wv,-80.87244,38.32431,8007,1,5,4,400
26656,wv,-81.16347,38.26461,280,4,14,10,250
26660,wv,-80.69975,38.35751,217,1,4,3,300
26662,wv,-80.75477,38.26325,840,1,4,3,300
26676,wv,-80.65974,38.16195,551,0,2,2,NA
26678,wv,-80.91072,38.16849,907,1,5,4,400
26679,wv,-80.79765,38.16528,2743,1,4,3,300
26680,wv,-80.86939,38.09521,436,1,3,2,200
26681,wv,-80.71021,38.22731,1312,0,3,3,NA
26684,wv,-80.84584,38.16215,97,1,4,3,300
26690,wv,-81.12725,38.22552,443,3,11,8,266.7
26691,wv,-80.66671,38.40449,423,1,3,2,200
26704,wv,-78.5905,39.2925,4446,4,10,6,150
26705,wv,-79.57636,39.31811,1073,0,2,2,NA
26707,wv,-79.39586,39.22439,653,0,0,0,NA
26710,wv,-78.94225,39.30723,1906,6,15,9,150
26711,wv,-78.47684,39.27846,2166,5,13,8,160
26714,wv,-78.63639,39.18416,773,2,7,5,250
26716,wv,-79.52099,39.26122,580,0,1,1,NA
26717,wv,-79.17428,39.343,1035,0,1,1,NA
26719,wv,-78.77371,39.48349,2027,8,18,10,125
26720,wv,-79.32958,39.28029,262,0,0,0,NA
26722,wv,-78.6425,39.50272,843,9,19,10,111.1
26726,wv,-78.99088,39.40135,8548,6,15,9,150
26731,wv,-79.07469,39.16141,344,3,9,6,200
26739,wv,-79.25568,39.24279,1428,0,1,1,NA
26743,wv,-79.0768,39.28866,1565,4,10,6,150
26750,wv,-79.04469,39.47667,628,2,6,4,200
26753,wv,-78.78865,39.56357,3808,12,25,13,108.3
26755,wv,-78.72752,39.15207,997,2,5,3,150
26757,wv,-78.74649,39.31565,4993,3,9,6,200
26761,wv,-78.687,39.29329,424,2,7,5,250
26763,wv,-78.69749,39.47014,1866,7,16,9,128.6
26764,wv,-79.55499,39.45264,5595,0,1,1,NA
26767,wv,-78.75716,39.6159,593,13,26,13,100
26801,wv,-78.80365,39.05029,1635,1,4,3,300
26802,wv,-79.19655,38.6275,1530,1,5,4,400
26804,wv,-79.53941,38.63643,902,0,0,0,NA
26807,wv,-79.3539,38.65569,4049,1,4,3,300
26808,wv,-78.45701,39.20373,633,3,9,6,200
26810,wv,-78.74478,38.9812,703,0,2,2,NA
26812,wv,-78.87692,38.88169,2365,1,3,2,200
26814,wv,-79.47145,38.76761,697,0,1,1,NA
26815,wv,-79.35935,38.48903,1455,0,2,2,NA
26817,wv,-78.39169,39.36041,344,5,12,7,140
26818,wv,-79.03419,39.07497,460,12,24,12,100
26823,wv,-78.4821,39.13665,264,3,8,5,166.7
26833,wv,-79.22066,39.09292,2317,4,11,7,175
26836,wv,-78.9745,38.99074,5503,6,13,7,116.7
26845,wv,-78.96529,39.16197,938,8,18,10,125
26847,wv,-79.13652,38.95303,5178,8,18,10,125
26851,wv,-78.628,39.05163,2630,3,7,4,133.3
26852,wv,-78.90076,39.24799,863,5,12,7,140
26855,wv,-79.26278,38.96117,1045,5,12,7,140
26865,wv,-78.50865,39.19584,271,4,10,6,150
26866,wv,-79.23698,38.79402,1551,3,9,6,200
26884,wv,-79.39255,38.85832,1023,1,3,2,200
27006,nc,-80.43765,35.94453,8270,17,33,16,94.1
27007,nc,-80.59249,36.38731,1363,9,21,12,133.3
27009,nc,-80.07616,36.23303,1706,12,26,14,116.7
27011,nc,-80.6967,36.21562,4113,10,23,13,130
27012,nc,-80.37582,36.00411,13030,16,31,15,93.8
27013,nc,-80.70355,35.75593,4155,17,33,16,94.1
27014,nc,-80.55528,35.81191,472,19,36,17,89.5
27016,nc,-80.21452,36.4517,1971,9,20,11,122.2
27017,nc,-80.76034,36.38155,5477,8,20,12,150
27018,nc,-80.52079,36.19793,5932,12,26,14,116.7
27019,nc,-80.23477,36.28389,2555,11,25,14,127.3
27020,nc,-80.80798,36.10082,4653,11,24,13,118.2
27021,nc,-80.33867,36.31838,9054,9,20,11,122.2
27022,nc,-80.21471,36.51446,1236,9,22,13,144.4
27023,nc,-80.4505,36.09093,6335,14,28,14,100
27024,nc,-80.84163,36.52383,1948,5,15,10,200
27025,nc,-79.97286,36.3779,6914,14,28,14,100
27027,nc,-79.98927,36.44537,2542,16,31,15,93.8
27028,nc,-80.57515,35.92346,15670,17,33,16,94.1
27030,nc,-80.62897,36.48899,21318,7,18,11,157.1
27040,nc,-80.38976,36.16889,6338,12,26,14,116.7
27041,nc,-80.4824,36.41988,5075,8,19,11,137.5
27042,nc,-80.05593,36.34116,546,14,28,14,100
27043,nc,-80.45029,36.33748,4282,9,21,12,133.3
27045,nc,-80.29577,36.23488,4998,11,24,13,118.2
27046,nc,-80.09055,36.49321,1714,10,23,13,130
27047,nc,-80.57766,36.31156,781,11,24,13,118.2
27048,nc,-79.91058,36.47574,5195,16,31,15,93.8
27050,nc,-80.40129,36.236,2585,11,24,13,118.2
27051,nc,-80.1605,36.18761,4495,11,24,13,118.2
27052,nc,-80.1544,36.32619,6884,12,25,13,108.3
27053,nc,-80.34828,36.47282,2705,8,19,11,137.5
27054,nc,-80.59842,35.79244,1952,18,35,17,94.4
27055,nc,-80.63372,36.11344,9854,13,28,15,115.4
27101,nc,-80.19859,36.11173,8513,12,25,13,108.3
27103,nc,-80.32148,36.05799,14845,13,28,15,115.4
27104,nc,-80.3239,36.09481,11291,12,27,15,125
27105,nc,-80.23477,36.16284,17674,10,23,13,130
27106,nc,-80.32261,36.14291,16838,11,24,13,118.2
27107,nc,-80.17831,36.01472,22132,13,28,15,115.4
27109,nc,-80.27764,36.13395,2,10,23,13,130
27110,nc,-80.22496,36.08926,76,12,25,13,108.3
27127,nc,-80.27892,36.01991,16957,14,29,15,107.1
27201,nc,-79.48481,36.03423,63,19,36,17,89.5
27203,nc,-79.78929,35.73222,8877,15,30,15,100
27205,nc,-79.85092,35.63956,19131,16,31,15,93.8
27207,nc,-79.39304,35.60548,2951,21,38,17,81
27208,nc,-79.54297,35.56284,1595,21,38,17,81
27209,nc,-79.75079,35.34315,2636,22,39,17,77.3
27212,nc,-79.28062,36.46058,1270,27,47,20,74.1
27214,nc,-79.67855,36.21254,5424,16,31,15,93.8
27215,nc,-79.4889,36.03177,18214,20,37,17,85
27217,nc,-79.38333,36.19272,17996,21,39,18,85.7
27229,nc,-79.79754,35.25025,2908,22,40,18,81.8
27231,nc,-79.16978,36.20297,1482,17,33,16,94.1
27233,nc,-79.69956,35.88706,2038,15,30,15,100
27235,nc,-80.00896,36.09526,2290,12,25,13,108.3
27239,nc,-80.08962,35.60757,7775,19,35,16,84.2
27242,nc,-79.63977,35.33056,2038,22,39,17,77.3
27243,nc,-79.19496,36.07804,2705,19,36,17,89.5
27244,nc,-79.48778,36.21011,5516,19,36,17,89.5
27248,nc,-79.70968,35.78779,2872,17,32,15,88.2
27249,nc,-79.58189,36.15739,7615,18,34,16,88.9
27252,nc,-79.3495,35.56419,1817,24,42,18,75
27253,nc,-79.34544,35.96163,14100,21,38,17,81
27258,nc,-79.32609,36.03634,3295,21,38,17,81
27260,nc,-79.98834,35.95398,11230,16,32,16,100
27262,nc,-80.0384,35.96234,10834,16,31,15,93.8
27263,nc,-79.93797,35.90929,10552,15,30,15,100
27265,nc,-80.03054,36.00959,20747,15,31,16,106.7
27278,nc,-79.08617,36.08602,13660,20,37,17,85
27281,nc,-79.62674,35.18611,2574,24,42,18,75
27282,nc,-79.92826,35.99574,6853,15,30,15,100
27283,nc,-79.63722,35.95195,1996,16,31,15,93.8
27284,nc,-80.07739,36.11846,24106,12,25,13,108.3
27288,nc,-79.74658,36.49907,13721,18,34,16,88.9
27291,nc,-79.16606,36.40204,1775,23,41,18,78.3
27292,nc,-80.20925,35.7345,24262,18,34,16,88.9
27295,nc,-80.3151,35.86837,21099,17,34,17,100
27298,nc,-79.56713,35.88581,6442,16,31,15,93.8
27299,nc,-80.38596,35.75215,2708,19,36,17,89.5
27301,nc,-79.66685,36.11382,4889,17,33,16,94.1
27302,nc,-79.26436,36.14037,14648,19,36,17,89.5
27305,nc,-79.22883,36.51965,1233,22,40,18,81.8
27306,nc,-79.97527,35.21538,8846,29,48,19,65.5
27310,nc,-79.99316,36.17269,3559,12,25,13,108.3
27311,nc,-79.47454,36.48319,2365,20,38,18,90
27312,nc,-79.19671,35.75676,13596,20,37,17,85
27313,nc,-79.75182,35.92898,3695,15,29,14,93.3
27314,nc,-79.187,36.29169,744,20,36,16,80
27315,nc,-79.39268,36.50533,1538,23,41,18,78.3
27316,nc,-79.62224,35.68987,4347,17,33,16,94.1
27317,nc,-79.80283,35.83746,8969,15,30,15,100
27320,nc,-79.65759,36.34246,21724,15,30,15,100
27325,nc,-79.57468,35.46323,6106,23,40,17,73.9
27326,nc,-79.55639,36.45345,2433,18,35,17,94.4
27330,nc,-79.18719,35.51636,20144,23,41,18,78.3
27332,nc,-79.13602,35.3793,16909,24,42,18,75
27340,nc,-79.31717,35.94587,34,20,37,17,85
27341,nc,-79.70202,35.52465,4611,21,38,17,81
27343,nc,-79.09163,36.50316,2071,21,38,17,81
27344,nc,-79.43188,35.72929,10015,16,31,15,93.8
27349,nc,-79.41629,35.89842,3435,17,33,16,94.1
27350,nc,-79.88926,35.80576,3758,15,30,15,100
27355,nc,-79.56855,35.78963,1841,15,30,15,100
27356,nc,-79.79799,35.43919,2588,22,40,18,81.8
27357,nc,-79.977,36.26818,4833,12,26,14,116.7
27358,nc,-79.87974,36.22807,7053,14,28,14,100
27360,nc,-80.09979,35.85772,22759,16,31,15,93.8
27370,nc,-79.99172,35.81079,8153,16,32,16,100
27371,nc,-79.95884,35.42018,8057,25,44,19,76
27376,nc,-79.53538,35.25453,8147,23,40,17,73.9
27377,nc,-79.60261,36.03819,4846,18,34,16,88.9
27379,nc,-79.34624,36.37711,3289,26,45,19,73.1
27401,nc,-79.76577,36.07011,7784,15,30,15,100
27403,nc,-79.82469,36.06433,7976,14,28,14,100
27405,nc,-79.73542,36.11604,18505,15,30,15,100
27406,nc,-79.76567,35.99911,23445,15,29,14,93.3
27407,nc,-79.87646,36.00983,16087,14,29,15,107.1
27408,nc,-79.81414,36.10311,8563,14,28,14,100
27409,nc,-79.94473,36.09388,6096,13,27,14,107.7
27410,nc,-79.89431,36.11785,20241,13,26,13,100
27455,nc,-79.80765,36.18374,12468,14,29,15,107.1
27501,nc,-78.68498,35.48576,9684,22,40,18,81.8
27502,nc,-78.91503,35.72011,17512,18,35,17,94.4
27503,nc,-78.87778,36.15926,2349,20,37,17,85
27504,nc,-78.519,35.39896,10222,23,41,18,78.3
27505,nc,-79.00202,35.42069,3859,23,41,18,78.3
27507,nc,-78.56308,36.51274,1652,20,36,16,80
27508,nc,-78.24983,35.95769,913,24,42,18,75
27509,nc,-78.7758,36.12847,1750,22,40,18,81.8
27510,nc,-79.08193,35.91579,3345,23,41,18,78.3
27511,nc,-78.78434,35.76325,11370,18,34,16,88.9
27513,nc,-78.80268,35.80223,14215,18,34,16,88.9
27514,nc,-79.04446,35.96721,6554,25,44,19,76
27516,nc,-79.1514,35.91248,17073,22,40,18,81.8
27517,nc,-79.02489,35.85025,10443,24,41,17,70.8
27518,nc,-78.77349,35.72986,6640,18,34,16,88.9
27519,nc,-78.88693,35.80708,20786,19,35,16,84.2
27520,nc,-78.47187,35.61425,20697,21,39,18,85.7
27521,nc,-78.65923,35.41364,3491,22,41,19,86.4
27522,nc,-78.67393,36.10623,6704,21,39,18,85.7
27523,nc,-78.96054,35.77227,7915,19,35,16,84.2
27524,nc,-78.38192,35.39541,8894,24,44,20,83.3
27525,nc,-78.46805,36.11841,9049,21,38,17,81
27526,nc,-78.828,35.54135,24890,20,38,18,90
27527,nc,-78.38384,35.65776,14378,22,40,18,81.8
27529,nc,-78.58177,35.65228,21821,22,39,17,77.3
27530,nc,-78.07488,35.36899,21106,29,49,20,69
27531,nc,-77.96441,35.34299,25,29,49,20,69
27534,nc,-77.9076,35.37132,14094,29,49,20,69
27536,nc,-78.40886,36.32668,8673,19,35,16,84.2
27537,nc,-78.39039,36.36011,14774,20,36,16,80
27539,nc,-78.814,35.67671,10137,19,36,17,89.5
27540,nc,-78.86961,35.61215,18258,19,35,16,84.2
27541,nc,-79.08638,36.26326,2744,17,33,16,94.1
27542,nc,-78.14073,35.61824,6370,26,45,19,73.1
27544,nc,-78.44076,36.20053,2855,22,39,17,77.3
27545,nc,-78.4778,35.78348,10883,22,40,18,81.8
27546,nc,-78.8681,35.38385,11369,24,43,19,79.2
27549,nc,-78.23826,36.10364,17846,23,41,18,78.3
27551,nc,-78.05162,36.43181,4065,23,40,17,73.9
27553,nc,-78.307,36.48365,2331,20,37,17,85
27555,nc,-78.20423,35.56244,274,26,45,19,73.1
27556,nc,-78.31483,36.40832,198,20,36,16,80
27557,nc,-78.19922,35.7761,5136,24,42,18,75
27559,nc,-79.10089,35.63173,1807,24,42,18,75
27560,nc,-78.82709,35.85922,11746,19,36,17,89.5
27562,nc,-78.98813,35.64128,2669,22,40,18,81.8
27563,nc,-78.23715,36.42891,3668,21,38,17,81
27565,nc,-78.65006,36.36264,16668,19,36,17,89.5
27568,nc,-78.24399,35.50877,268,26,45,19,73.1
27569,nc,-78.17609,35.42909,4850,27,47,20,74.1
27571,nc,-78.45729,35.92045,3044,21,38,17,81
27572,nc,-78.88453,36.24909,4674,17,33,16,94.1
27573,nc,-78.97606,36.39674,6191,14,28,14,100
27574,nc,-78.94505,36.43046,10740,16,31,15,93.8
27576,nc,-78.25759,35.58283,9182,24,43,19,79.2
27577,nc,-78.34384,35.49186,12241,24,42,18,75
27581,nc,-78.73073,36.20133,2034,20,37,17,85
27582,nc,-78.57428,36.46174,243,19,35,16,84.2
27583,nc,-78.93614,36.2951,3998,15,30,15,100
27587,nc,-78.55287,35.98129,31515,21,38,17,81
27589,nc,-78.1291,36.33761,7130,22,39,17,77.3
27591,nc,-78.38606,35.78485,11837,22,40,18,81.8
27592,nc,-78.67344,35.55777,8506,22,40,18,81.8
27596,nc,-78.44625,36.01015,10020,20,37,17,85
27597,nc,-78.30023,35.84098,14839,22,40,18,81.8
27601,nc,-78.63446,35.77363,2937,21,39,18,85.7
27603,nc,-78.66173,35.66358,19069,21,38,17,81
27604,nc,-78.55882,35.81866,15547,22,39,17,77.3
27605,nc,-78.6546,35.79061,1009,21,38,17,81
27606,nc,-78.71765,35.74048,10685,20,36,16,80
27607,nc,-78.72235,35.81328,6756,20,37,17,85
27608,nc,-78.64723,35.80905,4655,21,39,18,85.7
27609,nc,-78.63334,35.8433,10243,21,39,18,85.7
27610,nc,-78.54647,35.74595,23706,22,40,18,81.8
27612,nc,-78.71024,35.85333,11945,21,38,17,81
27613,nc,-78.71143,35.92531,15252,20,37,17,85
27614,nc,-78.61913,35.94724,11993,22,39,17,77.3
27615,nc,-78.63611,35.89798,15101,21,38,17,81
27616,nc,-78.53807,35.8673,17430,22,40,18,81.8
27617,nc,-78.7717,35.90723,5267,20,36,16,80
27701,nc,-78.89862,35.99891,7418,22,39,17,77.3
27703,nc,-78.80681,35.96077,26133,21,38,17,81
27704,nc,-78.83041,36.04176,15098,22,39,17,77.3
27705,nc,-78.98065,36.02695,14816,22,40,18,81.8
27707,nc,-78.95484,35.95475,15266,23,41,18,78.3
27709,nc,-78.8355,35.92577,457,21,38,17,81
27712,nc,-78.90216,36.09689,10803,21,39,18,85.7
27713,nc,-78.92374,35.89497,19811,22,40,18,81.8
27801,nc,-77.73609,35.91551,11009,29,48,19,65.5
27803,nc,-77.85595,35.89988,10284,29,48,19,65.5
27804,nc,-77.84674,35.99037,13675,29,49,20,69
27805,nc,-77.0843,36.20779,2987,25,44,19,76
27806,nc,-76.75748,35.30746,4677,27,48,21,77.8
27807,nc,-78.09353,35.80664,3724,26,45,19,73.1
27808,nc,-76.75581,35.45517,3411,28,49,21,75
27809,nc,-77.74286,36.02029,2764,29,48,19,65.5
27810,nc,-76.54673,35.52907,6232,26,47,21,80.8
27812,nc,-77.36923,35.81565,2121,27,46,19,70.4
27813,nc,-77.93578,35.63094,297,29,49,20,69
27814,nc,-76.92501,35.39453,3247,31,52,21,67.7
27816,nc,-78.07055,36.10681,1960,24,42,18,75
27817,nc,-77.07544,35.44524,6197,33,53,20,60.6
27818,nc,-77.01399,36.50276,1058,24,41,17,70.8
27819,nc,-77.45495,35.816,219,29,49,20,69
27820,nc,-77.24179,36.41564,2589,26,45,19,73.1
27821,nc,-76.87461,35.32373,461,28,49,21,75
27822,nc,-77.84036,35.8052,5290,29,49,20,69
27823,nc,-77.72005,36.20577,5982,27,46,19,70.4
27824,nc,-76.03027,35.51489,1747,21,41,20,95.2
27825,nc,-77.1741,35.83287,73,26,45,19,73.1
27826,nc,-76.21187,35.58173,1068,23,44,21,91.3
27827,nc,-77.5128,35.69656,31,27,46,19,70.4
27828,nc,-77.58796,35.5861,5326,29,49,20,69
27829,nc,-77.62073,35.69019,1655,28,48,20,71.4
27830,nc,-77.95795,35.55529,3587,29,49,20,69
27831,nc,-77.57066,36.45912,3005,27,45,18,66.7
27832,nc,-77.7258,36.51198,2241,25,42,17,68
27834,nc,-77.38395,35.65857,21473,25,44,19,76
27837,nc,-77.20949,35.51691,3510,30,50,20,66.7
27839,nc,-77.55219,36.28838,3485,27,46,19,70.4
27840,nc,-77.22226,35.95921,419,30,49,19,63.3
27841,nc,-77.27636,35.90858,86,29,48,19,65.5
27842,nc,-77.85856,36.52482,2824,23,41,18,78.3
27843,nc,-77.39834,36.00049,1359,29,49,20,69
27844,nc,-77.94874,36.25229,2401,25,43,18,72
27845,nc,-77.43207,36.37388,2062,29,48,19,65.5
27846,nc,-76.88978,35.76372,2240,29,49,20,69
27847,nc,-77.18911,36.18457,880,29,48,19,65.5
27849,nc,-77.20661,36.07211,1311,30,49,19,63.3
27850,nc,-77.88394,36.40101,10691,23,41,18,78.3
27851,nc,-78.0284,35.64123,3027,28,47,19,67.9
27852,nc,-77.63588,35.75263,2232,28,48,20,71.4
27853,nc,-77.30432,36.51478,744,30,49,19,63.3
27855,nc,-77.0838,36.42202,3644,21,38,17,81
27856,nc,-77.98267,36.01379,9256,27,45,18,66.7
27857,nc,-77.2863,35.97359,1348,29,49,20,69
27858,nc,-77.29788,35.53207,19123,28,48,20,71.4
27860,nc,-76.68046,35.65074,2737,28,49,21,75
27861,nc,-77.32001,35.81488,96,27,46,19,70.4
27862,nc,-77.17964,36.49469,874,26,45,19,73.1
27863,nc,-77.96791,35.48763,7193,29,49,20,69
27864,nc,-77.64951,35.80835,2681,28,47,19,67.9
27865,nc,-76.81678,35.59316,1919,30,50,20,66.7
27866,nc,-77.51517,36.5184,804,27,46,19,70.4
27869,nc,-77.31436,36.26604,2383,28,47,19,67.9
27870,nc,-77.72096,36.43002,15401,25,42,17,68
27871,nc,-77.26215,35.81113,3431,27,46,19,70.4
27872,nc,-77.26029,36.19494,466,28,47,19,67.9
27873,nc,-77.77553,35.65356,257,29,49,20,69
27874,nc,-77.40916,36.12984,3944,29,48,19,65.5
27875,nc,-76.4977,35.45132,998,25,46,21,84
27876,nc,-77.39592,36.47748,1265,28,47,19,67.9
27878,nc,-77.83493,35.86688,783,28,48,20,71.4
27879,nc,-77.27963,35.5745,256,29,50,21,72.4
27880,nc,-78.08706,35.73495,2013,26,46,20,76.9
27881,nc,-77.43657,35.97841,84,30,50,20,66.7
27882,nc,-78.11627,35.94071,5119,25,43,18,72
27883,nc,-77.79707,35.59768,2506,30,50,20,66.7
27884,nc,-77.27003,35.70461,975,28,47,19,67.9
27885,nc,-76.27447,35.40218,1526,23,44,21,91.3
27886,nc,-77.52247,35.90298,11099,29,49,20,69
27888,nc,-77.70497,35.58514,1545,30,51,21,70
27889,nc,-77.0096,35.58528,17103,34,55,21,61.8
27890,nc,-77.59074,36.41525,1907,27,45,18,66.7
27891,nc,-77.74092,36.09928,4014,28,47,19,67.9
27892,nc,-77.06454,35.81743,9370,27,46,19,70.4
27893,nc,-77.9026,35.69202,17406,29,49,20,69
27896,nc,-77.97654,35.79144,8962,29,49,20,69
27897,nc,-77.21071,36.325,1602,25,43,18,72
27909,nc,-76.27094,36.28763,21859,24,43,19,79.2
27910,nc,-76.99315,36.28949,7732,24,43,19,79.2
27915,nc,-75.49734,35.40261,2194,8,24,16,200
27916,nc,-75.91514,36.32202,668,13,29,16,123.1
27917,nc,-75.99095,36.36143,435,14,31,17,121.4
27919,nc,-76.50351,36.31191,1368,26,46,20,76.9
27920,nc,-75.54342,35.26087,1187,8,23,15,187.5
27921,nc,-76.16887,36.35586,3092,22,41,19,86.4
27922,nc,-76.84837,36.32024,971,27,47,20,74.1
27923,nc,-75.9189,36.38839,534,14,30,16,114.3
27924,nc,-76.83367,36.17635,3157,29,49,20,69
27925,nc,-76.18514,35.84929,3917,25,45,20,80
27926,nc,-76.60773,36.51684,907,29,49,20,69
27927,nc,-75.85332,36.38634,8318,11,26,15,136.4
27928,nc,-76.43412,35.82888,2091,28,48,20,71.4
27929,nc,-75.9938,36.43242,1009,15,32,17,113.3
27932,nc,-76.59775,36.09911,10661,27,47,20,74.1
27935,nc,-76.85863,36.42985,1152,27,47,20,74.1
27936,nc,-75.58611,35.24357,1718,7,21,14,200
27937,nc,-76.7788,36.50223,2568,26,45,19,73.1
27938,nc,-76.71784,36.38343,1042,28,48,20,71.4
27939,nc,-75.85378,36.2373,1946,11,26,15,136.4
27941,nc,-75.81687,36.10255,501,12,27,15,125
27942,nc,-76.7599,36.28267,916,28,48,20,71.4
27943,nc,-75.70345,35.21142,1156,9,25,16,177.8
27944,nc,-76.41102,36.17047,12821,25,44,19,76
27946,nc,-76.60037,36.35849,1096,27,47,20,74.1
27947,nc,-75.87692,36.20132,1414,12,27,15,125
27948,nc,-75.69134,36.01756,9989,11,26,15,136.4
27949,nc,-75.75093,36.12751,9574,11,27,16,145.5
27950,nc,-75.99462,36.51643,1248,14,30,16,114.3
27953,nc,-75.87644,35.78692,698,14,31,17,121.4
27954,nc,-75.67821,35.91088,4002,12,29,17,141.7
27956,nc,-76.01407,36.40253,212,16,33,17,106.3
27957,nc,-76.76177,36.06728,1345,30,51,21,70
27958,nc,-76.13672,36.48299,6525,20,38,18,90
27959,nc,-75.60383,35.88647,5553,13,30,17,130.8
27960,nc,-75.89309,35.13972,1605,11,29,18,163.6
27962,nc,-76.73861,35.79074,6847,31,52,21,67.7
27964,nc,-75.80187,36.08331,627,12,27,15,125
27965,nc,-75.9186,36.26474,465,13,28,15,115.4
27966,nc,-75.81741,36.14359,1071,12,28,16,133.3
27967,nc,-76.90491,36.2295,284,27,46,19,70.4
27968,nc,-75.49412,35.68809,966,11,29,18,163.6
27970,nc,-76.57699,35.87972,3281,30,51,21,70
27972,nc,-75.47268,35.55581,1051,10,28,18,180
27973,nc,-76.06615,36.35992,971,20,38,18,90
27974,nc,-76.00823,36.23108,1515,16,34,18,112.5
27976,nc,-76.3509,36.4879,2197,26,45,19,73.1
27978,nc,-75.74511,35.72927,244,13,31,18,138.5
27979,nc,-76.55915,36.44135,1237,26,45,19,73.1
27980,nc,-76.61877,36.24376,1957,28,48,20,71.4
27981,nc,-75.64046,35.85551,1033,13,32,19,146.2
27982,nc,-75.4661,35.56523,292,11,28,17,154.5
27983,nc,-76.92757,35.98381,8595,32,52,20,62.5
27985,nc,-76.45827,36.21297,213,26,46,20,76.9
27986,nc,-76.9257,36.38788,1071,26,45,19,73.1
28001,nc,-80.20478,35.33624,16290,24,43,19,79.2
28006,nc,-81.0947,35.40685,753,19,36,17,89.5
28007,nc,-80.10991,35.10459,442,32,52,20,62.5
28009,nc,-80.10755,35.40851,883,25,44,19,76
28012,nc,-81.04079,35.21032,12852,19,35,16,84.2
28016,nc,-81.2882,35.31747,7510,17,33,16,94.1
28017,nc,-81.67068,35.24708,28,19,36,17,89.5
28018,nc,-81.79518,35.48378,4784,17,32,15,88.2
28019,nc,-81.79049,35.28042,74,20,37,17,85
28020,nc,-81.64132,35.52498,2018,16,31,15,93.8
28021,nc,-81.40975,35.39856,8459,16,31,15,93.8
28023,nc,-80.60221,35.56952,8319,17,33,16,94.1
28025,nc,-80.5279,35.38042,24323,24,42,18,75
28027,nc,-80.67522,35.40848,26926,24,42,18,75
28031,nc,-80.8981,35.47153,11615,19,35,16,84.2
28032,nc,-81.08028,35.235,1848,20,37,17,85
28033,nc,-81.32105,35.41874,1740,16,32,16,100
28034,nc,-81.18087,35.35324,9454,19,36,17,89.5
28036,nc,-80.79426,35.48576,7937,20,38,18,90
28037,nc,-81.01749,35.50706,13763,19,35,16,84.2
28039,nc,-80.43541,35.68046,136,18,35,17,94.4
28040,nc,-81.74722,35.39152,5328,19,35,16,84.2
28043,nc,-81.86929,35.31197,12755,21,38,17,81
28052,nc,-81.23375,35.22382,16990,19,35,16,84.2
28054,nc,-81.15015,35.26273,14573,19,36,17,89.5
28056,nc,-81.12515,35.2172,15509,20,36,16,80
28071,nc,-80.32697,35.51557,2316,20,37,17,85
28072,nc,-80.44554,35.61427,767,16,32,16,100
28073,nc,-81.48105,35.19725,2918,16,32,16,93.95
28075,nc,-80.63985,35.30272,8344,23,41,18,78.3
28076,nc,-81.78861,35.25916,467,21,39,18,85.7
28077,nc,-81.20286,35.4041,239,18,35,17,94.4
28078,nc,-80.86263,35.40491,28379,19,36,17,89.5
28079,nc,-80.60314,35.11225,16796,19,36,17,89.5
28080,nc,-81.10969,35.45254,4887,18,34,16,88.9
28081,nc,-80.66991,35.50228,13179,21,39,18,85.7
28083,nc,-80.58056,35.49084,12226,21,39,18,85.7
28086,nc,-81.3711,35.24305,14232,16,31,15,93.8
28088,nc,-80.61487,35.54422,1833,18,34,16,88.9
28089,nc,-81.65957,35.31823,84,19,35,16,84.2
28090,nc,-81.56042,35.45949,6204,17,33,16,94.1
28091,nc,-79.93155,34.98476,2210,30,49,19,63.3
28092,nc,-81.25448,35.48577,21954,16,31,15,93.8
28097,nc,-80.39304,35.29669,4064,22,40,18,81.8
28098,nc,-81.09841,35.27094,1947,20,37,17,85
28101,nc,-81.07881,35.25781,538,20,37,17,85
28102,nc,-79.97462,34.81445,66,31,51,20,64.5
28103,nc,-80.35281,35.00287,6718,25,44,19,76
28104,nc,-80.69572,35.06047,14463,19,35,16,84.2
28105,nc,-80.71313,35.1166,15567,18,34,16,88.9
28107,nc,-80.52008,35.25126,5241,24,42,18,75
28108,nc,-80.67994,34.93431,41,21,38,17,81
28109,nc,-80.28658,35.49221,78,21,39,18,85.7
28110,nc,-80.52705,35.0675,23543,20,37,17,85
28112,nc,-80.54081,34.89297,12928,22,40,18,81.8
28114,nc,-81.74922,35.22951,5128,20,37,17,85
28115,nc,-80.77325,35.57953,19778,17,34,17,100
28117,nc,-80.89561,35.57216,21162,18,34,16,88.9
28119,nc,-80.01594,34.85089,2151,29,48,19,65.5
28120,nc,-81.02616,35.33152,11232,20,37,17,85
28124,nc,-80.40378,35.40211,3977,22,40,18,81.8
28125,nc,-80.70304,35.65946,1964,17,33,16,94.1
28127,nc,-80.17345,35.45662,8727,23,42,19,82.6
28128,nc,-80.1585,35.21465,5976,29,49,20,69
28129,nc,-80.32716,35.2316,3812,25,44,19,76
28133,nc,-80.26134,34.93441,2188,28,47,19,67.9
28134,nc,-80.89179,35.08614,5176,20,37,17,85
28135,nc,-80.21083,35.04004,2787,28,47,19,67.9
28137,nc,-80.25465,35.50356,2302,22,40,18,81.8
28138,nc,-80.4418,35.52093,5818,18,35,17,94.4
28139,nc,-81.9923,35.3487,14929,21,38,17,81
28144,nc,-80.4642,35.7062,13253,19,35,16,84.2
28146,nc,-80.39309,35.62087,17238,18,34,16,88.9
28147,nc,-80.56392,35.67987,11369,18,34,16,88.9
28150,nc,-81.575,35.34829,16717,18,35,17,94.4
28152,nc,-81.5952,35.24302,13574,19,35,16,84.2
28159,nc,-80.43187,35.69482,1773,19,36,17,89.5
28160,nc,-81.92233,35.36101,2767,19,36,17,89.5
28163,nc,-80.42853,35.20742,2871,24,42,18,75
28164,nc,-81.03811,35.3917,8819,21,38,17,81
28166,nc,-80.87567,35.68144,6469,16,32,16,100
28167,nc,-81.96191,35.50617,2923,19,35,16,84.2
28168,nc,-81.42361,35.55476,7170,14,28,14,100
28169,nc,-81.42939,35.35847,102,17,32,15,88.2
28170,nc,-80.09671,34.99577,8265,28,47,19,67.9
28173,nc,-80.73014,34.91676,25583,21,38,17,81
28174,nc,-80.43859,34.96991,3421,23,41,18,78.3
28202,nc,-80.84461,35.22779,1192,18,34,16,88.9
28203,nc,-80.85911,35.20819,4266,18,34,16,88.9
28204,nc,-80.82701,35.21462,1903,18,34,16,88.9
28205,nc,-80.78792,35.21973,15512,18,34,16,88.9
28206,nc,-80.82117,35.25681,4834,18,33,15,83.3
28207,nc,-80.82621,35.19509,2848,18,34,16,88.9
28208,nc,-80.90991,35.23058,13938,17,33,16,94.1
28209,nc,-80.85386,35.17849,6605,19,35,16,84.2
28210,nc,-80.85551,35.12901,12106,20,36,16,80
28211,nc,-80.79618,35.16806,9174,19,35,16,84.2
28212,nc,-80.74512,35.18942,8082,19,35,16,84.2
28213,nc,-80.73326,35.28493,12582,19,35,16,84.2
28214,nc,-80.9685,35.27488,18654,17,32,15,88.2
28215,nc,-80.6935,35.24684,22474,19,35,16,84.2
28216,nc,-80.8875,35.31121,21310,17,32,15,88.2
28217,nc,-80.9084,35.17144,7224,19,35,16,84.2
28226,nc,-80.81985,35.1067,13025,20,36,16,80
28227,nc,-80.65127,35.18616,20499,19,35,16,84.2
28244,nc,-80.84309,35.2246,6,18,34,16,88.9
28262,nc,-80.74225,35.32514,8954,21,38,17,81
28269,nc,-80.80254,35.33785,28774,19,35,16,84.2
28270,nc,-80.76027,35.10982,11342,18,34,16,88.9
28273,nc,-80.94668,35.12684,12899,20,36,16,80
28277,nc,-80.81749,35.05241,22728,21,37,16,76.35
28278,nc,-81.00779,35.12971,13969,20,36,16,80
28280,nc,-80.84309,35.22633,3,18,34,16,88.9
28282,nc,-80.84528,35.22482,2,18,34,16,88.9
28301,nc,-78.88359,35.07434,9397,26,45,19,73.1
28303,nc,-78.96184,35.08605,12304,26,45,19,73.1
28304,nc,-78.98975,35.02599,14680,26,45,19,73.1
28305,nc,-78.90686,35.05265,3255,26,45,19,73.1
28306,nc,-78.89552,34.9588,20044,26,46,20,76.9
28307,nc,-78.98502,35.13738,4,25,43,18,72
28308,nc,-79.01499,35.17107,3,26,45,19,73.1
28311,nc,-78.88169,35.17184,13510,25,43,18,72
28312,nc,-78.74073,34.95502,12545,26,45,19,73.1
28314,nc,-79.0226,35.05816,18111,26,45,19,73.1
28315,nc,-79.43683,35.11647,8280,24,43,19,79.2
28318,nc,-78.61413,35.01787,3902,25,44,19,76
28320,nc,-78.77338,34.55183,7164,26,46,20,76.9
28323,nc,-78.84054,35.31194,2803,25,44,19,76
28325,nc,-78.10423,35.15374,283,28,48,20,71.4
28326,nc,-79.16849,35.28033,10251,25,44,19,76
28327,nc,-79.42308,35.35637,12390,23,42,19,82.6
28328,nc,-78.33827,35.00345,17812,25,44,19,76
28330,nc,-79.82198,34.9096,185,32,52,20,62.5
28332,nc,-78.73791,34.65906,365,24,43,19,79.2
28333,nc,-78.01279,35.28272,5646,28,48,20,71.4
28334,nc,-78.56987,35.26847,15928,23,42,19,82.6
28337,nc,-78.57073,34.66141,9280,23,42,19,82.6
28338,nc,-79.75909,35.10278,4088,26,45,19,73.1
28339,nc,-78.72176,35.31415,4288,23,42,19,82.6
28340,nc,-79.14072,34.47204,8129,29,50,21,72.4
28341,nc,-78.17834,35.11892,3218,27,47,20,74.1
28342,nc,-78.64979,35.19172,171,24,44,20,83.3
28343,nc,-79.5819,34.76347,1100,31,52,21,67.7
28344,nc,-78.62733,35.16339,2022,24,43,19,79.2
28345,nc,-79.66862,34.87409,8918,30,50,20,66.7
28347,nc,-79.59392,35.05501,816,27,46,19,70.4
28348,nc,-78.9115,34.92632,15984,26,46,20,76.9
28349,nc,-77.9171,34.97676,2771,30,50,20,66.7
28350,nc,-79.31304,35.24354,234,25,43,18,72
28351,nc,-79.55841,34.84017,3375,31,52,21,67.7
28352,nc,-79.45087,34.76735,13503,32,53,21,65.6
28356,nc,-78.79091,35.2309,3517,25,44,19,76
28357,nc,-79.087,34.90575,2185,27,47,20,74.1
28358,nc,-78.94113,34.60563,20087,27,47,20,74.1
28360,nc,-79.0734,34.67465,7457,27,48,21,77.8
28363,nc,-79.54202,34.9548,1120,29,49,20,69
28364,nc,-79.32694,34.71238,8917,29,50,21,72.4
28365,nc,-78.0566,35.17701,11156,28,48,20,71.4
28366,nc,-78.35946,35.23017,4200,25,45,20,80
28367,nc,-79.72525,35.17269,113,22,40,18,81.8
28369,nc,-79.03028,34.42096,2237,29,50,21,72.4
28371,nc,-78.98944,34.90635,3906,26,46,20,76.9
28372,nc,-79.17762,34.69688,6636,28,48,20,71.4
28373,nc,-79.48517,35.09079,1616,26,45,19,73.1
28374,nc,-79.46246,35.19761,11966,23,41,18,78.3
28375,nc,-79.03855,34.47574,122,29,50,21,72.4
28376,nc,-79.24265,34.99189,20551,27,47,20,74.1
28377,nc,-79.21328,34.83437,7480,27,48,21,77.8
28379,nc,-79.77993,34.93122,16589,32,52,20,62.5
28382,nc,-78.51329,34.9639,5856,25,45,20,80
28383,nc,-79.26556,34.57547,5566,29,50,21,72.4
28384,nc,-78.95737,34.79837,7510,26,46,20,76.9
28385,nc,-78.49748,35.04524,2501,24,44,20,83.3
28386,nc,-79.12748,34.85429,3295,27,47,20,74.1
28387,nc,-79.37605,35.17912,8917,23,41,18,78.3
28390,nc,-78.95465,35.21755,9749,26,45,19,73.1
28391,nc,-78.70175,35.02121,3729,25,44,19,76
28392,nc,-78.80151,34.73807,1569,25,45,20,80
28393,nc,-78.18777,34.97785,1499,28,47,19,67.9
28394,nc,-79.23464,35.21683,5808,26,45,19,73.1
28395,nc,-78.7398,35.13843,2204,25,44,19,76
28396,nc,-79.40381,34.92928,2526,28,48,20,71.4
28398,nc,-78.06875,34.99527,5162,31,51,20,64.5
28399,nc,-78.70511,34.76004,1816,25,45,20,80
28401,nc,-77.96331,34.27254,10448,24,45,21,87.5
28403,nc,-77.87985,34.22186,11348,22,42,20,90.9
28405,nc,-77.867,34.26514,13280,22,43,21,95.5
28409,nc,-77.86223,34.15454,15829,19,39,20,105.3
28411,nc,-77.79143,34.30224,17256,21,41,20,95.2
28412,nc,-77.91944,34.13316,15678,22,42,20,90.9
28420,nc,-78.48056,34.07424,3496,26,47,21,80.8
28421,nc,-78.17817,34.52084,1814,25,45,20,80
28422,nc,-78.173,34.01961,12350,20,40,20,100
28423,nc,-78.39378,34.31182,2197,24,45,21,87.5
28424,nc,-78.69968,34.29028,72,26,47,21,80.8
28425,nc,-77.89639,34.56276,8370,26,46,20,76.9
28428,nc,-77.90613,34.03881,5341,21,41,20,95.2
28429,nc,-77.90117,34.34199,4842,25,47,22,88
28430,nc,-78.93516,34.29242,1602,29,49,20,69
28431,nc,-78.83934,34.31373,5712,27,47,20,74.1
28432,nc,-78.76393,34.17623,1593,27,48,21,77.8
28433,nc,-78.62408,34.4911,4877,24,44,20,83.3
28434,nc,-78.4691,34.46645,1724,24,44,20,83.3
28435,nc,-78.10563,34.4076,2497,25,46,21,84
28436,nc,-78.26632,34.27617,1927,27,48,21,77.8
28438,nc,-78.92458,34.41155,1884,28,49,21,75
28439,nc,-79.00974,34.2948,1489,31,52,21,67.7
28441,nc,-78.4309,34.78966,3462,25,45,20,80
28442,nc,-78.60227,34.28908,1848,26,47,21,80.8
28443,nc,-77.672,34.43992,16702,19,39,20,105.3
28444,nc,-78.31958,34.69176,2528,25,46,21,84
28445,nc,-77.54665,34.51049,12906,19,38,19,100
28447,nc,-78.25933,34.60053,1496,26,46,20,76.9
28448,nc,-78.32199,34.49222,1336,24,44,20,83.3
28449,nc,-77.92718,33.98153,1942,20,41,21,105
28450,nc,-78.51764,34.32537,2824,26,47,21,80.8
28451,nc,-78.09331,34.23768,24561,25,47,22,88
28452,nc,-78.55296,33.99724,535,25,46,21,84
28453,nc,-78.07909,34.8819,2952,28,47,19,67.9
28454,nc,-77.65092,34.67829,3096,29,50,21,72.4
28455,nc,-78.63203,34.11282,2050,26,47,21,80.8
28456,nc,-78.28028,34.37595,3442,24,44,20,83.3
28457,nc,-77.8891,34.4476,7221,26,47,21,80.8
28458,nc,-78.08995,34.81827,4977,27,47,20,74.1
28460,nc,-77.42381,34.5328,11994,18,37,19,105.6
28461,nc,-78.03591,33.9655,23884,19,39,20,105.3
28462,nc,-78.28865,34.02266,21167,19,38,19,100
28463,nc,-78.78749,34.10814,6726,27,48,21,77.8
28464,nc,-78.01923,34.77792,1553,27,48,21,77.8
28465,nc,-78.10486,33.9125,12185,15,32,17,113.3
28466,nc,-77.90117,34.73525,8250,26,46,20,76.9
28467,nc,-78.58219,33.91765,10506,23,44,21,91.3
28468,nc,-78.52126,33.90241,6401,21,42,21,100
28469,nc,-78.46812,33.92667,12676,21,42,21,100
28470,nc,-78.40642,33.96367,11870,22,42,20,90.9
28472,nc,-78.68917,34.30706,14916,26,47,21,80.8
28478,nc,-78.03844,34.64301,4383,26,46,20,76.9
28479,nc,-78.01752,34.09649,4918,22,43,21,95.5
28480,nc,-77.79325,34.22275,1899,18,38,20,111.1
28501,nc,-77.52188,35.24439,11850,25,45,20,80
28504,nc,-77.63538,35.22496,12067,27,47,20,74.1
28508,nc,-77.82326,35.10034,1372,27,47,20,74.1
28510,nc,-76.80652,34.99167,2593,21,41,20,95.2
28511,nc,-76.33874,34.89589,689,20,41,21,105
28512,nc,-76.78664,34.70632,7649,17,37,20,117.6
28513,nc,-77.38894,35.44154,6243,28,48,20,71.4
28515,nc,-76.70155,35.18595,2447,26,47,21,80.8
28516,nc,-76.55232,34.91188,10792,17,37,20,117.6
28518,nc,-77.75658,34.89645,5710,25,45,20,80
28519,nc,-77.02489,35.12134,363,28,49,21,75
28520,nc,-76.31049,34.97358,542,24,46,22,91.7
28521,nc,-77.73761,34.82449,2030,25,45,20,80
28523,nc,-77.29181,35.20868,2116,28,49,21,75
28524,nc,-76.4631,34.78946,471,17,37,20,117.6
28525,nc,-77.6928,35.12449,2114,26,45,19,73.1
28526,nc,-77.39744,35.25089,2262,25,45,20,80
28527,nc,-77.01718,35.2661,992,31,52,21,67.7
28528,nc,-76.53936,34.73444,618,16,36,20,125
28529,nc,-76.87103,35.06675,2116,24,45,21,87.5
28530,nc,-77.41183,35.37271,5058,28,49,21,75
28531,nc,-76.5587,34.69938,1764,15,34,19,126.7
28532,nc,-76.8956,34.89508,9203,18,37,19,105.6
28537,nc,-76.54616,35.23718,349,25,47,22,88
28538,nc,-77.56438,35.4192,1355,31,52,21,67.7
28539,nc,-77.21128,34.70493,8689,21,42,21,100
28540,nc,-77.50564,34.75633,21856,26,48,22,84.6
28544,nc,-77.30735,34.72131,2368,26,48,22,84.6
28546,nc,-77.36102,34.79662,17984,29,50,21,72.4
28547,nc,-77.37344,34.67104,3,24,45,21,87.5
28551,nc,-77.78151,35.32189,8921,29,49,20,69
28552,nc,-76.54749,35.30953,491,26,47,21,80.8
28553,nc,-76.50898,34.73004,515,16,36,20,125
28554,nc,-77.58612,35.47848,131,30,52,22,73.3
28555,nc,-77.22875,34.87466,3658,29,51,22,75.9
28556,nc,-76.63238,35.12379,1636,25,46,21,84
28557,nc,-76.74955,34.73853,9450,17,37,20,117.6
28560,nc,-76.98416,35.12049,18355,26,47,21,80.8
28562,nc,-77.12676,35.0805,21127,27,47,20,74.1
28570,nc,-76.85573,34.77994,12625,16,36,20,125
28571,nc,-76.69913,35.05083,5076,24,45,21,87.5
28572,nc,-77.73024,35.023,4990,25,45,20,80
28573,nc,-77.19902,34.99641,1970,27,48,21,77.8
28574,nc,-77.5949,34.87871,10384,30,52,22,73.3
28575,nc,-76.89032,34.70346,1304,9,24,15,166.7
28577,nc,-76.38213,34.86265,445,20,41,21,105
28578,nc,-77.86342,35.20055,2984,28,48,20,71.4
28579,nc,-76.5103,34.75594,571,16,36,20,125
28580,nc,-77.68335,35.45271,6829,30,51,21,70
28581,nc,-76.42677,34.84214,279,19,40,21,110.5
28582,nc,-77.15031,34.75863,1428,21,41,20,95.2
28583,nc,-76.74058,35.13709,1155,25,46,21,84
28584,nc,-77.07278,34.73888,9332,18,37,19,105.6
28585,nc,-77.41442,35.07403,3794,24,44,20,83.3
28586,nc,-77.16348,35.31638,5516,31,52,21,67.7
28587,nc,-76.66927,35.19354,464,27,48,21,77.8
28589,nc,-76.50509,34.81049,178,17,37,20,117.6
28590,nc,-77.41631,35.52051,12353,27,46,19,70.4
28594,nc,-77.00026,34.68004,7497,13,30,17,130.8
28601,nc,-81.32634,35.77255,24331,12,25,13,108.3
28602,nc,-81.38617,35.67609,15953,14,28,14,100
28604,nc,-81.84787,36.17721,15578,0,0,0,NA
28605,nc,-81.6996,36.13548,6086,0,1,1,NA
28606,nc,-81.31878,36.05346,1787,6,15,9,150
28607,nc,-81.65524,36.21795,18727,0,1,1,NA
28609,nc,-81.05337,35.67416,4603,16,31,15,93.8
28610,nc,-81.13682,35.73232,6173,15,30,15,100
28611,nc,-81.73525,36.011,1709,8,18,10,125
28612,nc,-81.5401,35.66085,9762,11,23,12,109.1
28613,nc,-81.20915,35.74081,11795,14,28,14,100
28615,nc,-81.65861,36.46266,2864,0,0,0,NA
28616,nc,-81.92019,36.02307,461,0,0,0,NA
28617,nc,-81.38025,36.48213,3161,0,1,1,NA
28618,nc,-81.51718,36.2067,3028,1,5,4,400
28619,nc,-81.60249,35.7586,702,10,22,12,120
28621,nc,-80.83734,36.30805,6624,9,22,13,144.4
28622,nc,-81.94734,36.19269,2836,0,0,0,NA
28623,nc,-80.97073,36.52963,1738,1,3,2,200
28624,nc,-81.42017,36.12126,2083,6,16,10,166.7
28625,nc,-80.88576,35.86509,21680,16,31,15,93.8
28626,nc,-81.50146,36.2954,4161,0,1,1,NA
28627,nc,-81.00589,36.45784,1300,1,3,2,200
28628,nc,-81.78511,35.72633,282,16,33,17,106.3
28629,nc,-81.36522,36.34045,99,0,2,2,NA
28630,nc,-81.42341,35.82493,11968,12,26,14,116.7
28631,nc,-81.41077,36.55148,1844,0,1,1,NA
28634,nc,-80.75389,35.97156,3900,15,30,15,100
28635,nc,-81.12606,36.30548,2592,5,15,10,200
28636,nc,-81.06395,35.94325,3770,12,26,14,116.7
28637,nc,-81.41936,35.718,1012,12,25,13,108.3
28638,nc,-81.47664,35.8446,6257,12,25,13,108.3
28640,nc,-81.40743,36.40342,5524,0,1,1,NA
28642,nc,-80.8197,36.21936,3985,8,20,12,150
28643,nc,-81.53442,36.52958,4294,0,0,0,NA
28644,nc,-81.26681,36.43132,2716,0,1,1,NA
28645,nc,-81.54412,35.97737,30730,11,24,13,118.2
28646,nc,-81.8392,36.07919,1504,0,0,0,NA
28647,nc,-81.97306,35.93802,150,0,1,1,NA
28649,nc,-81.201,36.33686,1310,3,11,8,266.7
28650,nc,-81.15191,35.57213,7192,15,29,14,93.3
28651,nc,-81.28504,36.27231,5123,5,14,9,180
28652,nc,-81.98717,36.10003,39,0,0,0,NA
28654,nc,-81.15151,36.06183,3081,4,11,7,175
28655,nc,-81.74412,35.75714,32344,14,29,15,107.1
28657,nc,-81.941,36.03019,12390,0,0,0,NA
28658,nc,-81.24087,35.63586,14769,15,29,14,93.3
28659,nc,-81.07626,36.16605,12346,7,18,11,157.1
28660,nc,-80.85709,35.9684,1454,15,30,15,100
28662,nc,-81.89912,36.02152,162,0,0,0,NA
28663,nc,-81.30478,36.53897,1664,0,1,1,NA
28665,nc,-81.37514,36.20971,2892,5,13,8,160
28666,nc,-81.47066,35.72527,146,11,24,13,118.2
28667,nc,-81.42802,35.77215,342,12,24,12,100
28668,nc,-80.9913,36.40736,1413,1,5,4,400
28669,nc,-80.99497,36.2286,2180,8,19,11,137.5
28670,nc,-80.92346,36.19365,2024,9,21,12,133.3
28671,nc,-81.5279,35.75267,308,9,21,12,133.3
28672,nc,-81.32771,36.48322,96,0,1,1,NA
28673,nc,-80.99923,35.60759,4881,19,35,16,84.2
28675,nc,-81.13524,36.50345,6493,0,1,1,NA
28676,nc,-80.85745,36.32908,2290,8,19,11,137.5
28677,nc,-80.92344,35.7373,20901,16,32,16,100
28678,nc,-81.06028,35.83466,3574,14,28,14,100
28679,nc,-81.84266,36.25933,2132,0,0,0,NA
28681,nc,-81.2221,35.92094,16908,12,26,14,116.7
28682,nc,-80.9642,35.58094,1156,19,36,17,89.5
28683,nc,-80.91185,36.38918,1290,6,16,10,166.7
28684,nc,-81.61459,36.33836,3321,0,0,0,NA
28685,nc,-81.05986,36.3608,2318,5,15,10,200
28689,nc,-80.93539,36.04318,1508,11,24,13,118.2
28690,nc,-81.57404,35.73296,5866,10,22,12,120
28692,nc,-81.79539,36.28004,4088,0,0,0,NA
28693,nc,-81.56252,36.46955,2015,0,0,0,NA
28694,nc,-81.4738,36.36269,11399,0,1,1,NA
28697,nc,-81.16514,36.13611,8383,7,17,10,142.9
28698,nc,-81.74013,36.3394,2332,0,0,0,NA
28701,nc,-82.64105,35.70239,2274,5,15,10,200
28702,nc,-83.62056,35.39967,1075,1,7,6,600
28704,nc,-82.57753,35.46136,8931,2,8,6,300
28705,nc,-82.15891,36.04357,7065,0,1,1,NA
28707,nc,-83.0658,35.39739,389,0,0,0,NA
28708,nc,-82.86269,35.2714,635,2,7,5,250
28709,nc,-82.40611,35.76386,1731,0,2,2,NA
28711,nc,-82.29019,35.59866,10619,2,5,3,150
28712,nc,-82.77101,35.16967,14930,5,14,8,218.75
28713,nc,-83.50257,35.36936,10381,1,6,5,500
28714,nc,-82.31144,35.89376,15129,0,1,1,NA
28715,nc,-82.71226,35.51247,12802,2,7,5,250
28716,nc,-82.86109,35.43591,11847,0,2,2,NA
28717,nc,-83.09116,35.08257,5871,1,3,2,200
28718,nc,-82.6288,35.16561,670,3,9,6,200
28719,nc,-83.3342,35.51787,183,1,5,4,400
28720,nc,-82.25355,35.45107,498,12,26,14,116.7
28721,nc,-82.95111,35.64803,7742,0,3,3,NA
28722,nc,-82.12473,35.23415,3945,20,38,18,90
28723,nc,-83.12184,35.28061,6537,0,3,3,NA
28725,nc,-83.26051,35.37297,61,1,7,6,600
28726,nc,-82.41816,35.28117,1483,6,16,10,166.7
28729,nc,-82.60223,35.32004,1646,2,8,6,300
28730,nc,-82.37037,35.52466,6472,1,5,4,400
28731,nc,-82.39358,35.28894,5108,7,17,10,142.9
28732,nc,-82.46665,35.44586,8766,2,7,5,250
28733,nc,-83.80761,35.43677,27,0,3,3,NA
28734,nc,-83.42108,35.18279,29217,1,5,4,400
28735,nc,-82.35043,35.47571,548,2,7,5,250
28736,nc,-83.08141,35.18609,3067,0,1,1,NA
28739,nc,-82.54639,35.26356,14178,3,9,6,200
28740,nc,-82.28413,36.0501,1795,0,3,3,NA
28741,nc,-83.21082,35.06149,8767,1,4,3,300
28742,nc,-82.62469,35.37578,1770,2,8,6,300
28743,nc,-82.90056,35.80816,2665,2,7,5,250
28745,nc,-82.97039,35.52583,758,1,4,3,300
28746,nc,-82.16649,35.45946,9257,19,36,17,89.5
28747,nc,-82.92329,35.15717,3989,3,10,7,233.3
28748,nc,-82.75774,35.64959,6869,2,9,7,350
28749,nc,-82.09875,35.84063,207,4,12,8,200
28751,nc,-83.12069,35.50501,7126,0,1,1,NA
28752,nc,-82.03696,35.71189,18548,12,26,14,116.7
28753,nc,-82.70242,35.86771,10123,4,13,9,225
28754,nc,-82.51567,35.87556,7549,2,6,4,200
28756,nc,-82.18106,35.34732,4721,20,37,17,85
28757,nc,-82.30852,35.64977,496,0,3,3,NA
28759,nc,-82.58509,35.38181,4097,2,9,7,350
28761,nc,-81.90701,35.68635,7439,16,31,15,93.8
28762,nc,-82.19074,35.63368,5247,8,19,11,137.5
28763,nc,-83.43228,35.03812,3074,1,5,4,400
28766,nc,-82.61984,35.25103,1019,2,8,6,300
28768,nc,-82.70937,35.30434,4545,2,7,5,250
28771,nc,-83.8464,35.34574,8726,2,7,5,250
28772,nc,-82.82722,35.11698,1186,4,12,8,196.65
28773,nc,-82.31362,35.25642,4050,10,22,12,120
28774,nc,-82.99515,35.0914,4397,2,7,5,250
28775,nc,-83.32836,35.01978,778,0,2,2,NA
28777,nc,-82.06862,35.90169,9338,1,2,1,100
28778,nc,-82.40701,35.61716,5408,1,3,2,200
28779,nc,-83.21131,35.3552,13249,1,4,3,300
28781,nc,-83.64608,35.2152,2748,0,2,2,NA
28782,nc,-82.15036,35.23588,4779,18,34,16,86.55
28783,nc,-83.02058,35.25277,2330,0,3,3,NA
28785,nc,-83.09189,35.63715,8139,0,3,3,NA
28786,nc,-82.99231,35.46316,14723,0,2,2,NA
28787,nc,-82.5232,35.72596,11789,2,9,7,350
28789,nc,-83.31737,35.40657,5793,1,6,5,500
28790,nc,-82.48723,35.20139,3093,8,20,12,148.35
28791,nc,-82.50844,35.35612,7728,3,10,7,233.3
28792,nc,-82.36893,35.38982,17896,4,12,8,200
28801,nc,-82.55787,35.59418,5539,3,11,8,266.7
28803,nc,-82.52002,35.52959,12250,2,7,5,250
28804,nc,-82.56457,35.64775,11047,3,10,7,233.3
28805,nc,-82.48214,35.61359,8180,2,8,6,300
28806,nc,-82.61429,35.57237,17763,3,11,8,266.7
28901,nc,-83.81036,35.19809,4077,3,9,6,200
28902,nc,-83.95667,35.02605,1904,5,15,10,200
28904,nc,-83.72749,35.0624,12850,3,11,8,266.7
28905,nc,-83.94011,35.16393,2992,5,14,9,180
28906,ga,-84.13322,35.11871,25912,6,17,11,183.3
28909,nc,-83.90475,35.00161,1201,5,14,9,180
29001,sc,-80.1725,33.78349,1681,39,61,22,56.4
29003,sc,-81.01544,33.24054,4810,34,57,23,67.6
29006,sc,-81.55053,33.87024,6487,31,52,21,67.7
29009,sc,-80.37879,34.43983,2447,29,49,20,69
29010,sc,-80.27026,34.21605,8095,29,49,20,69
29014,sc,-81.13437,34.5446,1759,26,45,19,73.1
29015,sc,-81.337,34.43969,1646,30,50,20,66.7
29016,sc,-80.99574,34.20244,12540,29,49,20,69
29018,sc,-80.64537,33.34526,3425,35,59,24,68.6
29020,sc,-80.59703,34.31227,15223,24,43,19,79.2
29030,sc,-80.65353,33.58115,2048,35,59,24,68.6
29031,sc,-81.43241,34.60414,1495,29,49,20,69
29032,sc,-80.45557,34.34085,3141,26,46,20,76.9
29033,sc,-81.05785,33.95661,5477,39,61,22,56.4
29036,sc,-81.33686,34.1329,13682,30,50,20,66.7
29037,sc,-81.86436,34.18557,1073,32,52,20,62.5
29038,sc,-80.98136,33.37278,1932,33,56,23,69.7
29039,sc,-80.9076,33.41515,1900,33,56,23,69.7
29040,sc,-80.43427,34.05929,5129,27,47,20,74.1
29042,sc,-81.15069,33.30999,3516,34,57,23,67.6
29044,sc,-80.69349,33.93091,4353,31,52,21,67.7
29045,sc,-80.8099,34.18241,12263,28,48,20,71.4
29046,sc,-80.1584,34.10826,164,32,53,21,65.6
29047,sc,-80.58159,33.53364,3659,36,59,23,63.9
29048,sc,-80.29594,33.3889,3919,37,61,24,64.9
29051,sc,-80.12757,33.86442,805,36,58,22,61.1
29052,sc,-80.73848,33.81144,1395,36,59,23,63.9
29053,sc,-81.08766,33.82735,9025,31,52,21,67.7
29054,sc,-81.38043,33.94206,6204,30,50,20,66.7
29055,sc,-80.91757,34.57603,2808,26,45,19,73.1
29056,sc,-79.99458,33.60519,2379,37,60,23,62.2
29058,sc,-80.73584,34.56393,3271,23,41,18,78.3
29059,sc,-80.41762,33.32917,4357,37,61,24,64.9
29061,sc,-80.85031,33.89815,7880,33,54,21,63.6
29062,sc,-80.60011,33.99473,227,31,52,21,67.7
29063,sc,-81.20559,34.14019,15894,34,54,20,58.8
29065,sc,-81.29357,34.28525,758,31,51,20,64.5
29067,sc,-80.53222,34.54884,6571,25,43,18,72
29069,sc,-80.09626,34.18619,3682,32,53,21,65.6
29070,sc,-81.45615,33.91764,11164,31,52,21,67.7
29072,sc,-81.27553,34.00048,26995,31,52,21,67.7
29073,sc,-81.23817,33.89377,20870,32,53,21,65.6
29074,sc,-80.81552,34.44968,629,28,47,19,67.9
29075,sc,-81.37389,34.20037,2312,27,47,20,74.1
29078,sc,-80.6991,34.18347,8286,25,44,19,76
29079,sc,-80.11371,34.28653,115,32,53,21,65.6
29080,sc,-80.08537,34.01121,2958,34,55,21,61.8
29081,sc,-81.04244,33.09207,1433,39,63,24,61.5
29082,sc,-80.94172,33.03768,631,40,64,24,60
29101,sc,-80.24828,34.46021,2282,28,48,20,71.4
29102,sc,-80.1912,33.64503,14422,40,63,23,57.5
29104,sc,-80.21789,33.99852,1458,33,54,21,63.6
29105,sc,-81.59563,33.80842,987,31,52,21,67.7
29107,sc,-81.12387,33.52868,2666,33,56,23,69.7
29108,sc,-81.62476,34.29876,11301,33,54,21,63.6
29111,sc,-80.0123,33.78529,1187,36,58,22,61.1
29112,sc,-81.08272,33.63033,3987,33,56,23,69.7
29113,sc,-81.13229,33.43624,1365,34,57,23,67.6
29114,sc,-79.93237,33.95369,1489,35,57,22,62.9
29115,sc,-80.84881,33.4777,15897,33,56,23,69.7
29117,sc,-80.84882,33.49829,1,33,55,22,66.7
29118,sc,-80.89213,33.57049,8266,33,56,23,69.7
29122,sc,-81.32538,34.24016,70,31,51,20,64.5
29123,sc,-81.25947,33.76639,3852,30,51,21,70
29125,sc,-80.46723,33.6983,3073,36,58,22,61.1
29126,sc,-81.4204,34.32268,1996,30,51,21,70
29127,sc,-81.51232,34.16617,7568,30,50,20,66.7
29128,sc,-80.53036,34.09773,4092,26,46,20,76.9
29129,sc,-81.6726,33.78489,2194,32,53,21,65.6
29130,sc,-80.89265,34.32542,5586,27,46,19,70.4
29133,sc,-80.81377,33.35636,991,34,57,23,67.6
29135,sc,-80.78727,33.68916,7040,32,54,22,68.8
29137,sc,-81.32452,33.60058,2379,34,57,23,67.6
29138,sc,-81.77278,34.04454,6849,34,55,21,61.8
29142,sc,-80.52514,33.46345,3729,36,60,24,66.7
29145,sc,-81.77412,34.22067,785,33,54,21,63.6
29146,sc,-81.29826,33.50866,1648,38,62,24,63.2
29147,sc,-80.96649,34.09177,2,33,54,21,63.6
29148,sc,-80.3422,33.53657,6787,38,61,23,60.5
29150,sc,-80.3545,33.87557,20252,32,54,22,68.8
29152,sc,-80.47175,33.97494,20,26,46,20,76.9
29153,sc,-80.30419,33.96077,9517,32,53,21,65.6
29154,sc,-80.4401,33.87966,13482,31,53,22,71
29160,sc,-81.04177,33.74394,5621,32,54,22,68.8
29161,sc,-79.94264,34.10623,6869,33,55,22,66.7
29162,sc,-80.01096,33.88662,1649,36,58,22,61.1
29163,sc,-80.43948,33.42391,1538,37,60,23,62.2
29164,sc,-81.42212,33.65532,3484,32,54,22,68.8
29166,sc,-81.70817,33.90176,735,31,51,20,64.5
29168,sc,-80.55184,33.84861,2025,31,52,21,67.7
29169,sc,-81.09721,33.99652,9819,37,59,22,59.5
29170,sc,-81.14548,33.93811,9430,35,56,21,60
29172,sc,-81.07211,33.90744,4423,35,56,21,60
29175,sc,-80.59836,34.44385,285,25,43,18,72
29178,sc,-81.60219,34.49038,2861,31,52,21,67.7
29180,sc,-81.09595,34.36738,9160,29,48,19,65.5
29201,sc,-81.02807,33.98337,6925,39,61,22,56.4
29202,sc,-81.031,33.99356,23,39,61,22,56.4
29203,sc,-81.04356,34.10336,18628,36,57,21,58.3
29204,sc,-81.00069,34.02926,7900,37,59,22,59.5
29205,sc,-80.99725,33.99006,10201,38,59,21,55.3
29206,sc,-80.95842,34.0282,6881,35,56,21,60
29207,sc,-80.84044,34.04137,2,34,56,22,64.7
29208,sc,-81.02815,33.99813,2,39,61,22,56.4
29209,sc,-80.95327,33.92404,13627,35,57,22,62.9
29210,sc,-81.10664,34.04612,9317,37,59,22,59.5
29212,sc,-81.19938,34.07792,11754,35,56,21,60
29223,sc,-80.92145,34.0924,17678,31,51,20,64.5
29225,sc,-81.02503,33.99618,1,39,61,22,56.4
29229,sc,-80.88922,34.13879,18749,29,49,20,69
29301,sc,-82.01165,34.93486,13325,22,39,17,77.3
29302,sc,-81.8433,34.89513,8741,23,41,18,78.3
29303,sc,-81.96735,34.99338,9883,21,39,18,85.7
29306,sc,-81.92284,34.89368,7131,23,41,18,78.3
29307,sc,-81.83129,34.98391,8678,22,40,18,81.8
29316,sc,-81.97459,35.04117,11368,21,38,17,81
29320,sc,-81.99355,34.95869,276,21,39,18,85.7
29321,sc,-81.74199,34.71769,1607,27,46,19,70.4
29322,sc,-82.13045,35.12352,5308,20,37,17,85
29323,sc,-81.90842,35.12931,9053,21,38,17,81
29324,sc,-81.82654,34.98376,129,22,40,18,81.8
29325,sc,-81.84267,34.47226,7407,27,46,19,70.4
29329,sc,-81.83761,34.99369,163,22,40,18,81.8
29330,sc,-81.80489,35.0542,4656,21,38,17,81
29331,sc,-81.84676,34.65127,120,25,43,18,72
29332,sc,-81.9703,34.28278,3072,29,49,20,69
29333,sc,-81.9102,34.97122,228,23,41,18,78.3
29334,sc,-82.12593,34.90529,6528,19,36,17,89.5
29335,sc,-81.90674,34.65762,3089,24,42,18,75
29338,sc,-82.0016,35.13551,58,23,41,18,78.3
29340,sc,-81.5939,34.98192,10807,18,33,15,83.3
29341,sc,-81.7132,35.11767,10003,18,34,16,88.9
29346,sc,-81.83637,34.94508,160,23,41,18,78.3
29349,sc,-82.06685,35.07035,17583,20,37,17,85
29351,sc,-81.8097,34.4217,846,28,47,19,67.9
29353,sc,-81.65859,34.82897,2854,23,41,18,78.3
29355,sc,-81.76381,34.36271,608,31,51,20,64.5
29356,nc,-82.2637,35.14391,6714,16,30,15,100.45
29360,sc,-82.04671,34.49666,11453,27,46,19,70.4
29364,sc,-81.46813,34.76881,451,28,47,19,67.9
29365,sc,-82.16854,34.98304,6201,19,35,16,84.2
29368,sc,-81.86341,35.08158,39,21,39,18,85.7
29369,sc,-82.02148,34.86456,6992,22,39,17,77.3
29370,sc,-81.96723,34.37083,757,28,48,20,71.4
29372,sc,-81.70868,34.90588,2863,22,40,18,81.8
29373,sc,-81.7464,34.92237,151,22,40,18,81.8
29374,sc,-81.84913,34.78541,2234,23,40,17,73.9
29375,sc,-82.1138,34.8613,70,19,35,16,84.2
29376,sc,-81.94932,34.81528,4091,22,39,17,77.3
29377,sc,-82.09679,34.92932,468,20,36,16,80
29378,sc,-81.96868,34.96691,71,22,40,18,81.8
29379,sc,-81.60942,34.68076,11216,28,47,19,67.9
29384,sc,-82.09155,34.34491,3796,28,47,19,67.9
29385,sc,-82.09967,34.97339,3975,20,36,16,80
29388,sc,-82.04393,34.76401,8660,21,38,17,81
29401,sc,-79.93211,32.77707,3466,22,43,21,95.5
29403,sc,-79.94377,32.80463,7092,21,42,21,100
29404,sc,-80.05027,32.89866,11,30,53,23,76.7
29405,sc,-79.98183,32.85397,12511,24,46,22,91.7
29406,sc,-80.03257,32.93534,8258,31,53,22,71
29407,sc,-79.99866,32.79916,12440,23,45,22,95.7
29410,sc,-80.00278,32.93023,6394,31,53,22,71
29412,sc,-79.94947,32.71096,16318,23,44,21,91.3
29414,sc,-80.08834,32.838,13898,27,50,23,85.2
29418,sc,-80.06479,32.8892,7898,31,54,23,74.2
29420,sc,-80.10254,32.93363,8777,33,56,23,69.7
29424,sc,-79.93737,32.78364,7,21,42,21,100
29426,sc,-80.37267,32.79914,1146,37,61,24,64.9
29429,sc,-79.66148,32.97238,2864,27,49,22,81.5
29431,sc,-79.88064,33.2782,3670,44,68,24,54.5
29432,sc,-80.80785,33.23107,2966,35,59,24,68.6
29434,sc,-79.84692,33.14131,478,48,73,25,52.1
29435,sc,-80.4727,32.96697,2923,34,57,23,67.6
29436,sc,-80.18468,33.31862,3701,38,62,24,63.2
29437,sc,-80.42266,33.14176,2063,37,60,23,62.2
29438,sc,-80.31985,32.56577,5438,31,55,24,77.4
29439,sc,-79.92935,32.66614,1933,27,49,22,81.5
29440,sc,-79.32869,33.37682,18567,34,57,23,67.6
29445,sc,-79.98998,32.99781,19801,37,60,23,62.2
29446,sc,-80.53718,32.61855,1365,42,67,25,59.5
29448,sc,-80.44803,33.24786,1764,37,61,24,64.9
29449,sc,-80.28649,32.70258,5823,30,54,24,80
29450,sc,-79.78052,33.06496,2061,35,58,23,65.7
29451,sc,-79.75309,32.82181,4267,25,47,22,88
29452,sc,-80.46287,32.68007,304,40,65,25,62.5
29453,sc,-79.62823,33.22213,1284,40,65,25,62.5
29455,sc,-80.09081,32.69342,19955,28,51,23,82.1
29456,sc,-80.114,32.98657,10949,38,62,24,63.2
29458,sc,-79.46166,33.09354,2769,32,56,24,75
29461,sc,-80.00011,33.15873,21014,42,66,24,57.1
29464,sc,-79.85773,32.8183,18579,26,49,23,88.5
29466,sc,-79.7899,32.87848,16552,26,48,22,84.6
29468,sc,-80.06469,33.42264,2128,39,62,23,59
29469,sc,-80.08944,33.24879,477,41,65,24,58.5
29470,sc,-80.25108,32.82219,2956,32,56,24,75
29471,sc,-80.66857,33.18534,1471,36,60,24,66.7
29472,sc,-80.31843,33.05709,6202,33,56,23,69.7
29474,sc,-80.51734,32.89674,2032,37,61,24,64.9
29475,sc,-80.81785,32.96015,2497,37,61,24,64.9
29477,sc,-80.57063,33.16748,5253,37,61,24,64.9
29479,sc,-79.88695,33.37991,5478,41,64,23,56.1
29481,sc,-80.80304,33.11347,1782,38,61,23,60.5
29482,sc,-79.86633,32.76505,1093,28,51,23,82.1
29483,sc,-80.18746,33.05135,36095,35,59,24,68.6
29485,sc,-80.19349,32.9526,19123,37,61,24,64.9
29487,sc,-80.18477,32.6569,2280,30,54,24,80
29488,sc,-80.67207,32.90658,14968,36,60,24,66.7
29492,sc,-79.8824,32.9138,8457,23,45,22,95.7
29493,sc,-80.84284,33.03414,116,39,63,24,61.5
29501,sc,-79.82546,34.20617,18817,32,54,22,68.8
29505,sc,-79.68925,34.12309,10107,33,54,21,63.6
29506,sc,-79.64681,34.2153,9699,32,53,21,65.6
29510,sc,-79.60341,33.45796,8410,37,61,24,64.9
29511,sc,-79.11494,33.97728,3805,31,53,22,71
29512,sc,-79.70986,34.62628,12155,30,51,21,70
29516,sc,-79.63013,34.43762,1002,31,53,22,71
29518,sc,-79.84798,33.78861,1108,36,58,22,61.1
29519,sc,-79.35982,34.01864,287,36,58,22,61.1
29520,sc,-79.92721,34.67956,8742,29,49,20,69
29525,sc,-79.54113,34.55731,1690,30,51,21,70
29526,sc,-78.96948,33.86374,26351,27,49,22,81.5
29527,sc,-79.14733,33.7827,13676,31,54,23,74.2
29530,sc,-79.74203,33.99137,1661,35,57,22,62.9
29532,sc,-79.87246,34.27888,11034,33,54,21,63.6
29536,sc,-79.37302,34.41897,10890,31,52,21,67.7
29540,sc,-79.84005,34.38512,3353,32,53,21,65.6
29541,sc,-79.74324,34.06524,5259,34,56,22,64.7
29543,sc,-79.26592,34.2876,473,34,55,21,61.8
29544,sc,-79.21547,34.00018,3665,33,55,22,66.7
29545,sc,-78.96561,34.1624,1294,30,51,21,70
29546,sc,-79.35226,33.89265,2337,35,57,22,62.9
29547,sc,-79.3335,34.48817,1687,29,50,21,72.4
29550,sc,-80.07732,34.39886,19237,31,52,21,67.7
29554,sc,-79.38001,33.69805,7765,34,56,22,64.7
29555,sc,-79.4657,33.84036,3911,35,57,22,62.9
29556,sc,-79.7594,33.66676,9848,36,59,23,63.9
29560,sc,-79.74771,33.8343,8347,34,57,23,67.6
29563,sc,-79.2042,34.35344,1990,32,53,21,65.6
29564,sc,-79.84308,33.46144,1521,37,61,24,64.9
29565,sc,-79.50229,34.35768,5304,32,54,22,68.8
29566,sc,-78.6633,33.8723,11935,21,42,21,100
29567,sc,-79.43342,34.5614,567,29,50,21,72.4
29568,sc,-78.75208,33.90773,10964,23,43,20,87
29569,sc,-78.90523,34.03289,11790,28,49,21,75
29570,sc,-79.56054,34.67412,2639,31,52,21,67.7
29571,sc,-79.42191,34.13663,9811,36,59,23,63.9
29572,sc,-78.78914,33.76929,7726,19,38,19,100
29574,sc,-79.26507,34.17243,8235,35,57,22,62.9
29575,sc,-78.97364,33.62853,17559,21,41,20,95.2
29576,sc,-79.05823,33.5627,17949,26,47,21,80.8
29577,sc,-78.90335,33.69857,16701,17,35,18,105.9
29579,sc,-78.91727,33.75477,19721,18,37,19,105.6
29580,sc,-79.55891,33.66251,1387,35,58,23,65.7
29581,sc,-79.11227,34.19851,4304,33,54,21,63.6
29582,sc,-78.66047,33.83428,16587,21,41,20,95.2
29583,sc,-79.57205,33.97235,3934,36,58,22,61.1
29584,sc,-80.06094,34.58153,2077,29,49,20,69
29585,sc,-79.13415,33.52251,11103,29,51,22,75.9
29588,sc,-79.02449,33.67166,19733,21,41,20,95.2
29590,sc,-79.84908,33.56546,2497,37,60,23,62.2
29591,sc,-79.76241,33.9384,2994,34,57,23,67.6
29592,sc,-79.47875,34.26362,919,34,56,22,64.7
29593,sc,-79.85743,34.49496,1637,32,53,21,65.6
29594,sc,-79.57736,34.64023,112,30,51,21,70
29596,sc,-79.83808,34.74363,2217,29,50,21,72.4
29601,sc,-82.40276,34.84776,6313,12,25,13,108.3
29605,sc,-82.38017,34.77533,16780,14,27,13,92.9
29607,sc,-82.33131,34.81155,15382,12,25,13,108.3
29609,sc,-82.38902,34.91239,13801,12,24,12,100
29611,sc,-82.45923,34.82914,13194,14,27,13,92.9
29613,sc,-82.43861,34.9259,4,13,28,15,115.4
29614,sc,-82.36315,34.87377,12,11,22,11,100
29615,sc,-82.29514,34.85582,12256,13,26,13,100
29617,sc,-82.46658,34.912,10621,13,27,14,107.7
29620,sc,-82.42881,34.17875,8110,27,46,19,70.4
29621,sc,-82.6054,34.50708,20710,24,42,18,75
29624,sc,-82.62515,34.43731,9133,23,42,19,82.6
29625,sc,-82.76367,34.55698,15232,23,42,19,82.6
29626,sc,-82.76136,34.45956,7731,23,41,18,78.3
29627,sc,-82.47666,34.5178,11335,21,39,18,85.7
29628,sc,-82.56461,34.09088,1886,30,49,19,63.3
29630,sc,-82.7987,34.74026,6106,22,40,18,81.8
29631,sc,-82.81718,34.6813,4751,23,41,18,78.3
29634,sc,-82.83938,34.67528,1,23,42,19,82.6
29635,sc,-82.62819,35.07997,2323,12,26,14,116.7
29638,sc,-82.33656,34.35949,1983,24,42,18,75
29639,sc,-82.42479,34.30803,809,24,43,19,79.2
29640,sc,-82.5777,34.88831,16137,18,34,16,88.9
29642,sc,-82.5648,34.77559,15243,18,34,16,88.9
29643,sc,-83.00055,34.51192,3583,23,42,19,82.6
29644,sc,-82.19338,34.67153,9827,19,36,17,89.5
29645,sc,-82.12281,34.59354,5838,23,40,17,73.9
29646,sc,-82.15201,34.13467,13300,25,44,19,76
29649,sc,-82.14248,34.24272,12847,25,44,19,76
29650,sc,-82.25844,34.89756,14530,17,31,14,82.4
29651,sc,-82.22597,34.94719,23376,18,33,15,83.3
29653,sc,-82.23117,34.3002,3515,25,44,19,76
29654,sc,-82.36261,34.46548,6262,22,40,18,81.8
29655,sc,-82.64087,34.26494,5760,24,43,19,79.2
29657,sc,-82.6889,34.76608,8090,21,38,17,81
29658,sc,-83.28655,34.76474,365,12,26,14,116.7
29659,sc,-82.64699,34.20977,119,26,45,19,73.1
29661,nc,-82.53511,35.06213,4212,13,27,14,111.9
29662,sc,-82.30529,34.77783,5645,14,27,13,92.9
29664,sc,-83.15822,34.866,2017,12,25,13,108.3
29665,sc,-82.91399,34.72473,89,20,37,17,85
29666,sc,-81.99163,34.12226,5275,29,49,20,69
29667,sc,-82.75669,34.76479,169,22,40,18,81.8
29669,sc,-82.41661,34.64148,7278,21,38,17,81
29670,sc,-82.72343,34.6434,5778,23,41,18,78.3
29671,sc,-82.72151,34.9351,11784,19,36,17,89.5
29672,sc,-82.93968,34.74825,9050,20,38,18,90
29673,sc,-82.4572,34.71931,13563,18,34,16,88.9
29676,sc,-82.96068,34.93319,6152,19,37,18,94.7
29678,sc,-82.94112,34.63302,12958,20,38,18,90
29680,sc,-82.29157,34.68861,13329,17,32,15,88.2
29681,sc,-82.22476,34.76912,24427,17,32,15,88.2
29682,sc,-82.84558,34.8345,3219,20,37,17,85
29683,sc,-82.49417,35.03,152,16,31,15,93.8
29684,sc,-82.72654,34.38032,2886,22,40,18,81.8
29685,nc,-82.84714,34.98725,2767,10,20,11,175
29686,sc,-83.04656,34.9304,1149,15,31,16,106.7
29687,sc,-82.32763,34.98423,17848,15,30,15,100
29689,sc,-82.87393,34.52743,3762,24,42,18,75
29690,nc,-82.42153,35.05929,12585,12,25,12,101.65
29691,sc,-83.08605,34.78366,5932,17,34,17,100
29692,sc,-82.22195,34.41961,3165,26,44,18,69.2
29693,sc,-83.15156,34.6526,15021,20,38,18,90
29696,sc,-83.00585,34.77604,3451,18,35,17,94.4
29697,sc,-82.54803,34.62806,6980,21,39,18,85.7
29702,sc,-81.47685,35.11341,6093,16,31,15,93.8
29704,sc,-80.91534,34.82091,1882,23,41,18,78.3
29706,sc,-81.23292,34.71676,12023,25,43,18,72
29707,sc,-80.85826,34.97724,14388,22,39,17,77.3
29708,sc,-80.98582,35.04665,14047,22,39,17,77.3
29709,sc,-80.09659,34.72029,4927,30,50,20,66.7
29710,nc,-81.22031,35.10643,17772,20,36,16,82.5
29712,sc,-80.98564,34.79502,1329,24,41,17,70.8
29714,sc,-80.91536,34.71107,1837,24,42,18,75
29715,sc,-80.92655,35.01087,15108,22,40,18,81.8
29717,sc,-81.44313,34.95291,994,19,36,17,89.5
29718,sc,-80.33129,34.61982,2866,29,48,19,65.5
29720,sc,-80.73585,34.74095,26631,23,42,19,82.6
29724,sc,-81.01112,34.77395,11,24,42,18,75
29726,sc,-81.23182,34.85777,1181,23,40,17,73.9
29727,sc,-80.26827,34.7143,1129,28,48,20,71.4
29728,sc,-80.4024,34.76815,5820,28,48,20,71.4
29729,sc,-81.00586,34.67669,1549,24,42,18,75
29730,sc,-81.02083,34.8867,24886,23,41,18,78.3
29732,sc,-81.07935,34.96967,23039,23,41,18,78.3
29733,sc,-81.03196,34.93958,1,24,42,18,75
29741,sc,-80.20105,34.72499,1703,29,48,19,65.5
29742,sc,-81.38166,34.86973,1862,23,41,18,78.3
29743,sc,-81.39883,35.02551,839,18,34,16,88.9
29745,sc,-81.21603,34.99481,15457,21,38,17,81
29801,sc,-81.69699,33.58946,13997,38,61,23,60.5
29803,sc,-81.68007,33.42184,21546,38,61,23,60.5
29805,sc,-81.60523,33.64736,3789,38,60,22,57.9
29809,sc,-81.6917,33.41817,1583,40,64,24,60
29810,sc,-81.37637,32.99532,3430,40,64,24,60
29812,sc,-81.44139,33.22688,8030,40,64,24,60
29816,sc,-81.87352,33.50031,557,34,56,22,64.7
29817,sc,-81.27285,33.37057,3560,38,62,24,63.2
29819,sc,-82.22695,34.04505,1259,27,47,20,74.1
29821,sc,-82.11182,33.64381,1580,35,57,22,62.9
29824,sc,-81.99725,33.81936,5129,31,52,21,67.7
29826,sc,-81.36384,33.37216,176,39,64,25,64.1
29827,sc,-81.2533,32.96461,2719,40,64,24,60
29828,sc,-81.82832,33.52294,498,36,59,23,63.9
29829,sc,-81.85361,33.57394,6449,37,60,23,62.2
29831,sc,-81.80294,33.31122,2612,39,62,23,59
29832,sc,-81.80815,33.8396,3708,29,50,21,72.4
29834,sc,-81.85837,33.51188,910,34,57,23,67.6
29835,sc,-82.29031,33.91893,8987,30,51,21,70
29836,sc,-81.56865,33.11748,774,40,64,24,60
29838,sc,-82.16335,33.7375,697,36,57,21,58.3
29840,sc,-82.53237,34.00649,356,29,49,20,69
29841,sc,-81.93944,33.52508,15172,34,56,22,64.7
29842,sc,-81.86372,33.44614,4625,35,58,23,65.7
29843,sc,-81.18034,33.18289,1253,38,62,24,63.2
29844,sc,-82.23215,33.7682,124,36,57,21,58.3
29845,sc,-82.20498,33.82613,1016,33,54,21,63.6
29847,sc,-81.85584,33.70003,3785,31,52,21,67.7
29848,sc,-82.21349,34.0015,1019,29,49,20,69
29849,sc,-81.23311,33.09686,453,40,64,24,60
29850,sc,-81.81272,33.61274,111,36,59,23,63.9
29851,sc,-81.81158,33.51182,4095,36,59,23,63.9
29853,sc,-81.42337,33.40301,4711,39,63,24,61.5
29856,sc,-81.51322,33.48331,2029,37,61,24,64.9
29860,sc,-81.97478,33.60278,8954,29,50,21,72.4
29899,sc,-82.2506,33.92802,2,31,51,20,64.5
29902,sc,-80.69493,32.36846,7018,33,58,25,75.8
29906,sc,-80.75032,32.44682,8954,33,58,25,75.8
29907,sc,-80.60035,32.45405,8127,33,58,25,75.8
29909,sc,-80.84599,32.33844,13350,34,59,25,73.5
29910,sc,-80.88481,32.22079,21344,31,55,24,77.4
29911,sc,-81.14188,32.93759,1478,41,65,24,58.5
29912,sc,-80.93072,32.58273,45,38,62,24,63.2
29915,sc,-80.86859,32.1145,2273,29,54,25,86.2
29916,sc,-80.96342,32.72296,1479,47,73,26,55.3
29918,sc,-81.24219,32.7455,3181,40,65,25,62.5
29920,sc,-80.54209,32.36623,10856,31,56,25,80.6
29921,sc,-81.17291,32.68258,255,39,64,25,64.1
29922,sc,-81.28339,32.62219,1080,44,69,25,56.8
29923,sc,-81.24642,32.85952,392,40,64,24,60
29924,sc,-81.11326,32.87671,2933,40,65,25,62.5
29926,sc,-80.74082,32.23846,11212,29,53,24,82.8
29927,sc,-81.04403,32.23047,5734,41,66,25,61
29928,sc,-80.75694,32.16647,10926,29,53,24,82.8
29929,sc,-80.94262,32.93567,1187,39,64,25,64.1
29932,sc,-81.34768,32.81847,348,41,65,24,58.5
29934,sc,-81.10784,32.59311,1295,42,68,26,61.9
29935,sc,-80.69509,32.38322,1571,33,58,25,75.8
29936,sc,-80.97238,32.47806,9086,40,65,25,62.5
29939,sc,-81.24402,32.67252,185,43,68,25,58.1
29940,sc,-80.70666,32.55321,2921,36,60,24,66.7
29941,sc,-80.81181,32.54374,543,38,63,25,65.8
29943,sc,-81.16672,32.46797,413,44,69,25,56.8
29944,sc,-81.03281,32.79221,3600,40,65,25,62.5
29945,sc,-80.78435,32.67303,3899,45,71,26,57.8
30002,ga,-84.26064,33.77348,2408,18,36,18,100
30004,ga,-84.29952,34.14325,23474,11,24,13,118.2
30005,ga,-84.21598,34.08622,10645,11,25,14,127.3
30008,ga,-84.58927,33.89627,9020,14,29,15,107.1
30009,ga,-84.30328,34.07699,7075,11,24,13,118.2
30011,ga,-83.83771,34.02233,6461,18,34,16,88.9
30012,ga,-83.99866,33.71883,11302,22,41,19,86.4
30013,ga,-83.97194,33.64419,9974,24,43,19,79.2
30014,ga,-83.82046,33.57828,16983,26,46,20,76.9
30016,ga,-83.92944,33.51715,22074,27,48,21,77.8
30017,ga,-83.96319,33.8901,8364,16,32,16,100
30019,ga,-83.88224,33.97641,18484,17,32,15,88.2
30021,ga,-84.2381,33.8082,3277,18,34,16,88.9
30022,ga,-84.24722,34.0303,21479,13,27,14,107.7
30024,ga,-84.09078,34.06244,28226,15,30,15,100
30025,ga,-83.69567,33.65591,4890,24,42,18,75
30028,ga,-84.17947,34.28965,12585,10,22,12,120
30030,ga,-84.29207,33.77131,10490,17,34,17,100
30032,ga,-84.26433,33.73971,15859,21,39,18,85.7
30033,ga,-84.28364,33.81237,10851,16,32,16,100
30034,ga,-84.24883,33.69198,15738,23,42,19,82.6
30035,ga,-84.20524,33.72561,7555,22,40,18,81.8
30038,ga,-84.14238,33.6706,14173,24,43,19,79.2
30039,ga,-84.03319,33.79965,16845,19,37,18,94.7
30040,ga,-84.18067,34.21612,30139,11,24,13,118.2
30041,ga,-84.09418,34.20042,27894,12,26,14,116.7
30043,ga,-84.00736,34.00306,26222,15,30,15,100
30044,ga,-84.06917,33.92216,25431,17,33,16,94.1
30045,ga,-83.92998,33.93125,14528,17,33,16,94.1
30046,ga,-83.99416,33.94958,11351,16,31,15,93.8
30047,ga,-84.11267,33.87067,22633,17,34,17,100
30052,ga,-83.89465,33.81579,27113,19,36,17,89.5
30054,ga,-83.87455,33.67579,5285,23,42,19,82.6
30055,ga,-83.74235,33.48968,2230,28,48,20,71.4
30056,ga,-83.6627,33.49703,1321,28,49,21,75
30058,ga,-84.10615,33.73761,20186,21,39,18,85.7
30060,ga,-84.54206,33.9203,12136,14,29,15,107.1
30062,ga,-84.46982,33.99971,24211,13,28,15,115.4
30064,ga,-84.61638,33.93961,19615,15,31,16,106.7
30066,ga,-84.50793,34.03399,22148,13,27,14,107.7
30067,ga,-84.46152,33.93242,9885,15,31,16,106.7
30068,ga,-84.43277,33.96892,12153,14,29,15,107.1
30070,ga,-83.89519,33.5744,172,27,48,21,77.8
30071,ga,-84.20594,33.93943,7406,14,29,15,107.1
30072,ga,-84.20592,33.79145,428,18,35,17,94.4
30075,ga,-84.38741,34.0525,20804,12,25,13,108.3
30076,ga,-84.31763,34.02843,12769,12,26,14,116.7
30078,ga,-84.01772,33.86159,14088,16,32,16,100
30079,ga,-84.25765,33.79244,1835,18,35,17,94.4
30080,ga,-84.50112,33.87137,14873,17,33,16,94.1
30082,ga,-84.53507,33.85443,9832,16,33,17,106.3
30083,ga,-84.19448,33.79523,15569,18,35,17,94.4
30084,ga,-84.21601,33.85428,13272,15,30,15,100
30087,ga,-84.13131,33.81005,14258,20,37,17,85
30088,ga,-84.17921,33.75952,8779,20,38,18,90
30092,ga,-84.23517,33.97168,7715,13,27,14,107.7
30093,ga,-84.17808,33.9095,8696,15,31,16,106.7
30094,ga,-84.05635,33.61125,12753,24,44,20,83.3
30096,ga,-84.14824,33.97682,16048,15,30,15,100
30097,ga,-84.14709,34.02594,15138,15,30,15,100
30101,ga,-84.71272,34.04348,23091,18,35,17,94.4
30102,ga,-84.64338,34.10607,15343,16,32,16,100
30103,ga,-84.92067,34.36661,7396,19,36,17,89.5
30104,ga,-85.0615,34.08456,2711,22,40,18,81.8
30105,ga,-85.16108,34.47185,1524,24,42,18,75
30106,ga,-84.62703,33.83601,8376,16,32,16,100
30107,ga,-84.34749,34.33581,7797,10,22,12,120
30108,ga,-85.26319,33.53232,4282,17,34,17,100
30110,ga,-85.13336,33.74203,7274,12,27,15,125
30113,ga,-85.20834,33.85047,3984,14,29,15,107.1
30114,ga,-84.52569,34.24693,23705,12,27,15,125
30115,ga,-84.40075,34.20406,17569,12,26,14,116.7
30116,ga,-85.01358,33.55093,10652,16,33,17,106.3
30117,ga,-85.13241,33.58016,14550,16,33,17,106.3
30118,ga,-85.10362,33.57239,1,17,34,17,100
30120,ga,-84.85535,34.16709,16859,23,42,19,82.6
30121,ga,-84.77661,34.20839,8985,21,39,18,85.7
30122,ga,-84.63819,33.76298,7407,18,35,17,94.4
30124,ga,-85.35577,34.13052,2153,24,43,19,79.2
30125,ga,-85.27502,34.00204,12962,22,40,18,81.8
30126,ga,-84.55204,33.8159,16189,17,34,17,100
30127,ga,-84.69607,33.87476,25655,18,35,17,94.4
30132,ga,-84.85867,33.98837,17902,19,36,17,89.5
30134,ga,-84.7798,33.77476,17209,16,33,17,106.3
30135,ga,-84.74553,33.67236,26118,19,38,19,100
30137,ga,-84.75913,34.12235,685,22,40,18,81.8
30139,ga,-84.70866,34.43329,2351,15,31,16,106.7
30141,ga,-84.77175,33.86265,10069,18,36,18,100
30143,ga,-84.43318,34.45882,16149,7,17,10,142.9
30144,ga,-84.59193,34.03707,17535,15,31,16,106.7
30145,ga,-84.98321,34.24343,4259,23,41,18,78.3
30147,ga,-85.21677,34.14143,2378,20,37,17,85
30148,ga,-84.25844,34.45761,369,7,17,10,142.9
30149,ga,-85.22529,34.31031,11,23,41,18,78.3
30152,ga,-84.65078,33.99498,14619,15,31,16,106.7
30153,ga,-85.06209,33.96739,9735,18,34,16,88.9
30157,ga,-84.87325,33.88586,19669,17,34,17,100
30161,ga,-85.17178,34.2381,19515,21,38,17,81
30165,al,-85.27159,34.30355,18399,26,45,19,73.65
30168,ga,-84.58871,33.78369,7025,17,33,16,94.1
30170,ga,-85.16946,33.42923,1620,19,36,17,89.5
30171,ga,-84.72522,34.34303,1790,15,31,16,106.7
30173,ga,-85.14259,34.13306,3067,20,38,18,90
30175,ga,-84.52903,34.54322,4658,8,20,12,150
30176,ga,-85.30282,33.76785,4060,15,31,16,106.7
30177,ga,-84.37792,34.41135,467,9,21,12,133.3
30178,ga,-84.96539,34.09779,1804,23,41,18,78.3
30179,ga,-85.01567,33.77918,8742,14,30,16,114.3
30180,ga,-84.92175,33.71731,17841,15,31,16,106.7
30182,ga,-85.24594,33.65552,1656,14,29,15,107.1
30183,ga,-84.60032,34.33607,4980,10,24,14,140
30184,ga,-84.72392,34.25782,3453,17,34,17,100
30185,ga,-84.91016,33.51982,2323,23,43,20,87
30187,ga,-84.852,33.66646,4420,17,34,17,100
30188,ga,-84.45552,34.1188,26814,13,28,15,115.4
30189,ga,-84.57165,34.12812,13948,16,32,16,100
30204,ga,-84.12508,33.05732,6301,32,54,22,68.8
30205,ga,-84.46667,33.26833,1845,26,47,21,80.8
30206,ga,-84.46052,33.09435,1701,31,53,22,71
30213,ga,-84.63726,33.59147,16475,20,38,18,90
30214,ga,-84.48742,33.49171,12859,24,43,19,79.2
30215,ga,-84.45732,33.38851,13933,24,44,20,83.3
30216,ga,-83.88474,33.237,1253,34,57,23,67.6
30217,ga,-85.13023,33.28595,5404,26,47,21,80.8
30218,ga,-84.58357,33.12745,1448,30,52,22,73.3
30220,ga,-84.82432,33.22502,3503,26,47,21,80.8
30222,ga,-84.74459,33.043,3464,30,51,21,70
30223,ga,-84.27972,33.28629,18134,24,43,19,79.2
30224,ga,-84.23684,33.20484,11854,26,46,20,76.9
30228,ga,-84.30543,33.40449,18528,24,43,19,79.2
30230,ga,-84.92215,33.16418,5775,28,49,21,75
30233,ga,-83.96942,33.29193,12403,32,54,22,68.8
30234,ga,-84.03222,33.32408,945,29,51,22,75.9
30236,ga,-84.32424,33.52241,15620,26,46,20,76.9
30238,ga,-84.38166,33.4943,12998,25,44,19,76
30240,ga,-85.12363,33.03626,13791,28,49,21,75
30241,ga,-84.95161,33.02222,11519,26,47,21,80.8
30248,ga,-84.10775,33.35142,11719,28,49,21,75
30250,ga,-84.31421,33.43654,41,23,42,19,82.6
30251,ga,-84.69729,33.18813,1495,27,48,21,77.8
30252,ga,-84.06241,33.4697,18323,29,50,21,72.4
30253,ga,-84.18336,33.44885,21231,26,45,19,73.1
30256,ga,-84.32023,33.01414,1496,36,60,24,66.7
30257,ga,-84.18402,33.14313,2358,31,53,22,71
30258,ga,-84.46731,32.98756,1612,32,54,22,68.8
30259,ga,-84.74006,33.26419,1836,25,45,20,80
30260,ga,-84.32923,33.58487,8235,25,45,20,80
30263,ga,-84.85806,33.38871,24359,22,42,20,90.9
30265,ga,-84.70671,33.41789,13179,23,43,20,87
30268,ga,-84.725,33.54265,5280,20,39,19,95
30269,ga,-84.57105,33.39444,13242,24,44,20,83.3
30273,ga,-84.27211,33.58351,6572,27,47,20,74.1
30274,ga,-84.40064,33.55375,10306,24,44,20,83.3
30275,ga,-84.87418,33.43712,26,23,43,20,87
30276,ga,-84.58165,33.26735,8246,26,47,21,80.8
30277,ga,-84.65068,33.3813,8543,23,43,20,87
30281,ga,-84.19492,33.56351,23592,27,47,20,74.1
30284,ga,-84.28955,33.34231,36,22,41,19,86.4
30285,ga,-84.24908,32.98851,445,38,61,23,60.5
30286,ga,-84.3308,32.87907,12836,39,63,24,61.5
30288,ga,-84.32497,33.65542,3506,23,42,19,82.6
30289,ga,-84.63687,33.32533,59,23,43,20,87
30290,ga,-84.58794,33.47746,3759,21,40,19,90.5
30291,ga,-84.54184,33.57451,7889,19,38,19,100
30292,ga,-84.39453,33.17118,2836,26,47,21,80.8
30293,ga,-84.60174,32.97429,2130,30,52,22,73.3
30294,ga,-84.26382,33.63633,16077,24,43,19,79.2
30295,ga,-84.31266,33.09454,2300,32,54,22,68.8
30296,ga,-84.44297,33.5637,9767,23,42,19,82.6
30297,ga,-84.37184,33.61561,8406,22,40,18,81.8
30303,ga,-84.38994,33.75327,896,17,34,17,100
30305,ga,-84.38892,33.83566,6040,18,35,17,94.4
30306,ga,-84.3503,33.7887,7259,17,34,17,100
30307,ga,-84.33403,33.77065,7199,18,34,16,88.9
30308,ga,-84.37811,33.77113,2197,17,34,17,100
30309,ga,-84.38663,33.79757,3876,17,34,17,100
30310,ga,-84.42695,33.72658,12167,18,35,17,94.4
30311,ga,-84.4748,33.72335,9588,17,34,17,100
30312,ga,-84.37525,33.74473,5602,18,35,17,94.4
30313,ga,-84.39733,33.76456,668,17,34,17,100
30314,ga,-84.43195,33.75749,8126,17,33,16,94.1
30315,ga,-84.38249,33.70291,11546,20,37,17,85
30316,ga,-84.3325,33.71362,14027,20,38,18,90
30317,ga,-84.31521,33.74919,5638,18,35,17,94.4
30318,ga,-84.44791,33.79235,19456,17,34,17,100
30319,ga,-84.33619,33.87892,12889,15,31,16,106.7
30322,ga,-84.32569,33.79467,27,17,33,16,94.1
30324,ga,-84.35713,33.81952,5818,17,34,17,100
30326,ga,-84.36397,33.84952,365,18,35,17,94.4
30327,ga,-84.42316,33.86623,7465,17,34,17,100
30328,ga,-84.38577,33.93215,9011,13,27,14,107.7
30329,ga,-84.32295,33.82703,4858,16,32,16,100
30331,ga,-84.54389,33.70635,19969,18,35,17,94.4
30332,ga,-84.40454,33.77827,70,17,34,17,100
30334,ga,-84.38724,33.74885,16,18,35,17,94.4
30336,ga,-84.5665,33.73786,940,19,36,17,89.5
30337,ga,-84.45005,33.64005,4086,17,34,17,100
30338,ga,-84.31751,33.94372,10220,12,26,14,116.7
30339,ga,-84.46019,33.87621,2819,18,35,17,94.4
30340,ga,-84.25087,33.89786,7204,13,28,15,115.4
30341,ga,-84.29042,33.88786,9096,14,29,15,107.1
30342,ga,-84.3746,33.8821,7001,15,31,16,106.7
30344,ga,-84.46025,33.67516,11982,17,34,17,100
30345,ga,-84.28322,33.85097,6410,15,31,16,106.7
30346,ga,-84.33884,33.92426,254,13,27,14,107.7
30349,ga,-84.52591,33.62357,26920,19,37,18,94.7
30350,ga,-84.33349,33.97914,5585,12,26,14,116.7
30354,ga,-84.38703,33.66062,5894,20,37,17,85
30360,ga,-84.27209,33.934,4348,13,27,14,107.7
30363,ga,-84.39918,33.79098,206,17,34,17,100
30401,ga,-82.35204,32.60048,7927,43,68,25,58.1
30410,ga,-82.51752,32.18826,1428,41,66,25,61
30411,ga,-82.7982,32.12818,1974,43,69,26,60.5
30412,ga,-82.4916,32.07821,79,42,68,26,61.9
30413,ga,-82.51379,32.88978,1474,38,62,24,63.2
30415,ga,-81.60193,32.32628,4014,50,75,25,50
30417,ga,-81.92019,32.17323,6702,45,70,25,55.6
30420,ga,-82.15673,32.28836,1006,46,71,25,54.3
30421,ga,-82.10755,32.17931,2358,43,68,25,58.1
30423,ga,-81.8322,32.14921,92,46,72,26,56.5
30425,ga,-82.02117,32.64654,1073,44,69,25,56.8
30426,ga,-81.64684,33.03578,1099,42,66,24,57.1
30427,ga,-81.96475,31.91928,6017,46,72,26,56.5
30428,ga,-82.71128,32.21931,2064,44,70,26,59.1
30429,ga,-81.93734,32.16238,74,43,68,25,58.1
30434,ga,-82.37725,33.02517,3769,39,62,23,59
30436,ga,-82.28905,32.15188,7185,43,68,25,58.1
30438,ga,-82.019,32.16396,40,41,66,25,61
30439,ga,-82.07648,32.40569,6803,51,77,26,51
30441,ga,-82.2357,32.80989,2093,41,65,24,58.5
30442,ga,-81.98907,32.8018,5860,46,71,25,54.3
30445,ga,-82.58575,32.16295,1707,43,68,25,58.1
30446,ga,-81.46852,32.56759,1194,47,73,26,55.3
30448,ga,-82.36454,32.48742,57,44,70,26,59.1
30449,ga,-81.55146,32.52984,96,50,75,25,50
30450,ga,-81.93379,32.56017,1642,49,74,25,51
30451,ga,-81.95242,32.39072,28,50,76,26,52
30452,ga,-81.89059,32.32232,1106,50,76,26,52
30453,ga,-82.12386,32.01783,3670,43,68,25,58.1
30454,ga,-82.73374,32.43607,529,44,69,25,56.8
30455,ga,-81.80349,32.68862,582,47,71,24,51.1
30456,ga,-81.80599,32.97818,1837,41,65,24,58.5
30457,ga,-82.5676,32.40042,3888,41,66,25,61
30458,ga,-81.82559,32.39867,14687,51,77,26,51
30460,ga,-81.78152,32.41897,2,51,76,25,49
30461,ga,-81.72045,32.50901,6633,53,78,25,47.2
30464,ga,-82.22191,32.43502,73,48,74,26,54.2
30467,ga,-81.6126,32.75618,9144,44,68,24,54.5
30470,ga,-82.52285,32.33864,400,40,65,25,62.5
30471,ga,-82.17839,32.54918,3158,46,71,25,54.3
30473,ga,-82.46819,32.01598,2610,44,70,26,59.1
30474,ga,-82.41731,32.2384,9432,40,65,25,62.5
30475,ga,-82.36859,32.2247,32,39,64,25,64.1
30477,ga,-82.40011,32.86128,2220,40,64,24,60
30501,ga,-83.81619,34.31854,10190,10,22,12,120
30504,ga,-83.89089,34.26808,8586,10,22,12,120
30506,ga,-83.89366,34.35006,22067,11,25,14,127.3
30507,ga,-83.76695,34.26052,10233,14,29,15,107.1
30510,ga,-83.58288,34.44171,3250,11,24,13,118.2
30511,ga,-83.47612,34.45762,1755,14,29,15,107.1
30512,ga,-83.9709,34.85597,20675,3,11,8,266.7
30513,ga,-84.31997,34.82423,12814,6,17,11,183.3
30516,ga,-83.03707,34.37561,1109,19,36,17,89.5
30517,ga,-83.79748,34.1306,7115,19,36,17,89.5
30518,ga,-84.02636,34.1319,20343,14,28,14,100
30519,ga,-83.94119,34.08797,18160,14,29,15,107.1
30520,ga,-83.08673,34.337,2382,20,37,17,85
30521,ga,-83.29364,34.36237,3286,23,41,18,78.3
30522,ga,-84.33483,34.78341,1895,5,14,9,180
30523,ga,-83.53651,34.70784,9753,8,19,11,137.5
30525,ga,-83.3716,34.90868,7376,5,15,10,200
30527,ga,-83.78628,34.47945,2213,8,19,11,137.5
30528,ga,-83.79491,34.61548,13924,6,16,10,166.7
30529,ga,-83.48025,34.21827,5625,18,35,17,94.4
30530,ga,-83.38432,34.22573,3507,21,38,17,81
30531,ga,-83.5916,34.51014,5207,9,20,11,122.2
30533,ga,-84.01538,34.56408,13868,7,18,11,157.1
30534,ga,-84.15076,34.43888,16652,9,21,12,133.3
30535,ga,-83.57701,34.58065,3953,8,18,10,125
30536,ga,-84.35536,34.65504,9203,5,14,9,180
30537,ga,-83.31999,34.97772,2251,1,4,3,300
30538,ga,-83.26612,34.5041,1506,20,37,17,85
30540,ga,-84.54403,34.72433,20442,10,23,13,130
30541,ga,-84.53918,34.91289,1481,7,18,11,157.1
30542,ga,-83.90861,34.17775,15280,14,29,15,107.1
30543,ga,-83.65041,34.2953,2087,17,33,16,94.1
30545,ga,-83.76412,34.7416,1390,8,19,11,137.5
30546,ga,-83.70731,34.90881,10176,2,9,7,350
30547,ga,-83.46228,34.36057,1791,19,35,16,84.2
30548,ga,-83.76651,34.09049,9552,20,37,17,85
30549,ga,-83.57735,34.10678,12914,22,40,18,81.8
30552,ga,-83.4452,34.77104,2282,8,18,10,125
30553,ga,-83.08593,34.4433,7424,21,39,18,85.7
30554,ga,-83.659,34.3994,4255,12,26,14,116.7
30555,ga,-84.42917,34.97395,1759,9,22,13,144.4
30557,ga,-83.18386,34.48085,5182,22,41,19,86.4
30558,ga,-83.56448,34.27126,2843,18,35,17,94.4
30559,ga,-84.26674,34.95251,5117,8,20,12,150
30560,ga,-84.19487,34.87975,5899,5,15,10,200
30562,ga,-83.37742,34.92155,551,3,10,7,233.3
30563,ga,-83.46248,34.56348,2776,11,23,12,109.1
30564,ga,-83.88619,34.47051,2446,9,21,12,133.3
30565,ga,-83.4112,34.0869,2364,22,41,19,86.4
30566,ga,-83.89498,34.23575,4129,10,23,13,130
30567,ga,-83.67497,34.1836,2119,19,36,17,89.5
30568,ga,-83.41544,34.95506,1486,2,7,5,250
30571,ga,-83.68938,34.70872,3890,7,18,11,157.1
30572,ga,-84.07323,34.73543,2044,2,8,6,300
30573,ga,-83.41344,34.74168,181,11,24,13,118.2
30575,ga,-83.71594,34.20377,658,18,35,17,94.4
30576,ga,-83.44918,34.82767,2278,5,14,9,180
30577,ga,-83.32449,34.55423,12740,19,36,17,89.5
30581,ga,-83.41699,34.79644,36,8,19,11,137.5
30582,ga,-83.9031,34.951,4997,3,9,6,200
30601,ga,-83.34853,34.00085,8032,24,43,19,79.2
30602,ga,-83.37239,33.94321,23,25,44,19,76
30605,ga,-83.32329,33.90658,12347,26,44,18,69.2
30606,ga,-83.42878,33.93959,15164,26,45,19,73.1
30607,ga,-83.44595,34.0201,4646,25,44,19,76
30609,ga,-83.38201,33.94946,1,25,44,19,76
30619,ga,-83.24103,33.8575,922,25,45,20,80
30620,ga,-83.75733,33.92907,5853,22,40,18,81.8
30621,ga,-83.48398,33.80441,3091,25,45,20,80
30622,ga,-83.51981,33.92203,6575,25,44,19,76
30623,ga,-83.53609,33.73017,117,25,45,20,80
30624,ga,-83.04683,34.18719,1748,22,40,18,81.8
30625,ga,-83.33776,33.51949,2297,32,53,21,65.6
30627,ga,-82.9607,33.9755,2089,26,45,19,73.1
30628,ga,-83.21262,34.02974,3408,25,43,18,72
30629,ga,-83.11708,34.07902,2914,25,44,19,76
30630,ga,-83.1529,33.91152,1260,24,43,19,79.2
30631,ga,-82.87594,33.56778,2206,28,49,21,75
30633,ga,-83.24708,34.17835,5031,23,42,19,82.6
30634,ga,-82.94937,34.20116,1357,19,36,17,89.5
30635,ga,-82.8044,34.10317,11420,22,39,17,77.3
30641,ga,-83.56977,33.77765,1284,25,44,19,76
30642,ga,-83.19344,33.5544,12505,31,53,22,71
30643,ga,-82.90882,34.36262,11445,21,39,18,85.7
30646,ga,-83.31138,34.07829,3584,22,40,18,81.8
30648,ga,-83.04895,33.88223,1976,26,46,20,76.9
30650,ga,-83.47199,33.58412,7598,29,50,21,72.4
30655,ga,-83.69795,33.7784,11023,23,41,18,78.3
30656,ga,-83.71986,33.86079,7556,22,40,18,81.8
30660,ga,-82.95042,33.78562,1010,29,50,21,72.4
30662,ga,-83.14788,34.26568,4851,21,39,18,85.7
30663,ga,-83.59868,33.61586,1902,26,46,20,76.9
30664,ga,-82.79959,33.55819,20,27,47,20,74.1
30665,ga,-83.05655,33.53986,59,28,47,19,67.9
30666,ga,-83.58399,33.96,4564,23,42,19,82.6
30667,ga,-83.15613,33.78068,892,26,46,20,76.9
30668,ga,-82.70051,33.90155,3228,30,51,21,70
30669,ga,-83.11496,33.674,2395,28,48,20,71.4
30673,ga,-82.71738,33.72259,5190,29,49,20,69
30677,ga,-83.38243,33.79136,9070,26,45,19,73.1
30678,ga,-83.07432,33.45201,1661,29,49,20,69
30680,ga,-83.69948,33.99626,17524,22,39,17,77.3
30683,ga,-83.2573,33.94465,3540,23,42,19,82.6
30701,ga,-84.95572,34.49656,16976,24,42,18,75
30705,ga,-84.74897,34.75017,15031,23,42,19,82.6
30707,ga,-85.36038,34.77635,8030,21,39,18,85.7
30708,ga,-84.66458,34.96179,245,16,32,16,100
30710,ga,-84.91747,34.9506,3328,23,42,19,82.6
30711,ga,-84.73537,34.92766,1868,20,38,18,90
30720,ga,-85.00291,34.7347,10359,25,45,20,80
30721,ga,-84.91409,34.79158,19488,26,47,21,80.8
30725,ga,-85.35302,34.92436,2148,18,35,17,94.4
30726,ga,-85.13958,34.97624,46,19,36,17,89.5
30728,ga,-85.22469,34.6787,10070,20,37,17,85
30730,ga,-85.42122,34.35941,1203,25,45,20,80
30731,ga,-85.47742,34.58643,2841,21,38,17,81
30733,ga,-85.04398,34.41612,1064,22,40,18,81.8
30734,ga,-84.71436,34.53312,3903,15,31,16,106.7
30735,ga,-84.88146,34.60555,2643,25,45,20,80
30736,ga,-85.13623,34.90444,18756,19,37,18,94.7
30738,ga,-85.47855,34.79668,3284,13,27,14,107.7
30739,ga,-85.21564,34.80452,2722,19,36,17,89.5
30740,ga,-85.07835,34.75561,4239,20,38,18,90
30741,ga,-85.28227,34.95238,13136,20,38,18,90
30742,ga,-85.24324,34.95058,2452,23,41,18,78.3
30746,ga,-85.02728,34.57709,666,25,44,19,76
30747,ga,-85.29877,34.49891,8310,24,42,18,75
30750,ga,-85.38822,34.94142,1696,15,30,15,100
30751,ga,-84.73752,34.98214,63,19,36,17,89.5
30752,ga,-85.52911,34.91033,5083,16,32,16,100
30753,ga,-85.28595,34.58317,3421,22,41,19,86.4
30755,ga,-85.04079,34.86686,4516,20,38,18,90
30756,ga,-84.97705,34.89765,44,21,40,19,90.5
30757,ga,-85.43513,34.94196,740,13,28,15,115.4
30802,ga,-82.31816,33.6017,4227,28,49,21,75
30803,ga,-82.55289,33.13781,770,33,55,22,66.7
30805,ga,-82.18512,33.27683,1809,30,51,21,70
30807,ga,-82.64822,33.45678,115,25,46,21,84
30808,ga,-82.39351,33.38343,2698,28,49,21,75
30809,ga,-82.16436,33.55541,19130,31,52,21,67.7
30810,ga,-82.58915,33.23619,1448,31,52,21,67.7
30812,ga,-82.02857,33.36723,1,34,56,22,64.7
30813,ga,-82.22088,33.4714,19333,26,47,21,80.8
30814,ga,-82.31149,33.43562,4714,26,47,21,80.8
30815,ga,-82.08935,33.28732,18243,31,53,22,71
30816,ga,-82.16094,33.15362,1834,33,55,22,66.7
30817,ga,-82.436,33.77382,7150,30,51,21,70
30818,ga,-82.32938,33.26518,397,32,53,21,65.6
30820,ga,-82.71109,33.22053,1151,31,52,21,67.7
30821,ga,-82.73519,33.4837,967,26,47,21,80.8
30822,ga,-81.85377,32.91288,445,42,66,24,57.1
30823,ga,-82.45543,33.2236,1285,31,53,22,71
30824,ga,-82.51859,33.5161,9735,27,47,20,74.1
30828,ga,-82.6553,33.37218,3014,28,48,20,71.4
30830,ga,-81.9733,33.08047,8250,35,58,23,65.7
30833,ga,-82.35927,33.18487,2458,32,54,22,68.8
30901,ga,-81.95685,33.43644,9136,37,59,22,59.5
30903,ga,-82.16269,33.49015,288,25,45,20,80
30904,ga,-82.0128,33.47741,11031,34,56,22,64.7
30905,ga,-82.14269,33.41473,10,27,48,21,77.8
30906,ga,-81.97257,33.34503,23354,33,55,22,66.7
30907,ga,-82.08522,33.52292,19958,27,47,20,74.1
30909,ga,-82.08337,33.47172,15655,27,47,20,74.1
30912,ga,-81.98809,33.47051,28,36,58,22,61.1
31001,ga,-83.34068,31.97551,2216,45,72,27,60
31002,ga,-82.58291,32.54862,1882,41,66,25,61
31003,ga,-83.21252,32.60628,135,40,65,25,62.5
31005,ga,-83.59734,32.54439,7609,41,66,25,61
31006,ga,-84.25477,32.58491,3164,34,57,23,67.6
31007,ga,-83.93316,32.18895,705,45,71,26,57.8
31008,ga,-83.78254,32.65605,9673,34,57,23,67.6
31009,ga,-83.00934,32.27688,1127,44,70,26,59.1
31011,ga,-83.06217,32.12694,571,44,69,25,56.8
31012,ga,-83.17562,32.39464,1022,43,68,25,58.1
31014,ga,-83.3447,32.41368,7085,41,67,26,63.4
31015,ga,-83.77531,31.9355,11331,50,77,27,54
31016,ga,-84.11466,32.84313,1227,36,59,23,63.9
31017,ga,-83.23191,32.61856,1488,39,64,25,64.1
31018,ga,-82.62064,32.97652,1059,34,57,23,67.6
31019,ga,-83.04997,32.42639,1452,45,70,25,55.6
31020,ga,-83.50476,32.69682,2008,38,62,24,63.2
31021,ga,-82.93911,32.49308,15409,47,72,25,53.2
31022,ga,-83.10985,32.50646,1043,44,69,25,56.8
31023,ga,-83.20046,32.184,8040,44,71,27,61.4
31024,ga,-83.37447,33.32054,18091,34,56,22,64.7
31025,ga,-83.74583,32.34003,1107,38,63,25,65.8
31027,ga,-82.81139,32.57711,6079,46,71,25,54.3
31028,ga,-83.68168,32.63494,2614,35,59,24,68.6
31029,ga,-83.92707,33.03733,9905,33,55,22,66.7
31030,ga,-83.89034,32.57028,9030,35,59,24,68.6
31031,ga,-83.32838,32.87127,4478,42,67,25,59.5
31032,ga,-83.5691,33.01269,7256,33,56,23,69.7
31033,ga,-83.44183,33.08092,1744,35,57,22,62.9
31035,ga,-82.70312,32.84608,986,34,57,23,67.6
31036,ga,-83.50381,32.27252,6880,43,69,26,60.5
31037,ga,-82.9272,32.11232,1703,44,70,26,59.1
31038,ga,-83.6404,33.14207,709,32,54,22,68.8
31039,ga,-84.38527,32.59554,44,33,57,24,72.7
31041,ga,-84.17651,32.3713,755,39,65,26,66.7
31042,ga,-83.1721,32.74662,1308,44,68,24,54.5
31044,ga,-83.39337,32.63887,2487,37,61,24,64.9
31045,ga,-82.78306,33.28256,77,31,53,22,71
31046,ga,-83.77853,33.05621,2030,36,59,23,63.9
31047,ga,-83.58299,32.47367,6299,40,65,25,62.5
31049,ga,-82.52368,32.68757,1396,42,66,24,57.1
31050,ga,-83.94245,32.73732,654,33,56,23,69.7
31051,ga,-83.88831,32.15569,107,49,76,27,55.1
31052,ga,-83.84471,32.77312,4977,36,59,23,63.9
31054,ga,-83.20282,32.88425,1087,44,68,24,54.5
31055,ga,-82.89113,31.98878,3511,43,68,25,58.1
31057,ga,-83.93536,32.43286,1282,37,62,25,67.6
31058,ga,-84.41615,32.49216,1458,30,52,22,73.3
31060,ga,-83.06083,31.97572,1854,42,68,26,61.9
31061,ga,-83.24658,33.07616,20545,39,62,23,59
31062,ga,-83.21737,33.0491,9,42,67,25,59.5
31063,ga,-83.96822,32.2898,3331,43,68,25,58.1
31064,ga,-83.69706,33.28907,6946,31,52,21,67.7
31065,ga,-83.16919,32.5533,910,42,67,25,59.5
31066,ga,-84.01,32.80332,939,34,57,23,67.6
31067,ga,-82.93667,32.86034,137,39,63,24,61.5
31068,ga,-84.1077,32.32623,2180,42,68,26,61.9
31069,ga,-83.74346,32.44106,10327,40,65,25,62.5
31070,ga,-83.78406,32.18966,677,44,70,26,59.1
31071,ga,-83.52947,32.12972,975,45,72,27,60
31072,ga,-83.56354,31.96608,1121,43,69,26,60.5
31075,ga,-82.95554,32.35098,1578,45,70,25,55.6
31076,ga,-84.10528,32.54555,2272,39,64,25,64.1
31077,ga,-83.18366,31.93795,1183,44,70,26,59.1
31078,ga,-84.06607,32.69942,2364,36,60,24,66.7
31079,ga,-83.46039,31.94084,2025,43,69,26,60.5
31081,ga,-84.27965,32.4146,305,38,63,25,65.8
31082,ga,-82.89683,32.99244,6323,29,49,20,69
31083,ga,-82.81026,32.03948,198,42,67,25,59.5
31084,ga,-83.60564,31.96298,77,44,70,26,59.1
31085,ga,-83.62894,33.4257,680,31,53,22,71
31087,ga,-83.00243,33.26372,11022,32,54,22,68.8
31088,ga,-83.6484,32.58286,20304,39,63,24,61.5
31089,ga,-82.86381,32.85291,2842,31,52,21,67.7
31090,ga,-83.06214,32.82654,1037,43,68,25,58.1
31091,ga,-83.70127,32.24086,1941,42,68,26,61.9
31092,ga,-83.78571,32.09068,3767,50,76,26,52
31093,ga,-83.65655,32.64764,11389,38,62,24,63.2
31094,ga,-82.79398,33.1118,995,28,48,20,71.4
31096,ga,-82.70517,32.72234,3633,40,64,24,60
31097,ga,-84.15821,32.89561,1018,36,59,23,63.9
31098,ga,-83.57387,32.6181,40,42,67,25,59.5
31201,ga,-83.61682,32.80945,4518,40,65,25,62.5
31204,ga,-83.67585,32.85009,14848,38,62,24,63.2
31206,ga,-83.67898,32.79141,12119,40,64,24,60
31207,ga,-83.64914,32.82844,5,38,61,23,60.5
31210,ga,-83.73573,32.90487,11506,36,59,23,63.9
31211,ga,-83.606,32.91048,6833,37,61,24,64.9
31213,ga,-83.63935,32.84008,1,42,67,25,59.5
31216,ga,-83.68352,32.72779,7708,38,63,25,65.8
31217,ga,-83.50638,32.84493,10043,38,62,24,63.2
31220,ga,-83.82198,32.8778,6193,35,59,24,68.6
31301,ga,-81.60851,31.75282,1465,56,82,26,46.4
31302,ga,-81.34079,32.12245,3848,42,68,26,61.9
31303,ga,-81.30949,32.49982,1660,46,71,25,54.3
31304,ga,-81.35232,31.50908,75,40,64,24,60
31305,ga,-81.38952,31.39775,4075,43,67,24,55.8
31307,ga,-81.39921,32.17361,613,45,71,26,57.8
31308,ga,-81.48043,32.17485,4069,48,74,26,54.2
31309,ga,-81.43444,31.88144,709,47,73,26,55.3
31312,ga,-81.39871,32.31025,10368,45,71,26,57.8
31313,ga,-81.61007,31.83797,15212,57,83,26,45.6
31314,ga,-81.6319,31.87008,2,57,83,26,45.6
31315,ga,-81.59018,31.89382,14,58,83,25,43.1
31316,ga,-81.72855,31.71719,5058,52,78,26,50
31318,ga,-81.37194,32.14203,177,43,69,26,60.5
31320,ga,-81.36612,31.76808,7759,44,69,25,56.8
31321,ga,-81.66564,32.18122,3950,50,75,25,50
31322,ga,-81.25392,32.1096,10386,40,66,26,65
31323,ga,-81.42975,31.69566,1711,49,74,25,51
31324,ga,-81.26744,31.85397,12114,39,64,25,64.1
31326,ga,-81.22975,32.29601,9095,42,68,26,61.9
31327,ga,-81.25457,31.46019,309,40,63,23,57.5
31328,ga,-80.86783,32.00719,4119,31,56,25,80.6
31329,ga,-81.34872,32.42314,4853,46,71,25,54.3
31331,ga,-81.43593,31.52661,7824,40,64,24,60
31401,ga,-81.0889,32.07465,9314,38,64,26,68.4
31404,ga,-81.04978,32.05401,12240,34,60,26,76.5
31405,ga,-81.17253,32.03948,15291,38,63,25,65.8
31406,ga,-81.08489,31.97793,13362,32,57,25,78.1
31407,ga,-81.19255,32.18569,6402,40,66,26,65
31408,ga,-81.18419,32.11546,3825,41,67,26,63.4
31409,ga,-81.15695,32.00936,1,33,58,25,75.8
31410,ga,-80.99296,32.02437,10400,30,55,25,83.3
31411,ga,-81.03571,31.94087,4799,32,57,25,78.1
31415,ga,-81.12593,32.07857,6059,41,68,27,65.9
31419,ga,-81.23582,31.99572,19505,36,62,26,72.2
31501,ga,-82.35066,31.22434,8915,51,78,27,52.9
31503,ga,-82.41346,31.1979,12037,49,77,28,57.1
31510,ga,-82.44055,31.54584,5507,43,69,26,60.5
31512,ga,-83.01451,31.54332,1227,45,71,26,57.8
31513,ga,-82.34742,31.77749,10126,43,69,26,60.5
31516,ga,-82.25521,31.30994,9174,53,80,27,50.9
31518,ga,-82.18279,31.51469,624,45,71,26,57.8
31519,ga,-82.87978,31.6816,2303,45,71,26,57.8
31520,ga,-81.49481,31.18074,10455,48,73,25,52.1
31522,ga,-81.35023,31.23005,10439,31,55,24,77.4
31523,ga,-81.6266,31.22053,8536,49,75,26,53.1
31524,ga,-81.47231,31.24044,2,48,73,25,52.1
31525,ga,-81.52385,31.31159,12080,50,75,25,50
31527,ga,-81.43366,31.06649,880,32,56,24,75
31532,ga,-82.75264,31.72256,548,43,69,26,60.5
31533,ga,-82.8286,31.54913,7815,48,74,26,54.2
31535,ga,-82.85609,31.45512,4958,46,73,27,58.7
31537,ga,-82.00976,30.8932,5552,57,83,26,45.6
31539,ga,-82.60815,31.82649,7296,43,68,25,58.1
31542,ga,-82.1207,31.14306,1604,50,76,26,52
31543,ga,-81.8313,31.32842,2954,44,71,27,61.4
31544,ga,-82.95284,31.83789,982,43,69,26,60.5
31545,ga,-81.94185,31.6523,8245,52,77,25,48.1
31546,ga,-81.80865,31.51199,4182,51,76,25,49
31547,ga,-81.56071,30.79057,2,32,58,26,81.3
31548,ga,-81.698,30.79365,10046,40,67,27,67.5
31549,ga,-82.71099,31.94233,1603,43,68,25,58.1
31550,ga,-82.59148,31.14712,670,45,73,28,62.2
31551,ga,-82.27591,31.4935,716,45,71,26,57.8
31552,ga,-82.61266,31.29475,925,45,72,27,60
31553,ga,-81.97248,31.17665,3336,42,68,26,61.9
31554,ga,-82.62389,31.48874,3406,44,71,27,61.4
31555,ga,-82.0714,31.70139,1818,48,73,25,52.1
31556,ga,-82.11173,31.41394,65,48,74,26,54.2
31557,ga,-82.08886,31.37086,2323,48,73,25,52.1
31558,ga,-81.5009,30.82243,10648,31,57,26,83.9
31560,ga,-82.02598,31.49948,1697,46,71,25,54.3
31561,ga,-81.32584,31.1997,797,34,57,23,67.6
31562,ga,-82.10584,30.47561,1959,50,77,27,54
31563,ga,-82.18268,31.74548,1438,44,69,25,56.8
31565,ga,-81.63698,31.06237,4538,43,70,27,62.8
31566,ga,-81.80772,31.19038,4237,45,72,27,60
31567,ga,-82.7078,31.62919,555,44,71,27,61.4
31568,ga,-81.8114,31.00827,1879,45,71,26,57.8
31569,ga,-81.70485,30.90737,4153,40,67,27,67.5
31601,ga,-83.34207,30.75159,15542,46,76,30,65.2
31602,ga,-83.34392,30.8692,12313,46,75,29,63
31605,ga,-83.23018,30.93603,8958,44,73,29,65.9
31606,ga,-83.18914,30.79888,1949,46,76,30,65.2
31620,ga,-83.43765,31.11842,5999,47,75,28,59.6
31622,ga,-83.20567,31.37966,1303,42,70,28,66.7
31623,ga,-82.644,31.07443,78,44,71,27,61.4
31624,ga,-82.72144,31.29847,744,44,71,27,61.4
31625,ga,-83.52846,30.99312,832,45,74,29,64.4
31626,ga,-83.8011,30.77554,2351,43,74,31,72.1
31627,ga,-83.39207,31.04117,165,45,74,29,64.4
31629,ga,-83.68728,30.82256,755,44,74,30,68.2
31630,ga,-82.87933,30.9238,344,45,72,27,60
31631,ga,-82.59866,30.71167,653,53,82,29,54.7
31632,ga,-83.35997,30.98792,6271,45,74,29,64.4
31634,ga,-82.7674,31.04006,3397,44,71,27,61.4
31635,ga,-83.05414,31.10396,3525,43,71,28,65.1
31636,ga,-83.11255,30.73314,5420,46,76,30,65.2
31637,ga,-83.44112,31.29233,1899,43,71,28,65.1
31638,ga,-83.51954,30.91133,691,45,74,29,64.4
31639,ga,-83.1914,31.21657,5845,42,70,28,66.7
31641,ga,-83.09623,30.9324,1321,45,74,29,64.4
31642,ga,-82.89012,31.2771,2442,42,70,28,66.7
31643,ga,-83.55976,30.7692,5528,45,75,30,66.7
31645,ga,-83.21709,31.06184,2313,42,70,28,66.7
31647,ga,-83.43059,31.21057,2125,46,74,28,60.9
31648,ga,-83.01901,30.70651,476,47,76,29,61.7
31649,ga,-83.00268,30.96496,699,44,72,28,63.6
31650,ga,-83.02576,31.39583,1818,43,71,28,65.1
31698,ga,-83.28957,30.84894,1,46,76,30,65.2
31699,ga,-83.20522,30.9749,1,42,70,28,66.7
31701,ga,-84.15828,31.55278,10253,51,79,28,54.9
31705,ga,-84.04437,31.50973,12855,49,77,28,57.1
31707,ga,-84.20751,31.58831,9065,50,78,28,56
31709,ga,-84.13412,32.06395,6772,38,64,26,68.4
31711,ga,-84.12938,32.19142,749,40,65,25,62.5
31712,ga,-83.70927,31.83572,904,40,66,26,65
31714,ga,-83.68521,31.71543,3822,37,63,26,70.3
31716,ga,-84.11836,31.36468,1814,49,77,28,57.1
31719,ga,-84.29747,32.08332,4756,36,61,25,69.4
31720,ga,-83.72305,30.8799,311,42,71,29,69
31721,ga,-84.30865,31.5105,8648,49,77,28,57.1
31722,ga,-83.62251,31.06729,294,45,73,28,62.2
31730,ga,-84.28679,31.20676,5033,47,75,28,59.6
31733,ga,-83.48962,31.59179,1167,40,67,27,67.5
31735,ga,-83.9645,31.96913,1221,51,78,27,52.9
31738,ga,-83.87306,31.00957,1381,38,67,29,76.3
31743,ga,-84.00626,31.90928,483,46,73,27,58.7
31744,ga,-83.90417,31.3383,2231,41,68,27,65.9
31747,ga,-83.58762,31.17597,217,47,75,28,59.6
31749,ga,-83.32723,31.413,1276,42,69,27,64.3
31750,ga,-83.21609,31.73355,11083,45,71,26,57.8
31756,ga,-83.96248,31.18045,708,40,68,28,70
31757,ga,-83.89937,30.87255,5515,43,72,29,67.4
31763,ga,-84.14214,31.74223,10887,48,75,27,56.3
31764,ga,-84.08295,31.97812,1043,44,71,27,61.4
31765,ga,-84.03128,31.09399,1595,41,70,29,70.7
31768,ga,-83.84048,31.19178,11895,39,66,27,69.2
31771,ga,-83.64656,31.24273,2716,44,71,27,61.4
31772,ga,-83.95683,31.72507,490,46,73,27,58.7
31773,ga,-84.04653,30.9762,2044,43,72,29,67.4
31774,ga,-83.27384,31.5588,3870,44,71,27,61.4
31775,ga,-83.59736,31.32999,1412,42,70,28,66.7
31778,ga,-83.70906,30.97493,1698,41,69,28,68.3
31779,ga,-84.19314,31.10135,4428,41,69,28,68.3
31780,ga,-84.39094,32.03104,1424,34,57,23,67.6
31781,ga,-83.79233,31.55545,1053,38,65,27,71.1
31783,ga,-83.4712,31.76221,1077,42,69,27,64.3
31784,ga,-84.04229,31.25813,540,41,69,28,68.3
31787,ga,-84.24414,31.89586,1063,42,69,27,64.3
31788,ga,-83.67991,31.10952,4746,41,68,27,65.9
31789,ga,-83.73613,31.47991,848,40,66,26,65
31790,ga,-83.56902,31.65163,1313,39,65,26,66.7
31791,ga,-83.87741,31.53964,6406,40,67,27,67.5
31792,ga,-84.04502,30.76849,12373,42,72,30,71.4
31793,ga,-83.58728,31.46191,4201,40,66,26,65
31794,ga,-83.44933,31.44108,12077,40,66,26,65
31795,ga,-83.67902,31.47303,1161,40,67,27,67.5
31796,ga,-83.87304,31.77855,999,46,73,27,58.7
31798,ga,-83.05667,31.62141,923,44,70,26,59.1
31801,ga,-84.59271,32.5195,2001,32,55,23,71.9
31803,ga,-84.51957,32.30393,3606,33,56,23,69.7
31804,ga,-84.88516,32.66247,2865,28,49,21,75
31805,ga,-84.74501,32.26849,1831,35,59,24,68.6
31806,ga,-84.30892,32.26554,3012,35,60,25,71.4
31807,ga,-84.80297,32.63867,1171,28,50,22,78.6
31808,ga,-85.00794,32.63244,3879,30,52,22,73.3
31810,ga,-84.5408,32.56853,216,31,54,23,74.2
31811,ga,-84.93439,32.74409,3570,27,48,21,77.8
31812,ga,-84.41194,32.64405,708,31,53,22,71
31814,ga,-84.85514,32.19693,148,37,62,25,67.6
31815,ga,-84.83843,32.03553,2014,37,61,24,64.9
31816,ga,-84.60481,32.87858,4048,26,47,21,80.8
31820,ga,-84.826,32.57942,4654,33,56,23,69.7
31821,ga,-84.97112,32.11761,429,36,60,24,66.7
31822,ga,-84.91185,32.86683,4035,24,43,19,79.2
31823,ga,-84.82334,32.80503,416,22,41,19,86.4
31824,ga,-84.52714,32.05418,1123,35,60,25,71.4
31825,ga,-84.66914,32.11818,1778,35,59,24,68.6
31826,ga,-84.70355,32.79414,1655,25,45,20,80
31827,ga,-84.5269,32.68709,1884,29,51,22,75.9
31829,ga,-84.73522,32.56842,791,35,58,23,65.7
31830,ga,-84.73185,32.89652,1803,24,43,19,79.2
31831,ga,-84.70503,32.68426,3292,27,48,21,77.8
31832,ga,-84.61623,31.96121,177,35,60,25,71.4
31833,ga,-85.08916,32.85039,4466,29,50,21,72.4
31836,ga,-84.53997,32.79702,1060,31,53,22,71
31901,ga,-84.97992,32.4649,3799,38,62,24,63.2
31903,ga,-84.95336,32.41468,6918,38,63,25,65.8
31904,ga,-85.00075,32.55411,13972,35,58,23,65.7
31905,al,-84.90726,32.37979,6,40,64,25,63.4
31906,ga,-84.94954,32.46796,7674,37,61,24,64.9
31907,ga,-84.90135,32.48255,20290,35,59,24,68.6
31909,ga,-84.92156,32.54485,12029,34,56,22,64.7
32003,fl,-81.71256,30.09813,11760,40,68,28,70
32008,fl,-82.91312,29.91652,6351,56,87,31,55.4
32009,fl,-81.97326,30.4197,1849,48,76,28,58.3
32011,fl,-81.84035,30.57102,8414,45,73,28,62.2
32024,fl,-82.72642,30.08056,9960,51,81,30,58.8
32025,fl,-82.57604,30.11076,8724,47,78,31,66
32033,fl,-81.44177,29.78907,2596,46,74,28,60.9
32034,fl,-81.48865,30.60572,21641,28,53,25,89.3
32038,fl,-82.70056,29.938,7085,58,89,31,53.4
32040,fl,-82.23884,30.24356,3731,44,72,28,63.6
32043,fl,-81.72974,29.93483,13704,47,75,28,59.6
32044,fl,-82.17458,29.86112,1372,45,74,29,64.4
32046,fl,-81.91855,30.70326,5930,47,73,26,55.3
32052,fl,-82.93598,30.47855,6794,47,78,31,66
32053,fl,-83.13095,30.56821,4365,47,77,30,63.8
32054,fl,-82.39276,30.02744,6060,50,80,30,60
32055,fl,-82.62541,30.2702,9585,46,76,30,65.2
32058,fl,-82.10834,30.08343,2305,41,68,27,65.9
32059,fl,-83.27112,30.38387,3657,50,82,32,64
32060,fl,-83.04974,30.27523,15703,54,85,31,57.4
32061,fl,-82.51032,30.09756,332,48,78,30,62.5
32062,fl,-82.98044,30.13339,1939,53,85,32,60.4
32063,fl,-82.11204,30.24671,5864,42,69,27,64.3
32064,fl,-82.98444,30.29566,3515,60,91,31,51.7
32065,fl,-81.80125,30.14924,14717,44,72,28,63.6
32066,fl,-83.23398,30.03677,5101,51,82,31,60.8
32068,fl,-81.88324,30.07891,24947,47,74,27,57.4
32071,fl,-82.94445,30.04169,4296,54,86,32,59.3
32072,fl,-82.42281,30.18842,292,45,74,29,64.4
32073,fl,-81.73932,30.17026,14723,44,72,28,63.6
32079,fl,-81.80595,29.97841,82,53,82,29,54.7
32080,fl,-81.26979,29.81922,11935,34,60,26,76.5
32081,fl,-81.41279,30.1204,9151,37,64,27,73
32082,fl,-81.36268,30.12225,12856,26,50,24,92.3
32083,fl,-82.23422,30.09211,648,46,74,28,60.9
32084,fl,-81.36682,29.91756,17754,37,64,27,73
32086,fl,-81.30311,29.75675,15253,38,65,27,71.1
32087,fl,-82.28512,30.39033,2601,46,75,29,63
32091,fl,-82.12548,29.93121,9160,43,71,28,65.1
32092,fl,-81.51369,29.93413,18852,44,72,28,63.6
32094,fl,-82.82963,30.19602,1922,52,82,30,57.7
32095,fl,-81.41079,30.01102,8603,37,64,27,73
32096,fl,-82.69984,30.43955,2959,52,82,30,57.7
32097,fl,-81.62967,30.66379,10306,34,60,26,76.5
32102,fl,-81.56166,29.1468,2580,47,76,29,61.7
32110,fl,-81.3393,29.42165,8797,46,75,29,63
32112,fl,-81.55794,29.42721,7183,49,79,30,61.2
32113,fl,-82.08146,29.39952,5741,57,87,30,52.6
32114,fl,-81.05147,29.19398,10979,29,54,25,86.2
32117,fl,-81.06576,29.23534,10238,30,56,26,86.7
32118,fl,-81.0017,29.20952,6211,26,51,25,96.2
32119,fl,-81.0269,29.16002,8105,32,58,26,81.3
32124,fl,-81.14927,29.16541,3427,36,64,28,77.8
32127,fl,-80.9735,29.10671,12948,32,58,26,81.3
32128,fl,-81.07405,29.09797,8816,34,61,27,79.4
32129,fl,-81.02401,29.13711,7698,33,60,27,81.8
32130,fl,-81.34466,29.15571,4725,46,75,29,63
32131,fl,-81.57015,29.68139,3532,46,75,29,63
32132,fl,-80.92561,28.97678,4096,32,60,28,87.5
32133,fl,-81.90926,29.02018,98,62,92,30,48.4
32134,fl,-81.83702,29.38283,14334,63,91,28,44.4
32136,fl,-81.14015,29.45585,5976,29,55,26,89.7
32137,fl,-81.22153,29.58084,29699,38,65,27,71.1
32139,fl,-81.61591,29.3762,5398,47,76,29,61.7
32140,fl,-81.86792,29.75926,3931,58,87,29,50
32141,fl,-80.90102,28.92304,9645,34,62,28,82.4
32145,fl,-81.42207,29.67788,7616,45,74,29,64.4
32147,fl,-81.78624,29.60288,466,54,83,29,53.7
32148,fl,-81.8841,29.60796,31713,63,92,29,46
32157,fl,-81.57881,29.46812,444,52,82,30,57.7
32159,fl,-81.90291,28.92581,17568,61,91,30,49.2
32162,fl,-81.99283,28.91695,35183,64,94,30,46.9
32164,fl,-81.21788,29.4841,30448,41,69,28,68.3
32168,fl,-81.02741,28.97365,22124,35,62,27,77.1
32169,fl,-80.87092,28.97773,6852,30,57,27,90
32174,fl,-81.16355,29.28542,25625,35,62,27,77.1
32176,fl,-81.06069,29.33147,8210,30,57,27,90
32177,fl,-81.71137,29.69118,18500,49,78,29,59.2
32179,fl,-81.88794,29.08858,13654,61,90,29,47.5
32180,fl,-81.44498,29.22331,3552,49,78,29,59.2
32181,fl,-81.60014,29.50399,2835,52,82,30,57.7
32187,fl,-81.55414,29.57763,1310,47,76,29,61.7
32189,fl,-81.6512,29.5556,8443,53,82,29,54.7
32190,fl,-81.4855,29.34158,1062,50,79,29,58
32193,fl,-81.65291,29.49055,1069,52,82,30,57.7
32195,fl,-81.90182,28.98585,2182,61,90,29,47.5
32202,fl,-81.64798,30.32505,1797,39,67,28,71.8
32204,fl,-81.68075,30.31653,4062,40,68,28,70
32205,fl,-81.722,30.30286,12492,41,69,28,68.3
32206,fl,-81.63845,30.35051,9849,40,67,27,67.5
32207,fl,-81.63996,30.28999,15073,42,71,29,69
32208,fl,-81.68254,30.39343,15427,41,68,27,65.9
32209,fl,-81.69557,30.36108,17680,41,69,28,68.3
32210,fl,-81.74463,30.26559,22620,44,72,28,63.6
32211,fl,-81.58402,30.33268,11453,45,73,28,62.2
32212,fl,-81.67891,30.21908,5,41,69,28,68.3
32216,fl,-81.58312,30.27872,14106,47,75,28,59.6
32217,fl,-81.62722,30.23918,7087,43,71,28,65.1
32218,fl,-81.66924,30.48664,25451,40,67,27,67.5
32219,fl,-81.79384,30.43043,7864,43,71,28,65.1
32220,fl,-81.86659,30.35046,6240,46,75,29,63
32221,fl,-81.85423,30.25633,11008,47,76,29,61.7
32222,fl,-81.82882,30.21681,6149,45,74,29,64.4
32223,fl,-81.64819,30.15488,10852,41,69,28,68.3
32224,fl,-81.46798,30.27027,13569,36,62,26,72.2
32225,fl,-81.506,30.35751,20718,39,65,26,66.7
32226,fl,-81.50625,30.46459,9584,36,62,26,72.2
32227,fl,-81.40445,30.39041,5,30,55,25,83.3
32233,fl,-81.41929,30.35826,9032,26,50,24,92.3
32234,fl,-81.98372,30.2146,4388,49,77,28,57.1
32244,fl,-81.75349,30.21793,20591,44,72,28,63.6
32246,fl,-81.51798,30.294,18870,43,70,27,62.8
32250,fl,-81.40723,30.27827,13830,24,47,23,95.8
32254,fl,-81.7358,30.34156,8163,42,70,28,66.7
32256,fl,-81.50039,30.18784,18283,45,73,28,62.2
32257,fl,-81.61232,30.19516,14014,43,71,28,65.1
32258,fl,-81.54845,30.13755,14262,42,70,28,66.7
32259,fl,-81.58724,30.07586,22638,43,71,28,65.1
32266,fl,-81.41001,30.31644,2996,25,48,23,92
32277,fl,-81.5946,30.37278,9196,41,69,28,68.3
32301,fl,-84.25824,30.42565,9887,45,78,33,73.3
32303,fl,-84.34365,30.51432,19192,45,77,32,71.1
32304,fl,-84.35161,30.45363,8921,47,79,32,68.1
32305,fl,-84.28706,30.33397,9790,51,85,34,66.7
32308,fl,-84.22461,30.47713,9378,44,76,32,72.7
32309,fl,-84.09813,30.56621,13643,42,74,32,76.2
32310,fl,-84.51185,30.39472,7337,46,79,33,71.7
32311,fl,-84.16257,30.40033,8699,46,78,32,69.6
32312,fl,-84.22895,30.60547,14337,43,75,32,74.4
32317,fl,-84.11283,30.46504,6531,42,74,32,76.2
32320,fl,-85.08876,29.72653,3127,41,74,33,80.5
32321,fl,-84.98131,30.26047,4013,40,72,32,80
32322,fl,-84.62741,29.88111,6019,55,87,32,58.2
32323,fl,-84.61292,29.89328,612,61,89,28,45.9
32324,fl,-84.79155,30.65245,3040,42,73,31,73.8
32327,fl,-84.3037,30.18259,18776,62,94,32,51.6
32328,fl,-84.90049,29.76643,5990,49,81,32,65.3
32330,fl,-84.75053,30.57993,421,39,69,30,76.9
32331,fl,-83.6403,30.43974,4631,46,79,33,71.7
32332,fl,-84.66869,30.61004,861,37,67,30,81.1
32333,fl,-84.41263,30.60642,7221,43,74,31,72.1
32334,fl,-84.74534,30.25719,1681,42,75,33,78.6
32336,fl,-83.85913,30.25358,2172,49,81,32,65.3
32340,fl,-83.43507,30.46196,7434,48,80,32,66.7
32343,fl,-84.47692,30.48493,2113,44,76,32,72.7
32344,fl,-83.9096,30.4388,10290,41,72,31,75.6
32346,fl,-84.38709,29.9894,3944,69,99,30,43.5
32347,fl,-83.616,30.16685,5279,57,90,33,57.9
32348,fl,-83.59879,29.96574,8378,59,90,31,52.5
32350,fl,-83.32293,30.58696,1266,47,78,31,66
32351,fl,-84.6818,30.52229,9929,41,71,30,73.2
32352,fl,-84.58662,30.65119,3801,39,70,31,79.5
32355,fl,-84.20719,30.17166,617,77,106,29,37.7
32356,fl,-83.43125,29.85171,237,52,84,32,61.5
32358,fl,-84.55998,30.11313,3521,53,85,32,60.4
32359,fl,-83.39529,29.67892,4013,53,86,33,62.3
32361,fl,-83.98858,30.35771,201,52,86,34,65.4
32399,fl,-84.27078,30.43307,29,46,78,32,69.6
32401,fl,-85.6608,30.1598,12259,32,63,31,96.9
32403,fl,-85.55611,30.05021,11,30,60,30,100
32404,fl,-85.50607,30.20104,19726,27,56,29,107.4
32405,fl,-85.6679,30.20041,12637,32,63,31,96.9
32407,fl,-85.79281,30.19973,10299,40,71,31,77.5
32408,fl,-85.72452,30.13414,17745,40,72,32,80
32409,fl,-85.65982,30.34839,6276,28,57,29,103.6
32410,fl,-85.41819,29.99233,2001,29,59,30,103.4
32413,fl,-85.91063,30.3105,24954,37,67,30,81.1
32420,fl,-85.38485,30.63285,5582,36,65,29,80.6
32421,fl,-85.18209,30.52992,4083,41,72,31,75.6
32423,fl,-85.05857,30.94594,1386,46,76,30,65.2
32424,fl,-85.08924,30.37152,4484,44,76,32,72.7
32425,fl,-85.72084,30.85517,9154,36,65,29,80.6
32426,fl,-85.36945,30.94708,1068,40,69,29,72.5
32427,fl,-85.80143,30.71234,1346,37,66,29,78.4
32428,fl,-85.57853,30.61435,36054,35,65,30,85.7
32430,fl,-85.2341,30.41838,1476,40,71,31,77.5
32431,fl,-85.41357,30.78695,3624,39,69,30,76.9
32432,fl,-85.07757,30.71487,55,44,74,30,68.2
32433,fl,-86.20231,30.8494,16622,37,67,30,81.1
32435,fl,-86.12572,30.66388,5101,37,67,30,81.1
32437,fl,-85.90551,30.43365,495,32,62,30,93.8
32438,fl,-85.42899,30.50527,5556,32,63,31,96.9
32439,fl,-86.12228,30.48563,10595,27,55,28,103.7
32440,fl,-85.52475,30.92006,3752,38,67,29,76.3
32442,fl,-85.01146,30.68788,2945,45,75,30,66.7
32443,fl,-85.11532,30.86674,2617,44,73,29,65.9
32444,fl,-85.6521,30.23936,8642,28,58,30,107.1
32445,fl,-85.19415,30.96924,996,43,72,29,67.4
32446,fl,-85.22905,30.84506,6742,42,72,30,71.4
32447,fl,-85.25157,30.75995,3,42,72,30,71.4
32448,fl,-85.22109,30.66925,9150,41,71,30,73.2
32449,fl,-85.24125,30.28572,560,31,62,31,100
32455,fl,-85.96498,30.64251,4926,35,65,30,85.7
32456,fl,-85.31955,29.79224,10942,32,64,32,100
32459,fl,-86.18816,30.36353,24070,28,57,29,103.6
32460,fl,-84.94779,30.7688,2741,47,78,31,66
32461,fl,-86.0276,30.2897,442,35,66,31,88.6
32462,fl,-85.83112,30.55565,3987,34,64,30,88.2
32463,fl,-85.59028,30.63141,74,35,65,30,85.7
32464,fl,-85.95424,30.89905,3761,34,61,27,79.4
32465,fl,-85.17803,30.00213,7209,30,60,30,100
32466,fl,-85.51913,30.39079,4177,26,55,29,111.5
32501,fl,-87.22238,30.42841,5880,35,65,30,85.7
32502,fl,-87.2229,30.40946,3270,35,64,29,82.9
32503,fl,-87.21401,30.46021,13687,38,68,30,78.9
32504,fl,-87.19102,30.48459,9482,39,69,30,76.9
32505,fl,-87.26079,30.45479,13263,39,69,30,76.9
32506,fl,-87.36803,30.39184,15234,36,66,30,83.3
32507,fl,-87.38438,30.33556,17408,34,65,31,91.2
32508,fl,-87.30284,30.35479,20,35,65,30,85.7
32509,fl,-87.34105,30.4709,3,39,68,29,74.4
32514,fl,-87.22198,30.53185,14341,41,71,30,73.2
32526,fl,-87.36506,30.49643,18302,39,69,30,76.9
32530,fl,-87.03036,30.59824,34,29,58,29,100
32531,fl,-86.69101,30.87687,4636,37,66,29,78.4
32533,fl,-87.32671,30.61054,15019,39,68,29,74.4
32534,fl,-87.28301,30.53289,7193,41,71,30,73.2
32535,fl,-87.34899,30.96479,3460,37,64,27,73
32536,fl,-86.59176,30.76427,11686,37,66,29,78.4
32539,fl,-86.46308,30.77475,15381,38,67,29,76.3
32541,fl,-86.46919,30.39492,10050,20,45,25,125
32542,fl,-86.57436,30.55295,14,27,54,27,100
32544,fl,-86.69929,30.42794,13,27,56,29,107.4
32547,fl,-86.66718,30.46868,12671,25,53,28,112
32548,fl,-86.6528,30.40252,9064,23,51,28,121.7
32550,fl,-86.34741,30.38498,14111,21,48,27,128.6
32561,fl,-87.11242,30.34868,4419,35,65,30,85.7
32563,fl,-87.02738,30.39622,13872,33,63,30,90.9
32564,fl,-86.78242,30.72608,2669,34,62,28,82.4
32565,fl,-87.13922,30.89329,5313,36,63,27,75
32566,fl,-86.88929,30.43722,20934,31,61,30,96.8
32567,fl,-86.43984,30.92505,3737,37,65,28,75.7
32568,fl,-87.45381,30.88325,2746,36,63,27,75
32569,fl,-86.73511,30.40854,5348,27,56,29,107.4
32570,fl,-86.97175,30.80755,17367,32,60,28,87.5
32571,fl,-87.19822,30.67979,17675,35,65,30,85.7
32577,fl,-87.36794,30.72985,3204,33,61,28,84.8
32578,fl,-86.45225,30.51025,14763,21,46,25,119
32579,fl,-86.575,30.44932,4404,21,47,26,123.8
32580,fl,-86.52385,30.49583,2052,20,45,25,125
32583,fl,-86.97103,30.59366,19753,32,61,29,90.6
32601,fl,-82.32498,29.64885,5295,48,79,31,64.6
32603,fl,-82.35398,29.64998,867,47,78,31,66
32605,fl,-82.3736,29.67659,10100,48,79,31,64.6
32606,fl,-82.44432,29.68414,7406,52,83,31,59.6
32607,fl,-82.4207,29.64594,7160,53,84,31,58.5
32608,fl,-82.40661,29.59688,12624,54,85,31,57.4
32609,fl,-82.28315,29.7708,7211,47,77,30,63.8
32612,fl,-82.3534,29.64475,14,50,82,32,64
32615,fl,-82.49207,29.8165,8879,52,83,31,59.6
32616,fl,-82.49526,29.78849,606,54,85,31,57.4
32617,fl,-82.07626,29.30708,2304,56,87,31,55.4
32618,fl,-82.51504,29.54034,5656,54,85,31,57.4
32619,fl,-82.86262,29.7617,4831,54,86,32,59.3
32621,fl,-82.6233,29.42524,6454,50,83,33,66
32622,fl,-82.31506,29.90282,1118,49,79,30,61.2
32625,fl,-83.0014,29.20717,3171,80,106,26,32.5
32626,fl,-82.89025,29.43102,7992,54,87,33,61.1
32628,fl,-83.20315,29.63723,2261,37,70,33,89.2
32631,fl,-82.10135,29.72444,251,45,74,29,64.4
32639,fl,-82.71431,29.22285,830,58,90,32,55.2
32640,fl,-82.08935,29.57581,14570,63,92,29,46
32641,fl,-82.22679,29.64358,6142,50,80,30,60
32643,fl,-82.64689,29.82185,7803,59,90,31,52.5
32648,fl,-83.27195,29.4958,983,62,91,29,46.8
32653,fl,-82.39537,29.74329,6381,46,77,31,67.4
32656,fl,-81.95611,29.81493,11307,50,78,28,56
32658,fl,-82.39431,29.84749,210,49,80,31,63.3
32664,fl,-82.22118,29.44554,341,53,84,31,58.5
32666,fl,-81.99461,29.72555,4930,53,82,29,54.7
32667,fl,-82.30535,29.51215,3029,50,82,32,64
32668,fl,-82.49038,29.26626,5348,49,82,33,67.3
32669,fl,-82.60462,29.63268,7906,54,86,32,59.3
32680,fl,-83.07242,29.62301,11013,49,81,32,65.3
32681,fl,-82.20558,29.42339,51,53,84,31,58.5
32683,fl,-82.78071,29.29394,249,56,89,33,58.9
32686,fl,-82.26636,29.36442,3335,50,81,31,62
32692,fl,-83.12817,29.33628,782,70,99,29,41.4
32693,fl,-82.79227,29.62385,9413,52,85,33,63.5
32694,fl,-82.15556,29.79601,1628,45,74,29,64.4
32696,fl,-82.46057,29.39798,13557,50,83,33,66
32697,fl,-82.42903,29.93157,41,54,84,30,55.6
32701,fl,-81.36946,28.66533,9331,60,92,32,53.3
32702,fl,-81.62533,29.03925,2264,54,83,29,53.7
32703,fl,-81.55304,28.67071,21368,61,93,32,52.5
32707,fl,-81.31429,28.66268,13969,59,90,31,52.5
32708,fl,-81.27274,28.68737,17617,57,88,31,54.4
32709,fl,-80.97767,28.51103,2831,48,79,31,64.6
32712,fl,-81.50595,28.74008,18790,61,92,31,50.8
32713,fl,-81.32519,28.88533,10568,56,87,31,55.4
32714,fl,-81.41168,28.66244,12386,60,92,32,53.3
32720,fl,-81.36798,29.00962,16738,47,76,29,61.7
32724,fl,-81.22876,29.05646,24520,44,72,28,63.6
32725,fl,-81.25072,28.88342,20961,50,80,30,60
32726,fl,-81.67894,28.85503,9685,56,87,31,55.4
32730,fl,-81.34363,28.65322,1859,59,91,32,54.2
32732,fl,-81.10597,28.74549,3394,44,74,30,68.2
32735,fl,-81.73762,28.89155,1807,52,83,31,59.6
32736,fl,-81.49497,28.89667,6846,55,86,31,56.4
32738,fl,-81.18974,28.90899,20171,43,72,29,67.4
32744,fl,-81.21923,28.98627,3608,42,71,29,69
32746,fl,-81.35452,28.76395,17913,57,89,32,56.1
32750,fl,-81.35199,28.70611,10399,59,91,32,54.2
32751,fl,-81.36411,28.63121,8406,59,91,32,54.2
32754,fl,-80.92619,28.68913,9412,53,84,31,58.5
32757,fl,-81.63814,28.77354,13916,59,90,31,52.5
32759,fl,-80.90039,28.83579,5809,43,73,30,69.8
32763,fl,-81.29817,28.9406,9868,52,82,30,57.7
32764,fl,-81.08387,28.84704,3317,43,72,29,67.4
32765,fl,-81.20181,28.66741,22718,56,87,31,55.4
32766,fl,-81.08124,28.6476,6256,49,80,31,63.3
32767,fl,-81.50655,29.01999,2699,48,77,29,60.4
32771,fl,-81.32644,28.81348,22614,55,86,31,56.4
32773,fl,-81.24729,28.75204,11830,52,83,31,59.6
32776,fl,-81.49637,28.81769,5720,60,91,31,51.7
32778,fl,-81.73002,28.77667,12150,55,87,32,58.2
32779,fl,-81.41272,28.7167,11544,60,92,32,53.3
32780,fl,-80.79344,28.53645,17763,51,83,32,62.7
32784,fl,-81.72195,28.97597,7966,54,84,30,55.6
32789,fl,-81.35207,28.59962,10873,58,90,32,55.2
32792,fl,-81.29878,28.60999,14454,58,90,32,55.2
32796,fl,-80.8418,28.62694,9209,55,86,31,56.4
32798,fl,-81.5856,28.72724,1733,61,92,31,50.8
32801,fl,-81.37357,28.54181,2344,59,91,32,54.2
32803,fl,-81.34771,28.55492,8883,59,91,32,54.2
32804,fl,-81.39728,28.57727,8555,58,91,33,56.9
32805,fl,-81.40581,28.52943,7914,60,93,33,55
32806,fl,-81.36054,28.51222,10104,61,94,33,54.1
32807,fl,-81.30088,28.55268,9350,59,92,33,55.9
32808,fl,-81.4433,28.57909,13514,60,92,32,53.3
32809,fl,-81.38585,28.46206,7352,62,94,32,51.6
32810,fl,-81.42938,28.6214,9693,60,92,32,53.3
32811,fl,-81.44466,28.51693,6846,61,94,33,54.1
32812,fl,-81.32851,28.48504,9534,62,94,32,51.6
32814,fl,-81.32645,28.57016,2353,58,91,33,56.9
32817,fl,-81.24457,28.59034,9936,59,91,32,54.2
32818,fl,-81.48769,28.58649,11757,61,93,32,52.5
32819,fl,-81.47104,28.4559,10654,62,95,33,53.2
32820,fl,-81.12129,28.58498,4138,50,81,31,62
32821,fl,-81.47525,28.38712,4558,63,96,33,52.4
32822,fl,-81.29047,28.48981,10979,61,94,33,54.1
32824,fl,-81.34887,28.38839,19135,64,96,32,50
32825,fl,-81.22802,28.51537,18682,61,93,32,52.5
32826,fl,-81.18625,28.58827,6085,57,88,31,54.4
32827,fl,-81.29413,28.41572,4257,63,95,32,50.8
32828,fl,-81.16718,28.52825,19096,58,90,32,55.2
32829,fl,-81.24605,28.4802,6539,62,94,32,51.6
32830,fl,-81.5691,28.3822,529,62,95,33,53.2
32831,fl,-81.14822,28.47306,40,60,92,32,53.3
32832,fl,-81.18698,28.39796,14898,64,96,32,50
32833,fl,-81.08015,28.4948,6490,50,81,31,62
32835,fl,-81.48429,28.52104,10471,62,94,32,51.6
32836,fl,-81.52057,28.41535,8117,62,95,33,53.2
32837,fl,-81.42933,28.37847,15899,63,96,33,52.4
32839,fl,-81.40712,28.48837,6979,62,94,32,51.6
32901,fl,-80.6232,28.07906,9287,43,73,30,69.8
32903,fl,-80.58495,28.1084,5449,32,62,30,93.8
32904,fl,-80.67794,28.06728,13897,49,80,31,63.3
32905,fl,-80.59943,28.03127,9555,43,75,32,74.4
32907,fl,-80.68228,28.01562,21742,50,82,32,64
32908,fl,-80.69893,27.95633,20520,55,87,32,58.2
32909,fl,-80.64442,27.92038,27185,53,85,32,60.4
32920,fl,-80.61919,28.39498,2481,27,58,31,114.8
32922,fl,-80.74286,28.3725,5537,42,75,33,78.6
32925,fl,-80.62065,28.24264,7,21,50,29,138.1
32926,fl,-80.81723,28.39231,14541,44,77,33,75
32927,fl,-80.80758,28.46083,14125,43,76,33,76.7
32931,fl,-80.62533,28.32341,4263,26,57,31,119.2
32934,fl,-80.71118,28.13315,7022,42,74,32,76.2
32935,fl,-80.64846,28.14568,15516,39,70,31,79.5
32937,fl,-80.60201,28.17804,10701,25,55,30,120
32940,fl,-80.78753,28.21134,21883,36,68,32,88.9
32948,fl,-80.73351,27.88941,3641,57,92,35,61.4
32949,fl,-80.55054,27.92335,4598,45,79,34,75.6
32950,fl,-80.57878,27.976,4350,44,77,33,75
32951,fl,-80.51355,27.96092,6140,33,63,30,90.9
32952,fl,-80.66342,28.30019,9180,31,63,32,103.2
32953,fl,-80.70514,28.44826,9917,36,69,33,91.7
32955,fl,-80.72536,28.29665,16210,38,71,33,86.8
32958,fl,-80.49118,27.79375,16133,43,79,36,83.7
32960,fl,-80.40288,27.64115,8460,41,78,37,90.2
32962,fl,-80.38374,27.58697,11124,48,85,37,77.1
32963,fl,-80.39296,27.71768,8966,37,72,35,94.6
32966,fl,-80.69043,27.67795,8912,46,83,37,80.4
32967,fl,-80.46117,27.71216,14737,41,77,36,87.8
32968,fl,-80.46542,27.58698,7536,48,85,37,77.1
32970,fl,-80.4531,27.75134,409,39,76,37,94.9
32976,fl,-80.53948,27.8638,7094,44,78,34,77.3
33004,fl,-80.13821,26.05783,5368,44,83,39,88.6
33009,fl,-80.14681,25.98546,6974,38,78,40,105.3
33010,fl,-80.27873,25.83301,7698,49,92,43,87.8
33012,fl,-80.30249,25.86566,9842,53,96,43,81.1
33013,fl,-80.27029,25.86228,8004,50,92,42,84
33014,fl,-80.30308,25.90429,7519,55,97,42,76.4
33015,fl,-80.31764,25.94133,10142,54,97,43,79.6
33016,fl,-80.33251,25.89489,5614,56,98,42,75
33018,fl,-80.37946,25.92592,12021,57,99,42,73.7
33019,fl,-80.1198,26.0311,4800,38,76,38,100
33020,fl,-80.15232,26.01896,12096,41,82,41,100
33021,fl,-80.18758,26.02334,13757,46,88,42,91.3
33023,fl,-80.21532,25.9894,19876,46,88,42,91.3
33024,fl,-80.24526,26.02696,20102,48,89,41,85.4
33025,fl,-80.28143,25.98742,13680,49,92,43,87.8
33026,fl,-80.29643,26.02593,9894,50,92,42,84
33027,fl,-80.34364,25.98245,16215,57,99,42,73.7
33028,fl,-80.34489,26.01852,8277,58,99,41,70.7
33029,fl,-80.40891,25.99236,15302,64,105,41,64.1
33030,fl,-80.50996,25.4847,9116,72,112,40,55.6
33031,fl,-80.50114,25.52754,3522,68,108,40,58.8
33032,fl,-80.39186,25.53024,14242,48,92,44,91.7
33033,fl,-80.41361,25.48375,16196,55,100,45,81.8
33034,fl,-80.62449,25.28465,7084,78,116,38,48.7
33035,fl,-80.39902,25.41734,4730,63,106,43,68.3
33037,fl,-80.37901,25.20648,13178,75,110,35,46.7
33039,fl,-80.3997,25.5021,266,49,95,46,93.9
33054,fl,-80.25827,25.90692,8229,48,91,43,89.6
33055,fl,-80.27802,25.94823,11106,52,95,43,82.7
33056,fl,-80.24563,25.94921,9623,50,92,42,84
33060,fl,-80.12059,26.23478,10157,59,98,39,66.1
33062,fl,-80.08992,26.24586,6391,55,94,39,70.9
33063,fl,-80.20883,26.2501,14397,60,99,39,65
33064,fl,-80.11566,26.27849,17712,57,97,40,70.2
33065,fl,-80.26032,26.2729,11868,65,105,40,61.5
33066,fl,-80.17745,26.25349,3415,61,100,39,63.9
33067,fl,-80.22611,26.30774,8171,63,104,41,65.1
33068,fl,-80.21774,26.21572,13150,56,96,40,71.4
33069,fl,-80.15797,26.23566,6483,61,100,39,63.9
33071,fl,-80.26626,26.24392,9882,64,104,40,62.5
33073,fl,-80.18281,26.2985,7718,61,102,41,67.2
33076,fl,-80.2753,26.31681,14780,69,109,40,58
33101,fl,-80.19874,25.7793,1,30,70,40,133.3
33109,fl,-80.13764,25.75881,137,16,48,32,200
33122,fl,-80.29842,25.79739,346,50,92,42,84
33125,fl,-80.23751,25.78389,7920,36,78,42,116.7
33126,fl,-80.29892,25.77985,5024,45,86,41,91.1
33127,fl,-80.20551,25.8132,7275,30,71,41,136.7
33128,fl,-80.20399,25.77653,655,29,69,40,137.9
33129,fl,-80.19911,25.74915,1774,29,67,38,131
33130,fl,-80.203,25.76814,1945,29,67,38,131
33131,fl,-80.18445,25.76318,252,28,67,39,139.3
33132,fl,-80.17403,25.77782,553,29,69,40,137.9
33133,fl,-80.24051,25.72863,8259,36,76,40,111.1
33134,fl,-80.27111,25.75346,10350,41,82,41,100
33135,fl,-80.23509,25.76654,5054,34,74,40,117.6
33136,fl,-80.2046,25.78682,1686,30,70,40,133.3
33137,fl,-80.17798,25.81535,3007,29,69,40,137.9
33138,fl,-80.1784,25.85395,6929,27,66,39,144.4
33139,fl,-80.14611,25.78466,3090,14,44,30,214.3
33140,fl,-80.13453,25.81842,3211,11,38,27,245.5
33141,fl,-80.13999,25.85167,3913,17,49,32,188.2
33142,fl,-80.23852,25.81195,13257,36,78,42,116.7
33143,fl,-80.29779,25.70221,7978,47,87,40,85.1
33144,fl,-80.31235,25.76323,6162,49,89,40,81.6
33145,fl,-80.23442,25.75313,6932,34,74,40,117.6
33146,fl,-80.27281,25.72046,3885,43,83,40,93
33147,fl,-80.2382,25.85144,13013,40,82,42,105
33149,fl,-80.16085,25.71769,1558,19,52,33,173.7
33150,fl,-80.20713,25.85206,6378,32,73,41,128.1
33154,fl,-80.13208,25.88305,2238,22,58,36,163.6
33155,fl,-80.31087,25.73653,13332,49,89,40,81.6
33156,fl,-80.29728,25.66819,9216,50,90,40,80
33157,fl,-80.34261,25.60618,18498,51,91,40,78.4
33158,fl,-80.30939,25.6373,2231,50,90,40,80
33160,fl,-80.13188,25.93406,2274,31,69,38,122.6
33161,fl,-80.18254,25.89373,9410,31,72,41,132.3
33162,fl,-80.178,25.92825,9664,34,75,41,120.6
33165,fl,-80.35883,25.73432,14977,57,96,39,68.4
33166,fl,-80.31659,25.82864,7295,50,93,43,86
33167,fl,-80.23693,25.88527,4794,40,83,43,107.5
33168,fl,-80.20929,25.89299,6978,35,76,41,117.1
33169,fl,-80.21454,25.94302,8327,42,85,43,102.4
33170,fl,-80.4615,25.55766,5247,52,94,42,80.8
33172,fl,-80.36053,25.78629,2340,52,94,42,80.8
33173,fl,-80.3571,25.70214,8592,58,96,38,65.5
33174,fl,-80.36119,25.76153,4721,56,95,39,69.6
33175,fl,-80.40678,25.73405,14119,60,100,40,66.7
33176,fl,-80.35895,25.65863,13331,55,95,40,72.7
33177,fl,-80.40458,25.59678,15104,55,96,41,74.5
33178,fl,-80.41951,25.85801,13171,57,99,42,73.7
33179,fl,-80.17991,25.95802,6596,39,81,42,107.7
33180,fl,-80.14205,25.96064,2606,34,75,41,120.6
33181,fl,-80.15089,25.89872,2861,29,69,40,137.9
33182,fl,-80.43398,25.78367,4103,60,101,41,68.3
33183,fl,-80.40435,25.70027,6584,59,99,40,67.8
33184,fl,-80.40656,25.7595,4066,61,100,39,63.9
33185,fl,-80.44974,25.72731,8611,65,104,39,60
33186,fl,-80.41049,25.65547,18719,57,98,41,71.9
33187,fl,-80.50706,25.59602,9744,69,108,39,56.5
33189,fl,-80.33744,25.57302,7066,48,89,41,85.4
33190,fl,-80.3483,25.55924,3171,44,86,42,95.5
33193,fl,-80.4668,25.70175,8842,63,102,39,61.9
33194,fl,-80.6124,25.72008,11587,88,123,35,39.8
33196,fl,-80.48642,25.65142,13899,60,101,41,68.3
33301,fl,-80.12747,26.1212,4465,48,86,38,79.2
33304,fl,-80.1218,26.13871,5839,48,86,38,79.2
33305,fl,-80.12,26.15334,4375,54,93,39,72.2
33306,fl,-80.11389,26.16547,1428,55,94,39,70.9
33308,fl,-80.10614,26.18822,7705,57,95,38,66.7
33309,fl,-80.17324,26.18798,11032,57,96,39,68.4
33311,fl,-80.17323,26.14407,19204,52,92,40,76.9
33312,fl,-80.18167,26.08826,18060,49,89,40,81.6
33313,fl,-80.22634,26.15042,10709,51,91,40,78.4
33314,fl,-80.22311,26.06766,6302,48,89,41,85.4
33315,fl,-80.15299,26.08702,5530,48,88,40,83.3
33316,fl,-80.12119,26.09777,4078,46,84,38,82.6
33317,fl,-80.22641,26.11217,11288,49,89,40,81.6
33319,fl,-80.22568,26.18273,11478,53,94,41,77.4
33321,fl,-80.26963,26.21205,14787,60,100,40,66.7
33322,fl,-80.2745,26.1502,11715,53,94,41,77.4
33323,fl,-80.31651,26.15202,7164,59,99,40,67.8
33324,fl,-80.27414,26.11235,11410,51,92,41,80.4
33325,fl,-80.32151,26.10975,8605,58,98,40,69
33326,fl,-80.36813,26.11589,9830,64,104,40,62.5
33327,fl,-80.42469,26.11177,7408,68,109,41,60.3
33328,fl,-80.27229,26.06711,9940,49,91,42,85.7
33330,fl,-80.3218,26.05906,5409,54,95,41,75.9
33331,fl,-80.3681,26.05974,8003,61,102,41,67.2
33332,fl,-80.44527,26.0303,4183,70,111,41,58.6
33334,fl,-80.1344,26.18315,10254,57,95,38,66.7
33351,fl,-80.27459,26.1793,8867,54,95,41,75.9
33401,fl,-80.06779,26.71641,5143,46,85,39,84.8
33403,fl,-80.07542,26.80346,3617,53,90,37,69.8
33404,fl,-80.0637,26.7833,9980,51,89,38,74.5
33405,fl,-80.05823,26.66772,7017,43,83,40,93
33406,fl,-80.09069,26.66494,8037,48,88,40,83.3
33407,fl,-80.09065,26.75771,9511,49,88,39,79.6
33408,fl,-80.05501,26.84288,5287,52,90,38,73.1
33409,fl,-80.09644,26.71614,6008,50,89,39,78
33410,fl,-80.08802,26.8466,13032,55,92,37,67.3
33411,fl,-80.19977,26.71979,22662,59,99,40,67.8
33412,fl,-80.21258,26.80679,8562,65,103,38,58.5
33413,fl,-80.15536,26.66393,4755,51,92,41,80.4
33414,fl,-80.25009,26.64844,19361,61,101,40,65.6
33415,fl,-80.12731,26.66034,9228,50,90,40,80
33417,fl,-80.12486,26.71998,6020,51,90,39,76.5
33418,fl,-80.16697,26.86074,18988,58,95,37,63.8
33426,fl,-80.08297,26.534,7860,47,88,41,87.2
33428,fl,-80.21547,26.34934,11439,63,104,41,65.1
33430,fl,-80.55047,26.63945,5298,73,108,35,47.9
33431,fl,-80.10137,26.38073,5158,53,95,42,79.2
33432,fl,-80.08182,26.34507,4266,50,93,43,86
33433,fl,-80.15924,26.34716,11617,62,103,41,66.1
33434,fl,-80.1687,26.38158,4972,61,102,41,67.2
33435,fl,-80.06099,26.52535,8861,45,86,41,91.1
33436,fl,-80.10748,26.52434,11228,51,91,40,78.4
33437,fl,-80.149,26.51177,14410,52,93,41,78.8
33438,fl,-80.59591,26.9318,522,72,106,34,47.2
33440,fl,-81.0364,26.54356,17518,84,117,33,39.3
33441,fl,-80.09733,26.31116,8360,55,96,41,74.5
33442,fl,-80.14546,26.31036,10625,60,102,42,70
33444,fl,-80.07997,26.45819,6552,46,88,42,91.3
33445,fl,-80.10628,26.45469,8148,54,96,42,77.8
33446,fl,-80.1862,26.45026,12473,56,98,42,75
33449,fl,-80.23273,26.58998,4628,56,97,41,73.2
33455,fl,-80.16112,27.05669,12043,58,93,35,60.3
33458,fl,-80.13189,26.93749,19025,58,94,36,62.1
33460,fl,-80.05652,26.61986,9599,43,83,40,93
33461,fl,-80.09095,26.62015,9396,48,88,40,83.3
33462,fl,-80.07113,26.57947,8561,46,86,40,87
33463,fl,-80.13002,26.59527,16452,50,90,40,80
33467,fl,-80.17552,26.59462,18906,51,92,41,80.4
33469,fl,-80.10795,26.98315,5676,54,89,35,64.8
33470,fl,-80.32035,26.72705,13719,67,105,38,56.7
33471,fl,-81.19266,26.88395,4758,72,108,36,50
33472,fl,-80.1858,26.53836,8554,51,92,41,80.4
33473,fl,-80.19162,26.5038,5174,52,94,42,80.8
33476,fl,-80.62376,26.80472,2240,73,106,33,45.2
33477,fl,-80.07809,26.9146,5202,56,91,35,62.5
33478,fl,-80.24526,26.94041,6881,62,99,37,59.7
33480,fl,-80.03811,26.6864,2958,42,81,39,92.9
33483,fl,-80.06144,26.4624,4628,45,88,43,95.6
33484,fl,-80.13448,26.45427,6380,56,98,42,75
33486,fl,-80.11428,26.34708,6859,59,100,41,69.5
33487,fl,-80.0892,26.41,5315,51,93,42,82.4
33493,fl,-80.72921,26.53999,1698,75,110,35,46.7
33496,fl,-80.16009,26.40793,9056,59,100,41,69.5
33498,fl,-80.21993,26.38578,6027,60,101,41,68.3
33503,fl,-82.27651,27.76515,56,77,110,33,42.9
33510,fl,-82.30012,27.95592,9188,89,119,30,33.7
33511,fl,-82.29461,27.90984,16873,84,116,32,38.1
33513,fl,-82.16579,28.67023,6202,64,97,33,51.6
33514,fl,-81.99666,28.67743,1328,64,96,32,50
33521,fl,-82.06855,28.79841,437,63,94,31,49.2
33523,fl,-82.21853,28.42468,10905,73,105,32,43.8
33525,fl,-82.20146,28.33599,9683,75,108,33,44
33527,fl,-82.21255,27.97554,5403,82,113,31,37.8
33534,fl,-82.3794,27.82335,5533,70,105,35,50
33538,fl,-82.17525,28.84397,3864,62,94,32,51.6
33540,fl,-82.15055,28.21509,5762,70,103,33,47.1
33541,fl,-82.22069,28.23202,9570,71,105,34,47.9
33542,fl,-82.17708,28.23545,11420,70,104,34,48.6
33543,fl,-82.29637,28.20075,13886,77,110,33,42.9
33544,fl,-82.36603,28.24406,12719,73,107,34,46.6
33545,fl,-82.29027,28.26967,9347,72,106,34,47.2
33547,fl,-82.13395,27.77634,10053,76,109,33,43.4
33548,fl,-82.48214,28.13854,3445,69,104,35,50.7
33549,fl,-82.44646,28.14045,6927,71,106,35,49.3
33556,fl,-82.59418,28.14136,11424,66,102,36,54.5
33558,fl,-82.51561,28.15882,9643,69,104,35,50.7
33559,fl,-82.41117,28.15528,5742,75,108,33,44
33563,fl,-82.12458,28.01708,9246,67,102,35,52.2
33565,fl,-82.15235,28.0951,6826,73,107,34,46.6
33566,fl,-82.1164,27.99274,7082,70,104,34,48.6
33567,fl,-82.12161,27.92202,4616,69,104,35,50.7
33569,fl,-82.2872,27.84516,10589,81,113,32,39.5
33570,fl,-82.46034,27.68978,12839,68,103,35,51.5
33572,fl,-82.41138,27.76285,11413,70,105,35,50
33573,fl,-82.35937,27.72363,17289,76,110,34,44.7
33576,fl,-82.3291,28.32591,3130,77,109,32,41.6
33578,fl,-82.34994,27.86331,19238,75,109,34,45.3
33579,fl,-82.28743,27.79651,16863,78,111,33,42.3
33584,fl,-82.28789,28.00862,10666,92,121,29,31.5
33585,fl,-82.06727,28.74637,761,63,95,32,50.8
33592,fl,-82.28809,28.10065,4052,92,122,30,32.6
33594,fl,-82.24194,27.9407,12082,85,116,31,36.5
33596,fl,-82.23612,27.8881,10866,83,115,32,38.6
33597,fl,-82.08058,28.54894,8895,66,99,33,50
33598,fl,-82.28171,27.68652,9846,77,111,34,44.2
33602,fl,-82.45686,27.95364,3309,64,101,37,57.8
33603,fl,-82.46463,27.98544,7691,66,102,36,54.5
33604,fl,-82.45528,28.01697,14299,70,105,35,50
33605,fl,-82.42949,27.95104,8228,67,103,36,53.7
33606,fl,-82.4647,27.93126,5504,64,100,36,56.3
33607,fl,-82.51541,27.9675,7962,59,97,38,64.4
33609,fl,-82.51757,27.94416,6880,61,98,37,60.7
33610,fl,-82.38034,27.99717,13597,80,112,32,40
33611,fl,-82.50622,27.89058,11438,66,101,35,53
33612,fl,-82.44975,28.05074,11770,73,108,35,47.9
33613,fl,-82.45088,28.08361,5132,70,105,35,50
33614,fl,-82.50609,28.00595,11757,60,97,37,61.7
33615,fl,-82.58126,28.00489,12319,58,95,37,63.8
33616,fl,-82.5297,27.86609,4765,71,103,32,45.1
33617,fl,-82.39271,28.03833,10597,86,117,31,36
33618,fl,-82.49854,28.07336,9026,65,102,37,56.9
33619,fl,-82.37883,27.93658,12965,73,108,35,47.9
33620,fl,-82.41116,28.06153,6,84,115,31,36.9
33621,fl,-82.5004,27.8428,8,66,101,35,53
33624,fl,-82.52676,28.07899,13365,63,100,37,58.7
33625,fl,-82.56037,28.06803,9824,61,99,38,62.3
33626,fl,-82.61648,28.06629,10044,61,99,38,62.3
33629,fl,-82.50986,27.92171,9587,63,100,37,58.7
33634,fl,-82.54613,28.00886,6726,57,94,37,64.9
33635,fl,-82.61774,28.02728,3999,61,99,38,62.3
33637,fl,-82.36136,28.04732,4076,91,120,29,31.9
33647,fl,-82.35798,28.13414,19961,80,112,32,40
33701,fl,-82.63254,27.7708,4075,61,96,35,57.4
33702,fl,-82.6299,27.84645,8465,68,100,32,47.1
33703,fl,-82.61973,27.81636,9868,64,98,34,53.1
33704,fl,-82.6297,27.79582,6779,61,95,34,55.7
33705,fl,-82.6428,27.73431,9440,63,97,34,54
33706,fl,-82.75135,27.74123,6485,72,102,30,41.7
33707,fl,-82.72554,27.75551,8901,68,100,32,47.1
33708,fl,-82.79656,27.81108,6237,76,105,29,38.2
33709,fl,-82.7306,27.81712,8131,72,102,30,41.7
33710,fl,-82.7304,27.79005,13339,70,101,31,44.3
33711,fl,-82.68837,27.73872,6928,66,99,33,50
33712,fl,-82.66695,27.73418,8769,64,97,33,51.6
33713,fl,-82.67756,27.78879,13046,65,98,33,50.8
33714,fl,-82.67757,27.81704,5953,68,99,31,45.6
33715,fl,-82.7222,27.66232,2038,71,102,31,43.7
33716,fl,-82.65088,27.87665,1115,72,102,30,41.7
33744,fl,-82.77444,27.80847,2,75,104,29,38.7
33755,fl,-82.78125,27.98011,9050,79,107,28,35.4
33756,fl,-82.79257,27.94482,10242,79,108,29,36.7
33759,fl,-82.70188,27.97501,4234,75,106,31,41.3
33760,fl,-82.71446,27.90776,3715,72,104,32,44.4
33761,fl,-82.72393,28.03097,4809,76,107,31,40.8
33762,fl,-82.68016,27.89816,2379,74,104,30,40.5
33763,fl,-82.74403,28.00335,4502,76,106,30,39.5
33764,fl,-82.73878,27.93456,6604,74,106,32,43.2
33765,fl,-82.74473,27.97469,3404,75,106,31,41.3
33767,fl,-82.82298,27.97402,2213,97,121,24,24.7
33770,fl,-82.80363,27.91467,7797,79,108,29,36.7
33771,fl,-82.75805,27.90665,5088,75,106,31,41.3
33772,fl,-82.79639,27.84259,7997,77,106,29,37.7
33773,fl,-82.75718,27.88208,6418,78,106,28,35.9
33774,fl,-82.82763,27.88265,6000,78,106,28,35.9
33776,fl,-82.82611,27.84982,5233,79,107,28,35.4
33777,fl,-82.75988,27.8533,6118,76,105,29,38.2
33778,fl,-82.79831,27.8826,4683,79,107,28,35.4
33781,fl,-82.71512,27.83868,8875,73,103,30,41.1
33782,fl,-82.7085,27.85992,7441,74,104,30,40.5
33785,fl,-82.84662,27.88027,2622,78,107,29,37.2
33786,fl,-82.83842,27.92362,990,79,108,29,36.7
33801,fl,-81.89621,28.04082,11980,67,100,33,49.3
33803,fl,-81.93266,28.00891,10701,68,101,33,48.5
33805,fl,-81.90737,28.10251,8384,68,100,32,47.1
33809,fl,-81.97053,28.22293,12393,67,100,33,49.3
33810,fl,-82.02757,28.127,19300,68,101,33,48.5
33811,fl,-82.0181,27.98021,11327,68,101,33,48.5
33812,fl,-81.89308,27.97287,5890,65,99,34,52.3
33813,fl,-81.93975,27.96114,14705,67,100,33,49.3
33815,fl,-81.99645,28.0407,4828,70,102,32,45.7
33823,fl,-81.81396,28.08723,14220,60,95,35,58.3
33825,fl,-81.46503,27.62432,18744,67,102,35,52.2
33827,fl,-81.51394,27.81636,2461,67,101,34,50.7
33830,fl,-81.81749,27.87485,14246,68,101,33,48.5
33834,fl,-81.99238,27.60298,3192,71,105,34,47.9
33837,fl,-81.59111,28.19085,23681,66,99,33,50
33838,fl,-81.61362,28.02011,2322,67,100,33,49.3
33839,fl,-81.7507,27.97559,1607,65,99,34,52.3
33841,fl,-81.75635,27.73561,6423,70,104,34,48.6
33843,fl,-81.53179,27.72287,8922,68,102,34,50
33844,fl,-81.58532,28.0845,21758,66,100,34,51.5
33847,fl,-81.82329,27.80457,124,70,104,34,48.6
33848,fl,-81.50689,28.2774,576,63,96,33,52.4
33849,fl,-82.07374,28.21682,1359,69,102,33,47.8
33850,fl,-81.73264,28.12108,3947,63,97,34,54
33851,fl,-81.62356,28.04444,771,66,99,33,50
33852,fl,-81.37414,27.23882,40000,76,110,34,44.7
33853,fl,-81.58466,27.90028,5357,69,102,33,47.8
33854,fl,-81.40992,27.85615,513,63,97,34,54
33855,fl,-81.35276,27.79537,543,65,98,33,50.8
33856,fl,-81.42835,27.85643,1,62,97,35,56.5
33857,fl,-81.18354,27.38263,2271,71,105,34,47.9
33859,fl,-81.62206,27.87734,6083,69,103,34,49.3
33860,fl,-81.99425,27.79163,10002,69,102,33,47.8
33865,fl,-81.96301,27.43855,996,66,101,35,53
33867,fl,-81.19561,27.77692,715,70,103,33,47.1
33868,fl,-81.82395,28.25612,17938,64,97,33,51.6
33870,fl,-81.40213,27.50424,13030,70,104,34,48.6
33872,fl,-81.52648,27.51317,17947,68,103,35,51.5
33873,fl,-81.77287,27.56256,6585,72,106,34,47.2
33875,fl,-81.50096,27.40593,12886,72,105,33,45.8
33876,fl,-81.3519,27.42874,6001,73,107,34,46.6
33877,fl,-81.61437,27.98911,227,68,101,33,48.5
33880,fl,-81.78038,27.98131,17041,64,98,34,53.1
33881,fl,-81.70751,28.05362,15825,63,97,34,54
33884,fl,-81.67358,27.98104,15012,68,101,33,48.5
33890,fl,-81.68891,27.44704,4013,70,104,34,48.6
33896,fl,-81.58422,28.25745,5977,64,97,33,51.6
33897,fl,-81.69024,28.27172,14679,63,96,33,52.4
33898,fl,-81.36218,27.82724,49107,66,100,34,51.5
33901,fl,-81.87867,26.62115,6482,73,110,37,50.7
33903,fl,-81.9067,26.68112,9713,71,108,37,52.1
33904,fl,-81.94537,26.57595,16204,74,109,35,47.3
33905,fl,-81.76046,26.66929,18625,69,108,39,56.5
33907,fl,-81.87136,26.56437,5740,72,110,38,52.8
33908,fl,-81.92554,26.49271,18142,78,110,32,41
33909,fl,-81.94524,26.69388,24879,74,110,36,48.6
33912,fl,-81.82522,26.53285,7388,73,110,37,50.7
33913,fl,-81.69648,26.51631,18527,73,111,38,52.1
33914,fl,-82.02056,26.55566,23987,76,109,33,43.4
33916,fl,-81.83915,26.63435,8126,71,109,38,53.5
33917,fl,-81.8435,26.73574,16109,68,107,39,57.4
33919,fl,-81.90336,26.55667,10253,74,110,36,48.6
33920,fl,-81.65268,26.72897,8664,74,112,38,51.4
33921,fl,-82.25246,26.7702,2061,86,112,26,30.2
33922,fl,-82.15606,26.64922,5077,82,111,29,35.4
33924,fl,-82.21343,26.61503,2565,124,145,21,16.9
33928,fl,-81.72327,26.41982,15803,80,114,34,42.5
33930,fl,-81.41392,26.56668,786,87,122,35,40.2
33931,fl,-81.90769,26.43502,5821,102,128,26,25.5
33935,fl,-81.43301,26.75915,20715,82,117,35,42.7
33936,fl,-81.58991,26.6157,13973,76,114,38,50
33944,fl,-81.28099,26.98642,538,74,110,36,48.6
33945,fl,-82.22071,26.60228,286,126,147,21,16.7
33946,fl,-82.27401,26.84804,9764,84,111,27,32.1
33947,fl,-82.26976,26.88714,12653,84,112,28,33.3
33948,fl,-82.15099,26.98398,16776,77,110,33,42.9
33950,fl,-82.04634,26.90286,16553,78,111,33,42.3
33952,fl,-82.09726,26.98699,18521,78,111,33,42.3
33953,fl,-82.21205,26.99968,18312,74,108,34,45.9
33954,fl,-82.12217,27.02515,13158,79,113,34,43
33955,fl,-81.98111,26.81039,16913,83,114,31,37.3
33956,fl,-82.11309,26.5387,4910,82,111,29,35.4
33957,fl,-82.1023,26.46136,5933,126,146,20,15.9
33960,fl,-81.42355,27.03756,1719,76,110,34,44.7
33965,fl,-81.77202,26.46301,25,79,113,34,43
33966,fl,-81.83202,26.58239,5125,72,110,38,52.8
33967,fl,-81.81221,26.47225,10523,79,112,33,41.8
33971,fl,-81.69917,26.6388,24376,72,111,39,54.2
33972,fl,-81.61668,26.64923,26723,73,112,39,53.4
33973,fl,-81.73106,26.60196,5329,71,110,39,54.9
33974,fl,-81.60369,26.56254,33166,81,119,38,46.9
33976,fl,-81.68544,26.59132,16169,73,111,38,52.1
33980,fl,-82.05482,26.97591,9288,78,111,33,42.3
33981,fl,-82.21757,26.92289,28433,80,110,30,37.5
33982,fl,-81.76903,26.91107,14582,77,113,36,46.8
33983,fl,-82.01515,27.00717,11889,77,111,34,44.2
33990,fl,-81.9433,26.62788,14648,72,108,36,50
33991,fl,-82.02162,26.62472,15627,77,110,33,42.9
33993,fl,-82.03348,26.69218,35658,79,112,33,41.8
34101,fl,-81.76911,26.04141,165,81,115,34,42
34102,fl,-81.79776,26.13765,5043,88,117,29,33
34103,fl,-81.80549,26.19333,3713,95,122,27,28.4
34104,fl,-81.74166,26.15289,7256,89,118,29,32.6
34105,fl,-81.76367,26.18942,4871,90,119,29,32.2
34108,fl,-81.80786,26.24524,6547,92,119,27,29.3
34109,fl,-81.7637,26.24094,7889,92,120,28,30.4
34110,fl,-81.78563,26.29554,8138,88,119,31,35.2
34112,fl,-81.74162,26.11799,9464,89,117,28,31.5
34113,fl,-81.72797,26.04791,8304,89,118,29,32.6
34114,fl,-81.5511,25.96375,27446,97,125,28,28.9
34116,fl,-81.71053,26.18804,7086,92,121,29,31.5
34117,fl,-81.59443,26.1803,15279,111,137,26,23.4
34119,fl,-81.71458,26.26656,15031,91,121,30,33
34120,fl,-81.5751,26.32344,24010,105,135,30,28.6
34134,fl,-81.82894,26.35501,8357,85,115,30,35.3
34135,fl,-81.75196,26.35553,23890,86,117,31,36
34137,fl,-81.38066,25.94099,493,115,142,27,23.5
34138,fl,-81.37273,25.81586,327,88,123,35,39.8
34139,fl,-81.41308,25.8255,852,94,127,33,35.1
34140,fl,-81.65931,25.92443,353,79,114,35,44.3
34141,fl,-81.09377,25.97233,21069,108,138,30,27.8
34142,fl,-81.33601,26.33823,18506,109,138,29,26.6
34145,fl,-81.6897,25.90357,9555,76,113,37,48.7
34201,fl,-82.46781,27.40284,2484,73,109,36,49.3
34202,fl,-82.39001,27.40669,12387,83,117,34,41
34203,fl,-82.50934,27.44357,14656,69,105,36,52.2
34205,fl,-82.58338,27.48412,10276,69,104,35,50.7
34207,fl,-82.58019,27.43756,10064,64,101,37,57.8
34208,fl,-82.51322,27.48722,12464,70,105,35,50
34209,fl,-82.64833,27.49836,11326,70,105,35,50
34210,fl,-82.63085,27.43801,3896,68,103,35,51.5
34211,fl,-82.37732,27.45002,9748,76,112,36,47.4
34212,fl,-82.4079,27.49888,9760,70,107,37,52.9
34215,fl,-82.685,27.47177,624,72,105,33,45.8
34216,fl,-82.73705,27.53761,1596,75,106,31,41.3
34217,fl,-82.7061,27.49365,3691,73,105,32,43.8
34219,fl,-82.29929,27.58667,14248,67,104,37,55.2
34221,fl,-82.55251,27.58069,21812,70,105,35,50
34222,fl,-82.50504,27.53623,4667,68,104,36,52.9
34223,fl,-82.35581,26.9811,13463,80,110,30,37.5
34224,fl,-82.30475,26.91996,15720,83,111,28,33.7
34228,fl,-82.64249,27.39678,3119,71,104,33,46.5
34229,fl,-82.48443,27.19115,3735,79,111,32,40.5
34231,fl,-82.51634,27.26661,12135,80,111,31,38.8
34232,fl,-82.47242,27.32616,12440,80,113,33,41.3
34233,fl,-82.47305,27.28369,6049,81,114,33,40.7
34234,fl,-82.54155,27.36841,7788,73,106,33,45.2
34235,fl,-82.47555,27.36763,4585,75,110,35,46.7
34236,fl,-82.55926,27.32404,3517,76,108,32,42.1
34237,fl,-82.51399,27.33774,5169,76,109,33,43.4
34238,fl,-82.46877,27.2305,9543,82,113,31,37.8
34239,fl,-82.52168,27.31097,6807,79,110,31,39.2
34240,fl,-82.34734,27.33901,7372,91,122,31,34.1
34241,fl,-82.37769,27.2464,6699,90,121,31,34.4
34242,fl,-82.54153,27.26026,3558,79,108,29,36.7
34243,fl,-82.52956,27.40321,12209,69,105,36,52.2
34251,fl,-82.17041,27.37612,4131,71,107,36,50.7
34266,fl,-81.82619,27.18986,15869,67,105,38,56.7
34268,fl,-81.89307,27.15262,63,67,105,38,56.7
34269,fl,-81.99621,27.09811,3854,78,114,36,46.2
34275,fl,-82.42246,27.15211,11995,79,111,32,40.5
34285,fl,-82.43646,27.09118,8229,78,109,31,39.7
34286,fl,-82.18158,27.08125,19045,81,116,35,43.2
34287,fl,-82.24462,27.05389,17799,74,110,36,48.6
34288,fl,-82.11162,27.05389,25879,80,115,35,43.8
34289,fl,-82.13588,27.08617,1663,84,119,35,41.7
34291,fl,-82.23862,27.09865,10843,81,116,35,43.2
34292,fl,-82.34101,27.10168,7462,77,110,33,42.9
34293,fl,-82.33551,27.02802,25775,76,109,33,43.4
34420,fl,-82.03762,29.05305,10088,65,94,29,44.6
34428,fl,-82.64837,28.95874,10391,71,102,31,43.7
34429,fl,-82.6669,28.85467,7869,80,108,28,35
34431,fl,-82.53282,29.13919,17536,47,81,34,72.3
34432,fl,-82.36339,29.06878,14334,51,84,33,64.7
34433,fl,-82.52319,28.99723,13405,53,85,32,60.4
34434,fl,-82.43916,28.99629,22599,50,83,33,66
34436,fl,-82.29709,28.72347,6141,62,95,33,53.2
34442,fl,-82.37737,28.93183,13984,59,92,33,55.9
34445,fl,-82.42081,28.96799,43,55,88,33,60
34446,fl,-82.52216,28.74729,13629,80,109,29,36.3
34448,fl,-82.62351,28.76746,10246,84,111,27,32.1
34449,fl,-82.68069,29.08364,3374,68,97,29,42.6
34450,fl,-82.27177,28.83557,7754,58,91,33,56.9
34452,fl,-82.36111,28.77764,9534,61,94,33,54.1
34453,fl,-82.34299,28.87853,11328,62,95,33,53.2
34461,fl,-82.47691,28.81109,7104,66,99,33,50
34465,fl,-82.48921,28.92949,12287,58,91,33,56.9
34470,fl,-82.08743,29.19891,9002,58,88,30,51.7
34471,fl,-82.12879,29.16049,11190,57,88,31,54.4
34472,fl,-81.99548,29.11249,20089,62,92,30,48.4
34473,fl,-82.18279,29.0058,29426,59,90,31,52.5
34474,fl,-82.20943,29.15642,5223,54,86,32,59.3
34475,fl,-82.16102,29.25733,6945,55,86,31,56.4
34476,fl,-82.19682,29.08161,13781,57,88,31,54.4
34479,fl,-82.1095,29.25408,5769,56,87,31,55.4
34480,fl,-82.09793,29.10569,11785,61,91,30,49.2
34481,fl,-82.30882,29.12243,22761,52,85,33,63.5
34482,fl,-82.27278,29.25028,13496,52,84,32,61.5
34484,fl,-82.08794,28.93378,3474,63,93,30,47.6
34488,fl,-81.93926,29.22165,7512,63,92,29,46
34491,fl,-82.0447,28.99651,20752,66,95,29,43.9
34498,fl,-82.74814,29.03138,753,75,103,28,37.3
34601,fl,-82.36479,28.59024,13361,72,106,34,47.2
34602,fl,-82.27957,28.50322,5304,73,106,33,45.2
34604,fl,-82.43428,28.47715,6542,75,108,33,44
34606,fl,-82.59753,28.46995,14945,90,116,26,28.9
34607,fl,-82.63923,28.50016,6347,96,119,23,24
34608,fl,-82.55317,28.48277,15125,84,112,28,33.3
34609,fl,-82.50819,28.47933,19810,77,109,32,41.6
34610,fl,-82.50008,28.3834,8325,78,109,31,39.7
34613,fl,-82.56889,28.57459,13445,85,113,28,32.9
34614,fl,-82.5518,28.64874,12001,83,111,28,33.7
34637,fl,-82.46412,28.29725,3599,74,108,34,45.9
34638,fl,-82.52052,28.26012,12762,72,106,34,47.2
34639,fl,-82.42583,28.24572,12129,75,108,33,44
34652,fl,-82.73965,28.23673,14352,87,115,28,32.2
34653,fl,-82.69299,28.24358,13320,84,112,28,33.3
34654,fl,-82.62879,28.29503,14342,80,110,30,37.5
34655,fl,-82.62586,28.21708,22358,77,108,31,40.3
34661,fl,-82.24834,28.6161,265,66,100,34,51.5
34667,fl,-82.6616,28.39169,20186,101,124,23,22.8
34668,fl,-82.70737,28.30216,21444,92,117,25,27.2
34669,fl,-82.61474,28.35826,7761,82,111,29,35.4
34677,fl,-82.67359,28.03777,8912,75,106,31,41.3
34679,fl,-82.66145,28.43074,116,96,117,21,21.9
34681,fl,-82.77776,28.08788,747,86,112,26,30.2
34683,fl,-82.76076,28.08731,12615,81,111,30,37
34684,fl,-82.7277,28.08123,9873,79,110,31,39.2
34685,fl,-82.68691,28.09646,5716,78,109,31,39.7
34688,fl,-82.68245,28.14584,3097,80,110,30,37.5
34689,fl,-82.76,28.14894,11388,87,115,28,32.2
34690,fl,-82.72658,28.19286,7295,85,114,29,34.1
34691,fl,-82.79824,28.19272,11929,87,115,28,32.2
34695,fl,-82.68981,28.00392,7337,77,107,30,39
34698,fl,-82.78662,28.03747,13035,79,108,29,36.7
34705,fl,-81.71561,28.69927,1589,59,91,32,54.2
34711,fl,-81.7567,28.5261,27350,62,94,32,51.6
34714,fl,-81.78115,28.41129,12729,63,96,33,52.4
34715,fl,-81.73054,28.62586,9621,62,94,32,51.6
34731,fl,-81.89778,28.86419,7739,56,87,31,55.4
34734,fl,-81.5222,28.53819,1721,62,94,32,51.6
34736,fl,-81.89641,28.55441,12366,63,95,32,50.8
34737,fl,-81.79654,28.69294,2364,60,91,31,51.7
34739,fl,-81.12442,27.93451,1514,69,101,32,46.4
34741,fl,-81.42573,28.30545,12004,63,96,33,52.4
34743,fl,-81.3544,28.33059,12794,64,96,32,50
34744,fl,-81.34475,28.29651,20544,64,97,33,51.6
34746,fl,-81.44055,28.24141,23909,64,97,33,51.6
34747,fl,-81.59669,28.30958,21748,63,96,33,52.4
34748,fl,-81.88186,28.76644,22028,57,89,32,56.1
34753,fl,-81.90074,28.58969,2756,64,96,32,50
34756,fl,-81.68219,28.58555,2610,62,94,32,51.6
34758,fl,-81.49516,28.19832,15405,65,98,33,50.8
34759,fl,-81.43916,28.09296,23409,67,100,33,49.3
34760,fl,-81.63217,28.55473,648,63,95,32,50.8
34761,fl,-81.53372,28.57758,15525,61,93,32,52.5
34762,fl,-81.91509,28.75445,1010,59,91,32,54.2
34769,fl,-81.2912,28.24505,9543,64,97,33,51.6
34771,fl,-81.16271,28.27651,12881,65,97,32,49.2
34772,fl,-81.26889,28.16399,16735,65,98,33,50.8
34773,fl,-81.00583,28.16509,8819,64,96,32,50
34785,fl,-82.0402,28.83931,25797,62,93,31,50
34786,fl,-81.55436,28.48207,15888,63,95,32,50.8
34787,fl,-81.62774,28.4824,34783,63,95,32,50.8
34788,fl,-81.79826,28.88709,8577,51,82,31,60.8
34797,fl,-81.81977,28.73556,1077,57,89,32,56.1
34945,fl,-80.55736,27.43801,4012,59,95,36,61
34946,fl,-80.36099,27.50407,3743,58,93,35,60.3
34947,fl,-80.37592,27.44897,5403,59,94,35,59.3
34949,fl,-80.30175,27.46678,3463,52,89,37,71.2
34950,fl,-80.32965,27.44349,6915,56,92,36,64.3
34951,fl,-80.41611,27.52249,7735,57,94,37,64.9
34952,fl,-80.29887,27.29563,17888,56,92,36,64.3
34953,fl,-80.38128,27.24899,35333,56,92,36,64.3
34956,fl,-80.50827,27.07921,5338,70,105,35,50
34957,fl,-80.24044,27.28575,11305,57,92,35,61.4
34972,fl,-80.92712,27.50655,20640,63,98,35,55.6
34974,fl,-80.94544,27.14475,15423,61,98,37,60.7
34981,fl,-80.37046,27.39421,2079,57,92,35,61.4
34982,fl,-80.30833,27.37303,9825,56,92,36,64.3
34983,fl,-80.35031,27.32315,19662,56,91,35,62.5
34984,fl,-80.33453,27.2478,9012,54,90,36,66.7
34986,fl,-80.40506,27.32868,16484,57,92,35,61.4
34987,fl,-80.50115,27.28098,10702,62,98,36,58.1
34990,fl,-80.34838,27.13748,14619,56,93,37,66.1
34994,fl,-80.25694,27.20074,4804,57,92,35,61.4
34996,fl,-80.19373,27.19928,3548,57,92,35,61.4
34997,fl,-80.2716,27.05248,28261,63,99,36,57.1
35004,al,-86.49611,33.60281,5298,28,48,20,71.4
35005,al,-87.00085,33.59518,4717,34,55,21,61.8
35006,al,-87.19708,33.42923,2779,39,61,22,56.4
35007,al,-86.79716,33.21593,10730,33,54,21,63.6
35010,al,-85.93683,32.91642,15540,35,58,23,65.7
35013,al,-86.51792,33.9016,1,25,44,19,76
35014,al,-86.26917,33.3599,4829,39,61,22,56.4
35016,al,-86.50143,34.32332,10411,20,37,17,85
35019,al,-86.63519,34.29851,1561,21,38,17,81
35020,al,-86.95154,33.40269,15605,40,61,21,52.5
35022,al,-86.96576,33.32256,12093,39,60,21,53.8
35023,al,-87.09267,33.46812,13205,42,63,21,50
35031,al,-86.54752,34.10153,6252,25,44,19,76
35032,al,-86.33642,33.26486,59,39,61,22,56.4
35033,al,-87.02961,33.94237,3414,30,50,20,66.7
35034,al,-87.26981,32.91196,2646,38,59,21,55.3
35035,al,-86.97383,33.04273,1279,37,58,21,56.8
35036,al,-86.9196,33.64408,191,35,56,21,60
35040,al,-86.73002,33.10384,9799,33,54,21,63.6
35042,al,-87.1148,32.95454,4033,41,62,21,51.2
35043,al,-86.6587,33.31374,6354,35,57,22,62.9
35044,al,-86.37285,33.24893,4825,40,62,22,55
35045,al,-86.67291,32.80709,9093,32,53,21,65.6
35046,al,-86.54505,32.92288,4539,34,56,22,64.7
35049,al,-86.60009,33.95624,2854,32,53,21,65.6
35051,al,-86.61972,33.20549,4783,36,57,21,58.3
35052,al,-86.40852,33.5918,20,29,49,20,69
35053,al,-87.06791,34.05329,5099,29,48,19,65.5
35054,al,-86.32868,33.50958,2592,37,59,22,59.5
35055,al,-86.75903,34.154,10877,25,44,19,76
35057,al,-86.96041,34.13785,8828,26,45,19,73.1
35058,al,-86.73787,34.23136,5983,22,41,19,86.4
35060,al,-86.9467,33.55859,404,36,57,21,58.3
35061,al,-86.95613,33.47194,1091,41,62,21,51.2
35062,al,-87.02033,33.72906,5242,35,56,21,60
35063,al,-87.00756,33.81953,2554,31,51,20,64.5
35064,al,-86.92021,33.47615,4587,37,58,21,56.8
35068,al,-86.83092,33.6074,3839,32,52,20,62.5
35070,al,-86.7543,34.00987,225,26,45,19,73.1
35071,al,-86.84366,33.70486,8579,32,52,20,62.5
35072,al,-86.06136,33.08979,4809,30,51,21,70
35073,al,-86.98034,33.65412,2252,34,55,21,61.8
35074,al,-87.12427,33.22235,30,37,58,21,56.8
35077,al,-86.83217,34.02053,8264,29,49,20,69
35078,al,-86.44234,33.32337,1717,41,64,23,56.1
35079,al,-86.75552,33.94056,6571,31,51,20,64.5
35080,al,-86.91283,33.25976,8395,37,58,21,56.8
35082,al,-86.15568,33.16336,35,26,47,21,80.8
35083,al,-86.5991,34.19827,2209,24,43,19,79.2
35085,al,-86.73686,32.97956,5184,31,51,20,64.5
35087,al,-86.58439,34.30642,1491,20,38,18,90
35089,al,-86.08228,32.93807,2012,33,55,22,66.7
35091,al,-86.78954,33.77935,1488,35,56,21,60
35094,al,-86.55996,33.52091,8736,30,50,20,66.7
35096,al,-86.10863,33.62051,7078,35,57,22,62.9
35097,al,-86.62611,33.89435,1118,30,50,20,66.7
35098,al,-87.04164,34.12469,1369,27,46,19,70.4
35111,al,-87.09457,33.28424,12451,37,58,21,56.8
35112,al,-86.4708,33.68969,457,28,48,20,71.4
35114,al,-86.87244,33.22308,2658,34,55,21,61.8
35115,al,-86.89576,33.12,7450,34,55,21,61.8
35116,al,-86.76627,33.73116,2601,34,55,21,61.8
35117,al,-86.89672,33.67297,2896,33,54,21,63.6
35118,al,-87.05145,33.53721,2586,37,58,21,56.8
35119,al,-86.77356,33.64317,119,30,50,20,66.7
35120,al,-86.42305,33.66656,8640,28,47,19,67.9
35121,al,-86.45541,33.94118,12002,22,40,18,81.8
35124,al,-86.76314,33.31346,10986,34,55,21,61.8
35125,al,-86.29436,33.62575,5564,34,55,21,61.8
35126,al,-86.65417,33.73145,12162,26,45,19,73.1
35127,al,-86.97644,33.49179,4552,38,59,21,55.3
35128,al,-86.34279,33.54889,6601,35,57,22,62.9
35130,al,-87.13405,33.6337,3144,37,58,21,56.8
35131,al,-86.18609,33.73377,3423,33,55,22,66.7
35133,al,-86.59956,33.8187,2845,24,43,19,79.2
35135,al,-86.19958,33.6166,1122,35,57,22,62.9
35136,al,-86.29571,32.87838,3610,32,53,21,65.6
35139,al,-86.97046,33.71136,115,35,56,21,60
35143,al,-86.55296,33.08733,2795,36,58,22,61.1
35146,al,-86.43192,33.79557,7779,27,47,20,74.1
35147,al,-86.52929,33.41511,3182,35,56,21,60
35148,al,-87.04555,33.75632,1885,33,54,21,63.6
35149,al,-86.19671,33.24813,437,35,57,22,62.9
35150,al,-86.24172,33.18528,10702,33,54,21,63.6
35151,al,-86.37208,33.09298,7004,32,54,22,68.8
35160,al,-86.08669,33.37489,20240,38,60,22,57.9
35171,al,-86.73967,32.88209,2058,32,52,20,62.5
35172,al,-86.69739,33.8447,2264,33,54,21,63.6
35173,al,-86.56421,33.65047,15263,30,50,20,66.7
35175,al,-86.517,34.43724,3616,20,38,18,90
35176,al,-86.49822,33.48535,577,34,55,21,61.8
35178,al,-86.39877,33.41983,2554,40,63,23,57.5
35179,al,-86.9669,34.26846,5905,22,40,18,81.8
35180,al,-86.83546,33.8264,8959,34,54,20,58.8
35183,al,-86.35077,33.0159,784,30,50,20,66.7
35184,al,-87.13921,33.11477,4391,40,61,21,52.5
35186,al,-86.51427,33.25698,3409,38,60,22,57.9
35187,al,-86.88579,33.08053,21,35,55,20,57.1
35188,al,-87.17011,33.1821,1629,37,59,22,59.5
35203,al,-86.80981,33.5186,1304,30,50,20,66.7
35204,al,-86.83981,33.52212,5798,32,52,20,62.5
35205,al,-86.80809,33.49501,5093,29,50,21,72.4
35206,al,-86.71338,33.56926,9850,28,48,20,71.4
35207,al,-86.82298,33.56609,6596,32,53,21,65.6
35208,al,-86.87935,33.49681,6987,35,56,21,60
35209,al,-86.81169,33.4653,7510,30,50,20,66.7
35210,al,-86.66547,33.54517,8161,31,52,21,67.7
35211,al,-86.87148,33.45011,12918,32,53,21,65.6
35212,al,-86.75296,33.54743,5376,29,49,20,69
35213,al,-86.74284,33.50663,5276,30,50,20,66.7
35214,al,-86.89187,33.5769,10751,34,55,21,61.8
35215,al,-86.70579,33.64904,16415,26,46,20,76.9
35216,al,-86.78671,33.41871,10141,36,57,21,58.3
35217,al,-86.76034,33.60811,8820,30,50,20,66.7
35218,al,-86.89396,33.50773,4224,35,56,21,60
35221,al,-86.89907,33.44953,3596,35,56,21,60
35222,al,-86.77019,33.52409,3934,29,49,20,69
35223,al,-86.73757,33.48688,4690,32,53,21,65.6
35224,al,-86.94438,33.51946,4655,36,57,21,58.3
35226,al,-86.84434,33.39853,14173,37,58,21,56.8
35228,al,-86.92125,33.45611,5491,37,58,21,56.8
35229,al,-86.7892,33.46564,7,31,51,20,64.5
35233,al,-86.80197,33.50875,856,29,49,20,69
35234,al,-86.80276,33.54081,3262,32,52,20,62.5
35235,al,-86.6483,33.62411,8252,27,47,20,74.1
35242,al,-86.67145,33.42521,19730,30,51,21,70
35243,al,-86.73994,33.44276,6851,35,56,21,60
35244,al,-86.82534,33.35378,11164,37,58,21,56.8
35254,al,-86.85756,33.51615,81,34,55,21,61.8
35401,al,-87.61358,33.16878,13353,44,66,22,50
35404,al,-87.48608,33.21665,8890,41,63,22,53.7
35405,al,-87.5429,33.11579,15140,42,63,21,50
35406,al,-87.47043,33.33412,8069,42,64,22,52.4
35441,al,-87.73859,32.85372,1892,45,68,23,51.1
35442,al,-88.19361,33.07377,4683,45,68,23,51.1
35443,al,-88.01124,32.75294,2986,44,67,23,52.3
35444,al,-87.30324,33.33698,3550,37,58,21,56.8
35446,al,-87.74715,33.2162,1666,42,64,22,52.4
35447,al,-88.15455,33.25667,3872,45,67,22,48.9
35452,al,-87.68365,33.28176,2478,43,65,22,51.2
35453,al,-87.38807,33.16421,7029,41,62,21,51.2
35456,al,-87.42701,33.05551,2832,41,63,22,53.7
35457,al,-87.77372,33.29621,119,44,66,22,50
35458,al,-87.79137,33.36694,559,43,65,22,51.2
35459,al,-88.30285,32.79856,1299,45,68,23,51.1
35460,al,-88.15035,32.70908,1276,46,69,23,50
35461,al,-88.21417,33.41547,2582,43,65,22,51.2
35462,al,-87.95286,32.93442,5356,44,67,23,52.3
35463,al,-87.68755,33.06901,1910,45,67,22,48.9
35464,al,-88.15354,32.80326,686,44,66,22,50
35466,al,-87.91413,33.25825,5915,43,65,22,51.2
35469,al,-87.77203,32.96992,336,45,67,22,48.9
35470,al,-88.10362,32.55682,4458,46,69,23,50
35473,al,-87.58243,33.27236,7865,44,65,21,47.7
35474,al,-87.57197,32.93787,5499,42,64,22,52.4
35475,al,-87.58693,33.43294,11336,41,62,21,51.2
35476,al,-87.59448,33.22731,3222,44,66,22,50
35477,al,-88.24099,32.95151,721,44,67,23,52.3
35480,al,-87.82007,33.08963,1344,44,65,21,47.7
35481,al,-88.03736,33.39398,3559,43,65,22,51.2
35490,al,-87.24589,33.21333,3272,38,59,21,55.3
35501,al,-87.29274,33.81907,7817,36,56,20,55.6
35503,al,-87.30034,33.93755,6837,31,51,20,64.5
35504,al,-87.16669,33.89268,8974,33,53,20,60.6
35540,al,-87.18819,34.23389,1937,25,44,19,76
35541,al,-87.18067,34.08014,5231,28,48,20,71.4
35542,al,-87.67858,33.71664,1413,36,57,21,58.3
35543,al,-87.75004,34.22413,944,29,48,19,65.5
35544,al,-88.01906,33.95522,1225,33,53,20,60.6
35545,al,-87.93488,33.65152,99,37,58,21,56.8
35546,al,-87.54902,33.60721,4671,36,56,20,55.6
35548,al,-87.75118,34.06755,1583,30,50,20,66.7
35549,al,-87.54728,33.83643,4219,32,52,20,62.5
35550,al,-87.16598,33.74173,4467,36,57,21,58.3
35552,al,-88.1422,34.07229,1262,36,56,20,55.6
35553,al,-87.38568,34.12064,5285,26,45,19,73.1
35554,al,-87.6572,33.8961,1395,31,51,20,64.5
35555,al,-87.81834,33.66625,11027,39,61,22,56.4
35559,al,-87.72814,33.90548,48,32,52,20,62.5
35563,al,-87.89769,33.98371,3663,31,51,20,64.5
35564,al,-87.84791,34.25604,2096,29,48,19,65.5
35565,al,-87.55885,34.23415,9914,27,45,18,66.7
35570,al,-87.99502,34.16459,8849,35,55,20,57.1
35571,al,-87.95003,34.3561,1083,30,50,20,66.7
35572,al,-87.29648,34.20361,2193,27,45,18,66.7
35574,al,-87.9505,33.56504,2045,39,60,21,53.8
35575,al,-87.57841,34.04294,1133,28,47,19,67.9
35576,al,-88.1313,33.57923,3700,41,62,21,51.2
35577,al,-87.62005,34.10238,111,28,47,19,67.9
35578,al,-87.46614,33.98436,4712,29,49,20,69
35579,al,-87.3562,33.63663,3546,36,57,21,58.3
35580,al,-87.26449,33.67377,4228,36,57,21,58.3
35581,al,-87.71319,34.35852,4465,25,44,19,76
35582,al,-88.09448,34.48826,3113,36,57,21,58.3
35584,al,-87.08699,33.82202,322,36,57,21,58.3
35585,al,-87.80987,34.41687,1136,24,43,19,79.2
35586,al,-88.13868,33.87665,5091,36,57,21,58.3
35587,al,-87.45393,33.80054,1406,34,55,21,61.8
35592,al,-88.08439,33.74629,4635,37,58,21,56.8
35593,al,-88.08023,34.34973,2127,34,55,21,61.8
35594,al,-87.77209,33.9297,6633,32,52,20,62.5
35601,al,-87.01329,34.60905,14889,29,48,19,65.5
35603,al,-86.96674,34.53749,13732,27,47,20,74.1
35610,al,-87.24203,34.95094,1640,27,46,19,70.4
35611,al,-87.08567,34.76711,14294,27,46,19,70.4
35613,al,-86.87738,34.82404,11818,25,44,19,76
35614,al,-87.0838,34.86541,4629,26,45,19,73.1
35615,al,-86.87417,34.66402,63,30,50,20,66.7
35616,al,-88.01902,34.73876,4627,33,53,20,60.6
35618,al,-87.30612,34.64791,1627,32,52,20,62.5
35619,al,-87.14543,34.38733,3430,28,47,19,67.9
35620,al,-86.99133,34.93151,5785,24,43,19,79.2
35621,al,-86.72506,34.34965,2080,20,38,18,90
35622,al,-86.89791,34.34339,4466,23,41,18,78.3
35630,al,-87.66057,34.82362,15066,36,56,20,55.6
35633,al,-87.79858,34.87638,11258,35,55,20,57.1
35634,al,-87.61355,34.9186,5913,33,53,20,60.6
35640,al,-86.94407,34.44125,12859,27,47,20,74.1
35643,al,-87.20544,34.67015,2430,30,49,19,63.3
35645,al,-87.50087,34.9018,8198,31,51,20,64.5
35646,al,-87.52832,34.67172,3689,33,53,20,60.6
35647,al,-87.12179,34.96592,895,28,47,19,67.9
35648,al,-87.38485,34.95868,2371,28,47,19,67.9
35649,al,-86.87103,34.61703,124,31,50,19,61.3
35650,al,-87.30239,34.45071,8946,31,50,19,61.3
35651,al,-87.48754,34.46679,1140,31,50,19,61.3
35652,al,-87.31128,34.84537,5932,31,51,20,64.5
35653,al,-87.87133,34.51688,7149,28,47,19,67.9
35654,al,-87.6279,34.49815,5453,28,47,19,67.9
35660,al,-87.70089,34.75595,5593,37,58,21,56.8
35661,al,-87.56507,34.77343,13261,35,55,20,57.1
35670,al,-86.71907,34.46094,4699,25,44,19,76
35671,al,-86.94944,34.66634,1495,30,50,20,66.7
35672,al,-87.40676,34.64715,5012,32,52,20,62.5
35673,al,-87.13629,34.58093,4523,27,47,20,74.1
35674,al,-87.78292,34.65762,12684,33,53,20,60.6
35677,al,-88.02698,34.95501,2009,32,53,21,65.6
35739,al,-86.79578,34.96902,3116,21,39,18,85.7
35740,al,-85.75849,34.95009,2919,26,45,19,73.1
35741,al,-86.48336,34.72148,1941,24,43,19,79.2
35744,al,-85.90673,34.61216,1780,19,36,17,89.5
35745,al,-86.20013,34.94082,783,18,35,17,94.4
35746,al,-85.99598,34.82901,915,26,44,18,69.2
35747,al,-86.30739,34.49447,4844,24,43,19,79.2
35748,al,-86.387,34.72196,5584,23,41,18,78.3
35749,al,-86.75333,34.82432,11478,22,40,18,81.8
35750,al,-86.59507,34.95091,8014,23,42,19,82.6
35751,al,-86.27959,34.81059,427,19,36,17,89.5
35752,al,-85.94587,34.74808,2179,30,50,20,66.7
35754,al,-86.61026,34.51955,3246,21,39,18,85.7
35755,al,-86.13534,34.50008,1071,24,43,19,79.2
35756,al,-86.81676,34.64296,9299,27,46,19,70.4
35757,al,-86.7449,34.78312,6976,23,41,18,78.3
35758,al,-86.7467,34.7135,16317,25,44,19,76
35759,al,-86.55039,34.86439,3981,24,43,19,79.2
35760,al,-86.38258,34.54918,3864,29,49,20,69
35761,al,-86.41158,34.91475,7748,22,40,18,81.8
35763,al,-86.46439,34.62149,10105,27,47,20,74.1
35764,al,-86.31044,34.72329,712,22,41,19,86.4
35765,al,-85.81784,34.69067,3204,18,34,16,88.9
35766,al,-86.27668,34.87344,494,17,34,17,100
35768,al,-86.10539,34.7711,8496,29,48,19,65.5
35769,al,-86.09798,34.58998,7065,29,49,20,69
35771,al,-86.00238,34.53625,2905,20,37,17,85
35772,al,-85.88751,34.89068,4371,28,47,19,67.9
35773,al,-86.71249,34.8933,7636,22,40,18,81.8
35774,al,-86.2295,34.76323,199,21,38,17,81
35775,al,-86.69781,34.5481,488,24,43,19,79.2
35776,al,-86.23827,34.66143,3004,25,44,19,76
35801,al,-86.56226,34.72465,12537,23,42,19,82.6
35802,al,-86.55886,34.66969,7305,23,42,19,82.6
35803,al,-86.52141,34.56468,13372,22,41,19,86.4
35805,al,-86.62128,34.70859,7136,27,46,19,70.4
35806,al,-86.68509,34.76305,7979,24,43,19,79.2
35808,al,-86.65739,34.63186,12,25,43,18,72
35810,al,-86.60759,34.80097,13003,25,44,19,76
35811,al,-86.50599,34.79696,14340,24,42,18,75
35816,al,-86.63038,34.74023,4039,27,46,19,70.4
35824,al,-86.75322,34.64442,3196,27,46,19,70.4
35896,al,-86.65461,34.75428,4,25,44,19,76
35901,al,-85.92466,34.04793,13940,33,53,20,60.6
35903,al,-85.86093,34.02707,12471,32,52,20,62.5
35904,al,-85.99304,34.07022,10615,31,52,21,67.7
35905,al,-85.89955,33.93403,4517,28,48,20,71.4
35906,al,-86.08982,33.93176,6473,32,52,20,62.5
35907,al,-86.02445,33.8979,6056,31,51,20,64.5
35950,al,-86.26202,34.25259,10220,21,39,18,85.7
35951,al,-86.1617,34.34124,6687,21,39,18,85.7
35952,al,-86.30821,34.05284,6057,23,41,18,78.3
35953,al,-86.22613,33.81243,6714,31,51,20,64.5
35954,al,-86.06006,34.08839,9598,30,50,20,66.7
35956,al,-86.14795,34.14372,5778,21,39,18,85.7
35957,al,-86.19414,34.19209,8369,20,38,18,90
35958,al,-85.64683,34.91816,2541,16,32,16,100
35959,al,-85.60702,34.2406,7782,30,51,21,70
35960,al,-85.57401,34.12779,11765,29,50,21,72.4
35961,al,-85.86022,34.27948,4540,23,41,18,78.3
35962,al,-86.03996,34.30188,4746,20,37,17,85
35963,al,-85.93025,34.36165,1219,21,39,18,85.7
35966,al,-85.67883,34.79657,3135,17,34,17,100
35967,al,-85.69626,34.40141,11282,21,38,17,81
35968,al,-85.76574,34.48974,3302,24,42,18,75
35971,al,-85.94509,34.45557,3319,19,36,17,89.5
35972,al,-86.24524,33.99143,900,24,43,19,79.2
35973,al,-85.55433,34.34647,3242,27,47,20,74.1
35974,al,-86.01171,34.36352,1193,19,36,17,89.5
35975,al,-86.0663,34.44014,988,20,37,17,85
35976,al,-86.33348,34.34748,13493,26,45,19,73.1
35978,al,-85.72791,34.64375,3778,17,33,16,94.1
35979,al,-85.60965,34.83233,776,17,34,17,100
35980,al,-86.38523,34.17623,3304,24,43,19,79.2
35981,al,-85.64884,34.72226,1403,16,32,16,100
35983,al,-85.76881,34.17231,4395,31,52,21,67.7
35984,al,-85.56685,34.52956,3770,18,34,16,88.9
35986,al,-85.84036,34.50308,5071,19,36,17,89.5
35987,al,-86.23811,33.91707,2251,31,52,21,67.7
35988,al,-85.80017,34.5601,1120,17,34,17,100
35989,al,-85.63127,34.60742,2852,19,36,17,89.5
35990,al,-86.30469,34.06778,42,23,42,19,82.6
36003,al,-86.72387,32.45323,1895,39,63,24,61.5
36005,al,-85.72073,31.88589,2242,35,60,25,71.4
36006,al,-86.72346,32.64152,1306,35,57,22,62.9
36009,al,-86.297,31.58358,2966,42,68,26,61.9
36010,al,-85.81174,31.66886,4104,36,61,25,69.4
36013,al,-85.98263,32.29372,449,40,64,24,60
36016,al,-85.42936,31.85208,4411,32,56,24,75
36017,al,-85.555,31.68172,1869,34,59,25,73.5
36020,al,-86.31929,32.48815,727,42,66,24,57.1
36022,al,-86.40467,32.61948,7021,36,59,23,63.9
36024,al,-86.03201,32.66677,5900,29,51,22,75.9
36025,al,-86.32558,32.54156,1678,40,64,24,60
36026,al,-86.12748,32.77815,1865,30,52,22,73.3
36027,al,-85.20921,31.93344,13092,36,61,25,69.4
36028,al,-86.38882,31.49913,2314,40,67,27,67.5
36029,al,-85.93364,32.17788,1107,38,62,24,63.2
36030,al,-86.85982,31.86637,901,39,65,26,66.7
36031,al,-85.74356,32.24878,192,37,61,24,64.9
36032,al,-86.56926,31.99431,2005,38,63,25,65.8
36033,al,-86.76783,31.67123,5154,40,66,26,65
36034,al,-86.11066,31.62105,1075,40,66,26,65
36035,al,-86.12767,31.7946,2346,39,65,26,66.7
36036,al,-86.1557,31.97762,2156,37,61,24,64.9
36037,al,-86.62528,31.79898,10475,42,68,26,61.9
36038,al,-86.48947,31.43618,69,40,67,27,67.5
36039,al,-85.83492,32.28151,535,39,63,24,61.5
36040,al,-86.68285,32.16518,3271,39,64,25,64.1
36041,al,-86.31828,31.91464,1639,36,60,24,66.7
36042,al,-86.44932,31.8666,1752,38,63,25,65.8
36043,al,-86.41766,32.19947,2666,40,64,24,60
36046,al,-86.33779,32.00539,1583,36,60,24,66.7
36047,al,-86.51663,32.08133,1552,39,63,24,61.5
36048,al,-85.59038,31.79021,1974,33,58,25,75.8
36049,al,-86.28197,31.76333,5105,40,66,26,65
36051,al,-86.49465,32.68408,1903,33,55,22,66.7
36052,al,-86.04645,32.18681,887,39,63,24,61.5
36053,al,-85.43919,32.03354,2966,34,58,24,70.6
36054,al,-86.36669,32.4836,7076,40,64,24,60
36064,al,-86.07946,32.30268,5705,39,64,25,64.1
36066,al,-86.42409,32.48003,7631,38,62,24,63.2
36067,al,-86.56896,32.51249,14679,36,60,24,66.7
36069,al,-86.15239,32.09519,2427,37,61,24,64.9
36071,al,-86.39561,31.70589,882,42,68,26,61.9
36075,al,-85.91118,32.38454,2253,39,63,24,61.5
36078,al,-85.93554,32.54062,9731,34,57,23,67.6
36079,al,-86.01069,31.75952,6145,38,64,26,68.4
36080,al,-86.28412,32.70209,2351,36,59,23,63.9
36081,al,-85.89685,31.9049,9100,38,63,25,65.8
36082,al,-85.95464,31.80276,8,38,64,26,68.4
36083,al,-85.68246,32.38843,9517,35,59,24,68.6
36088,al,-85.7178,32.41687,2412,35,58,23,65.7
36089,al,-85.70042,32.15115,6227,33,57,24,72.7
36091,al,-86.51191,32.75084,2863,34,56,22,64.7
36092,al,-86.19333,32.61801,11945,37,60,23,62.2
36093,al,-86.14037,32.49755,6367,38,61,23,60.5
36104,al,-86.32497,32.39969,6018,39,63,24,61.5
36105,al,-86.28961,32.21337,6264,41,66,25,61
36106,al,-86.2576,32.35253,6109,40,64,24,60
36107,al,-86.27933,32.38376,4096,39,63,24,61.5
36108,al,-86.4063,32.33962,11945,41,66,25,61
36109,al,-86.24138,32.38713,10584,38,63,25,65.8
36110,al,-86.25672,32.44856,6532,40,64,24,60
36111,al,-86.27157,32.33759,4638,41,65,24,58.5
36112,al,-86.34914,32.38083,1,39,63,24,61.5
36113,al,-86.35806,32.38274,30,40,64,24,60
36115,al,-86.24671,32.40676,15,40,65,25,62.5
36116,al,-86.2154,32.27261,13901,41,65,24,58.5
36117,al,-86.14565,32.37856,20173,40,64,24,60
36201,al,-85.87879,33.65141,14863,26,45,19,73.1
36203,al,-85.83285,33.58154,10766,28,48,20,71.4
36205,al,-85.7949,33.71724,646,23,41,18,78.3
36206,al,-85.81443,33.73402,5890,25,44,19,76
36207,al,-85.71377,33.68026,11387,28,48,20,71.4
36250,al,-85.89683,33.76776,2608,30,51,21,70
36251,al,-85.86645,33.2299,4785,19,37,18,94.7
36255,al,-85.73841,33.17457,1278,21,39,18,85.7
36256,al,-85.70288,33.04207,1795,30,51,21,70
36258,al,-85.7148,33.47581,2249,20,38,18,90
36260,al,-86.00156,33.58364,2866,33,54,21,63.6
36262,al,-85.46554,33.78752,2133,19,36,17,89.5
36263,al,-85.35931,33.46625,627,18,35,17,94.4
36264,al,-85.53864,33.595,7891,22,40,18,81.8
36265,al,-85.78524,33.84778,10382,26,45,19,73.1
36266,al,-85.74076,33.34868,6158,20,38,18,90
36267,al,-85.94829,33.19736,44,24,43,19,79.2
36268,al,-85.94131,33.49717,4988,30,51,21,70
36269,al,-85.38288,33.74342,1379,17,34,17,100
36271,al,-86.01612,33.78149,4923,32,54,22,68.8
36272,al,-85.596,33.94167,11685,24,43,19,79.2
36273,al,-85.37853,33.54032,2376,17,35,18,105.9
36274,al,-85.36788,33.17308,8741,27,48,21,77.8
36276,al,-85.5706,33.13385,3042,27,48,21,77.8
36277,al,-85.81876,33.75969,3153,28,48,20,71.4
36278,al,-85.52697,33.32619,7314,21,39,18,85.7
36279,al,-85.88407,33.87338,1858,31,52,21,67.7
36280,al,-85.38685,33.38184,4110,17,34,17,100
36301,al,-85.40238,31.14367,18672,36,63,27,75
36303,al,-85.39712,31.26678,16362,36,62,26,72.2
36305,al,-85.49809,31.20138,7022,35,61,26,74.3
36310,al,-85.21632,31.60295,9121,35,61,26,74.3
36311,al,-85.6815,31.60246,2946,35,61,26,74.3
36312,al,-85.2374,31.17091,4267,39,67,28,71.8
36313,al,-85.79395,31.17857,240,31,56,25,80.6
36314,al,-85.77581,31.01866,616,32,58,26,81.3
36316,al,-85.86277,31.17371,1597,31,56,25,80.6
36317,al,-85.39107,31.64458,657,35,61,26,74.3
36318,al,-85.95326,31.1751,1223,32,57,25,78.1
36319,al,-85.1476,31.3246,2568,42,70,28,66.7
36320,al,-85.31541,31.05076,2998,41,69,28,68.3
36321,al,-85.30183,31.21176,1007,38,65,27,71.1
36322,al,-85.73271,31.25281,5203,33,58,25,75.8
36323,al,-86.0714,31.4268,7358,38,64,26,68.4
36330,al,-85.86317,31.3062,19790,31,56,25,80.6
36340,al,-85.89145,31.05087,5986,32,58,26,81.3
36343,al,-85.11607,31.05904,2223,45,74,29,64.4
36344,al,-85.70899,31.09817,4268,31,57,26,83.9
36345,al,-85.30832,31.37525,6316,39,65,26,66.7
36346,al,-85.92675,31.55883,1311,36,62,26,72.2
36350,al,-85.49031,31.34914,3800,34,60,26,76.5
36351,al,-85.91878,31.41554,2830,32,57,25,78.1
36352,al,-85.61535,31.25984,3680,32,58,26,81.3
36353,al,-85.36605,31.48283,2164,37,64,27,73
36360,al,-85.6177,31.46766,13141,36,62,26,72.2
36362,al,-85.69072,31.35088,55,33,59,26,78.8
36370,al,-85.15677,31.14242,806,42,70,28,66.7
36371,al,-85.55211,31.31334,629,34,59,25,73.5
36373,al,-85.10521,31.52052,902,37,64,27,73
36374,al,-85.4937,31.57875,1086,36,62,26,72.2
36375,al,-85.53888,31.07546,5319,34,61,27,79.4
36376,al,-85.27016,31.25624,1420,38,65,27,71.1
36401,al,-86.94932,31.47369,9375,38,64,26,68.4
36420,al,-86.57648,31.17684,7856,40,67,27,67.5
36421,al,-86.50656,31.32474,8049,39,66,27,69.2
36425,al,-87.18468,31.75817,2478,40,65,25,62.5
36426,al,-87.074,31.14049,14369,39,66,27,69.2
36432,al,-87.02764,31.29374,2695,40,67,27,67.5
36435,al,-87.45981,31.88219,660,42,67,25,59.5
36436,al,-87.64953,31.78537,527,40,66,26,65
36439,al,-87.34222,31.42395,287,38,65,27,71.1
36441,al,-87.25595,31.03638,3241,39,65,26,66.7
36442,al,-86.36264,31.07157,3638,38,66,28,73.7
36444,al,-87.45328,31.66427,1269,40,66,26,65
36445,al,-87.44745,31.44246,4206,38,64,26,68.4
36446,al,-87.71995,31.79247,429,41,67,26,63.4
36451,al,-87.8027,31.69908,5304,41,67,26,63.4
36453,al,-86.15139,31.19255,2074,38,64,26,68.4
36454,al,-87.20062,31.33329,52,42,68,26,61.9
36455,al,-86.35192,31.01292,362,39,67,28,71.8
36456,al,-86.81278,31.56339,2406,39,65,26,66.7
36460,al,-87.30746,31.52094,7504,39,65,26,66.7
36467,al,-86.25715,31.28125,6956,38,65,27,71.1
36470,al,-87.55088,31.53799,245,40,66,26,65
36471,al,-87.24303,31.62618,2068,39,64,25,64.1
36473,al,-87.21368,31.3058,125,41,68,27,65.9
36474,al,-86.61985,31.42679,3386,40,67,27,67.5
36475,al,-87.2247,31.38142,2586,40,67,27,67.5
36476,al,-86.55095,31.36305,56,41,68,27,65.9
36477,al,-86.05579,31.09521,4298,34,60,26,76.5
36480,al,-87.60796,31.32708,2374,40,66,26,65
36481,al,-87.36778,31.80217,617,41,66,25,61
36482,al,-87.64255,31.6318,1707,39,65,26,66.7
36483,al,-86.69173,31.04303,1099,40,67,27,67.5
36502,al,-87.49393,31.14063,11612,37,64,27,73
36505,al,-88.01642,30.94265,1179,35,60,25,71.4
36507,al,-87.73893,30.86319,12619,34,61,27,79.4
36509,al,-88.26348,30.39989,1573,28,58,30,107.1
36511,al,-87.74311,30.31276,560,34,65,31,91.2
36512,al,-88.01481,30.99759,178,40,68,28,70
36513,al,-88.0034,31.17175,500,42,69,27,64.3
36518,al,-88.28395,31.45454,3297,44,70,26,59.1
36521,al,-88.18117,30.96477,4275,36,62,26,72.2
36522,al,-88.27134,31.09179,6169,40,67,27,67.5
36523,al,-88.17032,30.37586,4224,30,60,30,100
36524,al,-88.02107,31.81425,2657,43,68,25,58.1
36525,al,-88.01798,30.88999,1301,31,56,25,80.6
36526,al,-87.86277,30.61278,17259,34,63,29,85.3
36527,al,-87.87345,30.69822,8146,32,60,28,87.5
36528,al,-88.15456,30.24391,3487,31,62,31,100
36529,al,-88.26573,31.27781,641,42,69,27,64.3
36530,al,-87.55474,30.4102,6384,35,66,31,88.6
36532,al,-87.86416,30.48121,20394,37,67,30,81.1
36535,al,-87.72825,30.38407,19473,37,68,31,83.8
36538,al,-88.13789,31.66249,759,44,70,26,59.1
36539,al,-88.38403,31.33968,1342,41,68,27,65.9
36540,al,-87.6686,31.44548,794,41,67,26,63.4
36541,al,-88.34058,30.49298,8592,30,58,28,93.3
36542,al,-87.75888,30.2717,14533,33,64,31,93.9
36543,al,-87.46333,31.22084,58,40,66,26,65
36544,al,-88.23288,30.47442,5713,28,56,28,100
36545,al,-87.87434,31.48941,10113,43,69,26,60.5
36548,al,-87.97158,31.48752,1141,43,69,26,60.5
36549,al,-87.44852,30.41374,4866,34,64,30,88.2
36550,al,-87.72112,31.23747,600,39,66,27,69.2
36551,al,-87.75284,30.63763,5381,30,57,27,90
36553,al,-88.06926,31.241,3202,42,68,26,61.9
36555,al,-87.77263,30.39984,436,38,69,31,81.6
36556,al,-87.9718,31.2065,375,42,68,26,61.9
36558,al,-88.31852,31.60778,5567,44,70,26,59.1
36559,al,-87.90642,30.56608,174,37,67,30,81.1
36560,al,-88.04002,31.09637,3041,43,70,27,62.8
36561,al,-87.57203,30.28494,8268,33,64,31,93.9
36562,al,-87.66138,31.03434,1373,36,63,27,75
36564,al,-87.92489,30.47602,129,39,70,31,79.5
36567,al,-87.5598,30.61465,8196,31,58,27,87.1
36568,al,-88.27261,30.5128,70,29,57,28,96.6
36569,al,-88.08932,31.54251,1079,44,70,26,59.1
36571,al,-88.09552,30.84282,7942,28,53,25,89.3
36572,al,-88.06047,30.85844,3310,28,54,26,92.9
36574,al,-87.48053,30.51524,1072,34,64,30,88.2
36575,al,-88.27272,30.76897,9446,30,56,26,86.7
36576,al,-87.76645,30.5264,2742,32,61,29,90.6
36578,al,-87.77878,30.74776,1638,31,58,27,87.1
36579,al,-87.79841,31.10663,2208,39,66,27,69.2
36580,al,-87.70047,30.48176,4422,35,65,30,85.7
36581,al,-87.96133,31.37321,442,41,66,25,61
36582,al,-88.17168,30.51006,13966,29,57,28,96.6
36583,al,-88.19765,31.35529,921,43,70,27,62.8
36584,al,-88.38062,31.1982,1533,42,69,27,64.3
36585,al,-88.07549,31.38848,1189,42,68,26,61.9
36587,al,-88.35491,30.84268,6580,32,59,27,84.4
36602,al,-88.04554,30.69333,906,28,56,28,100
36603,al,-88.04346,30.69048,4705,28,55,27,96.4
36604,al,-88.06815,30.68223,4469,29,56,27,93.1
36605,al,-88.0885,30.60433,12753,29,57,28,96.6
36606,al,-88.1063,30.67077,8023,29,56,27,93.1
36607,al,-88.10575,30.69856,3828,27,54,27,100
36608,al,-88.29447,30.68168,14431,28,54,26,92.9
36609,al,-88.16312,30.66088,7622,28,55,27,96.4
36610,al,-88.07285,30.73627,9392,27,54,27,100
36611,al,-88.07814,30.77048,3031,27,53,26,96.3
36612,al,-88.11247,30.75375,2458,26,52,26,100
36613,al,-88.18101,30.81179,7101,28,54,26,92.9
36615,al,-88.06653,30.63241,43,28,56,28,100
36616,al,-88.08159,30.7245,4,28,55,27,96.4
36617,al,-88.09599,30.71642,7018,27,54,27,100
36618,al,-88.17349,30.73593,7787,27,53,26,96.3
36619,al,-88.1979,30.59643,6847,28,56,28,100
36688,al,-88.18209,30.69616,4,28,54,26,92.9
36693,al,-88.14983,30.62659,7833,28,55,27,96.4
36695,al,-88.28061,30.63011,18807,28,54,26,92.9
36701,al,-87.05708,32.4768,14392,44,68,24,54.5
36703,al,-86.91068,32.43261,8026,45,69,24,53.3
36720,al,-87.34676,32.15842,1071,42,66,24,57.1
36722,al,-87.57342,32.09152,623,42,67,25,59.5
36723,al,-87.28489,32.06773,426,42,66,24,57.1
36726,al,-87.29108,31.97316,5278,40,65,25,62.5
36727,al,-88.00802,31.92125,580,43,68,25,58.1
36728,al,-87.47939,32.1679,885,41,66,25,61
36732,al,-87.9152,32.42337,5985,42,65,23,54.8
36736,al,-87.77719,32.05956,1236,42,66,24,57.1
36738,al,-87.61933,32.42662,1147,43,67,24,55.8
36740,al,-87.84018,32.62732,1435,44,67,23,52.3
36742,al,-87.73799,32.46432,2423,43,67,24,55.8
36744,al,-87.59874,32.69751,5898,47,70,23,48.9
36748,al,-87.78495,32.2759,3756,43,67,24,55.8
36749,al,-86.86169,32.54321,1161,40,63,23,57.5
36750,al,-86.85065,32.78699,2752,37,58,21,56.8
36751,al,-87.54526,31.80805,1238,41,66,25,61
36752,al,-86.62155,32.30011,2827,40,64,24,60
36753,al,-87.08599,31.81596,175,37,62,25,67.6
36754,al,-87.70149,32.15415,731,41,66,25,61
36756,al,-87.28016,32.69352,6083,37,59,22,59.5
36758,al,-86.89916,32.6503,1585,37,60,23,62.2
36759,al,-87.28546,32.42247,2376,40,64,24,60
36761,al,-86.97498,32.08457,2436,39,63,24,61.5
36763,al,-87.96575,32.27107,271,44,68,24,54.5
36765,al,-87.52273,32.58284,1463,44,68,24,54.5
36766,al,-87.08669,31.95512,75,38,62,24,63.2
36767,al,-87.19072,32.26012,2714,41,66,25,61
36768,al,-87.02164,31.90804,2828,39,63,24,61.5
36769,al,-87.5386,31.99844,2761,42,67,25,59.5
36773,al,-87.35878,32.26103,912,41,66,25,61
36775,al,-87.0166,32.22922,1076,39,63,24,61.5
36776,al,-87.74254,32.74499,1723,46,70,24,52.2
36782,al,-87.91861,32.12821,3309,43,67,24,55.8
36783,al,-87.601,32.24722,1639,41,65,24,58.5
36784,al,-87.80017,31.93989,7406,42,67,25,59.5
36785,al,-86.83672,32.25267,1643,39,62,23,59
36786,al,-87.48805,32.43967,2603,41,64,23,56.1
36790,al,-86.89629,32.7332,145,39,61,22,56.4
36792,al,-86.90596,32.9217,890,34,55,21,61.8
36793,al,-87.02613,32.8173,776,35,57,22,62.9
36801,al,-85.39717,32.69173,11024,20,38,18,90
36804,al,-85.34221,32.53344,9877,25,46,21,84
36830,al,-85.49203,32.53894,14807,24,44,20,83.3
36832,al,-85.58194,32.59622,6944,25,45,20,80
36849,al,-85.48734,32.60242,1,25,46,21,84
36850,al,-85.65684,32.78589,3034,28,49,21,75
36852,al,-85.29145,32.75731,1106,26,46,20,76.9
36853,al,-85.76793,32.80722,10902,30,51,21,70
36854,al,-85.18451,32.75374,8894,29,50,21,72.4
36855,al,-85.30251,33.03163,1550,30,51,21,70
36856,al,-84.99901,32.27657,3557,39,64,25,64.1
36858,al,-85.32066,32.31549,735,33,56,23,69.7
36859,al,-85.00448,32.23262,40,37,61,24,64.9
36860,al,-85.41886,32.25247,2131,34,57,23,67.6
36861,al,-85.83259,32.88567,3296,34,57,23,67.6
36862,al,-85.4418,32.90443,5398,25,46,21,84
36863,al,-85.25506,32.89517,7831,30,51,21,70
36865,al,-85.58934,32.60262,20,28,49,21,75
36866,al,-85.71552,32.55432,3320,33,56,23,69.7
36867,al,-85.02351,32.49654,10021,37,61,24,64.9
36869,al,-85.07991,32.42015,10678,38,62,24,63.2
36870,al,-85.12023,32.484,7864,34,58,24,70.6
36871,al,-85.15227,32.18102,1935,34,57,23,67.6
36874,al,-85.20577,32.56553,5677,30,52,22,73.3
36875,al,-85.17286,32.33318,3859,35,59,24,68.6
36877,al,-85.09867,32.55858,5524,33,55,22,66.7
36879,al,-85.55879,32.72835,2346,23,43,20,87
36901,al,-88.14745,32.42545,270,46,69,23,50
36904,al,-88.25854,32.10203,4854,45,70,25,55.6
36907,al,-88.34326,32.43642,2460,47,71,24,51.1
36908,al,-88.31019,31.90116,3697,44,69,25,56.8
36910,al,-88.14697,32.20461,59,46,70,24,52.2
36912,al,-88.30455,32.23509,3361,46,71,25,54.3
36913,al,-88.44709,31.96097,107,44,69,25,56.8
36915,al,-88.35873,31.9551,949,45,69,24,53.3
36916,al,-88.05654,32.20998,975,45,69,24,53.3
36919,al,-88.29291,31.76624,3336,44,69,25,56.8
36921,al,-88.19166,31.96814,1842,45,69,24,53.3
36922,al,-88.14755,32.30381,1274,45,70,25,55.6
36925,al,-88.17809,32.43251,2948,47,71,24,51.1
37010,tn,-87.1088,36.56758,2711,30,50,20,66.7
37012,tn,-86.00155,36.07384,1334,26,45,19,73.1
37013,tn,-86.63243,36.04705,29092,26,45,19,73.1
37014,tn,-86.65754,35.86954,1755,26,45,19,73.1
37015,tn,-87.07725,36.28418,8898,32,51,19,59.4
37016,tn,-86.10022,35.95745,544,24,43,19,79.2
37018,tn,-86.19707,35.63864,4374,17,35,18,105.9
37019,tn,-86.70983,35.39229,473,22,41,19,86.4
37020,tn,-86.40265,35.6266,2839,25,44,19,76
37022,tn,-86.31074,36.50011,3411,27,47,20,74.1
37023,tn,-87.78432,36.58342,967,29,49,20,69
37025,tn,-87.30777,35.94871,3660,36,56,20,55.6
37026,tn,-86.10566,35.69649,1257,19,36,17,89.5
37027,tn,-86.78393,35.99939,21698,26,45,19,73.1
37028,tn,-87.85929,36.62853,1690,33,53,20,60.6
37029,tn,-87.26451,36.04187,3294,40,60,20,50
37030,tn,-85.94763,36.27437,3924,27,48,21,77.8
37031,tn,-86.29963,36.37138,2287,31,52,21,67.7
37032,tn,-87.01713,36.52424,2667,29,48,19,65.5
37033,tn,-87.55115,35.73429,5220,33,53,20,60.6
37034,tn,-86.69169,35.64057,4032,30,50,20,66.7
37035,tn,-87.12716,36.38332,1845,32,51,19,59.4
37036,tn,-87.27193,36.23989,3529,38,58,20,52.6
37037,tn,-86.35155,35.70277,3831,26,46,20,76.9
37040,tn,-87.33341,36.5233,22345,33,53,20,60.6
37042,tn,-87.41695,36.5691,28602,33,53,20,60.6
37043,tn,-87.23242,36.49577,22218,32,52,20,62.5
37046,tn,-86.71735,35.77987,3569,27,46,19,70.4
37047,tn,-86.83581,35.31732,1434,23,41,18,78.3
37048,tn,-86.59591,36.49134,3179,23,42,19,82.6
37049,tn,-86.67721,36.56008,1750,25,45,20,80
37050,tn,-87.63061,36.37287,1287,33,53,20,60.6
37051,tn,-87.41026,36.30428,2221,34,54,20,58.8
37052,tn,-87.39877,36.37347,1556,33,53,20,60.6
37055,tn,-87.44265,36.0785,13015,38,58,20,52.6
37057,tn,-86.02838,36.40327,556,33,54,21,63.6
37058,tn,-87.87961,36.47883,5853,31,50,19,61.3
37059,tn,-85.90928,35.98747,874,19,37,18,94.7
37060,tn,-86.63775,35.74548,1632,27,47,20,74.1
37061,tn,-87.65521,36.28316,3147,32,53,21,65.6
37062,tn,-87.13346,35.9832,5527,33,53,20,60.6
37064,tn,-86.95883,35.88756,24842,29,49,20,69
37066,tn,-86.45527,36.39869,21505,27,47,20,74.1
37067,tn,-86.77835,35.9137,9808,28,48,20,71.4
37069,tn,-86.90485,35.98849,7912,29,48,19,65.5
37072,tn,-86.74424,36.35752,12864,25,45,20,80
37073,tn,-86.81412,36.4279,6225,23,42,19,82.6
37074,tn,-86.14428,36.41899,4229,33,55,22,66.7
37075,tn,-86.60659,36.34002,24057,25,44,19,76
37076,tn,-86.58185,36.14942,13976,25,44,19,76
37078,tn,-87.76786,35.92275,909,33,53,20,60.6
37079,tn,-87.65937,36.48172,1757,32,51,19,59.4
37080,tn,-86.91676,36.32824,4227,24,43,19,79.2
37082,tn,-87.11344,36.09665,3233,35,55,20,57.1
37083,tn,-86.0024,36.54399,7769,36,57,21,58.3
37085,tn,-86.28052,35.95484,2504,28,48,20,71.4
37086,tn,-86.55919,36.02121,11287,28,48,20,71.4
37087,tn,-86.27213,36.27277,20014,30,51,21,70
37090,tn,-86.29663,36.12507,7563,28,48,20,71.4
37091,tn,-86.76277,35.48619,10847,27,46,19,70.4
37095,tn,-85.96212,35.98209,1377,22,41,19,86.4
37096,tn,-87.86555,35.60375,5517,30,49,19,63.3
37097,tn,-87.82658,35.7696,2404,31,51,20,64.5
37098,tn,-87.31517,35.86809,2844,35,55,20,57.1
37101,tn,-87.63499,36.06551,3973,34,54,20,58.8
37110,tn,-85.74463,35.64416,18172,19,37,18,94.7
37115,tn,-86.69606,36.25448,12907,26,46,20,76.9
37118,tn,-86.19023,35.93026,773,26,46,20,76.9
37122,tn,-86.48888,36.17752,24553,26,45,19,73.1
37127,tn,-86.32772,35.78121,7283,28,48,20,71.4
37128,tn,-86.47277,35.79916,18029,28,48,20,71.4
37129,tn,-86.44047,35.92714,21362,28,48,20,71.4
37130,tn,-86.32911,35.87897,15842,28,48,20,71.4
37132,tn,-86.36432,35.84927,3,29,49,20,69
37134,tn,-87.95078,36.00132,1769,36,57,21,58.3
37135,tn,-86.66601,35.93631,8450,26,45,19,73.1
37137,tn,-87.50116,35.87603,5611,35,55,20,57.1
37138,tn,-86.61936,36.24668,10226,25,44,19,76
37140,tn,-87.65249,35.85915,167,32,52,20,62.5
37141,tn,-86.70197,36.61496,722,26,46,20,76.9
37142,tn,-87.50134,36.41115,1125,32,53,21,65.6
37143,tn,-87.03099,36.12777,2106,30,50,20,66.7
37144,tn,-86.66032,35.30524,2184,23,42,19,82.6
37145,tn,-85.91222,36.37943,1588,28,48,20,71.4
37146,tn,-87.03331,36.40165,3549,29,49,20,69
37148,tn,-86.50181,36.57394,11805,24,44,20,83.3
37149,tn,-86.19282,35.80404,1428,26,46,20,76.9
37150,tn,-85.81352,36.54104,3512,27,48,21,77.8
37151,tn,-86.03989,36.31759,375,31,52,21,67.7
37153,tn,-86.554,35.76388,3036,27,46,19,70.4
37160,tn,-86.48383,35.46395,14849,27,47,20,74.1
37165,tn,-87.47027,36.2923,48,33,53,20,60.6
37166,tn,-85.78931,35.9246,12075,19,37,18,94.7
37167,tn,-86.53271,35.95856,18145,28,49,21,75
37171,tn,-87.29988,36.36655,667,35,55,20,57.1
37172,tn,-86.86097,36.5355,13904,27,46,19,70.4
37174,tn,-86.89987,35.72177,16338,31,50,19,61.3
37175,tn,-87.89722,36.32703,1575,32,53,21,65.6
37178,tn,-87.7842,36.3232,1390,31,51,20,64.5
37179,tn,-86.92771,35.81156,7705,29,49,20,69
37180,tn,-86.58123,35.61159,1504,29,49,20,69
37181,tn,-87.48185,36.24481,951,34,55,21,61.8
37183,tn,-86.30892,35.50288,2059,22,41,19,86.4
37184,tn,-86.14409,36.08245,3398,25,44,19,76
37185,tn,-87.838,36.06968,6715,34,53,19,55.9
37186,tn,-86.23012,36.58709,5064,29,50,21,72.4
37187,tn,-87.19959,36.14706,3652,38,58,20,52.6
37188,tn,-86.6813,36.48021,6267,22,41,19,86.4
37189,tn,-86.82827,36.28035,2196,26,45,19,73.1
37190,tn,-86.0399,35.82912,5010,22,41,19,86.4
37191,tn,-87.53124,36.49963,2073,32,53,21,65.6
37201,tn,-86.77742,36.16598,446,27,46,19,70.4
37203,tn,-86.79032,36.14924,5501,26,45,19,73.1
37204,tn,-86.77428,36.10674,6168,25,44,19,76
37205,tn,-86.87254,36.11121,9854,26,46,20,76.9
37206,tn,-86.73104,36.18093,10878,26,45,19,73.1
37207,tn,-86.77653,36.23285,14630,26,46,20,76.9
37208,tn,-86.80784,36.17778,8232,27,46,19,70.4
37209,tn,-86.9216,36.15547,15592,28,47,19,67.9
37210,tn,-86.73363,36.14433,5974,25,45,20,80
37211,tn,-86.7237,36.06723,21244,25,44,19,76
37212,tn,-86.80125,36.13388,5169,25,45,20,80
37213,tn,-86.76695,36.16627,129,27,46,19,70.4
37214,tn,-86.6651,36.16308,12806,25,45,20,80
37215,tn,-86.8347,36.08188,10410,24,43,19,79.2
37216,tn,-86.72643,36.21605,9080,26,45,19,73.1
37217,tn,-86.659,36.10513,8260,25,44,19,76
37218,tn,-86.89262,36.20694,6631,28,48,20,71.4
37219,tn,-86.78319,36.1668,321,27,46,19,70.4
37220,tn,-86.78089,36.0673,2706,25,44,19,76
37221,tn,-86.97339,36.05563,16031,29,48,19,65.5
37228,tn,-86.80409,36.19503,166,27,47,20,74.1
37240,tn,-86.80547,36.14489,2,25,45,20,80
37243,tn,-86.78214,36.16501,8,27,46,19,70.4
37246,tn,-86.79145,36.15986,2,27,46,19,70.4
37301,tn,-85.79525,35.41971,1521,9,22,13,144.4
37302,tn,-85.01628,35.01324,2130,18,35,17,94.4
37303,tn,-84.6432,35.44069,13325,23,43,20,87
37305,tn,-85.69426,35.4652,860,10,24,14,140
37306,tn,-86.18919,35.09858,1870,18,35,17,94.4
37307,tn,-84.62581,35.16905,3046,17,34,17,100
37308,tn,-84.99611,35.34824,1781,22,41,19,86.4
37309,tn,-84.73761,35.30338,1412,23,42,19,82.6
37310,tn,-84.7801,35.2639,2757,22,42,20,90.9
37311,tn,-84.92862,35.11288,13861,19,36,17,89.5
37312,tn,-84.87065,35.22986,15889,20,38,18,90
37313,tn,-85.71265,35.36126,1310,9,23,14,155.6
37315,tn,-85.05155,35.04827,4,19,36,17,89.5
37317,tn,-84.44346,35.03148,2250,8,21,13,162.5
37318,tn,-85.99265,35.17782,1176,15,31,16,106.7
37321,tn,-85.0077,35.50217,10115,24,45,21,87.5
37322,tn,-84.81604,35.49562,5952,26,48,22,84.6
37323,tn,-84.82057,35.09721,16014,20,38,18,90
37324,tn,-85.99128,35.25513,3338,18,35,17,94.4
37325,tn,-84.59176,35.24958,1145,18,35,17,94.4
37326,tn,-84.38468,35.04003,330,9,22,13,144.4
37327,tn,-85.40584,35.42275,9210,16,32,16,100
37328,tn,-86.3667,35.02721,783,19,36,17,89.5
37329,tn,-84.46103,35.39437,3430,19,38,19,100
37330,tn,-86.12995,35.2818,4063,21,39,18,85.7
37331,tn,-84.53025,35.31934,5028,19,37,18,94.7
37332,tn,-84.97312,35.59543,1644,26,46,20,76.9
37333,tn,-84.33545,35.15375,378,9,22,13,144.4
37334,tn,-86.58111,35.16681,11914,23,41,18,78.3
37335,tn,-86.40464,35.06482,1588,21,39,18,85.7
37336,tn,-84.93329,35.30249,2703,21,40,19,90.5
37337,tn,-84.87055,35.78338,1361,14,30,16,114.3
37338,tn,-85.21402,35.42081,2165,13,28,15,115.4
37339,tn,-85.63423,35.37997,1304,8,21,13,162.5
37340,tn,-85.52315,35.03171,423,15,31,16,106.7
37341,tn,-85.08403,35.21552,6022,21,39,18,85.7
37342,tn,-85.94763,35.38823,2223,18,35,17,94.4
37343,tn,-85.20912,35.16886,18019,23,41,18,78.3
37345,tn,-86.24025,35.03672,1460,19,36,17,89.5
37347,tn,-85.61894,35.06114,5283,25,44,19,76
37348,tn,-86.43732,35.12594,834,21,39,18,85.7
37350,tn,-85.35018,34.99392,901,17,33,16,94.1
37351,tn,-85.26147,35.10096,283,23,41,18,78.3
37352,tn,-86.35526,35.28092,2149,21,39,18,85.7
37353,tn,-84.98668,35.11863,2627,19,36,17,89.5
37354,tn,-84.34846,35.5001,9250,17,36,19,111.8
37355,tn,-86.08475,35.50099,13236,18,35,17,94.4
37356,tn,-85.82421,35.229,2455,10,24,14,140
37357,tn,-85.9172,35.5861,3719,18,36,18,100
37359,tn,-86.41287,35.2042,545,22,41,19,86.4
37360,tn,-86.25495,35.44057,1072,19,36,17,89.5
37361,tn,-84.68634,35.09883,1342,20,37,17,85
37362,tn,-84.68734,35.03523,2060,19,37,18,94.7
37363,tn,-85.06431,35.11411,16891,18,36,18,100
37365,tn,-85.56121,35.38229,898,7,19,12,171.4
37366,tn,-85.83805,35.3212,755,13,29,16,123.1
37367,tn,-85.22662,35.6317,7901,14,29,15,107.1
37369,tn,-84.47983,35.19206,1100,14,30,16,114.3
37370,tn,-84.7029,35.36002,2778,23,43,20,87
37373,tn,-85.1027,35.39789,2053,22,41,19,86.4
37374,tn,-85.65649,35.18909,1754,16,32,16,100
37375,tn,-85.89178,35.1543,1901,11,25,14,127.3
37376,tn,-85.95583,35.04777,439,17,33,16,94.1
37377,tn,-85.33526,35.20882,8024,14,29,15,107.1
37379,tn,-85.17353,35.29451,14476,21,40,19,90.5
37380,tn,-85.75433,35.07593,4877,22,40,18,81.8
37381,tn,-84.87676,35.68138,9406,22,41,19,86.4
37385,tn,-84.24297,35.33118,6494,12,27,15,125
37387,tn,-85.7469,35.2733,2441,9,23,14,155.6
37388,tn,-86.21999,35.34684,12260,19,36,17,89.5
37391,tn,-84.35291,35.0894,1464,8,20,12,150
37394,tn,-85.86005,35.53941,67,18,36,18,100
37396,tn,-85.49973,35.0058,184,14,28,14,100
37397,tn,-85.51563,35.21758,6280,18,34,16,88.9
37398,tn,-86.13983,35.18374,9583,20,38,18,90
37402,tn,-85.31836,35.04364,469,22,40,18,81.8
37403,tn,-85.29445,35.04771,1267,21,38,17,81
37404,tn,-85.27366,35.02791,6322,21,38,17,81
37405,tn,-85.40589,35.12138,6911,21,38,17,81
37406,tn,-85.24553,35.07226,7073,23,41,18,78.3
37407,tn,-85.28961,35.00205,4225,19,36,17,89.5
37408,tn,-85.30855,35.02863,1441,22,39,17,77.3
37409,tn,-85.34474,35.00185,1857,22,39,17,77.3
37410,tn,-85.31374,35.00208,1747,22,39,17,77.3
37411,tn,-85.22616,35.02876,7614,23,42,19,82.6
37412,tn,-85.22743,34.99752,8393,23,41,18,78.3
37415,tn,-85.28014,35.12734,9637,23,41,18,78.3
37416,tn,-85.17661,35.10446,6294,22,41,19,86.4
37419,tn,-85.40819,35.03831,3696,17,33,16,94.1
37421,tn,-85.15096,35.02891,17898,21,39,18,85.7
37601,tn,-82.32147,36.33029,14319,4,14,10,250
37604,tn,-82.38319,36.29958,14233,3,10,7,233.3
37614,tn,-82.37124,36.30139,3,1,5,4,400
37615,tn,-82.45225,36.39959,10272,5,15,10,200
37616,tn,-82.74757,36.22651,3118,8,21,13,162.5
37617,tn,-82.37209,36.53066,7161,4,14,10,250
37618,tn,-82.20727,36.4657,6581,4,14,10,250
37620,tn,-82.09765,36.5514,17966,4,13,9,225
37640,tn,-81.97856,36.32922,4800,1,3,2,200
37641,tn,-82.66423,36.19903,5684,6,17,11,183.3
37642,tn,-82.7299,36.52901,7952,8,21,13,162.5
37643,tn,-82.13641,36.37734,17418,3,9,6,200
37645,tn,-82.6624,36.56208,2703,8,20,12,150
37650,tn,-82.45619,36.10445,6516,1,4,3,300
37656,tn,-82.62986,36.39881,2377,3,12,9,300
37657,tn,-82.56013,36.01759,878,0,1,1,NA
37658,tn,-82.14066,36.25846,2727,0,2,2,NA
37659,tn,-82.49389,36.2801,15391,4,13,9,225
37660,tn,-82.57451,36.52907,18335,8,21,13,162.5
37663,tn,-82.48631,36.46572,7213,6,17,11,183.3
37664,tn,-82.50573,36.51331,13251,6,17,11,183.3
37665,tn,-82.57053,36.57877,2766,8,21,13,162.5
37680,tn,-81.72541,36.57929,657,0,0,0,NA
37681,tn,-82.62498,36.25403,3727,7,20,13,185.7
37682,tn,-82.29077,36.30106,35,2,9,7,350
37683,tn,-81.82205,36.45474,8145,0,1,1,NA
37686,tn,-82.34492,36.44202,4414,5,16,11,220
37687,tn,-82.09915,36.18,3942,0,0,0,NA
37688,tn,-81.88284,36.54545,947,0,1,1,NA
37690,tn,-82.55648,36.24921,2316,6,18,12,200
37691,tn,-81.75673,36.37168,794,0,0,0,NA
37692,tn,-82.30084,36.18981,2955,1,3,2,200
37694,tn,-82.27586,36.38622,1117,5,16,11,220
37701,tn,-83.98461,35.79425,4028,17,35,18,105.9
37705,tn,-84.01002,36.22897,3051,13,29,16,123.1
37708,tn,-83.33404,36.32523,4227,13,30,17,130.8
37709,tn,-83.66478,36.16498,2260,16,34,18,112.5
37710,tn,-84.31612,36.15862,781,9,22,13,144.4
37711,tn,-83.03737,36.28321,3080,12,28,16,133.3
37713,tn,-83.13206,36.09019,1065,13,29,16,123.1
37714,tn,-84.26984,36.2664,2846,11,26,15,136.4
37715,tn,-83.96053,36.55423,617,6,17,11,183.3
37716,tn,-84.16806,36.09954,12052,16,34,18,112.5
37719,tn,-84.42938,36.02241,104,16,33,17,106.3
37721,tn,-83.80703,36.13177,6558,14,31,17,121.4
37722,tn,-83.2345,35.80702,5898,4,12,8,200
37723,tn,-84.82057,35.9537,1724,7,18,11,157.1
37724,tn,-83.70096,36.5469,1475,11,25,14,127.3
37725,tn,-83.39816,35.9987,12850,13,30,17,130.8
37726,tn,-84.83439,36.20756,1915,6,18,12,200
37727,tn,-83.00725,35.88802,2511,5,14,9,180
37729,tn,-84.03448,36.51667,997,7,19,12,171.4
37730,tn,-83.97555,36.54734,38,6,17,11,183.3
37731,tn,-83.00654,36.54331,849,6,17,11,183.3
37732,tn,-84.60636,36.32704,96,8,22,14,175
37733,tn,-84.71123,36.35408,173,9,23,14,155.6
37737,tn,-84.11974,35.75769,3217,16,34,18,112.5
37738,tn,-83.47484,35.67021,8083,2,8,6,300
37742,tn,-84.18028,35.6754,3565,17,35,18,105.9
37743,tn,-82.85681,36.06548,15456,9,23,14,155.6
37745,tn,-82.82389,36.27441,10335,10,25,15,150
37748,tn,-84.51339,35.94878,10957,19,38,19,100
37752,tn,-83.53978,36.56933,3679,10,23,13,130
37753,tn,-83.10041,35.82314,869,1,7,6,600
37754,tn,-84.03297,36.1311,2347,14,31,17,121.4
37755,tn,-84.52723,36.41291,2110,9,22,13,144.4
37756,tn,-84.41981,36.30461,1778,7,18,11,157.1
37757,tn,-84.14315,36.30166,5477,12,28,16,133.3
37760,tn,-83.46451,36.11046,5902,11,26,15,136.4
37762,tn,-84.12595,36.57706,1735,8,20,12,150
37763,tn,-84.49248,35.82253,9967,19,37,18,94.7
37764,tn,-83.61713,35.97096,4789,16,34,18,112.5
37765,tn,-83.06488,36.57193,473,8,21,13,162.5
37766,tn,-84.08637,36.39802,13333,12,27,15,125
37769,tn,-84.15333,36.21837,3100,14,31,17,121.4
37770,tn,-84.66324,36.1533,2187,9,22,13,144.4
37771,tn,-84.31655,35.8393,8620,19,39,20,105.3
37772,tn,-84.21878,35.78827,7905,18,37,19,105.6
37774,tn,-84.35411,35.73041,14301,19,38,19,100
37777,tn,-84.05212,35.82712,5570,16,34,18,112.5
37779,tn,-83.75606,36.21512,2206,12,27,15,125
37801,tn,-84.08769,35.66811,11745,16,34,18,112.5
37803,tn,-83.98471,35.66054,14593,14,30,16,114.3
37804,tn,-83.89316,35.79205,11057,16,34,18,112.5
37806,tn,-83.72848,36.08381,1615,17,35,18,105.9
37807,tn,-83.82801,36.26002,6499,12,27,15,125
37809,tn,-83.03485,36.15417,1416,12,28,16,133.3
37810,tn,-83.10308,36.18019,1329,13,30,17,130.8
37811,tn,-83.21484,36.35523,2623,13,29,16,123.1
37813,tn,-83.26502,36.176,8630,12,27,15,125
37814,tn,-83.33154,36.23562,14802,11,26,15,136.4
37818,tn,-82.96876,36.18917,3225,12,27,15,125
37819,tn,-84.21198,36.55417,461,8,20,12,150
37820,tn,-83.56635,36.08533,4199,13,29,16,123.1
37821,tn,-83.19481,35.97622,13047,10,25,15,150
37825,tn,-83.69152,36.41242,6568,11,26,15,136.4
37826,tn,-84.58969,35.55829,2742,18,37,19,105.6
37828,tn,-84.06899,36.19793,714,14,30,16,114.3
37829,tn,-84.6324,36.00388,1218,14,31,17,121.4
37830,tn,-84.29123,35.96499,13590,17,35,18,105.9
37840,tn,-84.37546,36.05937,5145,16,34,18,112.5
37841,tn,-84.57838,36.51842,6266,8,21,13,162.5
37843,tn,-83.05139,36.00786,2553,10,24,14,140
37845,tn,-84.4395,36.09337,328,5,14,9,180
37846,tn,-84.48497,35.68052,2730,17,35,18,105.9
37847,tn,-84.27889,36.4342,1868,5,16,11,220
37848,tn,-83.68013,36.23572,182,12,27,15,125
37849,tn,-84.04312,36.0585,11171,14,31,17,121.4
37851,tn,-83.90627,36.58227,18,4,14,10,250
37852,tn,-84.58393,36.32639,1954,8,22,14,175
37853,tn,-83.91278,35.8363,1739,17,35,18,105.9
37854,tn,-84.71717,35.87867,9974,17,34,17,100
37857,tn,-82.94223,36.42007,15344,10,25,15,150
37860,tn,-83.18251,36.25304,2247,13,29,16,123.1
37861,tn,-83.51234,36.24647,5736,13,29,16,123.1
37862,tn,-83.61251,35.77805,15719,10,24,14,140
37863,tn,-83.56222,35.78597,4047,11,26,15,136.4
37865,tn,-83.74097,35.84936,10537,14,31,17,121.4
37866,tn,-83.85619,36.34644,2840,13,29,16,123.1
37869,tn,-83.24124,36.5185,4149,7,20,13,185.7
37870,tn,-83.83519,36.4634,4467,12,27,15,125
37871,tn,-83.67887,36.04933,4640,15,33,18,120
37872,tn,-84.6495,36.26952,1683,7,19,12,171.4
37873,tn,-82.84799,36.5258,2774,9,23,14,155.6
37874,tn,-84.45767,35.5981,8339,17,35,18,105.9
37876,tn,-83.4794,35.86583,27502,11,26,15,136.4
37877,tn,-83.403,36.15094,4512,11,26,15,136.4
37878,tn,-83.9032,35.62121,1745,8,20,12,150
37879,tn,-83.49524,36.47714,7854,10,23,13,130
37880,tn,-84.66845,35.69983,3184,21,40,19,90.5
37881,tn,-83.34147,36.40095,1716,8,21,13,162.5
37882,tn,-83.80998,35.60487,3919,7,18,11,157.1
37885,tn,-84.12127,35.48824,5386,18,36,18,100
37886,tn,-83.8047,35.74559,2870,12,27,15,125
37887,tn,-84.58468,36.09667,2754,10,24,14,140
37888,tn,-83.61135,36.31022,1714,10,24,14,140
37890,tn,-83.29332,36.08151,4876,15,33,18,120
37891,tn,-83.13772,36.29001,2044,13,29,16,123.1
37892,tn,-84.37175,36.55319,1333,7,19,12,171.4
37902,tn,-83.92018,35.96375,642,17,35,18,105.9
37909,tn,-84.02141,35.94756,5039,15,33,18,120
37912,tn,-83.98485,36.00754,8133,15,33,18,120
37914,tn,-83.79916,35.9796,11265,18,37,19,105.6
37915,tn,-83.89996,35.97054,1724,17,36,19,111.8
37916,tn,-83.93346,35.95312,1066,17,35,18,105.9
37917,tn,-83.9137,36.00119,12406,16,35,19,118.8
37918,tn,-83.90935,36.06085,18382,15,32,17,113.3
37919,tn,-84.00106,35.91432,11912,16,34,18,112.5
37920,tn,-83.85928,35.91071,19166,16,34,18,112.5
37921,tn,-84.00292,35.9793,12822,15,33,18,120
37922,tn,-84.10031,35.86153,15018,17,35,18,105.9
37923,tn,-84.08014,35.92612,9768,15,32,17,113.3
37924,tn,-83.80247,36.03578,5928,17,35,18,105.9
37931,tn,-84.12519,35.97603,11184,14,31,17,121.4
37932,tn,-84.19589,35.92252,7265,15,32,17,113.3
37934,tn,-84.17914,35.87291,10856,17,36,19,111.8
37938,tn,-83.9386,36.12392,8505,13,30,17,130.8
38001,tn,-89.15656,35.81096,3109,36,57,21,58.3
38002,tn,-89.7084,35.28694,16995,42,64,22,52.4
38004,tn,-89.76743,35.41885,4669,43,65,22,51.2
38006,tn,-89.09723,35.6949,3261,38,59,21,55.3
38007,tn,-89.42709,36.15949,99,34,54,20,58.8
38008,tn,-88.99496,35.24683,5590,41,63,22,53.7
38011,tn,-89.70725,35.46698,4558,41,63,22,53.7
38012,tn,-89.27013,35.60825,7672,38,60,22,57.9
38015,tn,-89.82295,35.55877,1632,42,63,21,50
38016,tn,-89.75881,35.1798,15239,42,64,22,52.4
38017,tn,-89.65069,35.06745,20148,41,63,22,53.7
38018,tn,-89.76598,35.13814,13499,43,64,21,48.8
38019,tn,-89.63021,35.56347,7529,40,62,22,55
38021,tn,-89.16475,35.87585,41,36,56,20,55.6
38023,ar,-89.94513,35.47945,3137,46,66,21,46.2
38024,tn,-89.38072,36.03641,13868,33,53,20,60.6
38028,tn,-89.63489,35.18304,3782,41,63,22,53.7
38029,tn,-89.8219,35.23874,37,43,65,22,51.2
38030,tn,-89.5914,36.01231,972,34,55,21,61.8
38034,tn,-89.2344,35.90977,2417,35,56,21,60
38036,tn,-89.62582,35.32022,96,42,64,22,52.4
38037,tn,-89.39379,35.79606,1208,36,57,21,58.3
38039,tn,-89.18223,35.05817,1317,41,62,21,51.2
38040,tn,-89.43396,35.88517,3196,35,55,20,57.1
38041,tn,-89.70453,35.64367,1741,39,60,21,53.8
38042,tn,-89.13847,35.14743,615,41,62,21,51.2
38044,tn,-88.80321,35.20542,702,43,64,21,48.8
38046,tn,-89.24796,35.06992,123,42,63,21,50
38047,tn,-89.50341,36.09053,62,31,51,20,64.5
38049,tn,-89.54865,35.39031,2934,41,62,21,51.2
38050,tn,-89.23306,35.82962,345,36,57,21,58.3
38052,tn,-88.91096,35.08628,3298,42,63,21,50
38053,ar,-89.95339,35.34417,11779,46,67,22,47.25
38057,tn,-89.36721,35.05334,2183,42,63,21,50
38058,tn,-89.8197,35.45894,4371,43,65,22,51.2
38059,tn,-89.2452,36.11112,4508,33,54,21,63.6
38060,tn,-89.50331,35.20909,5772,41,63,22,53.7
38061,tn,-88.76753,35.06499,874,42,63,21,50
38063,ar,-89.63992,35.756,8874,38,60,21,54.75
38066,tn,-89.5323,35.07478,1966,42,63,21,50
38067,tn,-89.04263,35.09289,4931,40,61,21,52.5
38068,tn,-89.33587,35.26681,6282,41,62,21,51.2
38069,tn,-89.36436,35.46388,1938,40,61,21,52.5
38070,tn,-89.23701,35.94356,158,35,55,20,57.1
38075,tn,-89.15181,35.36841,2314,40,61,21,52.5
38076,tn,-89.4381,35.13548,533,41,62,21,51.2
38077,tn,-89.47439,36.32808,34,35,56,21,60
38079,ky,-89.46298,36.43033,2447,36,56,21,59.15
38080,tn,-89.52712,36.20974,1883,34,55,21,61.8
38103,tn,-90.05552,35.15301,5081,42,64,22,52.4
38104,tn,-90.00373,35.13255,8233,41,63,22,53.7
38105,tn,-90.03506,35.15121,1793,42,64,22,52.4
38106,tn,-90.09673,35.10133,14676,41,63,22,53.7
38107,tn,-90.02373,35.1702,9309,43,65,22,51.2
38108,tn,-89.9697,35.17608,9632,43,65,22,51.2
38109,tn,-90.1494,35.03383,21768,42,63,21,50
38111,tn,-89.94415,35.11017,16050,42,63,21,50
38112,tn,-89.97667,35.14785,6862,42,64,22,52.4
38114,tn,-89.98585,35.09648,11836,41,63,22,53.7
38115,tn,-89.86362,35.05497,7933,42,64,22,52.4
38116,tn,-90.01096,35.03341,11206,41,62,21,51.2
38117,tn,-89.90535,35.11518,12195,42,64,22,52.4
38118,tn,-89.93151,35.03599,12805,41,63,22,53.7
38119,tn,-89.84588,35.07981,7278,42,64,22,52.4
38120,tn,-89.8522,35.12356,5830,42,64,22,52.4
38122,tn,-89.92122,35.15893,10250,43,65,22,51.2
38125,tn,-89.78864,35.02591,12163,42,64,22,52.4
38126,tn,-90.04366,35.12697,2838,41,63,22,53.7
38127,tn,-90.01759,35.23766,16210,44,66,22,50
38128,tn,-89.92615,35.22609,13578,44,65,21,47.7
38131,tn,-89.99209,35.06636,36,40,62,22,55
38132,tn,-90.00135,35.07126,78,41,62,21,51.2
38133,tn,-89.7943,35.21288,7805,42,64,22,52.4
38134,tn,-89.85991,35.17694,11853,43,65,22,51.2
38135,tn,-89.84939,35.23822,11079,43,65,22,51.2
38138,tn,-89.79933,35.08483,9885,42,64,22,52.4
38139,tn,-89.75538,35.08548,6215,42,64,22,52.4
38141,tn,-89.85479,35.01603,8144,42,64,22,52.4
38152,tn,-89.93404,35.12277,15,42,63,21,50
38201,tn,-88.52914,36.12285,5828,33,53,20,60.6
38220,tn,-88.67055,35.98794,1314,36,57,21,58.3
38221,tn,-88.03582,36.245,4194,35,56,21,60
38222,tn,-88.16473,36.44528,3863,36,56,20,55.6
38224,tn,-88.48612,36.39145,754,31,51,20,64.5
38225,tn,-88.67906,36.32087,3819,32,53,21,65.6
38226,tn,-88.68218,36.48137,360,34,54,20,58.8
38229,tn,-88.60838,36.21999,1913,33,54,21,63.6
38230,tn,-88.77124,36.15611,2697,35,56,21,60
38231,tn,-88.42521,36.21179,1178,31,51,20,64.5
38232,tn,-89.32269,36.34942,1656,33,54,21,63.6
38233,tn,-89.04854,36.20283,2158,35,56,21,60
38235,tn,-88.564,35.98928,320,34,54,20,58.8
38236,tn,-88.27248,36.17193,463,34,55,21,61.8
38237,tn,-88.83436,36.3595,7244,34,55,21,61.8
38240,tn,-89.31929,36.2513,1812,35,56,21,60
38241,tn,-88.58492,36.42579,920,33,53,20,60.6
38242,tn,-88.32801,36.30372,11673,32,52,20,62.5
38251,tn,-88.35597,36.44525,2065,31,51,20,64.5
38253,tn,-89.05193,36.29684,917,35,56,21,60
38254,tn,-89.3474,36.3749,100,33,54,21,63.6
38255,tn,-88.86376,36.2386,1556,35,56,21,60
38256,tn,-88.13044,36.3064,5264,37,57,20,54.1
38257,tn,-88.87412,36.46033,2825,34,54,20,58.8
38258,tn,-88.6174,36.02598,1020,35,55,20,57.1
38259,tn,-89.18378,36.20015,625,35,56,21,60
38260,tn,-89.21066,36.36545,2334,33,54,21,63.6
38261,tn,-89.11649,36.43239,9059,34,55,21,61.8
38301,tn,-88.85281,35.58602,17966,37,59,22,59.5
38305,tn,-88.76793,35.70199,21631,36,57,21,58.3
38310,tn,-88.39882,35.25848,5386,42,64,22,52.4
38311,tn,-88.10558,35.43639,1732,37,57,20,54.1
38313,tn,-88.62502,35.60024,2080,37,58,21,56.8
38315,tn,-88.62638,35.26726,2745,39,60,21,53.8
38316,tn,-88.81494,36.0685,2029,36,57,21,58.3
38317,tn,-88.27449,36.05458,1622,35,56,21,60
38318,tn,-88.26284,35.95571,479,34,54,20,58.8
38320,tn,-88.11364,36.05142,7687,37,58,21,56.8
38321,tn,-88.52987,35.83714,2257,33,54,21,63.6
38326,ms,-88.28785,35.0579,4828,39,60,20,52.55
38327,tn,-88.2991,35.22126,1153,44,65,21,47.7
38328,tn,-88.21657,35.67783,538,38,58,20,52.6
38329,tn,-88.11061,35.54408,4269,35,56,21,60
38330,tn,-89.03653,36.06712,2680,36,56,20,55.6
38332,tn,-88.42646,35.4191,977,38,59,21,55.3
38333,tn,-87.96955,36.12376,528,37,57,20,54.1
38334,tn,-88.58759,35.35443,1317,39,61,22,56.4
38337,tn,-89.01402,35.78528,922,37,58,21,56.8
38339,tn,-88.51506,35.05239,555,40,61,21,52.5
38340,tn,-88.68046,35.39986,6862,40,61,21,52.5
38341,tn,-88.09094,35.87979,3580,35,55,20,57.1
38342,tn,-88.28377,36.10496,1089,34,55,21,61.8
38343,tn,-88.92624,35.82688,9425,37,58,21,56.8
38344,tn,-88.42845,35.97829,5769,34,55,21,61.8
38345,tn,-88.5126,35.59365,1223,36,57,21,58.3
38347,tn,-88.4986,35.47777,178,35,56,21,60
38348,tn,-88.65383,35.86851,677,34,55,21,61.8
38351,tn,-88.40306,35.66539,10186,37,58,21,56.8
38352,tn,-88.53213,35.53164,406,36,57,21,58.3
38355,tn,-88.76758,35.78692,3250,36,57,21,58.3
38356,tn,-88.89534,35.43448,1495,41,63,22,53.7
38357,tn,-88.41542,35.0458,1988,40,61,21,52.5
38358,tn,-88.75926,35.91668,6356,37,58,21,56.8
38359,tn,-88.35136,35.36984,261,40,62,22,55
38361,tn,-88.28502,35.31761,1304,41,62,21,51.2
38362,tn,-88.78298,35.72907,551,36,57,21,58.3
38363,tn,-88.11316,35.68529,4992,37,57,20,54.1
38365,tn,-88.2357,35.05367,1,38,58,20,52.6
38366,tn,-88.74606,35.47608,1330,40,61,21,52.5
38367,tn,-88.62789,35.0529,2043,41,62,21,51.2
38368,tn,-88.35345,35.50484,1277,37,58,21,56.8
38369,tn,-88.96121,36.13229,1368,36,57,21,58.3
38370,tn,-88.24395,35.38412,895,40,61,21,52.5
38371,tn,-88.29818,35.42297,1025,38,59,21,55.3
38372,tn,-88.1437,35.16948,14252,38,59,21,55.3
38374,tn,-88.23484,35.51579,1413,36,57,21,58.3
38375,tn,-88.58933,35.1577,5851,39,60,21,53.8
38376,tn,-88.37191,35.10333,260,41,63,22,53.7
38379,tn,-88.43376,35.16424,901,42,63,21,50
38380,tn,-88.03261,35.796,2239,35,56,21,60
38381,tn,-88.96623,35.35711,975,42,64,22,52.4
38382,tn,-88.99291,35.96724,6256,37,58,21,56.8
38387,tn,-88.27753,35.86742,312,33,53,20,60.6
38388,tn,-88.32136,35.7813,1382,35,56,21,60
38390,tn,-88.3723,35.84053,620,34,54,20,58.8
38391,tn,-88.99402,35.55103,1182,39,60,21,53.8
38392,tn,-89.03333,35.46457,649,41,62,21,51.2
38401,tn,-87.02062,35.62903,27554,29,49,20,69
38425,tn,-87.94816,35.40585,3129,33,53,20,60.6
38449,tn,-86.82593,35.04823,1975,21,39,18,85.7
38450,tn,-87.79176,35.18437,1986,20,38,18,90
38451,tn,-86.99182,35.46634,2580,25,43,18,72
38452,tn,-87.7963,35.08036,829,23,42,19,82.6
38453,tn,-86.81211,35.12136,295,24,42,18,75
38454,tn,-87.35211,35.72321,890,32,52,20,62.5
38455,tn,-86.88673,35.04899,148,23,41,18,78.3
38456,tn,-87.2664,35.33546,2232,19,36,17,89.5
38457,tn,-87.28444,35.02932,581,26,44,18,69.2
38459,tn,-86.80545,35.19428,320,23,42,19,82.6
38460,tn,-87.15319,35.08867,791,22,39,17,77.3
38461,tn,-87.34195,35.59302,1007,28,47,19,67.9
38462,tn,-87.55161,35.53112,6515,26,45,19,73.1
38463,tn,-87.64449,35.06824,2121,27,46,19,70.4
38464,tn,-87.42957,35.28669,12592,18,36,18,100
38468,tn,-87.29381,35.131,3330,21,38,17,81
38469,tn,-87.42725,35.07175,2619,24,43,19,79.2
38471,tn,-87.92141,35.07437,517,25,44,19,76
38472,tn,-87.03858,35.37758,1838,23,41,18,78.3
38473,tn,-87.17109,35.02768,685,26,44,18,69.2
38474,tn,-87.22654,35.51685,4509,26,45,19,73.1
38475,tn,-88.01612,35.25349,626,32,52,20,62.5
38476,tn,-87.21373,35.84121,892,33,52,19,57.6
38477,tn,-87.00393,35.05243,1979,26,44,18,69.2
38478,tn,-87.01128,35.21489,9923,25,44,19,76
38481,tn,-87.49238,35.0313,685,27,45,18,66.7
38482,tn,-87.14525,35.76891,1003,31,51,20,64.5
38483,tn,-87.33955,35.43769,3391,22,40,18,81.8
38485,tn,-87.7736,35.33675,4995,24,42,18,75
38486,tn,-87.54511,35.17058,876,25,44,19,76
38487,tn,-87.23475,35.72195,729,32,52,20,62.5
38488,tn,-86.68472,35.04056,1408,21,39,18,85.7
38501,tn,-85.53846,36.22823,15937,17,35,18,105.9
38504,tn,-84.72441,36.39559,973,9,22,13,144.4
38506,tn,-85.44081,36.18188,14851,16,34,18,112.5
38541,tn,-85.33741,36.52954,1340,18,36,18,100
38542,tn,-85.20222,36.31713,38,13,30,17,130.8
38543,tn,-85.16621,36.37242,575,14,31,17,121.4
38544,tn,-85.66489,36.11988,4635,19,38,19,100
38545,tn,-85.66283,36.23209,906,19,38,19,100
38547,tn,-86.00839,36.15174,1162,26,46,20,76.9
38548,tn,-85.79151,36.17047,537,23,43,20,87
38549,tn,-85.15167,36.56086,3981,17,36,19,111.8
38551,tn,-85.48551,36.55802,3519,23,42,19,82.6
38552,tn,-85.81001,36.22043,179,22,41,19,86.4
38553,tn,-85.00632,36.20187,1594,6,17,11,183.3
38554,tn,-85.16166,36.2495,1210,9,23,14,155.6
38555,tn,-84.98069,35.88934,11527,6,17,11,183.3
38556,tn,-84.92373,36.4094,10783,8,21,13,162.5
38558,tn,-84.87194,36.00774,17328,6,16,10,166.7
38559,tn,-85.50624,35.80758,966,18,35,17,94.4
38560,tn,-85.87017,36.23319,954,25,44,19,76
38562,tn,-85.6578,36.35438,4843,20,39,19,95
38563,tn,-86.02203,36.20009,1349,26,46,20,76.9
38564,tn,-85.7481,36.27565,631,22,42,20,90.9
38565,tn,-85.00946,36.26275,761,7,20,13,185.7
38567,tn,-85.91632,36.13571,518,25,45,20,80
38568,tn,-85.46819,36.43137,1654,19,38,19,100
38569,tn,-85.8554,36.09837,534,24,43,19,79.2
38570,tn,-85.32083,36.37413,5937,15,33,18,120
38571,tn,-85.01385,36.05274,11234,5,15,10,200
38572,tn,-85.13077,35.84872,17763,6,17,11,183.3
38573,tn,-85.21849,36.48912,1873,18,36,18,100
38574,tn,-85.23315,36.13736,6950,7,20,13,185.7
38575,tn,-85.63686,36.55964,827,24,44,20,83.3
38577,tn,-84.965,36.56488,1089,13,30,17,130.8
38578,tn,-85.19831,35.98124,149,4,14,10,250
38579,tn,-85.55188,35.83032,780,18,36,18,100
38580,tn,-85.29195,36.27812,1172,14,31,17,121.4
38581,tn,-85.61892,35.73879,3236,18,36,18,100
38582,tn,-85.75429,36.09387,1553,21,40,19,90.5
38583,tn,-85.43927,35.94325,16550,16,34,18,112.5
38585,tn,-85.42669,35.69356,4059,11,26,15,136.4
38587,tn,-85.61685,35.86949,988,19,37,18,94.7
38588,tn,-85.72128,36.45833,1030,23,43,20,87
38589,tn,-85.07711,36.28559,807,10,25,15,150
38601,ms,-89.43966,34.48202,1758,44,66,22,50
38603,ms,-89.1427,34.83461,3531,41,62,21,51.2
38606,ms,-89.95592,34.30466,10230,44,66,22,50
38610,ms,-89.02616,34.65295,2581,43,64,21,48.8
38611,ms,-89.6716,34.85317,11244,40,62,22,55
38614,ms,-90.60404,34.15578,10851,46,68,22,47.8
38617,ms,-90.52247,34.34943,945,46,68,22,47.8
38618,ms,-89.93038,34.70125,7213,39,61,22,56.4
38619,ms,-89.84233,34.51448,3535,43,65,22,51.2
38620,ms,-89.90596,34.2274,1863,44,66,22,50
38621,ms,-90.17013,34.44911,1087,44,66,22,50
38622,ms,-90.13849,34.17191,461,48,70,22,45.8
38623,ms,-90.28051,34.36162,376,47,69,22,46.8
38625,ms,-88.82567,34.6092,940,37,58,21,56.8
38626,ms,-90.41777,34.51369,1914,46,68,22,47.8
38627,ms,-89.22372,34.42429,1070,44,66,22,50
38629,ms,-89.00101,34.87502,1479,39,60,21,53.8
38630,ms,-90.68561,34.27884,102,46,68,22,47.8
38631,ms,-90.61972,34.36388,719,47,69,22,46.8
38632,ms,-90.00789,34.80031,14419,43,66,23,53.5
38633,ms,-89.19457,34.64142,2376,46,67,21,45.7
38635,ms,-89.4817,34.76804,11039,39,60,21,53.8
38637,ms,-90.05013,34.9515,9352,42,64,22,52.4
38639,ms,-90.43195,34.30306,627,47,69,22,46.8
38641,ms,-90.18971,34.91438,1522,43,65,22,51.2
38642,ms,-89.32987,34.91728,1926,39,60,21,53.8
38643,ms,-90.26631,34.15156,2480,48,70,22,45.8
38644,ms,-90.49354,34.46081,225,46,68,22,47.8
38645,ms,-90.47864,34.24561,1009,47,69,22,46.8
38646,ms,-90.29644,34.28104,3053,47,70,23,48.9
38647,ms,-89.22671,34.96079,1221,41,62,21,51.2
38650,ms,-89.14141,34.52585,2841,46,67,21,45.7
38651,ms,-90.00419,34.89148,3893,44,66,22,50
38652,ms,-88.99692,34.48347,10509,42,64,22,52.4
38654,ms,-89.82303,34.93522,23119,42,64,22,52.4
38655,ms,-89.47574,34.33305,24336,44,66,22,50
38658,ms,-89.90863,34.1916,1940,45,67,22,48.9
38659,ms,-89.31937,34.62212,2707,46,68,22,47.8
38661,ms,-89.55977,34.8962,1423,39,61,22,56.4
38663,ms,-88.88963,34.73985,8180,39,60,21,53.8
38664,ms,-90.32805,34.80956,1337,44,66,22,50
38665,ms,-90.16195,34.59101,1633,41,63,22,53.7
38666,ms,-89.91669,34.42659,4556,46,68,22,47.8
38668,ms,-89.91623,34.60128,6311,40,62,22,55
38670,ms,-90.29152,34.41564,1497,47,69,22,46.8
38671,ms,-89.9995,34.96573,13540,42,64,22,52.4
38672,ms,-89.94857,34.93786,6359,42,64,22,52.4
38673,ms,-89.61546,34.3,746,45,67,22,48.9
38674,ms,-88.89618,34.87435,858,40,61,21,52.5
38676,ar,-90.38526,34.66773,3921,44,66,22,49.45
38677,ms,-89.53718,34.36541,15,44,66,22,50
38680,ms,-90.14415,34.95261,2254,43,64,21,48.8
38683,ms,-88.87024,34.93755,4420,41,62,21,51.2
38685,ms,-89.48792,34.59957,1524,44,66,22,50
38701,ms,-91.04384,33.30988,13432,56,78,22,39.3
38702,ms,-91.17957,33.53608,60,52,74,22,42.3
38703,ms,-91.05927,33.48084,7107,55,77,22,40
38704,ms,-91.02125,33.00717,36,57,79,22,38.6
38720,ms,-90.7854,34.1239,705,48,69,21,43.8
38721,ms,-90.75039,32.98403,1407,58,80,22,37.9
38722,ms,-90.88611,33.25903,569,56,79,23,41.1
38723,ms,-91.03837,33.22966,34,57,79,22,38.6
38725,ms,-91.0277,33.65096,1059,52,74,22,42.3
38726,ms,-90.98309,33.74799,646,50,72,22,44
38730,ms,-90.78382,33.68907,1374,54,76,22,40.7
38731,ms,-91.04833,33.075,153,58,80,22,37.9
38732,ms,-90.72754,33.75623,8428,54,76,22,40.7
38736,ms,-90.53814,33.64538,640,53,75,22,41.5
38737,ms,-90.51236,33.86997,2121,52,74,22,42.3
38738,ms,-90.53112,33.939,78,50,72,22,44
38740,ms,-90.799,34.05561,795,49,70,21,42.9
38744,ms,-91.0353,33.01575,991,57,80,23,40.4
38745,ms,-90.98298,32.97745,257,57,80,23,40.4
38746,ms,-90.90988,33.96583,882,49,70,21,42.9
38748,ms,-90.9033,33.14903,3706,58,80,22,37.9
38749,ms,-90.75237,33.44742,29,54,76,22,40.7
38751,ms,-90.67951,33.44897,6206,54,77,23,42.6
38753,ms,-90.57872,33.34753,1199,55,78,23,41.8
38754,ms,-90.62235,33.24851,1470,57,80,23,40.4
38756,ms,-90.85611,33.39144,4517,54,76,22,40.7
38759,ms,-90.73133,33.82314,1267,53,75,22,41.5
38760,ms,-90.98927,33.45803,547,53,76,23,43.4
38761,ms,-90.48484,33.43207,1465,53,76,23,43.4
38762,ms,-90.71629,33.8879,2481,52,74,22,42.3
38764,ms,-90.86296,33.79006,340,53,75,22,41.5
38765,ms,-90.87461,33.06911,132,59,82,23,39
38767,ms,-90.78472,34.1405,75,47,69,22,46.8
38768,ms,-90.48726,33.96975,188,50,72,22,44
38769,ar,-90.98237,33.86459,2109,48,70,22,44.35
38771,ms,-90.52931,33.738,1679,52,75,23,44.2
38772,ms,-91.05151,33.56048,166,52,74,22,42.3
38773,ms,-90.7786,33.60625,3132,54,76,22,40.7
38774,ms,-90.76274,33.96313,1862,50,72,22,44
38778,ms,-90.52483,33.54827,1220,54,76,22,40.7
38781,ms,-90.75659,33.90855,233,52,73,21,40.4
38801,ms,-88.77303,34.22135,12788,44,66,22,50
38804,ms,-88.67147,34.28228,9453,43,64,21,48.8
38821,ms,-88.43764,33.97603,8588,44,66,22,50
38824,ms,-88.64307,34.52036,5340,41,62,21,51.2
38826,ms,-88.84617,34.30575,2739,41,63,22,53.7
38827,ms,-88.20045,34.53269,1726,37,57,20,54.1
38828,ms,-88.86405,34.42964,3197,41,63,22,53.7
38829,ms,-88.53079,34.65197,13659,36,57,21,58.3
38833,ms,-88.33924,34.83782,1707,35,56,21,60
38834,ms,-88.56346,34.9154,16400,42,63,21,50
38838,ms,-88.26044,34.54758,1273,36,57,21,58.3
38841,ms,-89.01668,34.35128,1711,40,61,21,52.5
38843,ms,-88.37564,34.26498,7070,41,62,21,51.2
38844,ms,-88.25526,33.83862,234,38,59,21,55.3
38846,ms,-88.39396,34.8508,1582,36,57,21,58.3
38847,ms,-88.24221,34.41088,2249,38,59,21,55.3
38848,ms,-88.27569,33.94753,1192,40,61,21,52.5
38849,ms,-88.69755,34.45625,3408,40,62,22,55
38850,ms,-89.0531,34.049,2672,41,63,22,53.7
38851,ms,-88.96908,33.90861,6548,41,63,22,53.7
38852,al,-88.21465,34.84196,8822,32,52,20,61.55
38855,ms,-88.48541,34.32671,2509,42,64,22,52.4
38856,ms,-88.44672,34.46861,1492,42,63,21,50
38857,ms,-88.5775,34.28029,1672,41,62,21,51.2
38858,ms,-88.54372,34.09972,4603,46,68,22,47.8
38859,ms,-88.37563,34.52642,1001,39,60,21,53.8
38860,ms,-88.76379,33.96938,4158,46,68,22,47.8
38862,ms,-88.6212,34.16945,1499,45,67,22,48.9
38863,ms,-89.01935,34.21932,12333,40,62,22,55
38864,ms,-89.19913,34.13402,1609,42,63,21,50
38865,ms,-88.59097,34.78436,3343,38,59,21,55.3
38866,ms,-88.68058,34.36794,6270,42,63,21,50
38868,ms,-88.75736,34.11926,3230,50,72,22,44
38869,ms,-88.83513,34.35746,274,41,63,22,53.7
38870,ms,-88.33643,34.06747,2233,41,62,21,51.2
38871,ms,-89.20328,34.33477,1466,41,62,21,51.2
38873,ms,-88.24945,34.65802,2405,32,52,20,62.5
38876,ms,-88.2304,34.21786,1200,37,58,21,56.8
38878,ms,-89.18912,33.88926,2207,42,64,22,52.4
38879,ms,-88.71703,34.187,290,47,69,22,46.8
38901,ms,-89.80424,33.76164,11669,44,66,22,50
38913,ms,-89.37885,34.1342,440,41,63,22,53.7
38914,ms,-89.45752,33.86817,564,45,67,22,48.9
38915,ms,-89.38951,34.02788,3177,44,66,22,50
38916,ms,-89.35211,33.81437,4376,44,66,22,50
38917,ms,-89.96043,33.5516,3066,44,66,22,50
38920,ms,-90.06536,33.87636,797,46,68,22,47.8
38921,ms,-90.14853,33.98141,3445,46,68,22,47.8
38922,ms,-89.6449,33.93121,4757,45,67,22,48.9
38923,ms,-89.98723,33.38101,1284,44,66,22,50
38924,ms,-90.22474,33.29291,990,49,72,23,46.9
38925,ms,-89.63217,33.62764,2581,40,62,22,55
38927,ms,-90.02498,34.13077,1012,44,66,22,50
38928,ms,-90.28801,33.85733,393,50,72,22,44
38929,ms,-89.53119,33.7403,1787,44,66,22,50
38930,ms,-90.14511,33.54541,12477,52,75,23,44.2
38940,ms,-90.03331,33.75511,2094,46,68,22,47.8
38941,ms,-90.35694,33.48086,2276,52,75,23,44.2
38943,ms,-89.84364,33.53888,493,40,63,23,57.5
38944,ms,-90.3439,33.75882,786,51,73,22,43.1
38945,ms,-90.17071,33.60001,132,52,75,23,44.2
38946,ms,-90.37912,33.36413,362,53,76,23,43.4
38947,ms,-89.90007,33.53242,280,43,65,22,51.2
38948,ms,-89.88861,34.07255,2736,44,65,21,47.7
38949,ms,-89.4218,34.19272,232,41,63,22,53.7
38950,ms,-90.21193,33.7486,546,51,73,22,43.1
38951,ms,-89.28958,33.97296,1294,42,63,21,50
38952,ms,-90.34603,33.62117,764,52,75,23,44.2
38953,ms,-89.9277,33.92644,827,42,64,22,52.4
38954,ms,-90.21174,33.4153,966,51,74,23,45.1
38957,ms,-90.35033,33.99174,573,49,71,22,44.9
38958,ms,-90.42564,33.30537,115,55,78,23,41.8
38961,ms,-89.88483,33.96246,823,43,65,22,51.2
38962,ms,-90.18426,33.87497,143,50,71,21,42
38963,ms,-90.38976,34.02204,1363,49,71,22,44.9
38964,ms,-90.3896,34.09099,269,49,71,22,44.9
38965,ms,-89.60009,34.13566,7056,44,66,22,50
38966,ms,-90.3583,33.91687,765,49,71,22,44.9
38967,ms,-89.73376,33.45926,5534,38,60,22,57.9
39038,ms,-90.48431,33.18466,4309,57,80,23,40.4
39039,ms,-90.22509,32.81972,2036,46,70,24,52.2
39040,ms,-90.41987,32.63746,2948,50,74,24,48
39041,ms,-90.47337,32.41376,3056,48,72,24,50
39042,ms,-89.88862,32.21202,20914,44,68,24,54.5
39044,ms,-89.97298,32.02921,3241,43,67,24,55.8
39045,ms,-89.81777,32.78992,2031,44,67,23,52.3
39046,ms,-89.98541,32.63195,16078,48,72,24,50
39047,ms,-89.94679,32.4263,16737,45,69,24,53.3
39051,ms,-89.50045,32.78826,12334,44,67,23,52.3
39054,ms,-90.92935,32.79867,207,53,76,23,43.4
39056,ms,-90.34933,32.37097,11223,45,69,24,53.3
39057,ms,-89.28509,32.49257,1392,40,64,24,60
39059,ms,-90.35554,31.98234,8060,49,74,25,51
39061,ms,-90.81733,33.08812,73,59,81,22,37.3
39062,ms,-89.89831,31.98509,361,43,67,24,55.8
39063,ms,-89.89911,33.11822,2737,45,68,23,51.1
39066,ms,-90.60564,32.302,3965,51,75,24,47.1
39067,ms,-89.44672,33.11032,1689,45,68,23,51.1
39069,ms,-91.04593,31.68631,4586,49,75,26,53.1
39071,ms,-90.31779,32.55326,4036,48,72,24,50
39073,ms,-90.13332,32.10175,11220,46,70,24,52.2
39074,ms,-89.4784,32.39096,10963,42,66,24,57.1
39078,ms,-90.18894,31.87709,938,48,72,24,50
39079,ms,-89.89871,32.93484,1226,41,64,23,56.1
39082,ms,-90.12171,31.94581,1036,46,70,24,52.2
39083,ms,-90.47005,31.83791,8793,49,75,26,53.1
39086,ms,-90.76335,31.9583,1881,51,76,25,49
39088,ms,-90.73823,32.7433,426,54,77,23,42.6
39090,ms,-89.55408,33.00423,9938,46,69,23,50
39092,ms,-89.37365,32.31615,2806,41,65,24,58.5
39094,ms,-89.67586,32.57822,3788,44,68,24,54.5
39095,ms,-90.08242,33.12457,7146,43,66,23,53.5
39096,ms,-91.11559,31.82548,2675,51,76,25,49
39097,ms,-90.59901,32.99036,1013,56,79,23,41.1
39108,ms,-89.33321,33.15865,3067,46,68,22,47.8
39110,ms,-90.1402,32.50599,21642,46,70,24,52.2
39111,ms,-89.71879,31.89315,6254,43,67,24,55.8
39113,ms,-91.02094,32.91028,269,56,78,22,39.3
39114,ms,-89.82893,31.95187,7196,42,66,24,57.1
39115,ms,-90.56432,33.04489,113,56,79,23,41.1
39116,ms,-89.5499,31.88966,2752,45,69,24,53.3
39117,ms,-89.65926,32.30563,7916,43,68,25,58.1
39119,ms,-89.67335,31.75288,5085,43,67,24,55.8
39120,ms,-91.35404,31.51026,18130,42,70,28,66.7
39140,ms,-90.00273,31.75173,2511,46,71,25,54.3
39144,ms,-90.80473,31.83048,1314,52,77,25,48.1
39145,ms,-89.79805,32.34293,4041,45,69,24,53.3
39146,ms,-89.99536,32.87091,2661,39,63,24,61.5
39149,ms,-90.00904,31.83347,1891,44,69,25,56.8
39150,ms,-90.98387,31.99671,5004,50,74,24,48
39152,ms,-89.57701,32.20928,1331,41,65,24,58.5
39153,ms,-89.49861,32.05162,4125,43,67,24,55.8
39154,ms,-90.44907,32.22582,5467,48,72,24,50
39156,ms,-90.77603,32.54033,704,53,77,24,45.3
39157,ms,-90.1715,32.42669,9500,45,70,25,55.6
39159,ms,-90.94764,32.82766,3707,55,78,23,41.8
39160,ms,-89.75749,32.99305,2707,45,68,23,51.1
39162,ms,-90.63534,32.62761,375,51,75,24,47.1
39166,ms,-90.48062,33.04034,825,55,78,23,41.8
39167,ms,-90.0412,32.09416,43,43,68,25,58.1
39168,ms,-89.409,31.83297,6087,45,69,24,53.3
39169,ms,-90.29019,33.13652,2138,50,73,23,46
39170,ms,-90.33717,32.11371,6094,48,73,25,52.1
39174,ms,-90.15954,32.40148,204,46,70,24,52.2
39175,ms,-90.62827,32.09205,5210,51,75,24,47.1
39176,ms,-89.7666,33.302,1861,45,67,22,48.9
39177,ms,-90.8004,32.62286,454,52,76,24,46.2
39179,ms,-90.10163,32.80401,1076,44,68,24,54.5
39180,ms,-90.85586,32.23085,15915,54,78,24,44.4
39183,ms,-90.80661,32.45227,9712,54,78,24,44.4
39189,ms,-89.39893,32.60502,2756,43,66,23,53.5
39191,ms,-90.41495,31.71345,6450,49,75,26,53.1
39192,ms,-89.76034,33.18906,2033,46,68,22,47.8
39193,ms,-90.07933,32.23448,3,45,70,25,55.6
39194,ms,-90.48743,32.83609,11648,50,74,24,48
39201,ms,-90.18395,32.28929,1194,47,71,24,51.1
39202,ms,-90.17097,32.31023,3671,47,71,24,51.1
39203,ms,-90.20031,32.30892,3973,46,70,24,52.2
39204,ms,-90.22684,32.26818,7214,46,70,24,52.2
39206,ms,-90.17246,32.37239,8189,46,70,24,52.2
39208,ms,-90.08964,32.26044,12159,46,70,24,52.2
39209,ms,-90.30136,32.39338,14245,44,69,25,56.8
39211,ms,-90.1222,32.37178,9196,47,71,24,51.1
39212,ms,-90.27307,32.24209,12721,46,71,25,54.3
39213,ms,-90.2337,32.39243,11403,44,69,25,56.8
39216,ms,-90.16029,32.33372,1637,47,71,24,51.1
39217,ms,-90.21049,32.29913,6,46,71,25,54.3
39218,ms,-90.15901,32.22861,3457,46,70,24,52.2
39232,ms,-90.0916,32.32977,3507,46,70,24,52.2
39269,ms,-90.1889,32.30114,1,46,71,25,54.3
39272,ms,-90.25949,32.18882,5942,47,72,25,53.2
39301,ms,-88.5839,32.26854,16509,43,67,24,55.8
39305,ms,-88.71998,32.46662,10128,43,67,24,55.8
39307,ms,-88.7962,32.33774,8292,43,67,24,55.8
39309,ms,-88.6132,32.55041,2,46,69,23,50
39320,ms,-88.754,32.56868,1410,42,65,23,54.8
39322,ms,-88.53432,31.5841,1041,43,69,26,60.5
39323,ms,-88.92635,32.35101,1203,43,67,24,55.8
39325,ms,-88.87498,32.56428,4355,42,65,23,54.8
39326,ms,-88.67903,32.59916,772,44,68,24,54.5
39327,ms,-89.11947,32.44578,3135,41,64,23,56.1
39328,ms,-88.70075,32.74432,4730,42,65,23,54.8
39330,ms,-88.85772,32.18561,2791,43,67,24,55.8
39332,ms,-89.00413,32.30005,1765,43,66,23,53.5
39335,ms,-88.49032,32.53543,3337,46,70,24,52.2
39336,ms,-89.26545,32.28883,1405,40,63,23,57.5
39337,ms,-88.98057,32.51416,1829,40,63,23,57.5
39338,ms,-89.22523,32.11478,4303,41,65,24,58.5
39339,ms,-89.00836,33.10145,12521,43,66,23,53.5
39341,ms,-88.56208,33.10054,5615,47,70,23,48.9
39342,ms,-88.64834,32.4245,520,43,67,24,55.8
39345,ms,-89.12585,32.29455,5035,41,64,23,56.1
39346,ms,-89.08969,32.96205,2095,43,65,22,51.2
39347,ms,-88.93099,32.05785,2180,42,66,24,57.1
39348,ms,-89.03141,32.01055,953,40,64,24,60
39350,ms,-89.12848,32.79577,13683,41,63,22,53.7
39352,ms,-88.47982,32.6844,1009,46,69,23,50
39354,ms,-88.83184,32.88007,2231,42,64,22,52.4
39355,ms,-88.62346,32.05255,6166,43,67,24,55.8
39356,ms,-89.02495,32.1364,1038,42,65,23,54.8
39358,ms,-88.46412,32.84397,1625,46,69,23,50
39359,ms,-89.33357,32.56782,268,42,66,24,57.1
39360,ms,-88.74884,31.85896,3660,43,68,25,58.1
39361,ms,-88.61159,32.98148,1782,47,69,22,46.8
39362,ms,-88.54071,31.39198,2514,42,68,26,61.9
39363,ms,-88.77846,32.12036,1285,43,67,24,55.8
39364,ms,-88.49593,32.40922,3370,47,71,24,51.1
39365,ms,-89.12604,32.60122,5735,40,63,23,57.5
39366,ms,-88.9166,31.94156,1609,41,66,25,61
39367,ms,-88.6675,31.67902,7545,44,70,26,59.1
39401,ms,-89.26716,31.23262,22829,39,65,26,66.7
39402,ms,-89.41259,31.3337,18601,42,68,26,61.9
39406,ms,-89.33457,31.32844,63,38,64,26,68.4
39421,ms,-89.71201,31.48473,2540,43,69,26,60.5
39422,ms,-89.25941,31.96057,5065,43,67,24,55.8
39423,ms,-88.91487,31.17099,2512,52,80,28,53.8
39425,ms,-89.07958,31.05913,2186,45,72,27,60
39426,ms,-89.66118,30.6537,10880,48,77,29,60.4
39427,ms,-89.82794,31.4814,1574,46,71,25,54.3
39428,ms,-89.57339,31.65048,8259,40,65,25,62.5
39429,ms,-89.76187,31.24371,12747,55,81,26,47.3
39437,ms,-89.22,31.57845,7939,41,66,25,61
39439,ms,-89.0124,31.85483,4434,42,67,25,59.5
39440,ms,-89.14715,31.69304,9494,43,69,26,60.5
39443,ms,-89.07595,31.71378,13507,44,69,25,56.8
39451,ms,-88.6192,31.17153,4402,44,72,28,63.6
39452,ms,-88.59958,30.8787,20600,39,67,28,71.8
39455,ms,-89.46549,31.01053,12143,47,75,28,59.6
39456,ms,-88.82992,31.04533,1461,44,71,27,61.4
39459,ms,-89.30085,31.49079,2618,35,60,25,71.4
39461,ms,-88.73817,31.18281,611,46,74,28,60.9
39462,ms,-89.06016,31.22293,1247,52,79,27,51.9
39464,ms,-89.06773,31.49249,1892,42,67,25,59.5
39465,ms,-89.18036,31.34449,12849,40,66,26,65
39466,ms,-89.63881,30.54003,14380,45,75,30,66.7
39470,ms,-89.57362,30.8136,9330,51,80,29,56.9
39474,ms,-89.85544,31.61224,6133,46,71,25,54.3
39475,ms,-89.41707,31.15479,8010,46,73,27,58.7
39476,ms,-88.87556,31.38345,6615,44,71,27,61.4
39477,ms,-89.03476,31.7926,483,44,69,25,56.8
39478,ms,-89.85757,31.05443,2143,54,81,27,50
39479,ms,-89.46075,31.53603,4848,37,63,26,70.3
39480,ms,-89.31218,31.71059,2289,42,68,26,61.9
39481,ms,-89.24217,31.86715,1461,44,68,24,54.5
39482,ms,-89.57861,31.37264,8664,44,71,27,61.4
39483,ms,-89.92949,31.23585,4781,57,83,26,45.6
39501,ms,-89.10198,30.38293,12075,44,75,31,70.5
39503,ms,-89.15361,30.47761,24783,48,78,30,62.5
39507,ms,-89.036,30.39945,7585,42,73,31,73.8
39520,ms,-89.4705,30.26645,26063,42,72,30,71.4
39525,ms,-89.37034,30.38178,7203,41,70,29,70.7
39530,ms,-88.95904,30.31712,6215,39,70,31,79.5
39531,ms,-88.96761,30.40405,4841,39,70,31,79.5
39532,ms,-88.96449,30.49357,16899,42,72,30,71.4
39534,ms,-88.9211,30.40673,1,39,69,30,76.9
39540,ms,-88.89896,30.44148,3148,40,70,30,75
39553,ms,-88.64729,30.4122,9661,42,73,31,73.8
39556,ms,-89.43769,30.4486,5737,48,78,30,62.5
39560,ms,-89.17402,30.37487,9176,43,73,30,69.8
39561,ms,-89.15499,30.70491,1403,44,73,29,65.9
39562,ms,-88.49275,30.54709,12341,33,62,29,87.9
39563,ms,-88.52327,30.42498,8752,36,67,31,86.1
39564,ms,-88.75917,30.40434,23529,44,75,31,70.5
39565,ms,-88.74311,30.58048,11813,44,75,31,70.5
39567,ms,-88.58198,30.28759,5994,35,67,32,91.4
39571,ms,-89.28177,30.41541,16300,43,73,30,69.8
39572,ms,-89.60113,30.25081,2307,48,79,31,64.6
39573,ms,-89.09232,30.72713,7998,45,73,28,62.2
39574,ms,-89.09002,30.60748,8081,49,79,30,61.2
39576,ms,-89.38381,30.28889,5769,40,70,30,75
39577,ms,-89.07638,30.90611,7689,42,69,27,64.3
39581,ms,-88.49056,30.3575,4073,35,66,31,88.6
39601,ms,-90.46975,31.56535,15069,48,73,25,52.1
39629,ms,-90.45859,31.43776,5363,48,74,26,54.2
39630,ms,-90.84574,31.45933,702,53,79,26,49.1
39631,ms,-91.09723,31.07759,3178,46,74,28,60.9
39633,ms,-91.18492,31.29103,1491,47,75,28,59.6
39635,ms,-90.46343,31.19143,116,46,73,27,58.7
39638,ms,-90.99353,31.226,4128,46,73,27,58.7
39641,ms,-90.16986,31.35668,4204,48,74,26,54.2
39643,ms,-90.01943,31.24401,969,53,78,25,47.2
39645,ms,-90.79781,31.14747,7152,47,74,27,57.4
39647,ms,-90.72014,31.51578,1427,50,76,26,52
39648,ms,-90.38235,31.18729,10958,46,72,26,56.5
39652,ms,-90.47404,31.11255,6569,47,74,27,57.4
39653,ms,-90.86621,31.46186,3692,52,78,26,50
39654,ms,-90.13542,31.54352,5084,51,77,26,51
39656,ms,-89.93764,31.44277,1232,54,79,25,46.3
39657,ms,-90.50384,31.02569,2364,49,76,27,55.1
39661,ms,-91.08122,31.48583,3921,49,75,26,53.1
39662,ms,-90.2943,31.39083,1168,48,74,26,54.2
39663,ms,-90.0254,31.58712,3516,50,75,25,50
39664,ms,-90.67977,31.33098,2804,48,75,27,56.3
39665,ms,-90.21402,31.63785,1358,51,76,25,49
39666,ms,-90.48189,31.29098,6492,47,73,26,55.3
39667,ms,-90.12537,31.1298,12191,50,76,26,52
39668,ms,-90.7906,31.69114,1173,51,76,25,49
39669,ms,-91.39688,31.14243,5894,48,76,28,58.3
39701,ms,-88.50474,33.41088,8951,49,72,23,46.9
39702,ms,-88.34478,33.43973,10769,46,69,23,50
39705,ms,-88.43575,33.58606,6344,46,69,23,50
39730,ms,-88.56428,33.84177,8888,45,67,22,48.9
39735,ms,-89.18524,33.34739,3580,50,73,23,46
39736,ms,-88.65232,33.43191,150,47,70,23,48.9
39737,ms,-89.32746,33.67003,337,46,68,22,47.8
39739,ms,-88.57382,33.2396,2590,48,71,23,47.9
39740,ms,-88.31216,33.72188,3355,41,62,21,51.2
39741,ms,-88.86238,33.65141,1173,47,69,22,46.8
39743,ms,-88.61295,33.3218,1618,48,71,23,47.9
39744,ms,-89.30716,33.58207,5765,48,70,22,45.8
39745,ms,-89.45056,33.29845,808,46,68,22,47.8
39746,ms,-88.41418,33.74844,2627,43,64,21,48.8
39747,ms,-89.55493,33.40852,2631,41,63,22,53.7
39750,ms,-89.0605,33.5686,2399,48,70,22,45.8
39751,ms,-89.10512,33.70516,1393,46,68,22,47.8
39752,ms,-89.15448,33.51954,2018,48,71,23,47.9
39755,ms,-88.95384,33.61194,1069,48,70,22,45.8
39756,ms,-88.74122,33.78648,1377,46,68,22,47.8
39759,ms,-88.82644,33.43663,19680,47,69,22,46.8
39760,ms,-88.70514,33.46423,6,47,70,23,48.9
39762,ms,-88.79521,33.45279,5,45,67,22,48.9
39766,ms,-88.31312,33.58952,1622,45,67,22,48.9
39767,ms,-89.44684,33.47665,1360,44,67,23,52.3
39769,ms,-89.00974,33.31489,2628,49,72,23,46.9
39771,ms,-89.27516,33.60697,101,48,71,23,47.9
39772,ms,-89.29573,33.3045,1756,48,71,23,47.9
39773,ms,-88.68528,33.64255,9478,46,69,23,50
39776,ms,-89.04258,33.78225,1487,43,65,22,51.2
39813,ga,-84.68101,31.41755,1589,40,68,28,70
39815,ga,-84.49255,30.73969,1160,42,73,31,73.8
39817,ga,-84.59341,30.93813,6929,54,84,30,55.6
39819,ga,-84.63846,30.78519,7266,49,80,31,63.3
39823,ga,-84.94157,31.33209,5929,44,73,29,65.9
39824,ga,-84.90875,31.50421,549,40,67,27,67.5
39825,ga,-84.73533,30.92534,1150,54,85,31,57.4
39826,ga,-84.33811,31.81995,522,41,68,27,65.9
39827,ga,-84.20686,30.95277,1804,44,73,29,65.9
39828,ga,-84.22121,30.80206,8015,44,75,31,70.5
39834,ga,-84.42559,30.89337,1733,45,75,30,66.7
39836,ga,-84.8733,31.66581,586,38,65,27,71.1
39837,ga,-84.67303,31.15273,4154,51,81,30,58.8
39840,ga,-84.76736,31.7775,3529,41,68,27,65.9
39841,ga,-84.68109,31.28183,785,46,75,29,63
39842,ga,-84.4368,31.76125,5432,40,67,27,67.5
39845,ga,-84.89443,30.95157,7270,50,80,30,60
39846,ga,-84.74661,31.56187,1381,37,64,27,73
39851,ga,-85.00607,31.61954,2305,36,61,25,69.4
39854,ga,-85.03992,31.86401,3064,36,61,25,69.4
39859,ga,-84.80724,30.99573,907,53,83,30,56.6
39861,ga,-84.9826,31.13682,949,47,76,29,61.7
39862,ga,-84.51599,31.45663,1139,42,71,29,69
39866,ga,-84.60236,31.55126,428,37,64,27,73
39867,ga,-84.92551,31.83426,519,39,66,27,69.2
39870,ga,-84.40793,31.32076,1498,50,79,29,58
39877,ga,-84.50913,31.9178,513,36,61,25,69.4
39885,ga,-84.35107,31.71744,47,43,70,27,62.8
39886,ga,-84.62021,31.74894,1370,38,65,27,71.1
39897,ga,-84.33031,30.91391,2436,44,74,30,68.2
40003,ky,-85.04704,38.26916,1696,15,31,16,106.7
40004,ky,-85.46496,37.80451,14082,20,39,19,95
40006,ky,-85.32654,38.59167,3174,16,33,17,106.3
40008,ky,-85.27639,37.91632,2414,17,34,17,100
40009,ky,-85.1072,37.47087,827,15,32,17,113.3
40010,ky,-85.45069,38.37349,277,19,37,18,94.7
40011,ky,-85.16939,38.526,295,16,33,17,106.3
40012,ky,-85.18463,37.90718,424,17,33,16,94.1
40013,ky,-85.46769,37.93894,3142,20,38,18,90
40014,ky,-85.43084,38.34169,8961,18,36,18,100
40019,ky,-85.17179,38.37988,93,16,33,17,106.3
40020,ky,-85.38761,37.93507,79,18,36,18,100
40022,ky,-85.33513,38.15091,561,17,34,17,100
40023,ky,-85.42805,38.16498,2574,17,34,17,100
40025,ky,-85.64876,38.29982,51,18,35,17,94.4
40026,ky,-85.53236,38.42807,2290,19,37,18,94.7
40031,ky,-85.39502,38.42759,8318,19,36,17,89.5
40033,ky,-85.23807,37.55848,6136,16,34,18,112.5
40037,ky,-85.41158,37.65468,1548,19,37,18,94.7
40040,ky,-85.05538,37.77058,328,15,31,16,106.7
40041,ky,-85.66416,38.2559,8,17,35,18,105.9
40045,ky,-85.36014,38.69005,2085,16,33,17,106.3
40046,ky,-85.17424,38.02262,1168,16,33,17,106.3
40047,ky,-85.55477,38.03973,8843,21,39,18,85.7
40048,ky,-85.46945,37.84724,1,20,38,18,90
40049,ky,-85.39506,37.66352,1,19,37,18,94.7
40051,ky,-85.5727,37.65573,3137,21,40,19,90.5
40052,ky,-85.51217,37.58294,424,20,38,18,90
40055,ky,-85.32476,38.49676,537,17,34,17,100
40056,ky,-85.48818,38.3062,1429,18,36,18,100
40057,ky,-85.04233,38.38941,509,15,32,17,113.3
40059,ky,-85.59439,38.35879,7304,18,36,18,100
40060,ky,-85.44178,37.53801,925,20,38,18,90
40062,ky,-85.43185,37.60315,178,19,37,18,94.7
40063,ky,-85.34213,37.57169,6,17,35,18,105.9
40065,ky,-85.20685,38.21652,13166,16,33,17,106.3
40067,ky,-85.36685,38.2218,2530,17,34,17,100
40068,ky,-85.27026,38.39466,217,17,35,18,105.9
40069,ky,-85.21602,37.71603,4688,17,33,16,94.1
40071,ky,-85.36912,38.04375,7363,18,35,17,94.4
40075,ky,-85.11239,38.56295,118,17,33,16,94.1
40076,ky,-85.08907,38.1126,1530,15,31,16,106.7
40077,ky,-85.44541,38.49713,389,19,37,18,94.7
40078,ky,-85.1517,37.8427,1467,16,32,16,100
40104,ky,-86.34161,38.09171,1126,21,40,19,90.5
40107,ky,-85.63967,37.7763,1532,23,43,20,87
40108,ky,-86.16631,37.97262,6793,19,37,18,94.7
40109,ky,-85.75892,38.06056,1017,20,39,19,95
40110,ky,-85.66024,37.93644,43,24,44,20,83.3
40111,ky,-86.62819,37.7731,1276,24,43,19,79.2
40115,ky,-86.22898,37.73162,581,20,38,18,90
40117,ky,-86.12644,37.89775,1125,18,35,17,94.4
40118,ky,-85.7512,38.09896,3604,18,36,18,100
40119,ky,-86.54861,37.60335,1430,26,45,19,73.1
40121,ky,-85.94139,37.92932,4,18,36,18,100
40140,ky,-86.30098,37.72467,577,20,39,19,95
40142,ky,-86.20986,37.88671,1307,20,38,18,90
40143,ky,-86.50879,37.78114,4967,23,42,19,82.6
40144,ky,-86.37862,37.74595,1625,21,40,19,90.5
40145,ky,-86.31126,37.64424,1077,21,40,19,90.5
40146,ky,-86.33148,37.85465,2701,22,41,19,86.4
40150,ky,-85.72252,37.86871,2158,25,44,19,76
40152,ky,-86.44296,37.61506,2255,24,42,18,75
40155,ky,-85.99182,37.93709,317,16,32,16,100
40157,ky,-86.38994,38.01983,599,21,40,19,90.5
40160,ky,-85.93907,37.81286,8247,17,34,17,100
40161,ky,-86.39049,38.00253,143,21,39,18,85.7
40162,ky,-86.0491,37.75456,3182,18,35,17,94.4
40165,ky,-85.67562,37.97159,15136,23,42,19,82.6
40170,ky,-86.50793,37.96477,394,23,42,19,82.6
40171,ky,-86.452,37.97171,253,21,40,19,90.5
40175,ky,-86.0856,37.82293,6733,18,35,17,94.4
40176,ky,-86.34405,37.92371,680,23,41,18,78.3
40177,ky,-85.92135,38.00822,933,18,36,18,100
40178,ky,-86.40385,37.65333,1374,22,41,19,86.4
40202,ky,-85.75347,38.2571,1801,19,37,18,94.7
40203,ky,-85.76501,38.24748,6455,19,37,18,94.7
40204,ky,-85.7209,38.23915,6014,18,36,18,100
40205,ky,-85.68263,38.22347,9620,18,36,18,100
40206,ky,-85.70488,38.26039,7466,18,35,17,94.4
40207,ky,-85.65724,38.26531,11947,17,35,18,105.9
40208,ky,-85.76554,38.21856,4597,19,37,18,94.7
40209,ky,-85.74784,38.1898,1233,19,37,18,94.7
40210,ky,-85.78621,38.23153,7007,19,37,18,94.7
40211,ky,-85.82399,38.2344,11072,20,38,18,90
40212,ky,-85.79841,38.27166,8825,20,38,18,90
40213,ky,-85.71946,38.17581,8181,18,36,18,100
40214,ky,-85.78256,38.15188,14460,19,37,18,94.7
40215,ky,-85.78598,38.19106,9060,19,37,18,94.7
40216,ky,-85.83973,38.18769,17278,19,37,18,94.7
40217,ky,-85.73722,38.217,6084,19,36,17,89.5
40218,ky,-85.65403,38.18905,9661,17,35,18,105.9
40219,ky,-85.687,38.1389,12259,18,35,17,94.4
40220,ky,-85.61725,38.21551,10483,17,34,17,100
40222,ky,-85.6204,38.27132,7407,17,34,17,100
40223,ky,-85.54183,38.25994,7149,17,34,17,100
40228,ky,-85.62829,38.13553,5605,18,35,17,94.4
40229,ky,-85.65483,38.08911,14079,19,37,18,94.7
40231,ky,-85.69492,38.19507,6,18,36,18,100
40241,ky,-85.57576,38.3016,9637,17,35,18,105.9
40242,ky,-85.59068,38.27737,3507,17,34,17,100
40243,ky,-85.53423,38.23923,4016,17,34,17,100
40245,ky,-85.45221,38.26473,12451,18,35,17,94.4
40258,ky,-85.87756,38.14686,10382,20,38,18,90
40272,ky,-85.85242,38.08447,14530,19,37,18,94.7
40280,ky,-85.68831,38.24764,34,18,35,17,94.4
40291,ky,-85.57807,38.12905,13879,18,35,17,94.4
40299,ky,-85.5168,38.16263,15990,17,35,18,105.9
40310,ky,-84.76611,37.75023,295,14,30,16,114.3
40311,ky,-84.02449,38.32375,4616,12,27,15,125
40312,ky,-83.9309,37.85239,2086,14,29,15,107.1
40313,ky,-83.42092,38.13046,1403,11,25,14,127.3
40324,ky,-84.55324,38.24675,19090,12,27,15,125
40328,ky,-85.02586,37.56398,784,14,30,16,114.3
40330,ky,-84.89168,37.78962,10529,14,30,16,114.3
40334,ky,-83.7655,38.01465,26,11,25,14,127.3
40337,ky,-83.85635,37.9535,2715,12,27,15,125
40339,ky,-84.64424,37.94204,75,11,26,15,136.4
40342,ky,-84.98495,38.00322,12032,14,30,16,114.3
40346,ky,-83.74471,37.98075,78,11,25,14,127.3
40347,ky,-84.71555,38.15841,1382,12,27,15,125
40348,ky,-84.13211,38.2875,355,13,29,16,123.1
40350,ky,-83.87447,38.30892,171,12,26,14,116.7
40351,ky,-83.41637,38.20548,10705,11,25,14,127.3
40353,ky,-83.94763,38.06565,9660,12,26,14,116.7
40356,ky,-84.56448,37.87301,17118,12,27,15,125
40358,ky,-83.67993,38.05909,521,12,27,15,125
40359,ky,-84.81943,38.4892,6148,16,32,16,100
40360,ky,-83.76739,38.15447,3855,13,28,15,115.4
40361,ky,-84.22728,38.20594,8105,13,27,14,107.7
40363,ky,-85.00976,38.51441,106,17,34,17,100
40370,ky,-84.52642,38.39837,1848,13,27,14,107.7
40371,ky,-83.59874,38.08165,1480,13,28,15,115.4
40372,ky,-84.88267,37.90782,1270,14,30,16,114.3
40374,ky,-83.89966,38.21281,1155,12,26,14,116.7
40376,ky,-83.69456,37.78145,97,11,24,13,118.2
40379,ky,-84.68719,38.31336,2063,13,28,15,115.4
40380,ky,-83.77923,37.82391,3106,11,26,15,136.4
40383,ky,-84.73987,38.01263,10079,11,26,15,136.4
40385,ky,-84.13247,37.73669,1699,13,29,16,123.1
40387,ky,-83.49263,37.93537,141,10,24,14,140
40390,ky,-84.67168,37.85339,2241,14,29,15,107.1
40391,ky,-84.14517,37.96944,16828,12,26,14,116.7
40403,ky,-84.27119,37.56944,10296,13,28,15,115.4
40404,ky,-84.29086,37.57347,2,14,30,16,114.3
40409,ky,-84.43293,37.37757,47,11,25,14,127.3
40419,ky,-84.49304,37.45058,2486,12,27,15,125
40422,ky,-84.80073,37.63787,10369,13,28,15,115.4
40437,ky,-84.86586,37.4455,3293,12,27,15,125
40440,ky,-84.8249,37.57867,1008,13,28,15,115.4
40442,ky,-84.72468,37.3527,727,9,23,14,155.6
40444,ky,-84.58844,37.67922,8192,13,29,16,123.1
40447,ky,-84.02862,37.45707,54,8,20,12,150
40448,ky,-84.75371,37.46167,52,11,26,15,136.4
40461,ky,-84.40718,37.59317,1468,13,29,16,123.1
40464,ky,-84.92345,37.55828,613,13,28,15,115.4
40468,ky,-84.98605,37.63527,1061,14,30,16,114.3
40475,ky,-84.31371,37.7666,22880,12,27,15,125
40484,ky,-84.66965,37.51614,6838,12,28,16,133.3
40486,ky,-83.86188,37.36931,42,7,19,12,171.4
40489,ky,-84.64331,37.36853,2690,10,24,14,140
40502,ky,-84.48205,38.01383,10281,11,25,14,127.3
40503,ky,-84.53424,38.00469,11447,10,24,14,140
40504,ky,-84.54163,38.04174,7392,10,25,15,150
40505,ky,-84.45689,38.05995,10453,11,25,14,127.3
40507,ky,-84.49635,38.04696,1000,10,25,15,150
40508,ky,-84.50112,38.05004,8014,10,25,15,150
40509,ky,-84.37619,37.99784,15649,11,25,14,127.3
40510,ky,-84.60147,38.06894,564,10,24,14,140
40511,ky,-84.47805,38.13369,12557,11,25,14,127.3
40513,ky,-84.60642,38.01593,4219,10,24,14,140
40514,ky,-84.56339,37.98267,5992,11,25,14,127.3
40515,ky,-84.40977,37.92032,12683,11,26,15,136.4
40516,ky,-84.36122,38.06965,1446,11,26,15,136.4
40517,ky,-84.48835,37.98386,10260,11,25,14,127.3
40601,ky,-84.88086,38.23396,22422,14,30,16,114.3
40604,ky,-84.86484,38.1751,6,15,30,15,100
40701,ky,-84.16357,36.91957,13217,7,20,13,185.7
40729,ky,-84.135,37.24779,3051,7,19,12,171.4
40734,ky,-83.96906,36.92813,1810,8,20,12,150
40737,ky,-84.13323,37.00529,554,8,20,12,150
40740,ky,-84.03398,37.01773,1253,7,20,13,185.7
40741,ky,-84.12616,37.13753,10780,7,19,12,171.4
40743,ky,-84.11837,37.07407,111,8,20,12,150
40744,ky,-84.09359,37.03733,8132,8,20,12,150
40759,ky,-84.06001,36.82041,1081,8,21,13,162.5
40763,ky,-83.92337,36.69268,305,7,18,11,157.1
40769,ky,-84.17018,36.71207,8098,9,22,13,144.4
40771,ky,-84.0347,36.85856,526,7,20,13,185.7
40801,ky,-83.24817,36.86067,354,1,6,5,500
40806,ky,-83.28757,36.88635,1430,3,11,8,266.7
40807,ky,-82.94709,36.96417,212,0,1,1,NA
40808,ky,-83.2106,36.99342,70,1,7,6,600
40810,ky,-83.30622,36.9493,1182,2,7,5,250
40815,ky,-83.215,36.78488,1003,4,12,8,200
40816,ky,-83.29738,37.00446,201,3,10,7,233.3
40818,ky,-83.24449,36.82021,49,4,14,10,250
40819,ky,-83.4628,36.80373,450,4,13,9,225
40820,ky,-83.18381,36.75582,298,2,10,8,400
40823,ky,-82.99713,36.95987,2618,1,3,2,200
40824,ky,-83.37222,36.82491,244,3,12,9,300
40826,ky,-82.78086,37.05396,389,0,2,2,NA
40827,ky,-83.47221,37.04673,471,4,13,9,225
40828,ky,-83.14264,36.87273,2492,1,6,5,500
40829,ky,-83.30242,36.79691,114,4,14,10,250
40830,ky,-83.32825,36.75912,169,2,8,6,300
40831,ky,-83.34986,36.75958,2944,3,11,8,266.7
40840,ky,-83.44292,36.89876,217,2,7,5,250
40843,ky,-82.97944,36.89689,196,1,5,4,400
40844,ky,-83.35014,37.06091,133,4,14,10,250
40847,ky,-83.17478,36.85057,120,1,5,4,400
40849,ky,-83.13402,36.89305,198,1,4,3,300
40854,ky,-83.35429,36.84585,786,4,12,8,200
40855,ky,-82.89422,36.94719,581,0,1,1,NA
40858,ky,-83.41146,36.98903,344,4,12,8,200
40862,ky,-82.87382,37.01186,333,0,2,2,NA
40863,ky,-83.44599,36.73951,266,3,10,7,233.3
40865,ky,-83.21389,36.9174,241,1,7,6,600
40868,ky,-83.46822,37.08233,671,4,14,10,250
40870,ky,-83.1448,36.92441,203,1,6,5,500
40873,ky,-83.40886,36.81788,1535,3,11,8,266.7
40874,ky,-83.4748,36.9732,373,3,12,9,300
40903,ky,-83.81839,36.80834,394,7,19,12,171.4
40906,ky,-83.88647,36.8821,5167,9,22,13,144.4
40915,ky,-83.81649,36.87995,480,9,22,13,144.4
40921,ky,-83.90089,36.77082,199,6,18,12,200
40923,ky,-83.85103,36.91945,315,9,22,13,144.4
40927,ky,-83.04136,36.87123,296,1,4,3,300
40935,ky,-83.71608,36.90609,1579,6,17,11,183.3
40940,ky,-83.94835,36.60704,221,6,17,11,183.3
40943,ky,-83.85789,36.95657,338,9,22,13,144.4
40946,ky,-83.79907,36.98197,165,8,20,12,150
40949,ky,-83.87162,36.89038,445,9,23,14,155.6
40953,ky,-83.80447,36.93625,416,8,20,12,150
40962,ky,-83.74063,37.14587,19,7,19,12,171.4
40964,ky,-83.31332,36.77282,82,1,6,5,500
40972,ky,-83.60333,37.25889,9,6,17,11,183.3
40979,ky,-83.50649,37.00752,72,3,11,8,266.7
40982,ky,-83.69008,36.93275,142,5,15,10,200
40983,ky,-83.76662,37.333,106,8,22,14,175
40988,ky,-83.53252,36.84898,54,5,15,10,200
40995,ky,-83.81545,36.76101,65,6,17,11,183.3
40997,ky,-83.68498,36.87744,327,4,12,8,200
41001,ky,-84.40264,38.9149,7661,13,27,14,107.7
41002,ky,-83.9827,38.73064,1487,10,23,13,130
41003,ky,-84.39039,38.5322,1540,13,28,15,115.4
41004,ky,-84.10654,38.6539,2845,11,25,14,127.3
41005,ky,-84.76743,39.0081,9721,11,24,13,118.2
41006,ky,-84.34437,38.78298,2036,12,27,15,125
41007,ky,-84.30458,38.89148,2168,12,26,14,116.7
41008,ky,-85.16789,38.66357,3260,18,35,17,94.4
41010,ky,-84.60523,38.49773,3067,13,29,16,123.1
41011,ky,-84.52951,39.06808,9914,14,28,14,100
41014,ky,-84.50545,39.06572,2915,14,28,14,100
41015,ky,-84.48443,38.97808,8694,13,27,14,107.7
41016,ky,-84.54935,39.0872,2459,14,28,14,100
41017,ky,-84.56148,39.02888,14083,12,26,14,116.7
41018,ky,-84.60288,39.01562,9714,11,25,14,127.3
41030,ky,-84.59319,38.78991,2390,13,28,15,115.4
41031,ky,-84.28684,38.41607,7251,14,29,15,107.1
41033,ky,-84.45741,38.76406,1093,13,27,14,107.7
41034,ky,-83.89546,38.70962,783,11,24,13,118.2
41035,ky,-84.65959,38.70514,4278,14,29,15,107.1
41039,ky,-83.88072,38.41148,1624,11,25,14,127.3
41040,ky,-84.33039,38.64995,4226,12,26,14,116.7
41041,ky,-83.72604,38.40896,3947,10,24,14,140
41042,ky,-84.65284,39.00116,18337,11,24,13,118.2
41043,ky,-84.19757,38.75878,1325,11,25,14,127.3
41044,ky,-83.9751,38.60775,744,11,24,13,118.2
41045,ky,-85.02643,38.71988,752,17,33,16,94.1
41046,ky,-84.80179,38.71966,810,16,31,15,93.8
41048,ky,-84.70714,39.09501,6260,11,24,13,118.2
41049,ky,-83.64762,38.27421,1433,12,26,14,116.7
41051,ky,-84.54503,38.934,11115,12,26,14,116.7
41052,ky,-84.76984,38.67367,50,16,32,16,100
41055,ky,-83.87085,38.51828,1270,10,24,14,140
41056,ky,-83.77866,38.60004,8776,10,23,13,130
41059,ky,-84.34818,39.00753,1384,13,28,15,115.4
41062,ky,-83.92284,38.70401,21,10,23,13,130
41063,ky,-84.49771,38.84795,1755,13,28,15,115.4
41064,ky,-84.05977,38.51063,1421,12,26,14,116.7
41071,ky,-84.48281,39.07389,7044,14,28,14,100
41073,ky,-84.47945,39.10214,2538,14,29,15,107.1
41074,ky,-84.46428,39.11289,2302,14,29,15,107.1
41075,ky,-84.45122,39.07967,5897,14,28,14,100
41076,ky,-84.43594,39.01778,5554,13,27,14,107.7
41080,ky,-84.83039,39.05046,1048,13,28,15,115.4
41083,ky,-84.98309,38.67039,835,16,32,16,100
41085,ky,-84.39289,39.0357,297,14,29,15,107.1
41086,ky,-84.87239,38.6885,1744,16,32,16,100
41091,ky,-84.73996,38.91863,9190,11,25,14,127.3
41092,ky,-84.70068,38.81851,1899,13,28,15,115.4
41093,ky,-83.56165,38.39065,1945,10,23,13,130
41094,ky,-84.62523,38.88398,6909,12,26,14,116.7
41095,ky,-84.82362,38.79221,1682,15,31,16,106.7
41097,ky,-84.58149,38.61985,4139,14,29,15,107.1
41098,ky,-85.0007,38.59179,3435,17,34,17,100
41099,ky,-84.46819,39.03589,2,13,27,14,107.7
41101,ky,-82.6461,38.47224,9596,13,28,15,115.4
41102,ky,-82.72504,38.42108,10493,11,25,14,127.3
41121,ky,-82.83394,38.44574,2017,11,24,13,118.2
41124,ky,-82.851,38.02975,866,10,24,14,140
41129,ky,-82.63985,38.32031,6548,11,24,13,118.2
41132,ky,-82.82463,38.26326,261,9,22,13,144.4
41135,ky,-83.28767,38.35626,70,9,22,13,144.4
41139,ky,-82.72841,38.51537,3935,13,27,14,107.7
41141,ky,-83.14636,38.54775,1012,10,23,13,130
41142,ky,-83.07331,38.27864,58,10,23,13,130
41143,ky,-82.97237,38.33256,7262,11,24,13,118.2
41144,ky,-82.91906,38.53685,7158,12,26,14,116.7
41146,ky,-82.89824,38.2766,149,10,23,13,130
41149,ky,-83.0393,38.06423,407,10,23,13,130
41159,ky,-82.96564,38.01257,303,10,23,13,130
41164,ky,-83.16255,38.28973,7363,9,22,13,144.4
41166,ky,-83.09206,38.63744,321,9,22,13,144.4
41168,ky,-82.76223,38.30734,1590,10,23,13,130
41169,ky,-82.71219,38.52622,3089,13,27,14,107.7
41171,ky,-83.10471,38.09415,2355,10,23,13,130
41174,ky,-83.01147,38.70483,625,10,22,12,120
41175,ky,-82.97232,38.65132,3552,11,25,14,127.3
41179,ky,-83.38763,38.52668,3708,10,23,13,130
41180,ky,-82.85386,38.13516,865,10,23,13,130
41183,ky,-82.73685,38.55258,934,13,27,14,107.7
41189,ky,-83.55472,38.54579,1716,10,23,13,130
41201,ky,-82.7295,38.0639,309,10,23,13,130
41203,ky,-82.44516,37.83805,392,11,25,14,127.3
41204,ky,-82.68464,37.81986,300,12,26,14,116.7
41214,ky,-82.60878,37.80577,443,10,23,13,130
41216,ky,-82.81379,37.72902,642,13,28,15,115.4
41219,ky,-82.90764,37.92814,1189,11,25,14,127.3
41222,ky,-82.85531,37.76926,1212,13,28,15,115.4
41224,ky,-82.53914,37.82734,2922,10,23,13,130
41226,ky,-82.95573,37.98041,105,10,23,13,130
41230,ky,-82.66635,38.06403,6717,11,25,14,127.3
41231,ky,-82.41092,37.80738,476,12,26,14,116.7
41232,ky,-82.73487,37.93152,368,11,25,14,127.3
41234,ky,-82.74026,37.7945,293,13,28,15,115.4
41238,ky,-82.95474,37.84853,489,11,25,14,127.3
41240,ky,-82.79756,37.82387,3168,14,29,15,107.1
41250,ky,-82.45233,37.73793,986,12,26,14,116.7
41254,ky,-82.72133,37.88954,280,13,27,14,107.7
41255,ky,-82.83308,37.9124,533,12,26,14,116.7
41256,ky,-82.885,37.83028,1172,13,28,15,115.4
41257,ky,-82.79667,37.9299,109,12,26,14,116.7
41260,ky,-82.75267,37.82199,259,14,29,15,107.1
41262,ky,-82.60328,37.86553,850,10,24,14,140
41263,ky,-82.76026,37.85178,248,14,29,15,107.1
41264,ky,-82.67389,37.94163,261,11,25,14,127.3
41265,ky,-82.70539,37.74809,987,14,29,15,107.1
41267,ky,-82.4386,37.87499,467,11,25,14,127.3
41268,ky,-82.78492,37.78865,302,15,30,15,100
41271,ky,-82.72358,37.82245,143,13,28,15,115.4
41274,ky,-82.81084,37.85836,205,14,29,15,107.1
41301,ky,-83.50063,37.71938,225,9,22,13,144.4
41311,ky,-83.71115,37.58222,47,10,24,14,140
41314,ky,-83.64037,37.42585,3918,9,22,13,144.4
41317,ky,-83.18915,37.44764,207,8,20,12,150
41332,ky,-83.38981,37.80018,302,8,21,13,162.5
41339,ky,-83.29613,37.53587,6204,9,22,13,144.4
41348,ky,-83.30807,37.42375,795,8,20,12,150
41352,ky,-83.33353,37.82353,438,8,21,13,162.5
41360,ky,-83.6276,37.78906,20,10,23,13,130
41366,ky,-83.21867,37.5946,29,8,21,13,162.5
41367,ky,-83.22555,37.41673,113,7,19,12,171.4
41385,ky,-83.3504,37.6528,271,9,21,12,133.3
41390,ky,-83.37635,37.40956,25,8,21,13,162.5
41408,ky,-83.27929,37.78087,221,8,21,13,162.5
41421,ky,-83.19784,37.98975,145,10,23,13,130
41425,ky,-83.42417,37.88389,727,10,23,13,130
41464,ky,-82.97329,37.66764,417,9,22,13,144.4
41465,ky,-83.08565,37.72848,6768,9,22,13,144.4
41472,ky,-83.21959,37.94286,5971,10,24,14,140
41517,ky,-82.58019,37.19508,50,1,4,3,300
41537,ky,-82.61115,37.22885,1681,1,5,4,400
41601,ky,-82.72245,37.60742,504,14,30,16,114.3
41602,ky,-82.74978,37.73748,479,14,30,16,114.3
41603,ky,-82.6883,37.55875,674,13,29,16,123.1
41604,ky,-82.66568,37.38912,368,4,14,10,250
41605,ky,-82.62665,37.55546,345,17,33,16,94.1
41606,ky,-82.73556,37.34862,462,4,14,10,250
41607,ky,-82.84178,37.62527,133,11,26,15,136.4
41612,ky,-82.723,37.35433,73,4,13,9,225
41615,ky,-82.68177,37.54388,295,15,31,16,106.7
41616,ky,-82.87667,37.58109,434,10,24,14,140
41619,ky,-82.74155,37.48057,288,10,23,13,130
41621,ky,-82.72778,37.62501,156,14,30,16,114.3
41622,ky,-82.81692,37.52228,140,11,25,14,127.3
41630,ky,-82.86473,37.4538,596,9,22,13,144.4
41631,ky,-82.65524,37.47298,530,10,24,14,140
41632,ky,-82.94016,37.54643,516,8,21,13,162.5
41635,ky,-82.62675,37.47709,1423,12,26,14,116.7
41636,ky,-82.72917,37.39937,487,6,17,11,183.3
41640,ky,-82.94517,37.47756,724,10,24,14,140
41642,ky,-82.64627,37.59562,294,15,31,16,106.7
41643,ky,-82.83223,37.4602,43,9,22,13,144.4
41645,ky,-82.79355,37.52403,667,12,27,15,125
41647,ky,-82.72033,37.43552,843,8,20,12,150
41649,ky,-82.78192,37.57078,1532,12,27,15,125
41650,ky,-82.68327,37.35451,334,3,12,9,300
41653,ky,-82.76359,37.66104,5658,13,28,15,115.4
41655,ky,-82.72489,37.50502,427,10,24,14,140
41659,ky,-82.6271,37.57412,267,14,30,16,114.3
41660,ky,-82.6371,37.41245,390,6,16,10,166.7
41663,ky,-82.65778,37.56561,150,16,32,16,100
41666,ky,-82.8073,37.4393,645,8,21,13,162.5
41667,ky,-82.69148,37.32019,455,3,12,9,300
41669,ky,-82.71552,37.33163,515,3,11,8,266.7
41701,ky,-83.19123,37.29827,7337,6,17,11,183.3
41712,ky,-83.13824,37.36671,234,6,17,11,183.3
41713,ky,-83.27644,37.21939,30,4,14,10,250
41714,ky,-83.51804,37.1578,281,5,15,10,200
41719,ky,-83.25438,37.29834,565,7,19,12,171.4
41721,ky,-83.4942,37.30929,621,7,18,11,157.1
41722,ky,-83.11754,37.37187,610,6,17,11,183.3
41723,ky,-83.31955,37.25345,870,5,16,11,220
41727,ky,-83.30573,37.35388,426,6,18,12,200
41729,ky,-83.21868,37.26557,110,6,17,11,183.3
41731,ky,-83.06912,37.10918,628,5,14,9,180
41735,ky,-83.10354,37.0171,124,2,8,6,300
41739,ky,-83.12143,37.32533,92,6,17,11,183.3
41745,ky,-83.43471,37.3353,165,6,18,12,200
41746,ky,-83.09801,37.21046,444,5,16,11,220
41749,ky,-83.41009,37.19766,2898,5,15,10,200
41751,ky,-83.13698,37.20769,147,6,16,10,166.7
41754,ky,-83.32193,37.30031,251,6,18,12,200
41759,ky,-83.02384,37.2218,10,4,13,9,225
41760,ky,-83.07899,37.20531,20,5,15,10,200
41762,ky,-83.48371,37.25357,108,5,16,11,220
41763,ky,-83.12944,37.05687,272,3,12,9,300
41764,ky,-83.2553,37.12687,544,3,12,9,300
41766,ky,-83.46573,37.17987,178,5,15,10,200
41773,ky,-83.02845,37.22861,489,5,14,9,180
41774,ky,-83.14048,37.15855,1670,5,14,9,180
41775,ky,-83.34193,37.09367,164,4,13,9,225
41776,ky,-83.2913,37.16711,927,4,13,9,225
41777,ky,-83.23279,37.06257,763,2,9,7,350
41804,ky,-82.99655,37.15251,512,5,15,10,200
41810,ky,-82.67387,37.18517,272,1,5,4,400
41812,ky,-82.74441,37.24723,154,2,8,6,300
41815,ky,-82.79742,37.16154,311,3,10,7,233.3
41819,ky,-83.07944,36.98922,247,2,7,5,250
41821,ky,-83.01163,37.07451,320,5,14,9,180
41824,ky,-82.87713,37.20148,529,4,14,10,250
41825,ky,-82.70803,37.23021,318,2,8,6,300
41826,ky,-82.92582,37.16991,616,5,14,9,180
41832,ky,-82.95851,37.1488,294,6,16,10,166.7
41833,ky,-82.98377,37.03468,167,2,9,7,350
41835,ky,-82.66954,37.2121,465,1,6,5,500
41837,ky,-82.74596,37.12702,584,1,4,3,300
41838,ky,-82.74766,37.19809,278,3,12,9,300
41840,ky,-82.71544,37.1972,673,2,7,5,250
41845,ky,-82.91895,37.13275,142,5,15,10,200
41848,ky,-82.94845,37.09529,52,5,15,10,200
41849,ky,-82.73403,37.1746,111,3,11,8,266.7
41855,ky,-82.7851,37.19062,327,4,13,9,225
41858,ky,-82.85274,37.13538,3474,3,11,8,266.7
42001,ky,-88.71099,37.03762,14588,34,54,20,58.8
42003,ky,-88.58568,37.01037,15389,35,55,20,57.1
42020,ky,-88.29294,36.69228,1683,36,57,21,58.3
42021,ky,-89.0267,36.80485,1099,35,56,21,60
42022,ky,-88.94551,37.14586,103,34,54,20,58.8
42023,ky,-88.99128,36.87163,1994,35,56,21,60
42024,ky,-89.05163,37.07567,1160,35,55,20,57.1
42025,ky,-88.33453,36.85639,13938,37,58,21,56.8
42027,ky,-88.62848,36.91633,1623,34,55,21,61.8
42029,ky,-88.39215,37.00779,3937,41,62,21,51.2
42031,ky,-88.99123,36.68754,2909,35,56,21,60
42032,ky,-89.10797,36.77217,223,35,56,21,60
42035,ky,-88.84194,36.90494,709,36,57,21,58.3
42036,ky,-88.2252,36.72213,910,37,57,20,54.1
42037,ky,-88.18771,37.17278,76,39,59,20,51.3
42038,ky,-88.02224,37.04141,7545,37,57,20,54.1
42039,ky,-88.83144,36.78262,1488,33,54,21,63.6
42040,ky,-88.50268,36.62047,1010,33,53,20,60.6
42041,ky,-88.87486,36.54753,3574,33,54,21,63.6
42044,ky,-88.26479,36.95874,5316,42,63,21,50
42048,ky,-88.22808,36.76681,2528,37,58,21,56.8
42049,ky,-88.32655,36.51787,1361,33,53,20,60.6
42050,ky,-89.22084,36.55203,2485,36,57,21,58.3
42051,ky,-88.64409,36.8553,2339,34,54,20,58.8
42053,ky,-88.88103,37.11296,3421,34,54,20,58.8
42054,ky,-88.43391,36.71527,827,35,55,20,57.1
42055,ky,-88.1678,37.06847,2649,41,62,21,51.2
42056,ky,-88.98608,37.11149,1512,35,55,20,57.1
42060,ky,-88.82769,36.9644,102,37,58,21,56.8
42061,ky,-88.76963,36.8827,92,34,55,21,61.8
42064,ky,-88.09397,37.35409,7313,31,51,20,64.5
42066,ky,-88.63943,36.73283,16725,32,52,20,62.5
42069,ky,-88.75654,36.92218,933,34,55,21,61.8
42071,ky,-88.28389,36.62034,23738,36,57,21,58.3
42076,ky,-88.09569,36.55813,8620,36,57,21,58.3
42078,ky,-88.27514,37.29175,265,31,51,20,64.5
42079,ky,-88.57883,36.56273,1408,32,52,20,62.5
42082,ky,-88.49961,36.91794,1334,35,55,20,57.1
42084,ky,-88.24607,37.43464,86,30,49,19,63.3
42085,ky,-88.80017,36.57041,885,32,53,21,65.6
42086,ky,-88.76902,37.08909,2099,33,53,20,60.6
42087,ky,-89.00626,36.97407,2004,36,57,21,58.3
42088,ky,-88.74671,36.61602,2356,31,52,21,67.7
42101,ky,-86.47618,37.06377,21842,30,50,20,66.7
42102,ky,-86.41823,37.00374,3,31,51,20,64.5
42103,ky,-86.33253,36.94901,8214,30,50,20,66.7
42104,ky,-86.45125,36.87838,12931,30,50,20,66.7
42120,ky,-86.26983,36.67118,1586,26,46,20,76.9
42122,ky,-86.35823,36.85954,2975,30,50,20,66.7
42123,ky,-85.98926,36.82162,659,29,49,20,69
42127,ky,-85.92893,37.1213,3270,27,47,20,74.1
42129,ky,-85.58875,36.99117,216,21,40,19,90.5
42130,ky,-85.77892,36.9241,96,22,42,20,90.9
42133,ky,-85.95756,36.72473,1533,29,50,21,72.4
42134,ky,-86.56605,36.72445,9354,27,47,20,74.1
42140,ky,-85.83404,36.65656,953,27,48,21,77.8
42141,ky,-85.9166,36.94755,16488,28,48,20,71.4
42151,ky,-85.55841,36.64817,206,24,44,20,83.3
42153,ky,-86.06117,36.66784,230,32,53,21,65.6
42154,ky,-85.72542,37.05421,35,23,42,19,82.6
42156,ky,-86.05232,36.85165,362,30,50,20,66.7
42157,ky,-85.81514,36.79091,277,23,43,20,87
42159,ky,-86.24532,36.99291,758,30,50,20,66.7
42160,ky,-86.0751,37.07794,1116,28,48,20,71.4
42163,ky,-86.1347,37.07968,37,29,49,20,69
42164,ky,-86.18474,36.77561,11720,27,48,21,77.8
42166,ky,-85.70939,36.87844,486,22,41,19,86.4
42167,ky,-85.67366,36.72414,6150,24,44,20,83.3
42170,ky,-86.57627,36.84424,911,29,49,20,69
42171,ky,-86.1659,37.03466,4277,29,49,20,69
42202,ky,-86.86041,36.68736,1648,29,49,20,69
42204,ky,-87.07352,36.69578,647,29,49,20,69
42206,ky,-86.72144,36.88561,3355,27,47,20,74.1
42207,ky,-86.27862,37.30339,1213,30,50,20,66.7
42210,ky,-86.24911,37.20974,2644,28,48,20,71.4
42211,ky,-87.839,36.82144,18004,36,56,20,55.6
42214,ky,-85.69147,37.13984,101,24,43,19,79.2
42215,ky,-87.66708,36.99697,823,33,53,20,60.6
42217,ky,-87.46145,37.04837,2388,30,51,21,70
42220,ky,-87.17895,36.89543,4249,27,47,20,74.1
42223,tn,-87.46287,36.62826,1,32,52,20,62.5
42232,ky,-87.65855,36.87534,559,34,54,20,58.8
42234,ky,-87.17657,36.70633,1569,30,50,20,66.7
42236,ky,-87.61942,36.71982,683,31,51,20,64.5
42240,ky,-87.46233,36.87885,18443,32,52,20,62.5
42254,ky,-87.63734,36.66074,164,31,51,20,64.5
42256,ky,-86.94592,37.01479,4739,29,48,19,65.5
42259,ky,-86.15143,37.24388,2576,27,46,19,70.4
42261,ky,-86.66901,37.21979,6614,27,46,19,70.4
42262,ky,-87.44872,36.6816,3004,31,51,20,64.5
42265,ky,-86.99342,36.73579,660,29,48,19,65.5
42266,ky,-87.36028,36.76624,1314,30,50,20,66.7
42273,ky,-86.85331,37.21754,413,29,48,19,65.5
42274,ky,-86.60235,36.94687,1220,29,49,20,69
42275,ky,-86.44737,37.22055,776,29,48,19,65.5
42276,ky,-86.88076,36.85709,9475,27,46,19,70.4
42280,ky,-87.09913,36.95377,405,28,47,19,67.9
42285,ky,-86.29781,37.26405,243,29,49,20,69
42286,ky,-87.27266,36.72635,837,30,49,19,63.3
42301,ky,-87.24611,37.74037,19107,29,49,20,69
42303,ky,-87.04895,37.76157,16959,29,48,19,65.5
42320,ky,-86.8709,37.35243,4905,28,48,20,71.4
42321,ky,-87.05595,37.1716,195,30,50,20,66.7
42322,ky,-87.39531,37.61365,23,29,49,20,69
42323,ky,-87.03495,37.17371,532,30,50,20,66.7
42324,ky,-87.00098,37.13532,1032,29,49,20,69
42325,ky,-87.27034,37.32734,1234,32,52,20,62.5
42326,ky,-87.01034,37.22443,295,30,50,20,66.7
42327,ky,-87.30165,37.58746,2759,30,50,20,66.7
42328,ky,-87.04225,37.41856,1197,29,49,20,69
42330,ky,-87.12001,37.32063,5164,31,51,20,64.5
42332,ky,-87.08776,37.24993,198,31,51,20,64.5
42333,ky,-86.76397,37.36404,724,28,47,19,67.9
42337,ky,-87.01075,37.22719,1562,30,50,20,66.7
42338,ky,-86.79124,37.54589,82,28,48,20,71.4
42339,ky,-86.95008,37.10952,767,29,48,19,65.5
42343,ky,-86.69752,37.63278,1291,27,46,19,70.4
42344,ky,-87.32012,37.25686,598,33,54,21,63.6
42345,ky,-87.18464,37.14411,7033,31,51,20,64.5
42347,ky,-86.88431,37.52453,3650,29,49,20,69
42348,ky,-86.76307,37.83489,2704,24,43,19,79.2
42349,ky,-86.67894,37.42766,1083,27,46,19,70.4
42350,ky,-87.18889,37.44955,980,31,52,21,67.7
42351,ky,-86.87959,37.90605,2092,26,44,18,69.2
42352,ky,-87.08144,37.51495,1274,30,51,21,70
42354,ky,-86.92977,37.37781,171,28,48,20,71.4
42355,ky,-86.9845,37.85789,1094,27,46,19,70.4
42361,ky,-86.68444,37.5207,298,28,47,19,67.9
42366,ky,-86.94541,37.7227,3103,28,47,19,67.9
42367,ky,-87.16001,37.23931,435,32,52,20,62.5
42368,ky,-86.75502,37.70263,845,26,45,19,73.1
42369,ky,-87.00654,37.3554,312,30,49,19,63.3
42370,ky,-86.73893,37.44902,29,26,45,19,73.1
42371,ky,-87.28934,37.49876,652,31,52,21,67.7
42372,ky,-87.2747,37.40533,1213,32,53,21,65.6
42374,ky,-87.15233,37.33436,198,32,52,20,62.5
42376,ky,-87.0876,37.61687,3719,29,48,19,65.5
42378,ky,-86.86895,37.65606,1957,28,47,19,67.9
42404,ky,-87.83305,37.47707,2156,37,57,20,54.1
42406,ky,-87.73176,37.76317,2243,27,47,20,74.1
42408,ky,-87.69432,37.18064,4830,34,54,20,58.8
42409,ky,-87.70067,37.543,2060,33,53,20,60.6
42410,ky,-87.51258,37.27726,1116,34,55,21,61.8
42411,ky,-88.01804,37.2031,1510,36,56,20,55.6
42413,ky,-87.47094,37.44363,2029,35,55,20,57.1
42420,ky,-87.51679,37.80342,15284,27,47,20,74.1
42431,ky,-87.47833,37.32921,14537,35,56,21,60
42436,ky,-87.57025,37.41446,699,35,56,21,60
42437,ky,-87.9366,37.66385,3982,29,49,20,69
42440,ky,-87.46496,37.24161,464,35,55,20,57.1
42441,ky,-87.66825,37.35488,1259,36,56,20,55.6
42442,ky,-87.49559,37.16369,2137,33,54,21,63.6
42445,ky,-87.85472,37.13022,7674,36,56,20,55.6
42450,ky,-87.76329,37.3961,3340,38,59,21,55.3
42451,ky,-87.39143,37.88629,525,28,48,20,71.4
42452,ky,-87.53226,37.68825,1264,29,49,20,69
42453,ky,-87.60339,37.158,454,33,53,20,60.6
42455,ky,-87.54169,37.5871,2343,31,51,20,64.5
42456,ky,-87.49432,37.51336,1504,33,53,20,60.6
42458,ky,-87.42359,37.84121,630,28,48,20,71.4
42459,ky,-88.01531,37.55856,2860,32,52,20,62.5
42461,ky,-87.91056,37.79351,981,28,48,20,71.4
42462,ky,-87.80072,37.74089,830,28,48,20,71.4
42463,ky,-87.87164,37.47518,185,35,56,21,60
42464,ky,-87.36704,37.18151,1372,34,55,21,61.8
42501,ky,-84.4498,37.06175,11990,13,29,16,123.1
42503,ky,-84.52478,37.15663,14181,14,30,16,114.3
42516,ky,-84.77861,37.22717,328,11,26,15,136.4
42518,ky,-84.633,36.93455,2541,14,31,17,121.4
42519,ky,-84.53571,36.93932,5658,13,29,16,123.1
42528,ky,-85.01406,37.18414,1070,15,32,17,113.3
42533,ky,-84.59285,37.0676,425,14,31,17,121.4
42539,ky,-84.95386,37.3038,6325,14,30,16,114.3
42541,ky,-84.79767,37.3715,355,11,26,15,136.4
42544,ky,-84.81659,37.034,9789,15,32,17,113.3
42553,ky,-84.69699,37.17121,3375,12,27,15,125
42565,ky,-84.89349,37.15502,541,12,28,16,133.3
42566,ky,-84.77974,37.28537,426,11,25,14,127.3
42567,ky,-84.60652,37.2642,3937,11,25,14,127.3
42602,ky,-85.13316,36.73159,162,19,38,18,97.35
42629,ky,-85.11681,36.92484,6055,18,36,18,100
42631,ky,-84.48099,36.74039,60,10,25,15,150
42633,ky,-84.83044,36.79284,13098,13,29,16,123.1
42634,ky,-84.41928,36.8792,1475,10,24,14,140
42635,ky,-84.39839,36.68069,1639,9,23,14,155.6
42638,ky,-84.47016,36.67477,113,10,24,14,140
42642,ky,-85.03748,37.0551,10820,16,33,17,106.3
42647,ky,-84.61065,36.69212,2506,11,25,14,127.3
42649,ky,-84.42243,36.62464,1568,9,22,13,144.4
42653,ky,-84.4574,36.77787,2664,10,25,15,150
42701,ky,-85.83596,37.70498,21443,18,35,17,94.4
42712,ky,-86.15972,37.56314,424,21,40,19,90.5
42713,ky,-85.8831,37.38318,1185,22,41,19,86.4
42715,ky,-85.39257,36.95294,355,20,39,19,95
42716,ky,-85.60847,37.47647,162,19,38,19,100
42717,ky,-85.37893,36.78187,4537,23,43,20,87
42718,ky,-85.37359,37.38735,13291,18,36,18,100
42721,ky,-86.49687,37.42147,234,27,46,19,70.4
42722,ky,-85.7169,37.27542,460,25,44,19,76
42724,ky,-86.06467,37.67291,2840,21,39,18,85.7
42728,ky,-85.28859,37.1109,11673,19,38,19,100
42729,ky,-86.09408,37.29759,2511,26,46,20,76.9
42731,ky,-85.54976,36.85095,179,24,44,20,83.3
42732,ky,-86.11394,37.60603,1407,21,40,19,90.5
42733,ky,-85.17317,37.34337,1002,17,34,17,100
42740,ky,-85.94054,37.59209,1103,20,39,19,95
42741,ky,-85.24055,36.99531,399,18,36,18,100
42743,ky,-85.53082,37.22893,6703,23,42,19,82.6
42746,ky,-85.73361,37.21187,1089,24,44,20,83.3
42749,ky,-85.88023,37.18954,2910,26,46,20,76.9
42753,ky,-85.18511,37.22355,592,19,37,18,94.7
42754,ky,-86.31462,37.476,2628,24,42,18,75
42757,ky,-85.72073,37.40058,1217,22,41,19,86.4
42758,ky,-85.19913,37.37625,87,17,35,18,105.9
42764,ky,-85.61911,37.42601,292,20,39,19,95
42765,ky,-85.92164,37.31397,3490,25,44,19,76
42776,ky,-85.9165,37.51363,1281,21,40,19,90.5
42782,ky,-85.63159,37.34401,750,23,42,19,82.6
42784,ky,-85.92067,37.45127,1125,21,40,19,90.5
42788,ky,-86.03473,37.5288,189,23,42,19,82.6
43001,oh,-82.61368,40.08863,1399,5,14,9,180
43002,oh,-83.1739,40.0633,2122,8,19,11,137.5
43003,oh,-82.97541,40.41034,1701,7,17,10,142.9
43004,oh,-82.80009,40.01584,10118,5,13,8,160
43005,oh,-82.27708,40.28624,133,5,12,7,140
43006,oh,-82.14575,40.45877,778,4,10,6,150
43008,oh,-82.48135,39.93386,1317,6,15,9,150
43009,oh,-83.6415,40.17258,1564,6,17,11,183.3
43010,oh,-83.6219,39.99963,159,6,16,10,166.7
43011,oh,-82.68614,40.31046,4697,4,11,7,175
43013,oh,-82.68765,40.2322,724,4,11,7,175
43014,oh,-82.25639,40.47131,2754,4,11,7,175
43015,oh,-83.06067,40.29679,22084,7,17,10,142.9
43016,oh,-83.1537,40.09858,11598,8,19,11,137.5
43017,oh,-83.13008,40.1168,13839,8,19,11,137.5
43019,oh,-82.5764,40.49344,5856,4,11,7,175
43021,oh,-82.8842,40.20091,6036,7,17,10,142.9
43022,oh,-82.33967,40.33831,1633,4,12,8,200
43023,oh,-82.5318,40.07527,5968,6,15,9,150
43025,oh,-82.51673,39.96632,3387,6,16,10,166.7
43026,oh,-83.18553,40.02275,21244,8,20,12,150
43028,oh,-82.29352,40.40031,8619,5,12,7,140
43029,oh,-83.4585,40.09519,378,9,20,11,122.2
43030,oh,-82.41584,39.96145,119,5,13,8,160
43031,oh,-82.66622,40.16102,6786,4,12,8,200
43032,oh,-82.95882,40.32862,71,7,17,10,142.9
43033,oh,-82.59981,39.96096,162,6,16,10,166.7
43035,oh,-82.99505,40.18912,9425,8,19,11,137.5
43036,oh,-83.26201,40.3523,252,8,18,10,125
43037,oh,-82.32578,40.27799,344,5,12,7,140
43040,oh,-83.3595,40.26095,13919,7,18,11,157.1
43044,oh,-83.56414,40.05027,3550,7,18,11,157.1
43045,oh,-83.44861,40.1699,1281,8,20,12,150
43046,oh,-82.54121,39.89868,3105,6,16,10,166.7
43050,oh,-82.49556,40.3723,17204,4,11,7,175
43054,oh,-82.80352,40.08087,9141,5,14,9,180
43055,oh,-82.37652,40.11783,27296,7,16,9,128.6
43056,oh,-82.33515,40.01136,7989,6,15,9,150
43060,oh,-83.57252,40.21995,1566,7,18,11,157.1
43061,oh,-83.20323,40.2866,2869,7,18,11,157.1
43062,oh,-82.68281,40.00755,13359,5,14,9,180
43064,oh,-83.28777,40.09807,8703,8,18,10,125
43065,oh,-83.09363,40.17761,17365,8,18,10,125
43066,oh,-83.16456,40.39766,1275,7,18,11,157.1
43067,oh,-83.47094,40.34566,1167,7,17,10,142.9
43068,oh,-82.78505,39.95636,16974,6,15,9,150
43070,oh,-83.95794,40.21578,106,5,15,10,200
43071,oh,-82.3582,40.18424,1378,6,14,8,133.3
43072,oh,-83.95624,40.11635,4152,6,15,9,150
43074,oh,-82.84957,40.27833,7280,6,15,9,150
43076,oh,-82.39753,39.89644,7582,6,15,9,150
43077,oh,-83.34082,40.13666,147,8,19,11,137.5
43078,oh,-83.7763,40.11282,12016,7,17,10,142.9
43080,oh,-82.42904,40.24271,3217,5,13,8,160
43081,oh,-82.89135,40.11066,22064,7,17,10,142.9
43082,oh,-82.88197,40.15242,10635,7,18,11,157.1
43084,oh,-83.54086,40.15681,748,8,20,12,150
43085,oh,-83.01571,40.09989,9583,8,18,10,125
43101,oh,-82.74562,39.46462,256,7,17,10,142.9
43102,oh,-82.76299,39.63957,2674,6,17,11,183.3
43103,oh,-82.93545,39.7257,5413,9,20,11,122.2
43105,oh,-82.61664,39.86357,4344,7,16,9,128.6
43106,oh,-83.42118,39.64233,1012,7,17,10,142.9
43107,oh,-82.40957,39.69088,1966,6,16,10,166.7
43109,oh,-82.83416,39.912,76,7,17,10,142.9
43110,oh,-82.79948,39.82634,13986,7,17,10,142.9
43111,oh,-82.24239,39.50203,211,7,17,10,142.9
43112,oh,-82.70359,39.7967,2916,7,17,10,142.9
43113,oh,-82.96317,39.59092,11880,9,20,11,122.2
43115,oh,-83.16271,39.49147,996,8,20,12,150
43116,oh,-83.0614,39.77155,845,8,20,12,150
43117,oh,-83.20613,39.76879,58,7,18,11,157.1
43119,oh,-83.20076,39.93571,9722,8,19,11,137.5
43123,oh,-83.11982,39.86853,25733,9,20,11,122.2
43125,oh,-82.88449,39.83662,5807,8,19,11,137.5
43126,oh,-83.16638,39.81389,187,8,19,11,137.5
43127,oh,-82.32421,39.48047,136,7,17,10,142.9
43128,oh,-83.57751,39.66413,1810,7,17,10,142.9
43130,oh,-82.61049,39.69882,27953,7,17,10,142.9
43135,oh,-82.69757,39.46643,3116,6,16,10,166.7
43136,oh,-82.81248,39.80132,371,6,15,9,150
43137,oh,-82.98548,39.80824,1139,9,21,12,133.3
43138,oh,-82.41101,39.522,11395,7,17,10,142.9
43140,oh,-83.42997,39.88299,10438,7,18,11,157.1
43142,oh,-83.5875,39.59337,78,7,17,10,142.9
43143,oh,-83.29396,39.71674,4108,7,18,11,157.1
43144,oh,-82.19211,39.52847,376,6,15,9,150
43145,oh,-83.25841,39.56535,1537,7,18,11,157.1
43146,oh,-83.14164,39.77434,4927,8,19,11,137.5
43147,oh,-82.74212,39.89924,16247,6,16,10,166.7
43148,oh,-82.4995,39.8167,1289,7,16,9,128.6
43149,oh,-82.57214,39.53833,2068,6,16,10,166.7
43150,oh,-82.40936,39.77327,1417,6,15,9,150
43151,oh,-83.47662,39.73327,255,7,17,10,142.9
43152,oh,-82.61482,39.39445,1061,6,17,11,183.3
43153,oh,-83.57004,39.73974,792,6,17,11,183.3
43154,oh,-82.82878,39.60076,1684,7,17,10,142.9
43155,oh,-82.52492,39.62612,2733,6,16,10,166.7
43156,oh,-82.77629,39.55379,181,8,18,10,125
43157,oh,-82.54621,39.84265,293,7,16,9,128.6
43158,oh,-82.35765,39.44919,145,7,17,10,142.9
43160,oh,-83.44268,39.52654,12598,6,16,10,166.7
43162,oh,-83.3045,39.94337,3700,8,19,11,137.5
43164,oh,-83.11845,39.58555,1753,8,20,12,150
43201,oh,-83.00046,39.99133,8102,7,17,10,142.9
43202,oh,-83.01413,40.02143,5591,7,17,10,142.9
43203,oh,-82.96905,39.97308,3206,7,18,11,157.1
43204,oh,-83.08158,39.96133,15034,9,21,12,133.3
43205,oh,-82.96219,39.95759,5685,7,18,11,157.1
43206,oh,-82.97372,39.94221,10017,8,18,10,125
43207,oh,-82.96292,39.89585,19084,8,19,11,137.5
43209,oh,-82.9301,39.95389,9179,7,17,10,142.9
43210,oh,-83.02275,40.00522,222,8,18,10,125
43211,oh,-82.9724,40.01164,10306,7,17,10,142.9
43212,oh,-83.04168,39.98706,6408,9,20,11,122.2
43213,oh,-82.86743,39.96896,10149,6,16,10,166.7
43214,oh,-83.01974,40.05214,10226,8,18,10,125
43215,oh,-83.01278,39.96634,4829,8,19,11,137.5
43217,oh,-82.93181,39.81673,213,9,21,12,133.3
43219,oh,-82.9212,40.00651,12019,7,16,9,128.6
43220,oh,-83.07125,40.04789,9024,9,20,11,122.2
43221,oh,-83.07766,40.02264,12700,9,20,11,122.2
43222,oh,-83.0352,39.96117,2162,9,20,11,122.2
43223,oh,-83.03507,39.92833,9844,9,20,11,122.2
43224,oh,-82.96626,40.04276,12573,7,17,10,142.9
43227,oh,-82.88935,39.94486,7957,7,17,10,142.9
43228,oh,-83.12596,39.96475,15092,9,20,11,122.2
43229,oh,-82.97603,40.08586,11605,7,18,11,157.1
43230,oh,-82.86985,40.03562,19388,6,15,9,150
43231,oh,-82.93895,40.07922,6515,7,18,11,157.1
43232,oh,-82.87017,39.9222,11887,7,17,10,142.9
43235,oh,-83.05242,40.10263,13843,8,19,11,137.5
43240,oh,-82.98172,40.14542,863,8,19,11,137.5
43302,oh,-83.12957,40.5997,25818,6,15,9,150
43310,oh,-83.78123,40.53492,3342,6,16,10,166.7
43311,oh,-83.75613,40.36589,10830,5,15,10,200
43314,oh,-82.95939,40.64918,2288,6,14,8,133.3
43315,oh,-82.87766,40.48322,4810,5,13,8,160
43316,oh,-83.3808,40.95417,4778,7,16,9,128.6
43317,oh,-82.68173,40.47713,174,4,11,7,175
43318,oh,-83.91278,40.30918,2688,6,17,11,183.3
43319,oh,-83.57219,40.3065,883,7,17,10,142.9
43320,oh,-82.89804,40.58854,1378,5,14,9,180
43321,oh,-82.82978,40.45734,267,4,12,8,200
43322,oh,-83.20784,40.53218,267,7,17,10,142.9
43323,oh,-83.25002,40.73161,879,7,16,9,128.6
43324,oh,-83.81058,40.44636,2576,6,16,10,166.7
43326,oh,-83.61503,40.63931,10705,7,18,11,157.1
43330,oh,-83.41941,40.81349,157,7,17,10,142.9
43331,oh,-83.91902,40.51764,6372,7,17,10,142.9
43332,oh,-83.37787,40.58665,1903,7,17,10,142.9
43333,oh,-83.93197,40.43992,757,6,16,10,166.7
43334,oh,-82.80417,40.40049,4157,4,12,8,200
43336,oh,-83.58233,40.29084,45,7,17,10,142.9
43337,oh,-83.24153,40.68202,953,7,16,9,128.6
43338,oh,-82.75946,40.5605,10055,4,11,7,175
43340,oh,-83.47901,40.53923,1531,7,17,10,142.9
43341,oh,-83.31532,40.59643,765,7,17,10,142.9
43342,oh,-83.18353,40.47558,2309,7,17,10,142.9
43343,oh,-83.9775,40.30907,1098,6,16,10,166.7
43344,oh,-83.3397,40.43311,3857,7,18,11,157.1
43345,oh,-83.58378,40.51121,929,6,16,10,166.7
43347,oh,-83.65958,40.47786,1093,6,15,9,150
43348,oh,-83.88698,40.46748,2227,7,17,10,142.9
43351,oh,-83.30375,40.82495,8251,7,17,10,142.9
43356,oh,-83.04718,40.45816,957,7,17,10,142.9
43357,oh,-83.74662,40.25335,3088,6,16,10,166.7
43358,oh,-83.53262,40.41956,2060,7,17,10,142.9
43359,oh,-83.45488,40.87349,909,7,16,9,128.6
43360,oh,-83.63126,40.33103,1429,6,15,9,150
43402,oh,-83.65459,41.40996,14383,6,15,9,150
43403,oh,-83.63712,41.37698,25,6,15,9,150
43406,oh,-83.4363,41.33616,1440,6,15,9,150
43407,oh,-83.24941,41.27783,555,6,15,9,150
43408,oh,-83.36346,41.57183,191,6,14,8,133.3
43410,oh,-82.95956,41.30699,5431,5,13,8,160
43412,oh,-83.3224,41.62709,4504,6,14,8,133.3
43413,oh,-83.65255,41.2415,1484,6,15,9,150
43416,oh,-83.26934,41.48356,2070,5,13,8,160
43420,oh,-83.11102,41.35862,15434,5,13,8,160
43430,oh,-83.37011,41.52464,2944,6,14,8,133.3
43431,oh,-83.33773,41.38991,2675,6,14,8,133.3
43432,oh,-83.25212,41.5631,1105,6,14,8,133.3
43433,oh,-82.88026,41.50469,111,3,9,6,200
43434,oh,-83.44474,41.69303,150,7,16,9,128.6
43435,oh,-83.31284,41.32531,1148,6,14,8,133.3
43437,oh,-83.60231,41.25369,424,6,15,9,150
43438,oh,-82.70284,41.60341,1876,2,6,4,200
43439,oh,-83.04129,41.51766,80,4,11,7,175
43440,oh,-82.78087,41.52638,8211,2,7,5,250
43442,oh,-83.21536,41.42697,763,5,13,8,160
43443,oh,-83.46736,41.46173,1365,6,14,8,133.3
43445,oh,-83.2984,41.5849,1068,6,14,8,133.3
43446,oh,-82.80785,41.68473,978,2,6,4,200
43447,oh,-83.43544,41.56606,2299,7,15,8,114.3
43449,oh,-83.14347,41.53618,6850,5,12,7,140
43450,oh,-83.49211,41.40069,2531,6,15,9,150
43451,oh,-83.61518,41.31283,1046,6,15,9,150
43452,oh,-82.9668,41.51518,13667,3,9,6,200
43456,oh,-82.82277,41.66837,2165,2,6,4,200
43457,oh,-83.42748,41.26733,1215,6,15,9,150
43458,oh,-83.21259,41.53105,317,6,14,8,133.3
43460,oh,-83.56305,41.6029,3486,8,17,9,112.5
43462,oh,-83.7187,41.28357,1083,6,15,9,150
43463,oh,-83.50803,41.50866,26,6,14,8,133.3
43464,oh,-82.93271,41.40723,1409,4,11,7,175
43465,oh,-83.50379,41.57001,2461,7,16,9,128.6
43466,oh,-83.51482,41.29536,1668,6,15,9,150
43467,oh,-83.48384,41.2432,120,6,15,9,150
43468,oh,-83.34149,41.59787,216,7,15,8,114.3
43469,oh,-83.36318,41.45944,1866,5,13,8,160
43501,oh,-84.45727,41.67247,758,7,15,8,114.3
43502,oh,-84.29884,41.53022,3943,7,16,9,128.6
43504,oh,-83.83676,41.69578,786,5,13,8,160
43505,oh,-84.73127,41.52394,127,7,16,9,128.6
43506,oh,-84.55623,41.46629,8253,8,17,9,112.5
43511,oh,-83.82368,41.26339,1292,6,15,9,150
43512,oh,-84.35805,41.30272,18554,7,17,10,142.9
43515,oh,-84.00777,41.5853,4308,6,14,8,133.3
43516,oh,-83.91494,41.21789,2440,6,15,9,150
43517,oh,-84.72684,41.4402,2496,8,17,9,112.5
43518,oh,-84.75394,41.58913,2155,7,15,8,114.3
43519,oh,-84.40853,41.42091,171,7,16,9,128.6
43521,oh,-84.29872,41.66291,2027,7,15,8,114.3
43522,oh,-83.84482,41.41915,2307,6,15,9,150
43523,oh,-83.98925,41.33707,61,6,15,9,150
43524,oh,-84.03955,41.22847,1073,6,15,9,150
43525,oh,-83.70445,41.46658,618,7,15,8,114.3
43526,oh,-84.72806,41.31448,4282,8,19,11,137.5
43527,oh,-84.16011,41.25057,1890,7,16,9,128.6
43528,oh,-83.74896,41.6286,7151,6,14,8,133.3
43529,oh,-83.78162,41.1876,246,6,15,9,150
43531,oh,-84.49567,41.63504,160,7,16,9,128.6
43532,oh,-83.9743,41.45516,2591,7,15,8,114.3
43533,oh,-84.08248,41.69142,1081,6,14,8,133.3
43534,oh,-83.93004,41.35557,1387,6,15,9,150
43535,oh,-84.02204,41.30728,714,7,16,9,128.6
43536,oh,-84.63289,41.3098,449,8,18,10,125
43537,oh,-83.68552,41.57466,11824,6,14,8,133.3
43540,oh,-83.94131,41.69563,994,6,13,7,116.7
43541,oh,-83.82954,41.30076,217,6,15,9,150
43542,oh,-83.76503,41.56671,1970,6,13,7,116.7
43543,oh,-84.6337,41.60567,6818,7,16,9,128.6
43545,oh,-84.12747,41.39128,8315,7,16,9,128.6
43547,oh,-83.87632,41.49216,233,6,14,8,133.3
43548,oh,-84.17511,41.18533,733,7,16,9,128.6
43549,oh,-84.51735,41.37448,1104,7,17,10,142.9
43551,oh,-83.57127,41.52153,18690,6,15,9,150
43553,oh,-84.22884,41.53123,130,6,16,10,166.7
43554,oh,-84.55808,41.66028,1868,7,15,8,114.3
43555,oh,-84.25432,41.43413,152,7,16,9,128.6
43556,oh,-84.56991,41.30607,1469,7,17,10,142.9
43557,oh,-84.39621,41.48409,1985,7,16,9,128.6
43558,oh,-83.87836,41.59284,7213,6,14,8,133.3
43560,oh,-83.73803,41.70108,13269,7,14,7,100
43565,oh,-83.74011,41.41997,312,7,15,8,114.3
43566,oh,-83.75867,41.49586,3740,6,14,8,133.3
43567,oh,-84.15407,41.57569,6408,6,15,9,150
43569,oh,-83.78832,41.35141,2105,6,15,9,150
43570,oh,-84.44006,41.58707,2042,7,16,9,128.6
43571,oh,-83.81977,41.51584,3323,6,14,8,133.3
43604,oh,-83.53998,41.652,4506,9,18,9,100
43605,oh,-83.50667,41.64827,12650,8,18,10,125
43606,oh,-83.61085,41.67172,9796,9,19,10,111.1
43607,oh,-83.60614,41.64751,11756,9,18,9,100
43608,oh,-83.52856,41.6799,8536,9,19,10,111.1
43609,oh,-83.58044,41.62707,10557,8,17,9,112.5
43610,oh,-83.56136,41.67802,2830,9,19,10,111.1
43611,oh,-83.48401,41.70476,9375,8,17,9,112.5
43612,oh,-83.54863,41.70945,12448,9,19,10,111.1
43613,oh,-83.60373,41.70625,13476,9,19,10,111.1
43614,oh,-83.62888,41.6032,10185,7,16,9,128.6
43615,oh,-83.67316,41.65078,13403,7,15,8,114.3
43616,oh,-83.40845,41.65955,10029,8,17,9,112.5
43617,oh,-83.72826,41.66463,3127,6,14,8,133.3
43619,oh,-83.47224,41.60448,5142,8,17,9,112.5
43620,oh,-83.55427,41.66518,2041,9,19,10,111.1
43623,oh,-83.65143,41.70412,7894,9,18,9,100
43701,oh,-81.994,39.96006,34161,5,14,9,180
43711,oh,-81.57751,39.84205,153,6,15,9,150
43713,oh,-81.1741,39.98804,6829,3,8,5,166.7
43716,oh,-81.00997,39.83677,2396,3,10,7,233.3
43717,oh,-81.55567,39.78972,367,5,15,10,200
43718,oh,-81.00091,40.00947,3127,3,9,6,200
43719,oh,-81.07942,39.99879,2460,3,9,6,200
43720,oh,-81.87311,39.7945,1423,5,13,8,160
43721,oh,-82.26006,39.94894,124,5,14,9,180
43722,oh,-81.51757,39.91918,547,5,14,9,180
43723,oh,-81.54011,39.96058,4071,5,14,9,180
43724,oh,-81.51484,39.73277,7331,5,15,10,200
43725,oh,-81.58943,40.04497,17200,6,16,10,166.7
43727,oh,-81.79393,39.86818,1474,5,13,8,160
43728,oh,-81.89471,39.49211,1538,6,15,9,150
43730,oh,-82.09728,39.62434,3232,5,14,9,180
43731,oh,-82.06483,39.72717,3781,5,14,9,180
43732,oh,-81.6528,39.84572,2032,5,14,9,180
43733,oh,-81.53807,39.92741,178,5,14,9,180
43734,oh,-81.90112,39.88312,956,5,13,8,160
43735,oh,-82.1188,39.86326,348,5,14,9,180
43736,oh,-81.2364,40.05904,98,3,8,5,166.7
43738,oh,-82.14123,39.85537,144,5,14,9,180
43739,oh,-82.28876,39.90777,1215,5,14,9,180
43740,oh,-82.21293,39.95219,163,5,13,8,160
43746,oh,-82.17437,39.97171,1114,5,14,9,180
43747,oh,-81.12166,39.8625,1060,3,9,6,200
43748,oh,-82.30933,39.70026,1777,5,15,10,200
43749,oh,-81.56953,40.16528,4192,5,13,8,160
43750,oh,-81.50946,39.9936,143,5,14,9,180
43754,oh,-81.23765,39.75807,1865,4,11,7,175
43755,oh,-81.43481,40.0543,1928,5,13,8,160
43756,oh,-81.79496,39.69076,6178,6,15,9,150
43758,oh,-81.94434,39.62286,4204,5,14,9,180
43759,oh,-81.07434,40.0648,61,3,8,5,166.7
43760,oh,-82.19922,39.88935,1312,5,14,9,180
43761,oh,-82.1469,39.66796,157,5,14,9,180
43762,oh,-81.74064,40.02763,3357,5,14,9,180
43764,oh,-82.19146,39.71067,5863,6,15,9,150
43766,oh,-82.25158,39.59848,1631,6,15,9,150
43767,oh,-81.80449,40.01235,1207,5,13,8,160
43768,oh,-81.44487,40.03779,255,5,13,8,160
43771,oh,-81.9438,39.83602,1763,4,12,8,200
43772,oh,-81.52433,39.88172,2038,5,14,9,180
43773,oh,-81.29621,39.98835,3859,3,10,7,233.3
43777,oh,-82.08734,39.81818,3588,5,14,9,180
43778,oh,-81.37625,40.00715,1726,4,12,8,200
43779,oh,-81.42434,39.8162,1271,4,12,8,200
43780,oh,-81.43857,39.91754,3914,4,12,8,200
43782,oh,-82.21734,39.61845,1032,5,14,9,180
43783,oh,-82.28406,39.8042,2844,5,14,9,180
43786,oh,-81.27701,39.71046,53,4,12,8,200
43787,oh,-81.8062,39.53139,4054,7,17,10,142.9
43788,oh,-81.33323,39.80227,1112,4,11,7,175
43793,oh,-81.09988,39.74331,4796,4,11,7,175
43802,oh,-81.8599,40.0958,888,5,13,8,160
43804,oh,-81.73745,40.45387,1917,4,11,7,175
43805,oh,-81.97254,40.39331,102,4,12,8,200
43811,oh,-81.92625,40.18323,673,5,14,9,180
43812,oh,-81.88218,40.27168,12922,5,13,8,160
43821,oh,-82.00665,40.1367,3283,5,14,9,180
43822,oh,-82.17251,40.1774,3218,6,15,9,150
43824,oh,-81.76148,40.36277,2461,5,13,8,160
43830,oh,-82.14475,40.06169,3611,6,15,9,150
43832,oh,-81.58243,40.27477,5960,5,13,8,160
43836,oh,-81.7198,40.20874,125,5,14,9,180
43837,oh,-81.48065,40.30193,1900,4,12,8,200
43840,oh,-81.60401,40.4072,1272,4,12,8,200
43842,oh,-82.01276,40.13692,291,5,14,9,180
43843,oh,-82.17393,40.33667,1133,4,11,7,175
43844,oh,-82.05254,40.33365,3772,5,13,8,160
43845,oh,-81.73121,40.25694,3149,5,14,9,180
43901,oh,-80.86211,40.22383,2427,3,10,7,233.3
43902,oh,-80.96235,39.89143,330,3,10,7,233.3
43903,oh,-80.95205,40.47028,2113,4,10,6,150
43905,oh,-80.83805,40.1035,341,4,11,7,175
43906,oh,-80.80373,40.0121,7893,4,11,7,175
43907,oh,-81.02124,40.25608,6350,4,11,7,175
43908,oh,-80.87439,40.50879,1506,4,10,6,150
43910,oh,-80.82294,40.37227,3241,4,11,7,175
43912,oh,-80.79459,40.08803,6547,4,12,8,200
43913,oh,-80.63085,40.271,1251,3,10,7,233.3
43914,oh,-80.95281,39.77522,94,3,10,7,233.3
43915,oh,-80.89766,39.75974,1831,4,12,8,200
43917,oh,-80.80314,40.22515,3472,3,10,7,233.3
43920,oh,-80.58326,40.67844,19441,4,11,7,175
43925,oh,-80.86232,40.44763,119,3,10,7,233.3
43926,oh,-80.62168,40.50815,302,5,14,9,180
43927,oh,-80.93577,40.11879,89,4,11,7,175
43928,oh,-80.90746,40.01029,171,3,10,7,233.3
43930,oh,-80.76589,40.56756,1010,4,11,7,175
43931,oh,-80.87263,39.67334,282,5,13,8,160
43932,oh,-80.76202,40.51683,1028,4,12,8,200
43933,oh,-80.89444,39.93718,2141,4,11,7,175
43934,oh,-80.79001,40.07807,249,4,11,7,175
43935,oh,-80.75151,40.12595,7021,4,12,8,200
43938,oh,-80.67251,40.30374,5326,5,12,7,140
43939,oh,-80.80002,40.16715,521,3,9,6,200
43940,oh,-80.82339,40.02875,332,4,12,8,200
43942,oh,-80.84879,39.86371,2107,4,12,8,200
43943,oh,-80.72452,40.22294,3801,3,9,6,200
43944,oh,-80.77105,40.43074,2117,4,11,7,175
43945,oh,-80.84361,40.6324,3007,4,10,6,150
43946,oh,-80.96514,39.65073,2257,4,13,9,225
43947,oh,-80.78559,39.95599,3830,4,12,8,200
43948,oh,-80.77827,40.27012,763,3,9,6,200
43950,oh,-80.92586,40.09621,10973,3,10,7,233.3
43951,oh,-81.01159,40.11081,163,4,11,7,175
43952,oh,-80.66159,40.39803,14328,4,12,8,200
43953,oh,-80.70776,40.3581,6815,4,11,7,175
43961,oh,-80.62977,40.52543,280,5,13,8,160
43962,oh,-80.87993,40.67203,89,3,9,6,200
43963,oh,-80.69678,40.17165,1053,3,9,6,200
43964,oh,-80.67062,40.48615,6978,5,13,8,160
43967,oh,-80.94009,40.02646,30,3,10,7,233.3
43968,oh,-80.68563,40.63221,5139,5,13,8,160
43970,oh,-80.88913,40.4632,55,3,10,7,233.3
43971,oh,-80.71296,40.1581,891,3,9,6,200
43972,oh,-80.97488,40.1016,102,3,10,7,233.3
43973,oh,-81.27184,40.19409,3069,4,12,8,200
43974,oh,-80.88753,40.18224,75,3,9,6,200
43976,oh,-80.90872,40.36523,1332,4,10,6,150
43977,oh,-81.10351,40.13977,2826,4,11,7,175
43983,oh,-81.20539,40.14154,1094,4,11,7,175
43985,oh,-81.13452,40.16587,226,4,11,7,175
43986,oh,-80.99377,40.38013,2091,4,11,7,175
43988,oh,-81.10267,40.40284,2701,4,12,8,200
44001,oh,-82.26177,41.36496,11180,5,12,7,140
44003,oh,-80.58601,41.62145,7554,2,7,5,250
44004,oh,-80.79163,41.85617,22040,1,5,4,400
44010,oh,-80.8521,41.76249,1180,2,7,5,250
44011,oh,-82.01874,41.44852,10887,4,10,6,150
44012,oh,-82.01629,41.49832,13534,3,9,6,200
44017,oh,-81.8631,41.36867,7432,3,9,6,200
44021,oh,-81.1474,41.44166,3819,3,8,5,166.7
44022,oh,-81.40459,41.4481,7996,2,6,4,200
44023,oh,-81.29064,41.38638,10341,3,8,5,166.7
44024,oh,-81.19261,41.57664,12135,2,5,3,150
44026,oh,-81.33179,41.53248,5454,1,5,4,400
44028,oh,-81.93898,41.31019,5271,4,11,7,175
44030,oh,-80.58192,41.89982,12112,1,4,3,300
44032,oh,-80.66993,41.666,1799,2,7,5,250
44035,oh,-82.12939,41.36513,31749,6,14,8,133.3
44039,oh,-82.01963,41.38477,19581,5,12,7,140
44040,oh,-81.41101,41.53202,1615,2,7,5,250
44041,oh,-80.95168,41.7778,9637,2,6,4,200
44044,oh,-82.04027,41.26675,6903,5,13,8,160
44045,oh,-81.28364,41.74628,433,1,5,4,400
44046,oh,-81.06938,41.5427,1081,2,7,5,250
44047,oh,-80.7389,41.71894,5749,2,7,5,250
44048,oh,-80.64561,41.84629,1499,2,6,4,200
44049,oh,-82.30534,41.2663,250,5,12,7,140
44050,oh,-82.1301,41.24847,3673,5,13,8,160
44052,oh,-82.16304,41.457,14451,4,11,7,175
44053,oh,-82.22476,41.42636,8866,4,11,7,175
44054,oh,-82.09333,41.46727,9431,4,11,7,175
44055,oh,-82.13365,41.43382,11376,5,12,7,140
44056,oh,-81.49828,41.31496,5311,3,8,5,166.7
44057,oh,-81.05829,41.76782,10583,2,6,4,200
44060,oh,-81.32851,41.67796,29091,2,6,4,200
44062,oh,-81.026,41.45765,5619,4,9,5,125
44064,oh,-81.04787,41.60517,1105,2,6,4,200
44065,oh,-81.243,41.46339,3944,2,7,5,250
44067,oh,-81.54762,41.31472,8637,3,8,5,166.7
44070,oh,-81.91893,41.41503,11510,3,8,5,166.7
44072,oh,-81.3279,41.47174,2478,2,6,4,200
44074,oh,-82.23361,41.28741,5713,5,13,8,160
44076,oh,-80.82076,41.5293,3067,4,10,6,150
44077,oh,-81.21075,41.69941,26577,2,7,5,250
44080,oh,-81.05039,41.36984,213,4,9,5,125
44081,oh,-81.14556,41.76775,3611,2,7,5,250
44082,oh,-80.56602,41.7623,1098,1,5,4,400
44084,oh,-80.89493,41.67261,3451,2,8,6,300
44085,oh,-80.87089,41.60525,2702,3,8,5,166.7
44086,oh,-81.05794,41.67512,1447,2,5,3,150
44087,oh,-81.44015,41.31797,8986,3,9,6,200
44089,oh,-82.36907,41.39052,10272,4,10,6,150
44090,oh,-82.22956,41.16741,6983,5,12,7,140
44092,oh,-81.46842,41.59796,7669,2,7,5,250
44093,oh,-80.61213,41.53274,1715,2,7,5,250
44094,oh,-81.37989,41.60999,16040,2,7,5,250
44095,oh,-81.44213,41.65243,15757,2,6,4,200
44099,oh,-80.9747,41.55008,1120,4,10,6,150
44101,oh,-81.66739,41.48935,12,2,7,5,250
44102,oh,-81.73792,41.47876,15586,2,7,5,250
44103,oh,-81.6424,41.51933,10563,2,7,5,250
44104,oh,-81.62681,41.48223,10205,2,7,5,250
44105,oh,-81.6302,41.45063,19859,3,8,5,166.7
44106,oh,-81.60673,41.50626,8352,2,7,5,250
44107,oh,-81.80177,41.48468,14896,2,7,5,250
44108,oh,-81.60827,41.54223,11948,2,6,4,200
44109,oh,-81.69671,41.44474,15441,3,7,4,133.3
44110,oh,-81.57156,41.56569,8498,2,6,4,200
44111,oh,-81.78859,41.45825,16121,2,7,5,250
44112,oh,-81.57371,41.53564,9850,2,6,4,200
44113,oh,-81.69755,41.48423,6529,2,7,5,250
44114,oh,-81.67776,41.51766,2162,2,7,5,250
44115,oh,-81.67107,41.49214,1747,2,7,5,250
44116,oh,-81.85331,41.47297,7193,2,7,5,250
44117,oh,-81.52697,41.57145,3928,2,7,5,250
44118,oh,-81.55626,41.50185,14131,2,7,5,250
44119,oh,-81.54846,41.58908,5496,2,6,4,200
44120,oh,-81.5793,41.4735,13024,3,7,4,133.3
44121,oh,-81.53213,41.5265,13932,2,7,5,250
44122,oh,-81.5118,41.47013,12129,2,7,5,250
44123,oh,-81.5249,41.60533,6954,2,6,4,200
44124,oh,-81.46676,41.50054,14216,2,6,4,200
44125,oh,-81.61511,41.40692,13369,3,8,5,166.7
44126,oh,-81.85299,41.44176,6411,2,7,5,250
44127,oh,-81.64923,41.4715,3592,3,8,5,166.7
44128,oh,-81.54022,41.43759,12679,2,7,5,250
44129,oh,-81.7351,41.3897,11361,2,7,5,250
44130,oh,-81.78676,41.37785,17730,3,8,5,166.7
44131,oh,-81.65236,41.38285,10413,3,8,5,166.7
44132,oh,-81.49935,41.60685,4983,2,7,5,250
44133,oh,-81.74534,41.3141,9968,2,7,5,250
44134,oh,-81.70445,41.3853,15801,2,7,5,250
44135,oh,-81.81964,41.42569,12498,2,7,5,250
44136,oh,-81.81105,41.31184,9078,3,9,6,200
44137,oh,-81.56252,41.4093,11534,3,8,5,166.7
44138,oh,-81.92311,41.37366,7452,4,10,6,150
44139,oh,-81.4444,41.38327,9997,2,7,5,250
44140,oh,-81.92853,41.48856,6749,2,7,5,250
44141,oh,-81.61423,41.30083,5651,3,8,5,166.7
44142,oh,-81.82519,41.40227,8003,3,8,5,166.7
44143,oh,-81.47514,41.55357,9412,2,7,5,250
44144,oh,-81.74265,41.43766,8229,3,7,4,133.3
44145,oh,-81.92948,41.45243,10234,2,7,5,250
44146,oh,-81.53019,41.38163,12692,2,7,5,250
44147,oh,-81.67876,41.31912,6665,2,7,5,250
44149,oh,-81.85617,41.3134,8369,3,9,6,200
44201,oh,-81.1793,41.02681,3864,3,9,6,200
44202,oh,-81.33989,41.31497,8931,3,9,6,200
44203,oh,-81.6289,41.02055,21252,4,10,6,150
44212,oh,-81.8295,41.24341,18171,4,10,6,150
44214,oh,-81.99849,40.95264,1480,5,11,6,120
44215,oh,-81.89778,41.07037,2014,5,12,7,140
44216,oh,-81.58504,40.93914,4595,4,10,6,150
44217,oh,-81.91163,40.95517,2313,5,11,6,120
44221,oh,-81.47654,41.13958,12538,4,10,6,150
44223,oh,-81.53127,41.17126,8077,4,11,7,175
44224,oh,-81.43883,41.17669,14413,4,10,6,150
44230,oh,-81.68995,40.96329,3760,4,10,6,150
44231,oh,-81.07238,41.30653,4319,4,10,6,150
44233,oh,-81.73513,41.23942,4098,4,9,5,125
44234,oh,-81.15756,41.33496,1762,3,8,5,166.7
44235,oh,-82.12452,41.03144,880,5,11,6,120
44236,oh,-81.45091,41.24769,10708,4,10,6,150
44240,oh,-81.34151,41.13304,14943,3,9,6,200
44241,oh,-81.34721,41.23941,6152,3,9,6,200
44243,oh,-81.34142,41.14796,12,3,9,6,200
44250,oh,-81.43739,41.02108,874,3,9,6,200
44251,oh,-81.92741,41.02916,545,5,12,7,140
44253,oh,-82.03323,41.16568,1775,5,11,6,120
44254,oh,-82.01481,41.04413,2586,5,12,7,140
44255,oh,-81.22974,41.2865,4102,3,8,5,166.7
44256,oh,-81.859,41.14012,29160,4,11,7,175
44260,oh,-81.34079,41.03677,6782,3,9,6,200
44262,oh,-81.43723,41.14047,2113,4,10,6,150
44264,oh,-81.54251,41.22825,2334,4,11,7,175
44265,oh,-81.25308,41.03571,33,3,9,6,200
44266,oh,-81.20257,41.16674,17659,3,9,6,200
44270,oh,-81.77805,40.96055,4592,4,11,7,175
44272,oh,-81.18329,41.08799,2708,3,9,6,200
44273,oh,-81.87615,41.02753,4072,5,12,7,140
44274,oh,-81.73267,41.09833,141,4,10,6,150
44275,oh,-82.09939,41.1015,2056,5,12,7,140
44276,oh,-81.8362,40.93616,1097,4,11,7,175
44278,oh,-81.42163,41.10153,8110,3,9,6,200
44280,oh,-81.92382,41.23894,2726,5,12,7,140
44281,oh,-81.73834,41.05857,14409,4,10,6,150
44285,oh,-81.0716,41.15967,40,4,10,6,150
44286,oh,-81.64063,41.23688,3367,4,10,6,150
44287,oh,-82.10108,40.93908,5555,4,11,7,175
44288,oh,-81.08441,41.23861,2019,4,10,6,150
44301,oh,-81.52456,41.04392,7986,3,9,6,200
44302,oh,-81.53867,41.08944,2313,4,10,6,150
44303,oh,-81.53694,41.10469,3394,4,11,7,175
44304,oh,-81.50785,41.08318,2108,4,10,6,150
44305,oh,-81.46139,41.07585,11434,3,9,6,200
44306,oh,-81.48317,41.03935,10706,3,9,6,200
44307,oh,-81.54626,41.07037,4050,4,10,6,150
44308,oh,-81.51701,41.08166,485,4,10,6,150
44310,oh,-81.49714,41.10662,10654,4,10,6,150
44311,oh,-81.52071,41.06423,3362,3,9,6,200
44312,oh,-81.44077,41.01541,16296,3,9,6,200
44313,oh,-81.56454,41.13273,9264,4,11,7,175
44314,oh,-81.55858,41.04057,9851,4,10,6,150
44319,oh,-81.53157,40.98305,12372,3,9,6,200
44320,oh,-81.58327,41.0783,10658,4,10,6,150
44321,oh,-81.65133,41.09889,6026,4,10,6,150
44333,oh,-81.63284,41.16192,8381,4,11,7,175
44401,oh,-80.94518,41.02263,2143,3,9,6,200
44402,oh,-80.85427,41.38658,1973,4,11,7,175
44403,oh,-80.58146,41.24046,1946,4,10,6,150
44404,oh,-80.54994,41.3266,1023,3,9,6,200
44405,oh,-80.59187,41.07768,6373,3,9,6,200
44406,oh,-80.77219,41.01105,11040,3,9,6,200
44408,oh,-80.68652,40.88615,6530,3,8,5,166.7
44410,oh,-80.72414,41.34931,8745,3,9,6,200
44411,oh,-81.04878,41.03498,1510,4,10,6,150
44412,oh,-81.02479,41.09399,1569,4,10,6,150
44413,oh,-80.55409,40.84789,4878,3,9,6,200
44417,oh,-80.66387,41.43638,1041,3,8,5,166.7
44418,oh,-80.60347,41.30737,797,3,8,5,166.7
44420,oh,-80.6801,41.17323,10418,4,11,7,175
44423,oh,-80.9008,40.7527,2052,4,10,6,150
44425,oh,-80.5738,41.17053,10116,4,10,6,150
44427,oh,-80.95634,40.7163,1257,4,10,6,150
44428,oh,-80.57856,41.43607,2244,3,8,5,166.7
44429,oh,-80.98164,41.09718,4715,4,11,7,175
44430,oh,-80.90783,41.24066,4186,5,11,6,120
44431,oh,-80.75418,40.84831,3410,3,8,5,166.7
44432,oh,-80.75815,40.75011,7718,4,10,6,150
44436,oh,-80.54333,41.0595,3735,3,9,6,200
44437,oh,-80.73131,41.15579,3646,5,11,6,120
44438,oh,-80.53372,41.24232,4481,5,12,7,140
44439,oh,-80.95637,41.45575,44,5,12,7,140
44440,oh,-80.78376,41.14835,2296,4,10,6,150
44441,oh,-80.55299,40.75793,1895,3,10,7,233.3
44442,oh,-80.54929,40.96614,1865,3,8,5,166.7
44443,oh,-80.59836,40.92438,1033,3,8,5,166.7
44444,oh,-80.97524,41.17345,12599,4,11,7,175
44445,oh,-80.61807,40.84866,1977,3,8,5,166.7
44446,oh,-80.74962,41.18997,11669,5,11,6,120
44449,oh,-81.03358,40.98035,1361,4,10,6,150
44450,oh,-80.82993,41.45517,1678,4,11,7,175
44451,oh,-80.86849,41.0812,2108,4,11,7,175
44452,oh,-80.66171,40.94771,1796,3,8,5,166.7
44454,oh,-80.54285,40.92002,777,3,9,6,200
44455,oh,-80.61014,40.7766,1392,3,9,6,200
44460,oh,-80.87055,40.89919,16309,3,8,5,166.7
44470,oh,-80.96187,41.29778,2098,4,11,7,175
44471,oh,-80.58966,41.04851,6998,3,9,6,200
44473,oh,-80.66249,41.24616,2251,3,8,5,166.7
44481,oh,-80.86402,41.22728,6805,5,11,6,120
44483,oh,-80.81564,41.2653,15397,5,11,6,120
44484,oh,-80.74905,41.23519,12138,4,11,7,175
44485,oh,-80.84609,41.2404,11401,5,12,7,140
44490,oh,-80.76808,40.89991,503,3,9,6,200
44491,oh,-80.96434,41.37502,1806,4,11,7,175
44493,oh,-80.88862,40.82502,15,3,9,6,200
44502,oh,-80.6425,41.08451,10557,4,10,6,150
44503,oh,-80.64901,41.09911,552,4,10,6,150
44504,oh,-80.65369,41.12359,2252,5,12,7,140
44505,oh,-80.61957,41.12797,21290,4,9,5,125
44506,oh,-80.62607,41.09352,4266,4,11,7,175
44507,oh,-80.65527,41.07426,5398,4,10,6,150
44509,oh,-80.69646,41.10804,8239,4,11,7,175
44510,oh,-80.6741,41.12266,2799,5,12,7,140
44511,oh,-80.69569,41.06952,11399,4,10,6,150
44512,oh,-80.66774,41.025,16132,3,9,6,200
44514,oh,-80.6081,40.99893,11641,3,8,5,166.7
44515,oh,-80.76378,41.10125,12598,4,9,5,125
44601,oh,-81.13019,40.91934,22170,4,9,5,125
44606,oh,-81.79764,40.73166,2870,3,10,7,233.3
44607,oh,-81.02574,40.68952,163,4,10,6,150
44608,oh,-81.59487,40.65397,1847,4,11,7,175
44609,oh,-80.98795,40.91734,2697,3,9,6,200
44610,oh,-81.79976,40.55963,257,4,10,6,150
44611,oh,-82.08584,40.60453,1587,4,10,6,150
44612,oh,-81.45964,40.63594,3285,5,12,7,140
44613,oh,-81.6002,40.71371,1360,4,10,6,150
44614,oh,-81.58628,40.88707,5933,3,10,7,233.3
44615,oh,-81.07428,40.5651,12366,4,11,7,175
44618,oh,-81.68897,40.7727,3486,4,10,6,150
44620,oh,-81.21375,40.58264,1529,5,12,7,140
44621,oh,-81.29592,40.42753,3194,6,14,8,133.3
44622,oh,-81.47896,40.54869,10237,5,14,9,180
44624,oh,-81.66095,40.6113,2844,4,11,7,175
44625,oh,-80.99995,40.76113,870,4,9,5,125
44626,oh,-81.38378,40.68962,2964,4,11,7,175
44627,oh,-81.8325,40.66605,2520,4,10,6,150
44628,oh,-82.16449,40.53712,1248,4,11,7,175
44629,oh,-81.44611,40.35648,1615,5,13,8,160
44632,oh,-81.30667,40.96381,4965,3,9,6,200
44633,oh,-81.93415,40.63141,1433,4,11,7,175
44634,oh,-81.04789,40.83418,1296,3,9,6,200
44637,oh,-82.03372,40.48311,2315,4,11,7,175
44638,oh,-82.13606,40.64819,1616,4,10,6,150
44640,oh,-81.14861,40.98447,162,4,10,6,150
44641,oh,-81.24172,40.86582,10991,3,9,6,200
44643,oh,-81.30088,40.63962,2013,5,12,7,140
44644,oh,-81.17661,40.68777,3849,4,11,7,175
44645,oh,-81.71653,40.90887,1347,4,10,6,150
44646,oh,-81.4984,40.8125,22870,4,10,6,150
44647,oh,-81.56502,40.79757,10828,4,10,6,150
44651,oh,-80.95389,40.6255,833,3,9,6,200
44652,oh,-81.32614,40.90022,50,3,9,6,200
44653,oh,-81.37033,40.4361,372,6,16,10,166.7
44654,oh,-81.87082,40.53912,12927,4,11,7,175
44656,oh,-81.33674,40.56899,2614,5,13,8,160
44657,oh,-81.09308,40.74117,6703,4,10,6,150
44659,oh,-81.70239,40.69458,162,4,10,6,150
44661,oh,-82.11302,40.59559,174,4,10,6,150
44662,oh,-81.55621,40.71086,6462,4,11,7,175
44663,oh,-81.45208,40.46046,14865,5,14,9,180
44666,oh,-81.63286,40.84409,1988,3,10,7,233.3
44667,oh,-81.76595,40.83346,6689,4,10,6,150
44669,oh,-81.15784,40.79666,960,4,10,6,150
44670,oh,-81.18878,40.76263,141,4,10,6,150
44671,oh,-81.36567,40.64603,259,5,13,8,160
44672,oh,-81.0254,40.92058,3112,4,10,6,150
44675,oh,-81.25004,40.50034,2399,5,13,8,160
44676,oh,-82.03537,40.6885,2985,4,11,7,175
44677,oh,-81.86114,40.8741,1586,4,10,6,150
44678,oh,-81.34997,40.56665,153,5,14,9,180
44680,oh,-81.5425,40.60259,2510,5,12,7,140
44681,oh,-81.66122,40.50208,4805,4,11,7,175
44682,oh,-81.40542,40.39724,456,5,14,9,180
44683,oh,-81.32316,40.35284,5764,5,14,9,180
44685,oh,-81.42411,40.95991,11814,3,9,6,200
44687,oh,-81.71998,40.53792,45,4,11,7,175
44688,oh,-81.25768,40.68459,2492,4,11,7,175
44689,oh,-81.65683,40.64974,399,4,11,7,175
44690,oh,-81.69402,40.61425,147,4,10,6,150
44691,oh,-81.97954,40.80572,20898,4,10,6,150
44693,oh,-81.18617,40.30186,157,5,13,8,160
44695,oh,-81.17834,40.43675,1951,5,12,7,140
44697,oh,-81.42377,40.61162,287,5,12,7,140
44699,oh,-81.2849,40.27808,1498,4,12,8,200
44702,oh,-81.37578,40.79979,870,4,10,6,150
44703,oh,-81.38135,40.81056,4041,4,10,6,150
44704,oh,-81.34038,40.80039,3689,4,10,6,150
44705,oh,-81.33224,40.83382,10247,4,10,6,150
44706,oh,-81.41864,40.75353,10723,4,10,6,150
44707,oh,-81.34984,40.7611,7602,4,10,6,150
44708,oh,-81.43563,40.81775,11938,4,10,6,150
44709,oh,-81.38621,40.84236,7998,4,10,6,150
44710,oh,-81.42596,40.78971,4226,4,10,6,150
44714,oh,-81.35901,40.83625,4281,4,10,6,150
44718,oh,-81.44743,40.85116,6009,3,9,6,200
44720,oh,-81.43168,40.90139,18708,3,9,6,200
44721,oh,-81.32837,40.89413,6387,3,9,6,200
44730,oh,-81.25905,40.76572,4602,4,10,6,150
44802,oh,-83.41942,41.04563,829,6,15,9,150
44804,oh,-83.53413,41.10559,897,6,14,8,133.3
44805,oh,-82.31685,40.87291,16763,4,11,7,175
44807,oh,-82.87732,41.0599,2190,6,13,7,116.7
44809,oh,-83.28895,41.1335,204,7,16,9,128.6
44811,oh,-82.8446,41.24464,7700,4,11,7,175
44813,oh,-82.53167,40.59885,4924,3,10,7,233.3
44814,oh,-82.47257,41.3219,1744,4,10,6,150
44815,oh,-83.23945,41.2466,466,6,15,9,150
44816,oh,-82.35252,41.3302,35,4,11,7,175
44817,oh,-83.54542,41.19985,1446,6,15,9,150
44818,oh,-82.99594,41.00039,2374,6,14,8,133.3
44820,oh,-82.97252,40.81745,13398,6,13,7,116.7
44822,oh,-82.39859,40.55722,2562,4,10,6,150
44824,oh,-82.80506,41.38062,2441,4,10,6,150
44825,oh,-82.94322,40.95419,50,6,13,7,116.7
44826,oh,-82.48015,41.24089,1320,4,10,6,150
44827,oh,-82.75772,40.81939,5337,4,11,7,175
44828,oh,-82.86091,41.23201,119,5,12,7,140
44830,oh,-83.39992,41.16706,11471,6,15,9,150
44833,oh,-82.79417,40.71066,12355,4,11,7,175
44836,oh,-83.0547,41.23808,1665,6,14,8,133.3
44837,oh,-82.48221,41.01644,3033,4,11,7,175
44838,oh,-82.25983,40.77229,249,3,9,6,200
44839,oh,-82.55963,41.37811,6935,3,8,5,166.7
44840,oh,-82.17891,40.78964,1942,4,10,6,150
44841,oh,-83.3061,41.25122,635,6,15,9,150
44842,oh,-82.22497,40.65142,4427,4,10,6,150
44843,oh,-82.41076,40.68904,1763,3,10,7,233.3
44844,oh,-83.26135,40.9922,739,7,16,9,128.6
44846,oh,-82.61033,41.32061,2060,3,10,7,233.3
44847,oh,-82.70554,41.22893,3208,4,11,7,175
44849,oh,-83.13047,40.80929,2283,6,15,9,150
44850,oh,-82.68402,41.03539,151,5,13,8,160
44851,oh,-82.40595,41.10393,4105,5,11,6,120
44853,oh,-83.30304,41.05532,1052,7,15,8,114.3
44854,oh,-82.85508,40.94344,1651,5,13,8,160
44855,oh,-82.58954,41.10396,1090,5,12,7,140
44856,oh,-82.85669,40.794,89,5,13,8,160
44857,oh,-82.58242,41.2185,12734,4,10,6,150
44859,oh,-82.32647,41.02046,1161,4,11,7,175
44861,oh,-83.14798,41.23949,49,6,15,9,150
44864,oh,-82.32132,40.665,2639,4,10,6,150
44865,oh,-82.67911,40.99232,2298,5,12,7,140
44866,oh,-82.19341,40.92059,1262,4,11,7,175
44867,oh,-82.98829,41.14705,1854,6,14,8,133.3
44870,oh,-82.74432,41.42538,20568,3,7,4,133.3
44874,oh,-82.36635,40.96806,263,5,11,6,120
44875,oh,-82.65268,40.88813,8138,4,10,6,150
44878,oh,-82.51718,40.94621,2052,4,11,7,175
44880,oh,-82.22032,41.03413,1754,4,11,7,175
44881,oh,-82.87604,40.87002,45,5,13,8,160
44882,oh,-83.13513,40.94761,2974,6,15,9,150
44883,oh,-83.17333,41.12372,16437,7,16,9,128.6
44887,oh,-82.78568,40.92163,1042,5,12,7,140
44889,oh,-82.38326,41.24553,4546,4,11,7,175
44890,oh,-82.71563,41.08114,8469,5,13,8,160
44902,oh,-82.51059,40.75816,3949,3,9,6,200
44903,oh,-82.52738,40.77603,16509,3,9,6,200
44904,oh,-82.61296,40.66547,6980,3,9,6,200
44905,oh,-82.46822,40.77749,7230,3,9,6,200
44906,oh,-82.57698,40.76578,10623,3,9,6,200
44907,oh,-82.52137,40.72724,6733,3,9,6,200
45001,oh,-84.71232,39.13916,801,13,26,13,100
45002,oh,-84.73404,39.19835,7097,13,27,14,107.7
45003,oh,-84.78785,39.58696,479,8,20,12,150
45005,oh,-84.30287,39.53572,13937,10,23,13,130
45011,oh,-84.50251,39.42965,31166,15,30,15,100
45013,oh,-84.64867,39.40771,26642,17,32,15,88.2
45014,oh,-84.55129,39.32805,17236,15,31,16,106.7
45015,oh,-84.53961,39.36203,6450,17,32,15,88.2
45030,oh,-84.76085,39.25707,9196,15,30,15,100
45032,oh,-84.0103,39.50232,255,7,19,12,171.4
45033,oh,-84.76297,39.17678,172,13,28,15,115.4
45034,oh,-84.24648,39.35888,491,12,25,13,108.3
45036,oh,-84.2202,39.44444,15083,10,23,13,130
45039,oh,-84.23939,39.32791,11247,11,25,14,127.3
45040,oh,-84.31257,39.35199,21044,12,25,13,108.3
45041,oh,-84.70294,39.21114,192,13,28,15,115.4
45042,oh,-84.43779,39.5488,15002,12,26,14,116.7
45044,oh,-84.38227,39.45004,24246,13,27,14,107.7
45050,oh,-84.35918,39.44535,3985,12,26,14,116.7
45051,oh,-84.64661,39.09796,7,11,25,14,127.3
45052,oh,-84.77935,39.14485,2869,13,27,14,107.7
45053,in,-84.78063,39.35255,1933,13,28,14,111.9
45054,oh,-84.07495,39.44056,1401,9,21,12,133.3
45056,oh,-84.74366,39.49068,8140,10,24,14,140
45062,oh,-84.55296,39.47966,384,16,32,16,100
45064,oh,-84.60075,39.5662,1675,10,23,13,130
45065,oh,-84.21026,39.37085,2268,11,25,14,127.3
45066,oh,-84.22319,39.549,10764,8,20,12,150
45067,oh,-84.4787,39.48784,5800,14,29,15,107.1
45068,oh,-84.06351,39.5262,5790,9,21,12,133.3
45069,oh,-84.41141,39.3424,19569,13,27,14,107.7
45070,oh,-84.55809,39.5897,142,9,22,13,144.4
45101,oh,-83.74138,38.69056,1602,11,25,14,127.3
45102,oh,-84.20427,39.01715,10437,11,24,13,118.2
45103,oh,-84.13764,39.09755,14997,10,23,13,130
45106,oh,-84.07146,38.94491,7732,10,23,13,130
45107,oh,-83.96612,39.29264,5570,8,20,12,150
45111,oh,-84.29019,39.19636,435,12,26,14,116.7
45112,oh,-84.14012,38.79341,246,12,25,13,108.3
45113,oh,-83.98499,39.39717,2434,8,20,12,150
45115,oh,-83.69915,38.82413,117,9,21,12,133.3
45118,oh,-83.93326,39.17027,3488,8,20,12,150
45120,oh,-84.08951,38.82227,2439,10,24,14,140
45121,oh,-83.90369,38.87001,6178,9,21,12,133.3
45122,oh,-84.11621,39.22033,5441,9,22,13,144.4
45123,oh,-83.38584,39.35022,5751,7,18,11,157.1
45130,oh,-83.99865,38.90944,2476,9,21,12,133.3
45131,oh,-83.9665,38.79019,211,11,25,14,127.3
45132,oh,-83.60026,39.34392,180,6,16,10,166.7
45133,oh,-83.57606,39.15725,18387,6,17,11,183.3
45135,oh,-83.54431,39.34608,3104,7,17,10,142.9
45140,oh,-84.24166,39.25759,24182,11,25,14,127.3
45142,oh,-83.81263,39.20568,3289,7,17,10,142.9
45144,oh,-83.61321,38.70526,3286,10,23,13,130
45145,oh,-84.00516,39.14533,43,8,20,12,150
45146,oh,-83.79828,39.31505,1138,7,17,10,142.9
45147,oh,-84.28886,39.20667,174,12,26,14,116.7
45148,oh,-83.8835,39.28715,1088,8,19,11,137.5
45150,oh,-84.233,39.16572,14567,11,25,14,127.3
45152,oh,-84.12165,39.35059,6376,10,23,13,130
45153,oh,-84.18498,38.86869,1302,11,25,14,127.3
45154,oh,-83.91926,39.05949,5576,9,20,11,122.2
45155,oh,-83.75175,39.03988,320,7,18,11,157.1
45156,oh,-84.21544,38.81471,397,11,25,14,127.3
45157,oh,-84.23016,38.95653,6167,12,26,14,116.7
45158,oh,-84.08991,39.18113,181,9,21,12,133.3
45159,oh,-83.68924,39.33067,2185,6,16,10,166.7
45160,oh,-84.13662,39.12288,455,9,22,13,144.4
45162,oh,-84.07827,39.26779,1616,9,21,12,133.3
45164,oh,-83.78261,39.55405,217,7,18,11,157.1
45166,oh,-83.68776,39.4766,76,6,17,11,183.3
45167,oh,-83.8006,38.77281,3394,11,24,13,118.2
45168,oh,-83.75576,38.84488,1417,8,20,12,150
45169,oh,-83.6498,39.50059,3410,7,17,10,142.9
45171,oh,-83.79882,39.01453,7732,7,18,11,157.1
45172,oh,-83.38688,39.07447,158,8,19,11,137.5
45174,oh,-84.31053,39.15884,2077,13,28,15,115.4
45176,oh,-84.02317,39.08341,5783,9,21,12,133.3
45177,oh,-83.83712,39.4601,12873,7,18,11,157.1
45202,oh,-84.50285,39.10901,11471,14,29,15,107.1
45203,oh,-84.53349,39.10434,4452,14,29,15,107.1
45204,oh,-84.57181,39.09637,6747,14,28,14,100
45205,oh,-84.57519,39.11007,9219,14,28,14,100
45206,oh,-84.48437,39.12733,5966,14,29,15,107.1
45207,oh,-84.47133,39.14207,3398,15,29,14,93.3
45208,oh,-84.43448,39.13474,8903,15,30,15,100
45209,oh,-84.42661,39.15304,5000,14,29,15,107.1
45211,oh,-84.59829,39.15635,15219,13,28,15,115.4
45212,oh,-84.45222,39.16417,10304,14,29,15,107.1
45213,oh,-84.42016,39.1808,5996,14,29,15,107.1
45214,oh,-84.54471,39.12267,8810,15,30,15,100
45215,oh,-84.46209,39.2353,15306,14,28,14,100
45216,oh,-84.48167,39.20093,6048,14,29,15,107.1
45217,oh,-84.49731,39.16765,3306,14,29,15,107.1
45218,oh,-84.52222,39.26639,1781,14,29,15,107.1
45219,oh,-84.51306,39.12738,7228,15,30,15,100
45220,oh,-84.52072,39.14863,5329,15,30,15,100
45223,oh,-84.54897,39.17129,8941,15,31,16,106.7
45224,oh,-84.5315,39.20101,9694,15,30,15,100
45225,oh,-84.55207,39.14311,5565,15,30,15,100
45226,oh,-84.42016,39.11103,5798,15,29,14,93.3
45227,oh,-84.3854,39.15389,10086,14,28,14,100
45229,oh,-84.48682,39.15272,5227,14,29,15,107.1
45230,oh,-84.39099,39.07436,13584,13,27,14,107.7
45231,oh,-84.53785,39.24543,17925,14,29,15,107.1
45232,oh,-84.51101,39.18251,1663,15,30,15,100
45233,oh,-84.66588,39.11831,8271,12,26,14,116.7
45236,oh,-84.3973,39.20981,12549,13,27,14,107.7
45237,oh,-84.45229,39.19308,8591,14,29,15,107.1
45238,oh,-84.61116,39.10918,17671,12,26,14,116.7
45239,oh,-84.5799,39.20448,12644,14,29,15,107.1
45240,oh,-84.5289,39.28517,9343,15,30,15,100
45241,oh,-84.40192,39.2771,11067,12,26,14,116.7
45242,oh,-84.35638,39.2436,11821,12,26,14,116.7
45243,oh,-84.34175,39.18379,8587,13,28,15,115.4
45244,oh,-84.32741,39.1199,13100,12,26,14,116.7
45245,oh,-84.27538,39.06267,7985,12,25,13,108.3
45246,oh,-84.46691,39.28964,6337,15,30,15,100
45247,oh,-84.65159,39.22033,10140,14,28,14,100
45248,oh,-84.66255,39.16431,10141,12,27,15,125
45249,oh,-84.32799,39.27549,5620,12,26,14,116.7
45251,oh,-84.59386,39.26814,8659,14,29,15,107.1
45252,oh,-84.63216,39.27347,2413,14,29,15,107.1
45255,oh,-84.32709,39.05887,8962,12,26,14,116.7
45301,oh,-84.02228,39.71138,82,12,25,13,108.3
45302,oh,-84.20381,40.40228,2832,6,16,10,166.7
45303,oh,-84.65778,40.21593,1317,7,17,10,142.9
45304,oh,-84.53123,39.98879,4168,6,16,10,166.7
45305,oh,-84.07971,39.63478,4551,9,22,13,144.4
45306,oh,-84.18718,40.45821,1760,6,16,10,166.7
45307,oh,-83.72337,39.58061,266,7,17,10,142.9
45308,oh,-84.45736,40.1255,2858,7,17,10,142.9
45309,oh,-84.42146,39.84261,6805,7,19,12,171.4
45310,oh,-84.64248,40.35296,179,7,17,10,142.9
45311,oh,-84.6671,39.62694,4196,8,20,12,150
45312,oh,-84.08025,40.06029,857,7,17,10,142.9
45314,oh,-83.77572,39.74699,2259,7,18,11,157.1
45315,oh,-84.33911,39.85699,2413,8,20,12,150
45316,oh,-83.82579,39.7971,118,8,19,11,137.5
45317,oh,-84.01912,40.17488,1047,6,15,9,150
45318,oh,-84.3534,40.12925,3153,7,18,11,157.1
45319,oh,-83.94325,39.91613,158,8,19,11,137.5
45320,oh,-84.68811,39.74914,8706,7,18,11,157.1
45321,oh,-84.67823,39.87352,687,6,16,10,166.7
45322,oh,-84.32866,39.89787,9985,8,20,12,150
45323,oh,-83.92763,39.84997,2222,8,20,12,150
45324,oh,-83.99405,39.82279,16255,10,22,12,120
45325,oh,-84.42455,39.69127,1598,10,23,13,130
45326,oh,-84.09288,40.14271,886,6,16,10,166.7
45327,oh,-84.39987,39.63253,5373,11,24,13,118.2
45328,oh,-84.49666,40.11613,265,7,17,10,142.9
45330,oh,-84.52815,39.64833,479,9,21,12,133.3
45331,oh,-84.64626,40.09787,12101,6,16,10,166.7
45332,oh,-84.78665,39.99699,492,5,15,10,200
45333,oh,-84.33281,40.2476,987,7,17,10,142.9
45334,oh,-84.0443,40.44538,1632,6,16,10,166.7
45335,oh,-83.73382,39.6303,4595,7,17,10,142.9
45336,oh,-84.26138,40.44016,136,7,17,10,142.9
45337,oh,-84.42057,39.97993,986,7,17,10,142.9
45338,oh,-84.54359,39.84997,2902,7,18,11,157.1
45339,oh,-84.34244,40.00916,752,8,19,11,137.5
45340,oh,-84.04742,40.3719,756,6,16,10,166.7
45341,oh,-84.0233,39.87671,2040,9,21,12,133.3
45342,oh,-84.27634,39.62991,15290,8,20,12,150
45344,oh,-84.00954,39.95643,7628,8,20,12,150
45345,oh,-84.40746,39.73787,3179,9,22,13,144.4
45346,oh,-84.71132,39.98076,1424,6,15,9,150
45347,oh,-84.76265,39.88233,2664,6,15,9,150
45348,oh,-84.65195,40.32806,758,7,17,10,142.9
45349,oh,-83.94135,39.98911,210,6,16,10,166.7
45350,oh,-84.57368,40.32441,58,7,17,10,142.9
45351,oh,-84.49512,40.33943,157,7,17,10,142.9
45352,oh,-84.74428,40.05012,122,6,16,10,166.7
45353,oh,-84.04272,40.29258,222,6,16,10,166.7
45354,oh,-84.39969,39.91055,474,7,18,11,157.1
45356,oh,-84.23153,40.1609,12967,8,19,11,137.5
45358,oh,-84.4877,39.98658,175,6,17,11,183.3
45359,oh,-84.35253,40.05144,1116,8,19,11,137.5
45360,oh,-84.09171,40.33059,243,6,16,10,166.7
45361,oh,-84.41482,39.96371,190,7,17,10,142.9
45362,oh,-84.63571,40.28677,871,7,17,10,142.9
45363,oh,-84.39892,40.24051,1154,7,17,10,142.9
45365,oh,-84.15956,40.28424,16561,7,17,10,142.9
45368,oh,-83.65488,39.84329,2768,6,17,11,183.3
45369,oh,-83.6043,39.95304,1864,6,17,11,183.3
45370,oh,-84.02842,39.60736,1440,9,21,12,133.3
45371,oh,-84.16253,39.94035,9364,8,19,11,137.5
45372,oh,-83.83868,40.01471,245,7,18,11,157.1
45373,oh,-84.19475,40.03217,15769,9,20,11,122.2
45377,oh,-84.22335,39.89645,7081,8,20,12,150
45378,oh,-84.48872,39.90292,189,6,17,11,183.3
45380,oh,-84.51425,40.24334,2992,7,17,10,142.9
45381,oh,-84.52453,39.73151,2860,9,21,12,133.3
45382,oh,-84.61348,39.90035,795,6,16,10,166.7
45383,oh,-84.33777,39.95622,3404,8,19,11,137.5
45384,oh,-83.88484,39.71529,259,7,18,11,157.1
45385,oh,-83.91314,39.6698,20671,8,20,12,150
45387,oh,-83.88696,39.79806,3478,9,21,12,133.3
45388,oh,-84.48197,40.32645,483,7,17,10,142.9
45389,oh,-84.02759,40.05717,373,6,16,10,166.7
45390,oh,-84.76867,40.21871,1993,6,16,10,166.7
45402,oh,-84.21005,39.75952,12119,12,26,14,116.7
45403,oh,-84.14772,39.76871,10115,10,23,13,130
45404,oh,-84.16171,39.79055,7688,12,26,14,116.7
45405,oh,-84.21586,39.79238,10078,13,27,14,107.7
45406,oh,-84.24165,39.78437,12344,12,26,14,116.7
45409,oh,-84.18751,39.72435,5003,10,23,13,130
45410,oh,-84.15813,39.74805,8573,10,23,13,130
45414,oh,-84.21243,39.84253,12284,11,25,14,127.3
45415,oh,-84.25695,39.83456,5716,10,22,12,120
45416,oh,-84.25811,39.80715,2975,11,25,14,127.3
45417,oh,-84.28566,39.73591,24621,12,26,14,116.7
45418,oh,-84.2652,39.69566,600,12,26,14,116.7
45419,oh,-84.16718,39.71338,8060,9,21,12,133.3
45420,oh,-84.13058,39.71951,11686,9,22,13,144.4
45424,oh,-84.11121,39.84672,21258,9,21,12,133.3
45426,oh,-84.31472,39.8018,6214,10,23,13,130
45428,oh,-84.26063,39.74288,13,13,27,14,107.7
45429,oh,-84.16095,39.6848,11760,9,21,12,133.3
45430,oh,-84.08446,39.71289,3391,10,22,12,120
45431,oh,-84.07954,39.76452,8956,11,24,13,118.2
45432,oh,-84.0856,39.73906,7288,10,23,13,130
45433,oh,-84.05831,39.81257,41,10,22,12,120
45434,oh,-84.02897,39.72158,5637,11,24,13,118.2
45439,oh,-84.21864,39.70103,5367,10,22,12,120
45440,oh,-84.09857,39.67401,8096,10,22,12,120
45449,oh,-84.24132,39.66469,7379,9,21,12,133.3
45458,oh,-84.15815,39.60071,14587,7,19,12,171.4
45459,oh,-84.1696,39.64689,12591,8,20,12,150
45502,oh,-83.81836,39.92831,7991,7,17,10,142.9
45503,oh,-83.77234,39.96013,14695,6,17,11,183.3
45504,oh,-83.86589,39.94926,8362,7,17,10,142.9
45505,oh,-83.76288,39.90689,9970,6,17,11,183.3
45506,oh,-83.85358,39.90048,7723,7,17,10,142.9
45601,oh,-82.95563,39.31023,28966,9,21,12,133.3
45612,oh,-83.27256,39.21588,4203,7,18,11,157.1
45613,oh,-82.85137,39.0332,3052,9,20,11,122.2
45614,oh,-82.27706,38.92978,3641,11,23,12,109.1
45616,oh,-83.30761,38.75334,1424,9,21,12,133.3
45617,oh,-83.15564,39.27965,65,9,20,11,122.2
45618,oh,-83.61641,38.88549,17,7,19,12,171.4
45619,oh,-82.45035,38.47364,7643,12,27,15,125
45620,oh,-82.13983,38.95775,1160,11,23,12,109.1
45621,oh,-82.60774,39.11079,351,8,19,11,137.5
45622,oh,-82.49934,39.37552,340,8,20,12,150
45623,oh,-82.26791,38.64138,3188,10,23,13,130
45624,oh,-83.34702,39.17022,49,7,17,10,142.9
45628,oh,-83.19806,39.39099,3467,8,19,11,137.5
45629,oh,-82.81292,38.64972,2873,12,26,14,116.7
45630,oh,-83.09156,38.69914,97,12,25,13,108.3
45631,oh,-82.25548,38.81776,11333,12,25,13,108.3
45634,oh,-82.48627,39.1798,2035,9,21,12,133.3
45636,oh,-82.82506,38.58735,90,13,28,15,115.4
45638,oh,-82.67795,38.56189,17511,13,27,14,107.7
45640,oh,-82.65362,39.02198,13253,9,20,11,122.2
45642,oh,-83.05298,39.04625,27,11,24,13,118.2
45644,oh,-82.84156,39.45318,2552,8,19,11,137.5
45645,oh,-82.53158,38.56987,2849,11,24,13,118.2
45646,oh,-83.32295,39.07673,598,8,19,11,137.5
45647,oh,-82.73776,39.29435,1993,8,20,12,150
45648,oh,-83.01514,38.9206,8939,10,22,12,120
45650,oh,-83.42085,38.74441,478,9,21,12,133.3
45651,oh,-82.48883,39.27869,4833,9,21,12,133.3
45652,oh,-83.08476,38.83143,2769,11,23,12,109.1
45653,oh,-82.82306,38.89153,3016,10,23,13,130
45654,oh,-82.38209,39.36661,956,8,20,12,150
45656,oh,-82.59257,38.87589,6295,10,22,12,120
45657,oh,-83.21421,38.85278,2718,9,21,12,133.3
45658,oh,-82.41127,38.76216,2570,10,22,12,120
45659,oh,-82.62351,38.67089,3049,10,23,13,130
45660,oh,-83.36119,38.98647,6520,9,21,12,133.3
45661,oh,-83.10694,39.0422,6149,10,22,12,120
45662,oh,-82.92045,38.78773,20175,12,25,13,108.3
45663,oh,-83.10375,38.74779,5308,12,25,13,108.3
45669,oh,-82.35532,38.49433,9282,12,26,14,116.7
45671,oh,-83.24141,38.96823,531,8,20,12,150
45672,oh,-82.6834,39.20163,1888,8,20,12,150
45673,oh,-82.81202,39.2039,252,9,20,11,122.2
45674,oh,-82.37322,38.88166,368,11,24,13,118.2
45678,oh,-82.37735,38.60115,1479,10,23,13,130
45679,oh,-83.56374,38.97536,1984,9,21,12,133.3
45680,oh,-82.54518,38.45483,9551,12,26,14,116.7
45681,oh,-83.25182,39.30598,1194,7,18,11,157.1
45682,oh,-82.6944,38.80769,1935,10,22,12,120
45684,oh,-83.27316,38.67302,2016,11,24,13,118.2
45685,oh,-82.44967,38.93038,1067,10,22,12,120
45686,oh,-82.37188,39.01094,3171,10,21,11,110
45688,oh,-82.53035,38.72998,999,10,22,12,120
45690,oh,-83.01685,39.13139,10765,10,22,12,120
45692,oh,-82.54059,39.11455,8212,9,20,11,122.2
45693,oh,-83.5367,38.81009,6078,9,21,12,133.3
45694,oh,-82.78219,38.74731,8381,11,24,13,118.2
45695,oh,-82.3692,39.15942,921,9,20,11,122.2
45696,oh,-82.4504,38.60593,1668,10,23,13,130
45697,oh,-83.66522,38.9339,3473,7,19,12,171.4
45698,oh,-82.39253,39.28583,565,10,23,13,130
45701,oh,-82.08214,39.31356,15275,8,18,10,125
45710,oh,-82.22951,39.19803,4645,8,19,11,137.5
45711,oh,-81.92991,39.42449,1528,6,16,10,166.7
45714,oh,-81.61895,39.31725,7481,9,21,12,133.3
45715,oh,-81.62985,39.60459,3047,8,20,12,150
45716,oh,-82.18178,39.46281,600,7,17,10,142.9
45719,oh,-82.1262,39.39997,792,8,18,10,125
45721,oh,-81.58438,39.56549,39,8,20,12,150
45723,oh,-81.82723,39.22294,3437,8,19,11,137.5
45724,oh,-81.79189,39.38113,1919,7,17,10,142.9
45727,oh,-81.48484,39.64398,789,6,15,9,150
45729,oh,-81.60782,39.4136,1123,7,17,10,142.9
45732,oh,-82.06732,39.51518,5793,6,15,9,150
45734,oh,-81.18573,39.63874,825,5,13,8,160
45735,oh,-81.92457,39.25473,1574,7,17,10,142.9
45740,oh,-82.07931,39.47701,447,6,15,9,150
45741,oh,-82.25233,39.06486,1303,8,19,11,137.5
45742,oh,-81.72923,39.28552,2638,8,20,12,150
45743,oh,-81.84992,39.07619,1777,9,21,12,133.3
45744,oh,-81.50407,39.53767,3420,7,18,11,157.1
45745,oh,-81.32979,39.61622,2271,5,14,9,180
45746,oh,-81.45919,39.6099,651,6,16,10,166.7
45750,oh,-81.42221,39.43132,25001,7,18,11,157.1
45760,oh,-82.12329,39.01611,3918,9,21,12,133.3
45761,oh,-82.09102,39.4265,1492,7,17,10,142.9
45764,oh,-82.24418,39.44972,6067,7,18,11,157.1
45766,oh,-82.25938,39.32282,1272,9,20,11,122.2
45767,oh,-81.1341,39.54032,3585,5,13,8,160
45768,oh,-81.27076,39.41036,1677,6,16,10,166.7
45769,oh,-82.04824,39.10645,8495,9,20,11,122.2
45770,oh,-81.80052,38.98347,935,11,23,12,109.1
45771,oh,-81.89766,38.98138,4337,10,22,12,120
45772,oh,-81.82521,39.1424,2298,9,20,11,122.2
45773,oh,-81.2673,39.45852,120,5,13,8,160
45775,oh,-82.15424,39.08289,822,8,19,11,137.5
45776,oh,-82.02045,39.18709,783,8,18,10,125
45778,oh,-81.8931,39.34709,1037,7,17,10,142.9
45779,oh,-81.97023,38.99799,903,10,22,12,120
45780,oh,-82.1312,39.36644,1891,8,19,11,137.5
45782,oh,-82.07964,39.48605,381,6,15,9,150
45784,oh,-81.68721,39.38717,2605,8,18,10,125
45786,oh,-81.65368,39.50243,3500,8,19,11,137.5
45787,oh,-81.6316,39.46919,34,7,18,11,157.1
45788,oh,-81.36685,39.51364,1314,6,15,9,150
45789,oh,-81.2568,39.55156,277,5,14,9,180
45801,oh,-84.03698,40.77557,10377,7,18,11,157.1
45804,oh,-84.06627,40.71464,9085,7,17,10,142.9
45805,oh,-84.16464,40.72873,9493,8,18,10,125
45806,oh,-84.12437,40.67522,5364,7,18,11,157.1
45807,oh,-84.1708,40.80632,6293,8,18,10,125
45808,oh,-83.97188,40.83176,215,7,16,9,128.6
45809,oh,-84.18716,40.84549,92,8,18,10,125
45810,oh,-83.81207,40.77681,4252,7,16,9,128.6
45812,oh,-83.8094,40.68519,1888,7,17,10,142.9
45813,oh,-84.7311,41.18989,2855,8,18,10,125
45814,oh,-83.61405,40.90192,1600,6,15,9,150
45816,oh,-83.79401,41.00454,175,6,14,8,133.3
45817,oh,-83.88358,40.87727,3464,6,16,10,166.7
45819,oh,-84.26033,40.62403,149,7,18,11,157.1
45820,oh,-84.084,40.83495,300,7,17,10,142.9
45821,oh,-84.5642,41.22626,1352,7,17,10,142.9
45822,oh,-84.59805,40.55266,11812,8,18,10,125
45826,oh,-84.49343,40.43574,268,7,17,10,142.9
45827,oh,-84.30087,41.00319,2488,7,17,10,142.9
45828,oh,-84.67528,40.4867,2985,8,18,10,125
45830,oh,-84.09239,40.90561,5120,7,17,10,142.9
45831,oh,-84.24959,41.11001,3310,7,16,9,128.6
45832,oh,-84.73286,40.92657,2236,9,19,10,111.1
45833,oh,-84.3492,40.83404,5938,8,18,10,125
45835,oh,-83.70008,40.75982,641,7,16,9,128.6
45836,oh,-83.63987,40.79268,1583,7,16,9,128.6
45838,oh,-84.47782,40.74221,52,8,19,11,137.5
45840,oh,-83.65208,41.02537,24021,6,14,8,133.3
45841,oh,-83.7372,40.87453,729,6,15,9,150
45843,oh,-83.53503,40.78155,3912,7,17,10,142.9
45844,oh,-84.27738,40.91744,3218,7,17,10,142.9
45845,oh,-84.3818,40.33034,2298,7,17,10,142.9
45846,oh,-84.74623,40.40887,2702,8,19,11,137.5
45849,oh,-84.45337,41.01385,765,8,17,9,112.5
45850,oh,-83.9182,40.70406,2382,7,16,9,128.6
45851,oh,-84.60004,41.03233,728,8,18,10,125
45853,oh,-84.19851,40.98619,870,7,17,10,142.9
45854,oh,-83.95175,40.75776,274,7,16,9,128.6
45855,oh,-84.58409,41.08791,234,7,17,10,142.9
45856,oh,-83.99908,41.11526,4929,6,15,9,150
45858,oh,-83.80443,41.10771,2318,6,15,9,150
45859,oh,-83.77866,40.68374,454,7,17,10,142.9
45860,oh,-84.51342,40.394,1379,7,17,10,142.9
45861,oh,-84.4265,41.08281,395,7,17,10,142.9
45862,oh,-84.51455,40.67073,1235,8,19,11,137.5
45863,oh,-84.44728,40.9078,1097,8,19,11,137.5
45864,oh,-84.14076,41.09937,239,7,16,9,128.6
45865,oh,-84.36881,40.39151,3695,7,17,10,142.9
45866,oh,-84.55156,40.49138,159,7,18,11,157.1
45867,oh,-83.53695,40.89833,926,6,15,9,150
45868,oh,-83.84968,40.9663,505,6,15,9,150
45869,oh,-84.39714,40.45659,2710,7,17,10,142.9
45870,oh,-83.95142,40.55626,103,6,16,10,166.7
45871,oh,-84.29966,40.49377,1251,7,18,11,157.1
45872,oh,-83.68574,41.1887,3640,6,15,9,150
45873,oh,-84.39313,41.11956,1934,7,17,10,142.9
45874,oh,-84.67282,40.78696,1779,8,19,11,137.5
45875,oh,-84.06171,41.02205,8277,7,16,9,128.6
45876,oh,-84.34124,40.92725,641,8,18,10,125
45877,oh,-83.93683,40.95581,1767,7,16,9,128.6
45879,oh,-84.56157,41.12848,4779,7,17,10,142.9
45880,oh,-84.73608,41.06774,2052,8,18,10,125
45881,oh,-83.77561,40.94953,1012,6,14,8,133.3
45882,oh,-84.67559,40.67735,2283,8,19,11,137.5
45883,oh,-84.6285,40.4071,1980,7,18,11,157.1
45884,oh,-84.08277,40.5543,118,6,16,10,166.7
45885,oh,-84.38854,40.57146,8007,7,18,11,157.1
45886,oh,-84.61727,40.99194,587,8,18,10,125
45887,oh,-84.36403,40.71001,3009,8,18,10,125
45888,oh,-84.08684,40.60236,166,6,16,10,166.7
45889,oh,-83.63994,41.14664,913,6,14,8,133.3
45890,oh,-83.48985,40.97566,615,6,15,9,150
45891,oh,-84.57437,40.87505,9112,8,19,11,137.5
45894,oh,-84.46509,40.7652,710,8,19,11,137.5
45895,oh,-84.15177,40.57018,10547,7,17,10,142.9
45896,oh,-83.93135,40.60422,1563,6,16,10,166.7
45897,oh,-83.65747,40.83171,91,6,15,9,150
45898,oh,-84.75696,40.74296,1101,8,19,11,137.5
45899,oh,-84.7747,40.80082,162,8,19,11,137.5
46001,in,-85.65878,40.2505,8875,8,20,12,150
46011,in,-85.76168,40.12736,9843,8,20,12,150
46012,in,-85.62526,40.14996,11088,8,20,12,150
46013,in,-85.67829,40.0491,9238,8,20,12,150
46016,in,-85.68151,40.09782,13439,8,20,12,150
46017,in,-85.60695,40.07417,3163,8,19,11,137.5
46030,in,-86.00748,40.17213,2073,9,21,12,133.3
46031,in,-86.019,40.21027,1714,9,20,11,122.2
46032,in,-86.17115,39.96579,18466,10,22,12,120
46033,in,-86.08544,39.9789,14359,10,23,13,130
46034,in,-86.03815,40.12976,3983,9,22,13,144.4
46035,in,-86.67798,40.19001,1352,9,22,13,144.4
46036,in,-85.83109,40.2952,9799,9,21,12,133.3
46037,in,-85.9472,39.96032,17005,9,22,13,144.4
46038,in,-86.01678,39.9674,15129,10,22,12,120
46039,in,-86.31229,40.36947,893,9,20,11,122.2
46040,in,-85.83547,39.92744,7687,9,21,12,133.3
46041,in,-86.49185,40.29754,16805,8,20,12,150
46044,in,-85.79018,40.20946,2470,9,21,12,133.3
46045,in,-86.14986,40.28876,70,8,18,10,125
46047,in,-85.94736,40.28414,41,9,20,11,122.2
46048,in,-85.80173,39.9555,1742,9,21,12,133.3
46049,in,-86.22059,40.29753,1056,8,18,10,125
46050,in,-86.34887,40.20443,1890,9,20,11,122.2
46051,in,-85.8373,40.05795,1866,9,21,12,133.3
46052,in,-86.45986,40.04481,12049,10,22,12,120
46055,in,-85.90444,39.88555,6057,9,21,12,133.3
46056,in,-85.61203,39.97518,1819,8,19,11,137.5
46057,in,-86.37733,40.33627,1151,8,20,12,150
46058,in,-86.64738,40.36117,1590,9,21,12,133.3
46060,in,-85.93088,40.06599,17421,10,22,12,120
46062,in,-86.05545,40.06174,16010,10,23,13,130
46063,in,-85.72403,40.27045,459,8,20,12,150
46064,in,-85.74744,39.98346,7667,9,21,12,133.3
46065,in,-86.61324,40.42451,2419,10,22,12,120
46068,in,-86.11583,40.37695,2519,9,20,11,122.2
46069,in,-86.22922,40.13939,5280,8,20,12,150
46070,in,-85.66018,40.34196,2258,8,20,12,150
46071,in,-86.60688,40.12017,2537,9,22,13,144.4
46072,in,-86.06735,40.28609,6909,8,20,12,150
46074,in,-86.17579,40.03627,16976,9,22,13,144.4
46075,in,-86.33491,40.02525,3736,10,23,13,130
46076,in,-85.9341,40.36265,1824,8,20,12,150
46077,in,-86.28387,39.98435,13130,10,23,13,130
46103,in,-86.61362,39.68862,81,12,26,14,116.7
46104,in,-85.59545,39.66103,735,9,22,13,144.4
46105,in,-86.81066,39.76416,1548,12,26,14,116.7
46106,in,-86.20537,39.51304,3771,10,23,13,130
46107,in,-86.09149,39.71655,4782,10,23,13,130
46110,in,-85.9163,39.5634,543,12,26,14,116.7
46111,in,-86.36984,39.53872,204,11,25,14,127.3
46112,in,-86.3826,39.86504,16553,9,21,12,133.3
46113,in,-86.30539,39.6328,6224,11,24,13,118.2
46115,in,-85.56625,39.7391,1372,9,21,12,133.3
46117,in,-85.61761,39.81718,510,9,21,12,133.3
46118,in,-86.52218,39.65376,3434,10,24,14,140
46120,in,-86.78696,39.51319,4858,13,27,14,107.7
46121,in,-86.67207,39.67725,4740,12,26,14,116.7
46122,in,-86.54962,39.76862,7838,9,22,13,144.4
46123,in,-86.39963,39.7629,16031,10,23,13,130
46124,in,-85.92746,39.37335,4242,13,28,15,115.4
46125,in,-86.6416,39.52152,56,12,26,14,116.7
46126,in,-85.88837,39.62056,3062,12,26,14,116.7
46127,in,-85.31221,39.71196,367,6,17,11,183.3
46128,in,-86.74281,39.6557,1667,13,27,14,107.7
46130,in,-85.83588,39.67545,1817,11,25,14,127.3
46131,in,-86.04308,39.47213,14350,11,25,14,127.3
46133,in,-85.2996,39.59159,719,7,18,11,157.1
46135,in,-86.89227,39.65834,10414,14,28,14,100
46140,in,-85.77068,39.80337,19857,10,23,13,130
46142,in,-86.1764,39.62024,11845,10,23,13,130
46143,in,-86.11657,39.5951,21326,10,23,13,130
46144,in,-85.64735,39.65516,194,10,23,13,130
46146,in,-85.56833,39.58567,84,9,22,13,144.4
46147,in,-86.62601,39.97066,2400,9,21,12,133.3
46148,in,-85.51292,39.80881,3658,8,20,12,150
46149,in,-86.55751,39.88591,1342,8,20,12,150
46150,in,-85.60237,39.54487,685,9,23,14,155.6
46151,in,-86.43052,39.44799,20636,11,25,14,127.3
46155,in,-85.42974,39.7435,46,7,18,11,157.1
46156,in,-85.48188,39.48421,1071,9,21,12,133.3
46157,in,-86.52813,39.55462,2613,11,24,13,118.2
46158,in,-86.37491,39.58223,11160,11,24,13,118.2
46160,in,-86.27076,39.3523,4964,12,27,15,125
46161,in,-85.69462,39.67044,2090,11,24,13,118.2
46162,in,-85.95349,39.55071,358,12,26,14,116.7
46163,in,-85.90342,39.72867,6087,10,24,14,140
46164,in,-86.11504,39.32194,4433,12,26,14,116.7
46165,in,-86.64559,39.84703,1372,9,21,12,133.3
46166,in,-86.58724,39.43206,1811,12,26,14,116.7
46167,in,-86.47054,39.87547,3632,8,20,12,150
46168,in,-86.39187,39.68929,14003,10,24,14,140
46171,in,-86.96897,39.53597,1642,14,29,15,107.1
46172,in,-86.81781,39.82589,2164,11,24,13,118.2
46173,in,-85.429,39.60275,7075,8,20,12,150
46175,in,-86.97355,39.82155,644,12,26,14,116.7
46176,in,-85.77396,39.52752,15725,12,27,15,125
46180,in,-86.61792,39.59822,1070,11,25,14,127.3
46181,in,-86.16265,39.3806,3690,11,25,14,127.3
46182,in,-85.66927,39.46134,1847,11,25,14,127.3
46183,in,-86.28165,39.65268,39,11,25,14,127.3
46184,in,-86.07229,39.5611,5690,10,23,13,130
46186,in,-85.64463,39.89382,1343,8,20,12,150
46201,in,-86.10919,39.77418,14416,10,23,13,130
46202,in,-86.16333,39.78412,7380,11,24,13,118.2
46203,in,-86.09694,39.73761,17705,10,23,13,130
46204,in,-86.15696,39.77156,1821,11,24,13,118.2
46205,in,-86.13488,39.82825,11323,10,24,14,140
46208,in,-86.17239,39.82375,10780,11,24,13,118.2
46214,in,-86.2896,39.7918,6366,10,23,13,130
46216,in,-86.01149,39.86625,817,9,22,13,144.4
46217,in,-86.19394,39.67275,12606,10,24,14,140
46218,in,-86.09971,39.80728,15978,10,23,13,130
46219,in,-86.04436,39.78277,13868,10,22,12,120
46220,in,-86.10817,39.86776,14715,10,23,13,130
46221,in,-86.23782,39.69208,10579,11,25,14,127.3
46222,in,-86.21475,39.79104,14369,11,25,14,127.3
46224,in,-86.25629,39.79547,8153,10,24,14,140
46225,in,-86.16316,39.74048,3897,11,24,13,118.2
46226,in,-86.05161,39.83851,14641,9,22,13,144.4
46227,in,-86.13146,39.67613,15802,10,23,13,130
46228,in,-86.20015,39.84887,6608,10,23,13,130
46229,in,-85.97792,39.78857,9150,9,22,13,144.4
46231,in,-86.32166,39.71594,4514,10,23,13,130
46234,in,-86.32566,39.8125,9688,10,22,12,120
46235,in,-85.97635,39.83772,8871,9,21,12,133.3
46236,in,-85.96848,39.89166,10259,9,21,12,133.3
46237,in,-86.07571,39.67297,14994,9,22,13,144.4
46239,in,-86.0003,39.72328,13176,9,22,13,144.4
46240,in,-86.12371,39.9069,6911,10,23,13,130
46241,in,-86.26608,39.72568,12141,11,24,13,118.2
46250,in,-86.06808,39.90412,5382,10,22,12,120
46254,in,-86.27207,39.84897,10654,10,22,12,120
46256,in,-86.01178,39.90685,8594,9,22,13,144.4
46259,in,-85.98719,39.65177,5576,10,23,13,130
46260,in,-86.17974,39.89773,8768,10,23,13,130
46268,in,-86.23333,39.89929,8573,10,22,12,120
46278,in,-86.29788,39.8952,4109,9,21,12,133.3
46280,in,-86.11891,39.93714,3237,10,23,13,130
46290,in,-86.16329,39.93466,155,10,23,13,130
46301,in,-86.97696,41.69079,2248,7,13,6,85.7
46303,in,-87.47639,41.37127,9350,9,18,9,100
46304,in,-87.04693,41.6143,14561,8,15,7,87.5
46307,in,-87.32767,41.40259,28746,8,18,10,125
46310,in,-87.23182,41.18404,7976,10,20,10,100
46311,in,-87.50904,41.46518,9652,9,19,10,111.1
46312,in,-87.45456,41.64697,9243,9,19,10,111.1
46319,in,-87.42229,41.52581,7155,11,21,10,90.9
46320,in,-87.50477,41.64326,5852,10,20,10,100
46321,in,-87.50405,41.54685,8709,11,21,10,90.9
46322,in,-87.4588,41.54826,9331,11,22,11,100
46323,in,-87.45327,41.58968,8055,11,20,9,81.8
46324,in,-87.50158,41.58305,8590,11,21,10,90.9
46327,in,-87.50692,41.63862,4581,10,19,9,90
46340,in,-86.76906,41.38417,994,9,18,9,100
46341,in,-87.21365,41.31357,5671,9,18,9,100
46342,in,-87.24519,41.51805,14953,10,21,11,110
46345,in,-86.69842,41.52735,137,7,16,9,128.6
46346,in,-86.69246,41.4722,870,8,18,10,125
46347,in,-87.00734,41.30497,3058,9,19,10,111.1
46348,in,-86.86189,41.31032,1182,9,19,10,111.1
46349,in,-87.42181,41.10782,2271,11,21,10,90.9
46350,in,-86.72156,41.60735,23464,7,14,7,100
46356,in,-87.41417,41.25999,10128,10,20,10,100
46360,in,-86.86942,41.68837,25906,7,14,7,100
46365,in,-86.54079,41.60762,842,7,16,9,128.6
46366,in,-86.76794,41.21534,4299,9,19,10,111.1
46368,in,-87.18096,41.59099,15324,9,19,10,111.1
46371,in,-86.60073,41.68002,2706,7,14,7,100
46373,in,-87.46886,41.4475,7153,9,18,9,100
46374,in,-86.89612,41.20593,1204,9,19,10,111.1
46375,in,-87.4486,41.49213,9207,10,19,9,90
46376,in,-87.4764,41.18465,735,10,21,11,110
46377,in,-87.34356,41.19163,377,10,20,10,100
46379,in,-87.43997,41.16789,545,10,21,11,110
46381,in,-87.32463,41.16855,149,10,20,10,100
46382,in,-86.76283,41.46899,1643,8,16,8,100
46383,in,-87.00337,41.45913,15971,7,15,8,114.3
46385,in,-87.12438,41.46189,17774,8,16,8,100
46390,in,-86.87487,41.41681,2173,8,17,9,112.5
46391,in,-86.91496,41.5454,3227,7,15,8,114.3
46392,in,-87.04764,41.18329,4635,10,20,10,100
46393,in,-87.17762,41.50821,226,9,18,9,100
46394,in,-87.48936,41.67701,4629,9,18,9,100
46402,in,-87.33072,41.59943,4595,10,20,10,100
46403,in,-87.26191,41.60866,7084,10,19,9,90
46404,in,-87.37461,41.58411,11434,10,20,10,100
46405,in,-87.2622,41.57443,7184,11,20,9,81.8
46406,in,-87.40806,41.60298,8781,11,20,9,81.8
46407,in,-87.33018,41.57846,10241,10,20,10,100
46408,in,-87.36943,41.54463,9537,11,22,11,100
46409,in,-87.3242,41.54831,7085,11,22,11,100
46410,in,-87.33367,41.48123,14016,10,19,9,90
46501,in,-86.24787,41.22615,2836,8,18,10,125
46502,in,-85.97624,41.25942,67,7,16,9,128.6
46504,in,-86.11099,41.29995,2507,8,18,10,125
46506,in,-86.1696,41.4617,6189,8,17,9,112.5
46507,in,-85.81756,41.72055,4940,8,16,8,100
46508,in,-85.97617,41.15084,118,7,16,9,128.6
46510,in,-85.8733,41.11969,3117,7,16,9,128.6
46511,in,-86.42693,41.22005,4657,9,18,9,100
46514,in,-85.97466,41.72348,17800,8,17,9,112.5
46516,in,-85.9445,41.6757,15531,8,17,9,112.5
46517,in,-85.99699,41.62476,9360,8,17,9,112.5
46524,in,-86.02121,41.29718,1359,8,17,9,112.5
46526,in,-85.88345,41.55315,12177,8,18,10,125
46528,in,-85.78551,41.60606,10952,8,17,9,112.5
46530,in,-86.12757,41.73994,11670,7,15,8,114.3
46531,in,-86.51483,41.35615,951,9,19,10,111.1
46532,in,-86.61876,41.41824,1519,9,19,10,111.1
46534,in,-86.61666,41.28577,8889,9,19,10,111.1
46536,in,-86.2848,41.51834,1757,7,15,8,114.3
46537,in,-86.3102,41.45988,319,8,17,9,112.5
46538,in,-85.8216,41.32683,3769,7,15,8,114.3
46539,in,-86.02421,41.16715,1490,7,16,9,128.6
46540,in,-85.69842,41.67666,6352,7,15,8,114.3
46542,in,-85.87438,41.39178,2664,7,16,9,128.6
46543,in,-85.6721,41.5352,1781,7,15,8,114.3
46544,in,-86.13892,41.61692,13193,7,15,8,114.3
46545,in,-86.14642,41.69299,8903,7,16,9,128.6
46550,in,-86.00018,41.44618,5748,7,16,9,128.6
46552,in,-86.48473,41.70629,4824,6,14,8,133.3
46553,in,-85.84922,41.47952,2109,7,17,10,142.9
46554,in,-86.41898,41.56255,2641,7,16,9,128.6
46555,in,-85.69043,41.32933,2409,6,15,9,150
46556,in,-86.2514,41.70658,60,7,15,8,114.3
46561,in,-86.07527,41.6638,5801,8,17,9,112.5
46562,in,-85.69774,41.21054,4492,6,15,9,150
46563,in,-86.32674,41.35631,14935,10,20,10,100
46565,in,-85.58048,41.69266,5360,6,14,8,133.3
46567,in,-85.73109,41.41349,8532,7,15,8,114.3
46570,in,-86.12002,41.20673,947,8,18,10,125
46571,in,-85.54556,41.56852,2376,6,14,8,133.3
46573,in,-86.06022,41.53987,2079,7,16,9,128.6
46574,in,-86.48797,41.47377,6612,9,18,9,100
46580,in,-85.8711,41.20773,10971,7,15,8,114.3
46582,in,-85.85465,41.28415,6681,7,15,8,114.3
46590,in,-85.80896,41.21595,2034,6,15,9,150
46595,in,-86.1666,41.52634,76,7,15,8,114.3
46601,in,-86.25316,41.67015,2650,7,15,8,114.3
46613,in,-86.25861,41.65483,6080,7,15,8,114.3
46614,in,-86.27872,41.60335,13197,6,14,8,133.3
46615,in,-86.21157,41.67464,5807,7,15,8,114.3
46616,in,-86.26658,41.69793,3081,7,15,8,114.3
46617,in,-86.23488,41.68443,5209,7,15,8,114.3
46619,in,-86.35094,41.66008,9691,7,15,8,114.3
46628,in,-86.33633,41.7214,14340,7,15,8,114.3
46635,in,-86.20855,41.71491,2815,7,15,8,114.3
46637,in,-86.24159,41.73392,8012,7,15,8,114.3
46701,in,-85.42992,41.36062,5124,6,15,9,150
46702,in,-85.61611,40.82814,1686,9,21,12,133.3
46703,in,-85.00798,41.65275,17166,5,13,8,160
46704,in,-85.29258,41.10397,40,8,17,9,112.5
46705,in,-85.06305,41.51832,1668,7,16,9,128.6
46706,in,-85.03938,41.34276,12656,8,17,9,112.5
46710,in,-85.25132,41.35056,2515,7,17,10,142.9
46711,in,-84.92556,40.66371,3740,9,20,11,122.2
46714,in,-85.17148,40.71844,7906,7,17,10,142.9
46721,in,-84.87446,41.42364,4362,8,17,9,112.5
46723,in,-85.32566,41.23982,4398,7,16,9,128.6
46725,in,-85.47491,41.14913,13834,6,15,9,150
46730,in,-85.15554,41.45327,1301,8,17,9,112.5
46731,in,-85.10273,40.79788,474,7,17,10,142.9
46732,in,-85.62359,41.37889,2741,6,15,9,150
46733,in,-84.94006,40.82854,11775,8,18,10,125
46737,in,-84.92375,41.72151,9589,5,13,8,160
46738,in,-85.13688,41.32173,6050,8,18,10,125
46740,in,-84.96457,40.60212,2469,9,20,11,122.2
46741,in,-84.94991,41.21129,2091,8,18,10,125
46742,in,-84.87891,41.54976,4069,7,15,8,114.3
46743,in,-84.85111,41.21536,1130,8,18,10,125
46745,in,-85.00943,40.95166,1103,8,18,10,125
46746,in,-85.34519,41.72273,3947,6,13,7,116.7
46747,in,-85.15343,41.5599,3210,6,15,9,150
46748,in,-85.1664,41.24829,3058,7,17,10,142.9
46750,in,-85.49629,40.8786,15093,9,21,12,133.3
46755,in,-85.27406,41.45019,7681,7,15,8,114.3
46759,in,-85.18086,40.59963,591,7,18,11,157.1
46760,in,-85.5557,41.34622,1021,6,15,9,150
46761,in,-85.36832,41.63488,7926,6,13,7,116.7
46763,in,-85.23557,41.29513,1104,7,17,10,142.9
46764,in,-85.62196,41.2219,1003,6,15,9,150
46765,in,-85.04361,41.23362,2718,8,18,10,125
46766,in,-85.28468,40.71199,536,7,17,10,142.9
46767,in,-85.57957,41.46846,3714,7,15,8,114.3
46770,in,-85.31898,40.83312,1925,8,18,10,125
46771,in,-85.29606,41.6926,85,6,13,7,116.7
46772,in,-84.91373,40.7215,1626,9,20,11,122.2
46773,in,-84.87561,40.98217,2752,8,19,11,137.5
46774,in,-84.96971,41.09193,7833,8,18,10,125
46776,in,-85.1627,41.72829,3137,5,13,8,160
46777,in,-85.15023,40.87217,3283,7,17,10,142.9
46779,in,-85.03509,41.57445,2165,6,14,8,133.3
46781,in,-85.27303,40.63688,730,7,18,11,157.1
46783,in,-85.35533,40.97425,4208,8,18,10,125
46784,in,-85.38164,41.49939,1969,6,15,9,150
46785,in,-84.88531,41.31874,1407,8,18,10,125
46786,in,-85.27237,41.53204,67,6,14,8,133.3
46787,in,-85.62308,41.06647,2366,7,17,10,142.9
46788,in,-84.91078,41.27015,2075,8,18,10,125
46791,in,-85.2403,40.83694,637,7,17,10,142.9
46792,in,-85.43937,40.68599,3015,8,18,10,125
46793,in,-85.01985,41.46202,3437,8,17,9,112.5
46794,in,-85.46059,41.46638,1208,6,15,9,150
46795,in,-85.33771,41.55114,6252,6,14,8,133.3
46797,in,-84.86022,41.12606,2426,8,19,11,137.5
46798,in,-85.22369,40.94079,941,7,17,10,142.9
46799,in,-85.28341,40.91215,106,8,17,9,112.5
46802,in,-85.16316,41.06792,4742,8,18,10,125
46803,in,-85.08867,41.07081,6217,8,18,10,125
46804,in,-85.24063,41.05123,10445,8,18,10,125
46805,in,-85.11749,41.09932,8008,8,18,10,125
46806,in,-85.08837,41.04682,10985,8,18,10,125
46807,in,-85.1476,41.0449,6504,8,18,10,125
46808,in,-85.17702,41.09848,9542,8,18,10,125
46809,in,-85.20625,41.00051,4380,8,18,10,125
46814,in,-85.30348,41.04591,6484,8,17,9,112.5
46815,in,-85.0573,41.10311,9313,8,18,10,125
46816,in,-85.03843,41.00459,5316,8,18,10,125
46818,in,-85.25014,41.14787,9267,7,17,10,142.9
46819,in,-85.13177,40.96585,3626,8,17,9,112.5
46825,in,-85.12543,41.15298,9970,8,18,10,125
46835,in,-85.04614,41.15195,13488,8,18,10,125
46845,in,-85.10804,41.20487,11711,8,18,10,125
46901,in,-86.15662,40.5253,20601,10,21,11,110
46902,in,-86.09539,40.43794,16738,9,21,12,133.3
46910,in,-86.04131,41.04154,2312,8,17,9,112.5
46911,in,-85.94541,40.62985,1438,9,20,11,122.2
46913,in,-86.50346,40.50298,1269,10,22,12,120
46914,in,-86.09549,40.63118,1380,9,19,10,111.1
46915,in,-86.38659,40.47773,675,9,21,12,133.3
46917,in,-86.46925,40.62285,1969,10,22,12,120
46919,in,-85.86881,40.58957,1782,9,20,11,122.2
46920,in,-86.49483,40.46439,1064,10,22,12,120
46922,in,-86.41343,41.13819,45,8,18,10,125
46923,in,-86.64586,40.60636,7660,12,24,12,100
46926,in,-86.05509,40.88293,1406,9,20,11,122.2
46928,in,-85.68648,40.40808,3574,8,20,12,150
46929,in,-86.47004,40.5482,2765,10,22,12,120
46930,in,-85.57228,40.40893,105,8,19,11,137.5
46931,in,-86.26427,40.94754,116,9,19,10,111.1
46932,in,-86.25749,40.59756,2469,9,20,11,122.2
46933,in,-85.58229,40.47985,3116,8,19,11,137.5
46936,in,-85.93088,40.47941,3702,9,20,11,122.2
46938,in,-85.64757,40.4474,1960,8,20,12,150
46939,in,-86.40341,40.99205,2310,9,19,10,111.1
46940,in,-85.69769,40.68728,1735,9,20,11,122.2
46941,in,-85.6968,40.8208,879,9,19,10,111.1
46943,in,-85.84168,40.97357,151,9,19,10,111.1
46946,in,-85.73046,41.03937,96,9,19,10,111.1
46947,in,-86.37645,40.76007,16715,10,21,11,110
46950,in,-86.37163,40.88283,683,9,19,10,111.1
46951,in,-86.10477,40.94541,2296,9,19,10,111.1
46952,in,-85.63288,40.59911,10960,9,20,11,122.2
46953,in,-85.64262,40.51862,12418,9,20,11,122.2
46957,in,-85.49596,40.3883,291,7,18,11,157.1
46958,in,-86.11701,40.82193,290,10,20,10,100
46959,in,-86.10719,40.62084,200,9,19,10,111.1
46960,in,-86.52923,41.15693,3144,9,19,10,111.1
46961,in,-86.19169,40.76651,96,10,20,10,100
46962,in,-85.76881,40.98671,4937,9,19,10,111.1
46967,in,-86.19511,40.69468,73,9,19,10,111.1
46968,in,-86.54636,41.17534,71,9,19,10,111.1
46970,in,-86.06306,40.76016,15003,9,20,11,122.2
46974,in,-85.93009,40.94819,1338,9,19,10,111.1
46975,in,-86.25093,41.0718,11240,8,18,10,125
46978,in,-86.5125,40.85664,2031,10,20,10,100
46979,in,-86.28002,40.42928,3077,9,21,12,133.3
46982,in,-85.88973,41.05842,2099,8,17,9,112.5
46984,in,-85.83078,40.66804,119,9,20,11,122.2
46985,in,-86.57827,40.95285,2320,9,19,10,111.1
46986,in,-85.81927,40.49796,1558,9,20,11,122.2
46987,in,-85.76342,40.56869,389,9,20,11,122.2
46988,in,-86.23395,40.87792,850,9,20,11,122.2
46989,in,-85.47979,40.45014,2068,7,18,11,157.1
46990,in,-85.72807,40.89727,606,9,19,10,111.1
46991,in,-85.50557,40.62869,1233,8,19,11,137.5
46992,in,-85.82908,40.78604,9549,8,19,11,137.5
46994,in,-86.25724,40.66814,2135,9,19,10,111.1
46996,in,-86.65942,41.06263,7793,9,19,10,111.1
46998,in,-86.34967,40.56761,80,9,20,11,122.2
47001,in,-84.96835,39.06665,6956,15,30,15,100
47003,in,-84.84398,39.55802,474,7,19,12,171.4
47006,in,-85.21584,39.29199,6428,9,21,12,133.3
47010,in,-84.84148,39.50069,257,8,20,12,150
47011,in,-85.07525,38.87544,764,16,32,16,100
47012,in,-84.9816,39.41774,7958,10,24,14,140
47016,in,-84.88711,39.37664,529,11,25,14,127.3
47017,in,-85.19037,38.94173,401,16,32,16,100
47018,in,-85.08283,38.98743,2888,15,30,15,100
47020,in,-84.93305,38.81652,857,16,31,15,93.8
47022,in,-84.95175,39.20493,2104,11,25,14,127.3
47023,in,-85.38149,39.07935,1173,13,29,16,123.1
47024,in,-85.20035,39.4763,2448,9,22,13,144.4
47025,in,-84.8743,39.15645,13186,14,29,15,107.1
47030,in,-85.1299,39.42569,1400,10,24,14,140
47031,in,-85.15854,39.11943,3175,10,23,13,130
47032,in,-85.04978,39.08079,2151,12,26,14,116.7
47034,in,-85.32747,39.20398,109,9,22,13,144.4
47035,in,-84.90554,39.30922,74,13,28,15,115.4
47036,in,-85.24527,39.38862,653,9,22,13,144.4
47037,in,-85.31849,39.16445,2899,11,25,14,127.3
47038,in,-84.84748,38.84836,1577,15,30,15,100
47040,in,-84.93655,38.9301,2877,15,31,16,106.7
47041,in,-85.08339,39.23279,3720,8,20,12,150
47042,in,-85.25929,39.01111,2894,14,30,16,114.3
47043,in,-85.0991,38.79427,3796,18,35,17,94.4
47060,in,-84.88103,39.30084,4223,13,27,14,107.7
47102,in,-85.79089,38.75867,4429,19,37,18,94.7
47104,in,-85.4209,38.53944,84,18,35,17,94.4
47106,in,-85.90233,38.46241,3552,18,35,17,94.4
47108,in,-86.25872,38.64151,1885,18,35,17,94.4
47110,in,-86.18505,38.09885,235,20,38,18,90
47111,in,-85.62772,38.46474,9084,19,37,18,94.7
47112,in,-86.14431,38.19542,10478,19,36,17,89.5
47114,in,-86.0718,38.28832,256,17,34,17,100
47115,in,-86.21709,38.34594,2183,19,37,18,94.7
47116,in,-86.61751,38.32494,1249,17,34,17,100
47117,in,-85.97308,38.1053,3567,18,35,17,94.4
47118,in,-86.48763,38.29756,4588,19,36,17,89.5
47119,in,-85.88373,38.36647,7059,18,36,18,100
47120,in,-86.18847,38.45656,734,18,36,18,100
47122,in,-85.98255,38.30473,5762,17,34,17,100
47123,in,-86.47937,38.26713,269,20,38,18,90
47124,in,-86.00832,38.36797,2622,17,35,18,105.9
47125,in,-86.30859,38.4607,1428,18,36,18,100
47126,in,-85.77569,38.54867,2691,19,37,18,94.7
47129,in,-85.76895,38.3138,7411,20,39,19,95
47130,in,-85.69714,38.33522,21573,19,38,19,100
47135,in,-86.0744,38.04107,1236,18,36,18,100
47136,in,-85.96043,38.23546,2646,17,34,17,100
47137,in,-86.38378,38.18649,2150,21,39,18,85.7
47138,in,-85.59556,38.68095,3172,17,34,17,100
47140,in,-86.36723,38.38354,2137,19,36,17,89.5
47141,in,-85.60942,38.55454,1286,18,35,17,94.4
47142,in,-86.21643,38.07575,1219,21,39,18,85.7
47143,in,-85.76987,38.46739,2169,20,38,18,90
47145,in,-86.30258,38.33065,1684,20,37,17,85
47147,in,-85.54728,38.59464,897,18,35,17,94.4
47150,in,-85.84662,38.2883,24571,21,40,19,90.5
47160,in,-86.051,38.16445,50,18,35,17,94.4
47161,in,-86.10356,38.32314,2150,18,36,18,100
47162,in,-85.47163,38.55385,851,18,36,18,100
47163,in,-85.66972,38.53226,1337,18,36,18,100
47164,in,-86.09276,38.40417,2378,17,34,17,100
47165,in,-86.00559,38.50454,3837,17,34,17,100
47166,in,-86.16745,38.30691,885,19,36,17,89.5
47167,in,-86.09582,38.61184,8944,18,35,17,94.4
47170,in,-85.84357,38.68494,8770,19,37,18,94.7
47172,in,-85.76865,38.39884,8662,21,39,18,85.7
47175,in,-86.55697,38.36483,1102,18,35,17,94.4
47177,in,-85.78271,38.60071,866,18,36,18,100
47201,in,-85.99069,39.15771,21483,14,30,16,114.3
47203,in,-85.83295,39.2316,10752,14,29,15,107.1
47220,in,-86.05039,38.87744,3590,17,33,16,94.1
47223,in,-85.47892,39.04912,1290,15,31,16,106.7
47224,in,-85.22124,38.88697,461,17,33,16,94.1
47226,in,-85.86911,39.28246,124,14,29,15,107.1
47227,in,-85.65176,38.87486,1238,17,34,17,100
47229,in,-85.86737,38.80408,2302,19,37,18,94.7
47230,in,-85.62975,38.79502,1654,17,34,17,100
47231,in,-85.49579,38.89927,846,17,34,17,100
47232,in,-85.79306,39.11338,1603,15,31,16,106.7
47234,in,-85.76788,39.37736,1556,12,27,15,125
47235,in,-86.13625,38.99606,1511,15,31,16,106.7
47240,in,-85.47994,39.32317,14246,10,23,13,130
47243,in,-85.48012,38.67077,3124,18,35,17,94.4
47244,in,-85.70154,39.21906,612,12,27,15,125
47246,in,-85.76732,39.29862,2757,13,28,15,115.4
47247,in,-85.88814,39.05953,91,15,31,16,106.7
47250,in,-85.35155,38.81843,13208,18,35,17,94.4
47260,in,-86.19863,38.83612,1703,18,35,17,94.4
47263,in,-85.33018,39.30944,156,9,22,13,144.4
47264,in,-86.26904,38.96687,1747,17,33,16,94.1
47265,in,-85.62757,39.01234,14548,17,33,16,94.1
47270,in,-85.72352,38.84044,589,18,35,17,94.4
47272,in,-85.62048,39.41237,1379,11,25,14,127.3
47273,in,-85.73674,39.07424,1179,16,32,16,100
47274,in,-85.93089,38.96581,15255,15,31,16,106.7
47280,in,-85.95052,39.29659,370,14,29,15,107.1
47281,in,-86.10387,38.78588,1373,18,35,17,94.4
47282,in,-85.61073,38.98235,184,18,35,17,94.4
47283,in,-85.58864,39.17338,2312,13,28,15,115.4
47302,in,-85.37671,40.12998,15301,8,19,11,137.5
47303,in,-85.37802,40.27159,11776,8,19,11,137.5
47304,in,-85.46054,40.2331,12680,8,20,12,150
47305,in,-85.38601,40.19379,2399,8,20,12,150
47306,in,-85.40695,40.2042,14,8,20,12,150
47320,in,-85.26668,40.27874,2635,8,19,11,137.5
47324,in,-84.85174,39.74117,99,6,16,10,166.7
47325,in,-85.01761,39.68918,512,8,20,12,150
47326,in,-84.9661,40.54567,1836,8,19,11,137.5
47327,in,-85.17378,39.83125,2969,7,18,11,157.1
47330,in,-85.02219,39.78636,3090,7,18,11,157.1
47331,in,-85.16413,39.62981,13346,8,21,13,162.5
47334,in,-85.52699,40.11767,2072,8,19,11,137.5
47335,in,-85.20497,39.81238,408,7,17,10,142.9
47336,in,-85.20753,40.39609,2706,7,17,10,142.9
47337,in,-85.43731,39.80244,147,7,18,11,157.1
47338,in,-85.34087,40.33991,1809,7,18,11,157.1
47339,in,-85.09493,39.96263,451,6,16,10,166.7
47340,in,-85.13228,40.18109,2063,7,17,10,142.9
47341,in,-84.89277,39.97232,1274,7,17,10,142.9
47342,in,-85.51231,40.32202,2073,8,19,11,137.5
47344,in,-85.4654,39.87839,122,7,18,11,157.1
47345,in,-85.04861,39.891,923,7,17,10,142.9
47346,in,-85.16282,39.93437,2444,6,16,10,166.7
47348,in,-85.34821,40.4567,6642,7,17,10,142.9
47351,in,-85.52219,39.9054,280,7,18,11,157.1
47352,in,-85.36463,39.7974,889,6,17,11,183.3
47353,in,-84.91946,39.62769,5344,7,19,12,171.4
47354,in,-85.19699,40.04567,987,6,16,10,166.7
47355,in,-84.92712,40.04531,2115,6,15,9,150
47356,in,-85.5053,40.02869,3594,7,18,11,157.1
47357,in,-85.14964,39.75629,964,8,19,11,137.5
47358,in,-85.11075,40.05393,931,6,15,9,150
47359,in,-85.28365,40.55041,2338,7,17,10,142.9
47360,in,-85.2627,40.01534,1211,6,16,10,166.7
47361,in,-85.38506,40.00419,79,6,17,11,183.3
47362,in,-85.36904,39.93024,15283,6,16,10,166.7
47367,in,-85.38722,40.08265,121,7,17,10,142.9
47368,in,-85.1997,40.18499,1755,7,18,11,157.1
47369,in,-85.14468,40.50539,1094,7,17,10,142.9
47371,in,-84.95994,40.41855,8821,7,18,11,157.1
47373,in,-85.1558,40.33673,1623,7,18,11,157.1
47374,in,-84.88914,39.83162,21902,7,18,11,157.1
47380,in,-85.03005,40.28677,1787,7,18,11,157.1
47381,in,-84.86688,40.38179,111,8,19,11,137.5
47382,in,-84.91749,40.23637,147,6,16,10,166.7
47383,in,-85.26243,40.14795,1912,7,18,11,157.1
47384,in,-85.55439,39.91455,1600,7,19,12,171.4
47385,in,-85.44652,39.83246,1190,7,17,10,142.9
47386,in,-85.38328,40.05272,852,7,17,10,142.9
47387,in,-85.29411,39.83538,679,6,16,10,166.7
47388,in,-85.44308,40.00487,246,6,16,10,166.7
47390,in,-84.84704,40.20617,3519,6,16,10,166.7
47393,in,-85.00187,39.96395,1093,7,17,10,142.9
47394,in,-84.98724,40.16898,5371,6,16,10,166.7
47396,in,-85.51636,40.18874,3909,8,20,12,150
47401,in,-86.45153,39.08593,18929,17,33,16,94.1
47403,in,-86.6113,39.08489,13735,17,34,17,100
47404,in,-86.58967,39.21964,9608,17,33,16,94.1
47405,in,-86.51861,39.16821,115,17,34,17,100
47406,in,-86.51545,39.1778,41,17,34,17,100
47408,in,-86.46453,39.22995,8001,16,33,17,106.3
47420,in,-86.54892,38.91316,126,18,35,17,94.4
47421,in,-86.45111,38.86268,17740,18,34,16,88.9
47424,in,-86.87336,39.02177,7342,19,36,17,89.5
47427,in,-87.01497,39.23932,1332,16,32,16,100
47429,in,-86.61593,39.27331,4470,16,32,16,100
47431,in,-86.90061,39.23879,1279,14,30,16,114.3
47432,in,-86.64362,38.48987,5750,17,34,17,100
47433,in,-86.65252,39.3559,3139,13,28,15,115.4
47434,in,-86.54729,39.01191,62,19,35,16,84.2
47436,in,-86.39411,38.95428,1639,18,36,18,100
47437,in,-86.67697,38.71474,130,18,35,17,94.4
47438,in,-87.1885,39.15934,4394,17,33,16,94.1
47441,in,-87.16591,39.04329,6069,18,35,17,94.4
47443,in,-87.09106,38.95976,1176,19,36,17,89.5
47446,in,-86.51378,38.73824,6593,18,35,17,94.4
47448,in,-86.24244,39.17382,7547,14,29,15,107.1
47449,in,-87.00275,38.92665,561,20,37,17,85
47451,in,-86.52355,38.89296,755,17,34,17,100
47452,in,-86.42249,38.64138,4421,18,35,17,94.4
47453,in,-86.7742,38.92525,425,20,37,17,85
47454,in,-86.45592,38.51758,7832,18,36,18,100
47455,in,-86.95615,39.3165,88,15,30,15,100
47456,in,-86.70444,39.45978,939,12,27,15,125
47457,in,-86.90475,38.90914,136,21,39,18,85.7
47458,in,-86.50723,39.07033,28,17,33,16,94.1
47459,in,-86.74958,39.11281,2552,17,34,17,100
47460,in,-86.79023,39.2838,8395,13,28,15,115.4
47462,in,-86.64719,38.95669,3325,18,35,17,94.4
47464,in,-86.64997,39.2998,171,14,29,15,107.1
47465,in,-87.04078,39.04649,665,19,35,16,84.2
47467,in,-86.34438,38.76786,72,20,38,18,90
47468,in,-86.40302,39.27287,1829,15,31,16,106.7
47469,in,-86.61279,38.61776,2640,18,35,17,94.4
47470,in,-86.6472,38.815,1407,18,35,17,94.4
47471,in,-87.00226,39.14168,2235,17,33,16,94.1
47501,in,-87.17243,38.66244,9942,22,41,19,86.4
47512,in,-87.3178,38.78316,4007,21,39,18,85.7
47513,in,-86.70313,38.3061,3064,17,33,16,94.1
47514,in,-86.58621,38.1562,173,20,38,18,90
47515,in,-86.70628,38.18398,1274,20,37,17,85
47516,in,-87.41941,38.76738,1294,21,40,19,90.5
47519,in,-86.98642,38.6032,496,20,37,17,85
47520,in,-86.59336,37.98596,3563,24,43,19,79.2
47521,in,-86.72828,38.39661,1133,16,32,16,100
47522,in,-86.83639,38.88882,179,21,39,18,85.7
47523,in,-87.02764,38.1722,3859,22,40,18,81.8
47524,in,-87.61274,38.48656,1103,26,45,19,73.1
47525,in,-86.56372,38.03117,709,23,42,19,82.6
47527,in,-86.77971,38.47206,2258,16,33,17,106.3
47528,in,-87.25695,38.83783,862,21,38,17,81
47529,in,-87.0798,38.86025,1103,20,37,17,85
47531,in,-86.85224,38.03901,1302,24,43,19,79.2
47532,in,-86.86043,38.22119,4044,20,37,17,85
47535,in,-87.30767,38.87235,426,18,35,17,94.4
47536,in,-86.83652,38.11229,51,21,40,19,90.5
47537,in,-87.07234,38.10578,894,24,42,18,75
47541,in,-87.0444,38.23616,1081,21,39,18,85.7
47542,in,-86.9693,38.29668,7801,20,38,18,90
47546,in,-86.9358,38.41951,15457,20,37,17,85
47550,in,-86.92635,38.06462,1090,24,42,18,75
47551,in,-86.56239,38.12331,751,20,37,17,85
47552,in,-86.99819,38.11407,327,22,40,18,81.8
47553,in,-86.91011,38.65259,6454,19,36,17,89.5
47557,in,-87.33779,38.57479,1782,22,41,19,86.4
47558,in,-87.04098,38.64336,3026,21,39,18,85.7
47561,in,-87.43586,38.85892,2130,21,39,18,85.7
47562,in,-86.98375,38.83533,3206,20,38,18,90
47564,in,-87.09413,38.48247,1537,21,38,17,81
47567,in,-87.30426,38.46999,7072,21,39,18,85.7
47568,in,-87.13417,38.79284,793,21,39,18,85.7
47574,in,-86.55193,37.95314,318,23,42,19,82.6
47575,in,-86.81062,38.3216,1183,18,35,17,94.4
47576,in,-86.60585,38.18344,529,19,36,17,89.5
47577,in,-86.80673,38.15216,1046,21,39,18,85.7
47578,in,-87.19852,38.90186,1218,20,37,17,85
47579,in,-86.91855,38.11403,3308,23,41,18,78.3
47580,in,-86.76812,38.3563,304,17,33,16,94.1
47581,in,-86.76791,38.66107,4666,18,35,17,94.4
47584,in,-87.2585,38.25487,186,22,40,18,81.8
47585,in,-87.14807,38.27092,1003,22,40,18,81.8
47586,in,-86.69936,38.03703,8057,23,41,18,78.3
47588,in,-86.77928,38.07045,674,23,42,19,82.6
47590,in,-87.10421,38.35964,1168,21,39,18,85.7
47591,in,-87.50413,38.62823,16061,23,42,19,82.6
47596,in,-87.22773,38.8665,220,19,37,18,94.7
47597,in,-87.29957,38.655,1382,23,42,19,82.6
47598,in,-87.21357,38.38799,3923,21,40,19,90.5
47601,in,-87.25528,38.05203,10033,25,45,20,80
47610,in,-87.40163,38.0573,3990,24,44,20,83.3
47611,in,-87.05341,38.02795,1782,25,43,18,72
47612,in,-87.69924,38.19303,764,25,45,20,80
47613,in,-87.41726,38.15751,2634,24,43,19,79.2
47615,in,-86.95902,37.97106,1806,26,45,19,73.1
47616,in,-87.89827,38.23669,717,29,49,20,69
47619,in,-87.29804,38.19129,1618,22,41,19,86.4
47620,in,-87.90609,37.93257,9771,27,46,19,70.4
47630,in,-87.35572,37.95549,16556,26,46,20,76.9
47631,in,-87.90999,38.10124,2148,28,47,19,67.9
47633,in,-87.78915,38.17263,2210,27,46,19,70.4
47634,in,-87.18335,37.93768,2636,27,47,20,74.1
47635,in,-87.10553,37.88608,5036,28,47,19,67.9
47637,in,-87.14951,38.13444,1997,24,43,19,79.2
47638,in,-87.77362,38.07144,2540,25,45,20,80
47639,in,-87.575,38.17981,2505,24,43,19,79.2
47640,in,-87.49342,38.47767,1275,24,43,19,79.2
47648,in,-87.55153,38.24635,2580,25,44,19,76
47649,in,-87.44736,38.3522,1235,24,43,19,79.2
47654,in,-87.39232,38.24953,44,24,43,19,79.2
47660,in,-87.32518,38.29471,3903,23,41,18,78.3
47665,in,-87.72267,38.27883,2549,26,46,20,76.9
47666,in,-87.60004,38.41896,1310,26,46,20,76.9
47670,in,-87.57536,38.34527,6260,25,44,19,76
47683,in,-87.37734,38.27632,114,22,41,19,86.4
47708,in,-87.57388,37.97436,406,29,49,20,69
47710,in,-87.57598,38.02563,8343,26,46,20,76.9
47711,in,-87.53594,38.0155,14881,26,45,19,73.1
47712,in,-87.66041,37.9288,11742,28,48,20,71.4
47713,in,-87.55963,37.95387,5250,28,48,20,71.4
47714,in,-87.52115,37.95757,13100,27,47,20,74.1
47715,in,-87.48422,37.96993,9176,26,46,20,76.9
47720,in,-87.64249,38.0605,7632,26,45,19,73.1
47725,in,-87.52562,38.10709,9727,24,43,19,79.2
47802,in,-87.40748,39.3511,17249,18,35,17,94.4
47803,in,-87.30754,39.4645,10480,16,33,17,106.3
47804,in,-87.38981,39.49765,6429,18,36,18,100
47805,in,-87.32666,39.54705,7455,17,34,17,100
47807,in,-87.4028,39.47073,7613,18,35,17,94.4
47809,in,-87.41011,39.47125,152,18,36,18,100
47832,in,-87.25419,39.87792,1347,17,33,16,94.1
47833,in,-86.97663,39.36,1203,15,30,15,100
47834,in,-87.12128,39.52587,14263,15,31,16,106.7
47836,in,-87.17908,39.6461,155,15,31,16,106.7
47837,in,-87.11327,39.63086,1406,15,30,15,100
47838,in,-87.37792,38.95544,2440,20,38,18,90
47840,in,-87.05827,39.41106,2288,16,31,15,93.8
47841,in,-87.11506,39.275,2758,16,32,16,100
47842,in,-87.46361,39.67855,6858,18,35,17,94.4
47846,in,-87.19769,39.37477,904,16,33,17,106.3
47847,in,-87.48741,39.82547,1068,17,34,17,100
47848,in,-87.26312,39.03867,1439,17,34,17,100
47849,in,-87.55597,39.1935,670,20,39,19,95
47850,in,-87.43136,39.24584,2327,17,34,17,100
47853,in,-87.07283,39.5382,62,15,30,15,100
47854,in,-87.40245,39.79854,816,18,35,17,94.4
47855,in,-87.3041,39.18983,473,17,33,16,94.1
47857,in,-87.09114,39.52413,242,15,30,15,100
47858,in,-87.23123,39.26385,979,16,33,17,106.3
47859,in,-87.17206,39.88658,1160,15,31,16,106.7
47860,in,-87.33027,39.72186,316,18,35,17,94.4
47861,in,-87.5663,39.06482,980,25,44,19,76
47862,in,-87.34553,39.77046,1892,18,35,17,94.4
47863,in,-87.45499,39.58566,179,17,34,17,100
47865,in,-87.39143,39.021,75,20,38,18,90
47866,in,-87.32535,39.28952,650,17,34,17,100
47868,in,-86.89941,39.40964,3163,13,28,15,115.4
47869,in,-87.49679,39.27377,86,18,36,18,100
47871,in,-87.29988,39.38968,156,17,34,17,100
47872,in,-87.16206,39.75343,8378,16,32,16,100
47874,in,-87.2745,39.62794,4060,17,33,16,94.1
47876,in,-87.45924,39.51306,21,19,37,18,94.7
47879,in,-87.37821,39.18914,2799,17,35,18,105.9
47880,in,-87.41884,39.59975,33,18,35,17,94.4
47881,in,-87.19239,39.4859,274,16,32,16,100
47882,in,-87.41029,39.09089,6647,19,37,18,94.7
47884,in,-87.44982,39.61521,232,18,35,17,94.4
47885,in,-87.47661,39.50953,6865,18,36,18,100
47901,in,-86.88988,40.41783,1342,11,24,13,118.2
47904,in,-86.87659,40.43836,6839,11,23,12,109.1
47905,in,-86.76596,40.42041,17638,11,23,12,109.1
47906,in,-86.98647,40.48692,17800,11,24,13,118.2
47907,in,-86.91549,40.4244,9,11,24,13,118.2
47909,in,-86.90075,40.32347,16697,10,23,13,130
47916,in,-87.05534,39.98354,68,12,25,13,108.3
47917,in,-87.47346,40.46687,766,11,24,13,118.2
47918,in,-87.20376,40.30478,5247,11,24,13,118.2
47920,in,-86.82362,40.54759,1779,12,25,13,108.3
47921,in,-87.37539,40.47716,1066,10,23,13,130
47922,in,-87.35285,40.87654,1525,12,24,12,100
47923,in,-86.93147,40.61125,3042,11,24,13,118.2
47924,in,-86.76285,40.48794,89,11,24,13,118.2
47925,in,-86.74697,40.87729,207,10,21,11,110
47926,in,-86.59596,40.77612,1106,10,22,12,120
47928,in,-87.46734,39.93048,1576,17,33,16,94.1
47929,in,-86.91637,40.67615,851,11,22,11,100
47930,in,-86.74235,40.23709,828,9,21,12,133.3
47932,in,-87.40883,40.12923,4225,15,30,15,100
47933,in,-86.89668,40.03866,15560,10,23,13,130
47940,in,-86.74664,40.11759,1036,9,22,13,144.4
47941,in,-86.77398,40.37613,603,10,23,13,130
47942,in,-87.44583,40.68553,851,11,24,13,118.2
47943,in,-87.27353,41.06203,764,10,21,11,110
47944,in,-87.33033,40.61421,3334,10,22,12,120
47946,in,-86.86843,40.98174,2309,10,20,10,100
47948,in,-87.28173,40.77703,1231,11,23,12,109.1
47949,in,-87.13282,40.05929,1115,12,25,13,108.3
47950,in,-86.65487,40.80247,941,10,22,12,120
47951,in,-87.4413,40.78946,1839,13,26,13,100
47952,in,-87.29603,39.96161,3625,15,30,15,100
47954,in,-86.81523,39.89955,1721,11,23,12,109.1
47955,in,-86.86187,40.19633,717,10,22,12,120
47957,in,-86.87473,41.08615,2271,10,20,10,100
47958,in,-87.14404,40.16428,187,11,24,13,118.2
47959,in,-86.9015,40.86485,2441,10,21,11,110
47960,in,-86.74992,40.7805,14944,11,22,11,100
47963,in,-87.43971,40.97162,1834,12,24,12,100
47964,in,-87.29864,40.95212,92,11,22,11,100
47965,in,-86.92019,39.95447,327,10,23,13,130
47966,in,-87.39698,39.88582,312,17,34,17,100
47967,in,-87.00165,40.19668,628,10,21,11,110
47968,in,-86.74578,39.96141,723,9,22,13,144.4
47969,in,-87.14885,40.20574,120,10,23,13,130
47970,in,-87.1314,40.47327,1684,11,23,12,109.1
47971,in,-87.23828,40.5321,1505,11,23,12,109.1
47974,in,-87.47333,40.0417,1005,15,31,16,106.7
47975,in,-87.25328,40.44911,972,10,23,13,130
47977,in,-87.15611,40.75495,1891,10,22,12,120
47978,in,-87.11549,40.98122,7673,10,21,11,110
47980,in,-86.90376,40.75275,1326,10,22,12,120
47981,in,-86.93042,40.24502,790,9,21,12,133.3
47982,in,-87.52707,40.19735,135,14,29,15,107.1
47983,in,-86.76729,40.27913,176,9,21,12,133.3
47987,in,-87.22668,40.12342,3593,13,27,14,107.7
47989,in,-87.05362,39.88974,1139,12,26,14,116.7
47990,in,-87.05428,40.06186,1153,11,24,13,118.2
47991,in,-87.44827,40.28054,1060,14,28,14,100
47992,in,-87.05292,40.3223,1164,10,22,12,120
47993,in,-87.4146,40.31214,4300,13,27,14,107.7
47994,in,-87.06213,40.16925,424,10,22,12,120
47995,in,-87.03252,40.76382,1707,10,22,12,120
47997,in,-86.7236,40.6677,121,12,24,12,100
48001,mi,-82.58665,42.63666,6640,3,8,5,166.7
48002,mi,-82.926,42.9392,1698,5,10,5,100
48003,mi,-83.04066,42.93259,2587,4,9,5,125
48005,mi,-82.92318,42.85022,2511,4,9,5,125
48006,mi,-82.69639,43.0754,2371,4,9,5,125
48009,mi,-83.21765,42.54414,8033,4,9,5,125
48014,mi,-82.93076,43.02547,2015,5,10,5,100
48015,mi,-83.02718,42.48049,2754,4,9,5,125
48017,mi,-83.15036,42.53669,5079,4,10,6,150
48021,mi,-82.94605,42.46563,13701,3,8,5,166.7
48022,mi,-82.81109,43.02823,1489,4,9,5,125
48023,mi,-82.65927,42.70104,2198,3,8,5,166.7
48025,mi,-83.26747,42.52033,5708,4,9,5,125
48026,mi,-82.94964,42.53879,4707,3,8,5,166.7
48027,mi,-82.6822,42.94466,1826,4,9,5,125
48028,mi,-82.62649,42.58592,2248,3,8,5,166.7
48030,mi,-83.09769,42.46192,7772,4,10,6,150
48032,mi,-82.59477,43.13333,1338,5,11,6,120
48033,mi,-83.28867,42.46455,4387,4,10,6,150
48034,mi,-83.29109,42.49693,1512,4,9,5,125
48035,mi,-82.90947,42.55615,10561,3,8,5,166.7
48036,mi,-82.89996,42.59212,5365,3,8,5,166.7
48038,mi,-82.94155,42.60549,8056,3,8,5,166.7
48039,mi,-82.55055,42.69664,3688,3,8,5,166.7
48040,mi,-82.4802,42.90986,3876,5,10,5,100
48041,mi,-82.80273,42.93859,2364,5,9,4,80
48042,mi,-82.90861,42.68677,9467,4,9,5,125
48043,mi,-82.88217,42.59783,5845,3,8,5,166.7
48044,mi,-82.92953,42.64989,14027,4,9,5,125
48045,mi,-82.81799,42.58822,7853,3,8,5,166.7
48047,mi,-82.77527,42.67299,12791,4,8,4,100
48048,mi,-82.79776,42.74247,1800,4,9,5,125
48049,mi,-82.57493,43.03596,2728,6,12,6,100
48050,mi,-82.80138,42.78485,945,4,9,5,125
48051,mi,-82.82071,42.69377,3885,4,8,4,100
48054,mi,-82.54496,42.77064,3419,4,8,4,100
48059,mi,-82.49418,43.08657,6417,6,11,5,83.3
48060,mi,-82.46008,42.98186,16484,6,11,5,83.3
48062,mi,-82.79989,42.84898,3426,4,9,5,125
48063,mi,-82.67674,42.85581,1813,4,8,4,100
48064,mi,-82.67234,42.76722,1799,4,8,4,100
48065,mi,-83.04072,42.84554,3660,4,9,5,125
48066,mi,-82.937,42.50733,17359,3,8,5,166.7
48067,mi,-83.13794,42.49046,10421,4,10,6,150
48069,mi,-83.14412,42.47135,1201,4,10,6,150
48070,mi,-83.1684,42.48162,2486,4,10,6,150
48071,mi,-83.10337,42.50727,11190,4,10,6,150
48072,mi,-83.18586,42.4979,7153,4,10,6,150
48073,mi,-83.16437,42.51921,12540,4,10,6,150
48074,mi,-82.56204,42.94827,4472,6,11,5,83.3
48075,mi,-83.2304,42.46206,6381,4,10,6,150
48076,mi,-83.23086,42.49751,8870,4,10,6,150
48079,mi,-82.54736,42.85774,5359,5,9,4,80
48080,mi,-82.89672,42.46469,9177,3,8,5,166.7
48081,mi,-82.89344,42.49446,9054,3,8,5,166.7
48082,mi,-82.88397,42.52661,6601,3,8,5,166.7
48083,mi,-83.11686,42.55702,7908,4,10,6,150
48084,mi,-83.1757,42.56063,3535,4,10,6,150
48085,mi,-83.11983,42.60061,8971,4,10,6,150
48088,mi,-82.98299,42.51565,8168,3,8,5,166.7
48089,mi,-82.99543,42.47019,13948,3,8,5,166.7
48091,mi,-83.058,42.46817,11799,4,9,5,125
48092,mi,-83.05941,42.514,8813,4,10,6,150
48093,mi,-83.01484,42.51417,7051,4,9,5,125
48094,mi,-83.03713,42.73641,4383,4,9,5,125
48095,mi,-83.03861,42.77981,2070,4,9,5,125
48096,mi,-82.92004,42.76132,2215,4,10,6,150
48097,mi,-82.82947,43.12602,2969,4,8,4,100
48098,mi,-83.17891,42.59905,6680,4,9,5,125
48101,mi,-83.2106,42.25982,12669,3,9,6,200
48103,mi,-83.84324,42.25993,19565,6,13,7,116.7
48104,mi,-83.71703,42.26425,9871,6,14,8,133.3
48105,mi,-83.70705,42.3317,9887,6,13,7,116.7
48108,mi,-83.73181,42.22215,7117,6,14,8,133.3
48109,mi,-83.72388,42.28376,31,7,14,7,100
48111,mi,-83.48675,42.17903,14608,4,10,6,150
48114,mi,-83.74843,42.57004,8944,3,7,4,133.3
48116,mi,-83.78196,42.50513,13164,3,8,5,166.7
48117,mi,-83.40922,42.04995,4387,6,14,8,133.3
48118,mi,-84.03881,42.3126,6492,4,10,6,150
48120,mi,-83.17477,42.30689,1682,3,8,5,166.7
48122,mi,-83.17812,42.28022,4694,3,8,5,166.7
48124,mi,-83.24751,42.29832,13812,4,10,6,150
48125,mi,-83.26535,42.27792,10702,4,10,6,150
48126,mi,-83.18291,42.32525,13554,4,9,5,125
48127,mi,-83.2829,42.33663,13876,5,11,6,120
48128,mi,-83.25926,42.32043,4473,5,11,6,120
48130,mi,-83.90328,42.35419,7066,4,11,7,175
48131,mi,-83.6724,41.96575,3671,5,11,6,120
48133,mi,-83.48429,41.77972,3603,8,16,8,100
48134,mi,-83.29342,42.10717,6144,4,11,7,175
48135,mi,-83.34121,42.32438,11858,4,10,6,150
48137,mi,-84.07362,42.4622,3422,4,9,5,125
48138,mi,-83.15571,42.13312,5976,4,9,5,125
48139,mi,-83.80605,42.45245,169,4,9,5,125
48140,mi,-83.58144,41.88133,1583,8,16,8,100
48141,mi,-83.31482,42.29348,11571,4,10,6,150
48143,mi,-83.85178,42.45939,18,4,9,5,125
48144,mi,-83.62835,41.75325,4317,9,18,9,100
48145,mi,-83.46332,41.85061,2378,8,16,8,100
48146,mi,-83.18107,42.24331,15286,3,8,5,166.7
48150,mi,-83.37258,42.36844,11843,4,11,7,175
48152,mi,-83.37458,42.42585,10976,4,11,7,175
48154,mi,-83.3729,42.39712,14692,4,11,7,175
48157,mi,-83.4382,41.81463,862,7,15,8,114.3
48158,mi,-84.03097,42.15602,4522,4,11,7,175
48159,mi,-83.55356,42.02415,1484,5,12,7,140
48160,mi,-83.67889,42.08088,6081,4,11,7,175
48161,mi,-83.47192,41.90804,9849,9,18,9,100
48162,mi,-83.43564,41.9603,11653,8,17,9,112.5
48164,mi,-83.39092,42.12695,4076,4,11,7,175
48165,mi,-83.61761,42.50134,2613,3,7,4,133.3
48166,mi,-83.29404,41.98633,4541,6,12,6,100
48167,mi,-83.5292,42.43528,6362,4,10,6,150
48168,mi,-83.54045,42.4063,5322,4,10,6,150
48169,mi,-83.94899,42.46278,11447,4,9,5,125
48170,mi,-83.53159,42.36763,13954,4,11,7,175
48173,mi,-83.21288,42.07302,4647,4,9,5,125
48174,mi,-83.35399,42.20856,12711,4,10,6,150
48176,mi,-83.81533,42.15133,8863,6,13,7,116.7
48177,mi,-83.58093,41.80396,115,9,18,9,100
48178,mi,-83.66354,42.44467,12873,4,9,5,125
48179,mi,-83.24943,42.03467,1497,4,10,6,150
48180,mi,-83.26881,42.22605,22294,4,10,6,150
48182,mi,-83.5793,41.79185,9452,9,18,9,100
48183,mi,-83.2193,42.1359,13564,4,9,5,125
48184,mi,-83.39408,42.27417,6431,4,9,5,125
48185,mi,-83.38457,42.33579,12058,4,10,6,150
48186,mi,-83.37461,42.29481,12841,4,10,6,150
48187,mi,-83.48782,42.3292,12536,4,11,7,175
48188,mi,-83.4859,42.28564,8710,4,10,6,150
48189,mi,-83.78538,42.41209,6337,4,10,6,150
48190,mi,-83.59381,42.13154,54,4,10,6,150
48191,mi,-83.564,42.11984,1426,4,10,6,150
48192,mi,-83.16157,42.20839,11264,3,8,5,166.7
48193,mi,-83.2094,42.17379,5120,3,9,6,200
48195,mi,-83.20586,42.2047,11316,3,8,5,166.7
48197,mi,-83.62884,42.19715,17478,5,12,7,140
48198,mi,-83.58837,42.27549,13137,5,12,7,140
48201,mi,-83.06018,42.34702,2664,3,7,4,133.3
48202,mi,-83.07772,42.37479,7479,3,8,5,166.7
48203,mi,-83.1023,42.42166,19168,4,9,5,125
48204,mi,-83.14294,42.36581,17314,4,9,5,125
48205,mi,-82.98116,42.43317,23003,3,8,5,166.7
48206,mi,-83.1079,42.37513,10852,4,9,5,125
48207,mi,-83.01477,42.34931,10547,3,7,4,133.3
48208,mi,-83.09194,42.34849,8323,3,8,5,166.7
48209,mi,-83.11627,42.30534,13619,3,7,4,133.3
48210,mi,-83.12833,42.33622,16581,3,8,5,166.7
48211,mi,-83.04572,42.38134,8479,3,8,5,166.7
48212,mi,-83.05595,42.40945,18366,3,9,6,200
48213,mi,-82.99521,42.39793,19897,3,7,4,133.3
48214,mi,-82.98736,42.36511,15099,3,7,4,133.3
48215,mi,-82.95432,42.37504,11493,3,7,4,133.3
48216,mi,-83.07879,42.32652,3819,3,7,4,133.3
48217,mi,-83.15398,42.27811,5273,3,8,5,166.7
48218,mi,-83.12722,42.27321,3900,3,8,5,166.7
48219,mi,-83.25285,42.42575,20855,5,11,6,120
48220,mi,-83.13518,42.45806,10868,4,10,6,150
48221,mi,-83.14869,42.42703,17066,4,10,6,150
48223,mi,-83.24633,42.39345,16540,5,12,7,140
48224,mi,-82.94127,42.41069,19451,3,7,4,133.3
48225,mi,-82.92949,42.43901,5997,3,8,5,166.7
48226,mi,-83.05006,42.33175,948,3,7,4,133.3
48227,mi,-83.19259,42.38725,23685,4,11,7,175
48228,mi,-83.21701,42.35545,24726,4,11,7,175
48229,mi,-83.14281,42.25086,5057,3,8,5,166.7
48230,mi,-82.92053,42.37994,6586,3,8,5,166.7
48233,mi,-83.06166,42.3237,2,3,7,4,133.3
48234,mi,-83.03953,42.43118,20196,3,9,6,200
48235,mi,-83.1948,42.42706,20272,4,11,7,175
48236,mi,-82.89364,42.4257,13120,3,8,5,166.7
48237,mi,-83.18237,42.46497,10352,4,10,6,150
48238,mi,-83.14136,42.39629,18478,4,10,6,150
48239,mi,-83.28467,42.3759,16715,5,11,6,120
48240,mi,-83.3013,42.42446,8138,5,11,6,120
48242,mi,-83.35253,42.21198,8,4,9,5,125
48243,mi,-83.03951,42.32997,3,3,7,4,133.3
48301,mi,-83.28281,42.54447,5358,4,9,5,125
48302,mi,-83.2952,42.58569,6309,4,9,5,125
48304,mi,-83.23456,42.58762,5134,4,9,5,125
48306,mi,-83.14911,42.72322,9224,4,9,5,125
48307,mi,-83.12324,42.65955,11664,4,9,5,125
48309,mi,-83.18367,42.65865,9581,4,9,5,125
48310,mi,-83.06784,42.56435,11724,4,10,6,150
48312,mi,-83.00946,42.55847,9589,4,9,5,125
48313,mi,-83.00147,42.59957,9343,4,9,5,125
48314,mi,-83.05434,42.60989,4773,4,10,6,150
48315,mi,-82.99632,42.67289,6733,4,9,5,125
48316,mi,-83.05684,42.69064,8001,4,9,5,125
48317,mi,-83.05319,42.64678,7129,4,10,6,150
48320,mi,-83.33806,42.6126,2164,3,8,5,166.7
48322,mi,-83.38137,42.54217,7917,3,9,6,200
48323,mi,-83.37616,42.57034,6423,3,8,5,166.7
48324,mi,-83.39263,42.59614,7274,3,8,5,166.7
48326,mi,-83.25335,42.67579,5533,4,9,5,125
48327,mi,-83.41418,42.64423,7920,3,8,5,166.7
48328,mi,-83.35628,42.64377,9242,3,8,5,166.7
48329,mi,-83.38887,42.68839,11035,3,8,5,166.7
48331,mi,-83.40853,42.50401,6408,3,9,6,200
48334,mi,-83.34944,42.50672,5253,4,9,5,125
48335,mi,-83.40199,42.46285,4439,4,9,5,125
48336,mi,-83.34727,42.46315,9218,4,10,6,150
48340,mi,-83.29099,42.67084,7926,4,8,4,100
48341,mi,-83.29631,42.6278,8191,3,8,5,166.7
48342,mi,-83.27442,42.64341,8406,4,9,5,125
48346,mi,-83.42306,42.72156,7320,3,7,4,133.3
48348,mi,-83.40126,42.76696,8673,3,7,4,133.3
48350,mi,-83.53217,42.74082,3098,2,6,4,200
48353,mi,-83.71679,42.64763,2569,3,7,4,133.3
48356,mi,-83.58928,42.65508,3859,2,6,4,200
48357,mi,-83.64388,42.65604,2886,2,6,4,200
48359,mi,-83.27886,42.72203,3265,3,8,5,166.7
48360,mi,-83.26894,42.74934,4144,3,8,5,166.7
48362,mi,-83.2697,42.78227,6474,3,8,5,166.7
48363,mi,-83.16182,42.77284,2693,4,9,5,125
48367,mi,-83.14144,42.84283,2301,4,8,4,100
48370,mi,-83.20079,42.84124,859,3,8,5,166.7
48371,mi,-83.29086,42.84122,8704,3,8,5,166.7
48374,mi,-83.52381,42.47079,4971,4,9,5,125
48375,mi,-83.46331,42.46483,5762,4,9,5,125
48377,mi,-83.47273,42.50647,3061,3,9,6,200
48380,mi,-83.66215,42.58074,3033,3,7,4,133.3
48381,mi,-83.59421,42.56168,4861,3,7,4,133.3
48382,mi,-83.50589,42.59075,9386,3,7,4,133.3
48383,mi,-83.53219,42.65797,4470,2,6,4,200
48386,mi,-83.47527,42.65786,7330,3,7,4,133.3
48390,mi,-83.4764,42.55141,7707,3,8,5,166.7
48393,mi,-83.54508,42.52111,3920,3,7,4,133.3
48397,mi,-83.04104,42.49502,27,4,9,5,125
48401,mi,-82.6672,43.35272,1082,4,8,4,100
48411,mi,-83.53079,42.93603,95,4,8,4,100
48412,mi,-83.17077,43.06289,3035,4,9,5,125
48413,mi,-82.99474,43.80193,4839,5,9,4,80
48414,mi,-84.07882,42.86179,1453,4,9,5,125
48415,mi,-83.80097,43.27113,4639,5,10,5,100
48416,mi,-82.98449,43.21672,2994,5,10,5,100
48417,mi,-83.93596,43.26052,1492,5,10,5,100
48418,mi,-83.97017,42.80428,2112,4,8,4,100
48419,mi,-82.6534,43.4287,2284,4,8,4,100
48420,mi,-83.71415,43.17959,9497,4,9,5,125
48421,mi,-83.39211,43.15369,3721,4,9,5,125
48422,mi,-82.65059,43.26264,3584,4,9,5,125
48423,mi,-83.51347,43.03977,11739,4,9,5,125
48426,mi,-83.05873,43.51011,764,6,11,5,83.3
48427,mi,-82.72196,43.53811,2409,4,9,5,125
48428,mi,-83.14819,42.93843,2431,4,8,4,100
48429,mi,-84.00369,42.9068,3754,4,9,5,125
48430,mi,-83.74283,42.75836,17212,3,7,4,133.3
48432,mi,-82.97677,43.89911,656,4,8,4,100
48433,mi,-83.86623,43.07575,11237,4,9,5,125
48434,mi,-82.61178,43.66189,207,3,7,4,133.3
48435,mi,-83.35811,43.24826,1192,4,10,6,150
48436,mi,-83.87327,42.86709,1803,3,8,5,166.7
48437,mi,-83.61541,43.11231,266,4,9,5,125
48438,mi,-83.47687,42.91239,3134,3,8,5,166.7
48439,mi,-83.62913,42.9168,19008,3,8,5,166.7
48440,mi,-83.41236,42.95072,83,3,8,5,166.7
48441,mi,-82.70678,43.80195,3538,3,7,4,133.3
48442,mi,-83.6035,42.79164,9015,3,7,4,133.3
48444,mi,-83.05513,43.06498,4257,5,10,5,100
48445,mi,-82.987,43.95158,1327,4,8,4,100
48446,mi,-83.33763,43.05353,12595,4,9,5,125
48449,mi,-83.94623,42.9949,1320,4,9,5,125
48450,mi,-82.53997,43.25819,4363,4,8,4,100
48451,mi,-83.81945,42.8027,6660,3,8,5,166.7
48453,mi,-83.03192,43.34412,3056,5,10,5,100
48454,mi,-82.81946,43.1992,869,3,8,5,166.7
48455,mi,-83.2892,42.93887,4094,3,8,5,166.7
48456,mi,-82.75956,43.67025,849,5,9,4,80
48457,mi,-83.89565,43.18943,3856,4,10,6,150
48458,mi,-83.68219,43.12225,7928,4,9,5,125
48460,mi,-83.98723,43.1282,1241,4,10,6,150
48461,mi,-83.2045,43.20397,3864,5,10,5,100
48462,mi,-83.42666,42.84889,6377,3,7,4,133.3
48463,mi,-83.52302,43.16586,2263,4,9,5,125
48464,mi,-83.42107,43.21905,1380,4,9,5,125
48465,mi,-82.70665,43.61471,832,4,8,4,100
48466,mi,-82.81672,43.27698,1014,4,8,4,100
48467,mi,-82.98227,44.01294,4347,3,7,4,133.3
48468,mi,-82.77898,43.94299,2222,4,7,3,75
48469,mi,-82.55695,43.4406,1078,3,7,4,133.3
48470,mi,-82.75782,43.73253,677,5,9,4,80
48471,mi,-82.85228,43.41813,3318,4,9,5,125
48472,mi,-82.95527,43.51348,1411,5,10,5,100
48473,mi,-83.82619,42.93989,9677,4,8,4,100
48475,mi,-82.93943,43.67061,2143,5,10,5,100
48476,mi,-84.0299,42.9385,279,4,9,5,125
48502,mi,-83.68864,43.01364,341,3,8,5,166.7
48503,mi,-83.68847,43.01183,13379,4,8,4,100
48504,mi,-83.74983,43.05729,14640,4,8,4,100
48505,mi,-83.6875,43.0704,17977,4,8,4,100
48506,mi,-83.62155,43.06788,13497,4,9,5,125
48507,mi,-83.71548,42.96543,12598,3,8,5,166.7
48509,mi,-83.60539,43.02612,4431,4,8,4,100
48519,mi,-83.60693,42.98748,3151,4,8,4,100
48529,mi,-83.66178,42.97244,4591,3,8,5,166.7
48532,mi,-83.79089,43.0124,7424,4,8,4,100
48551,mi,-83.71692,42.98101,2,3,8,5,166.7
48554,mi,-83.79074,42.97588,3,4,8,4,100
48601,mi,-83.89374,43.40417,22078,6,12,6,100
48602,mi,-83.97468,43.4197,13075,6,13,7,116.7
48603,mi,-84.02966,43.46313,9152,6,12,6,100
48604,mi,-83.96252,43.49441,5227,6,12,6,100
48607,mi,-83.93375,43.43177,1534,6,13,7,116.7
48609,mi,-84.08798,43.38741,5473,6,12,6,100
48610,mi,-84.17436,44.12831,5383,2,6,4,200
48611,mi,-84.09316,43.63181,3328,4,9,5,125
48612,mi,-84.43191,43.88114,8591,4,8,4,100
48613,mi,-84.16781,43.9532,972,3,6,3,100
48614,mi,-84.30252,43.25054,920,5,10,5,100
48615,mi,-84.47146,43.42948,1949,5,11,6,120
48616,mi,-84.11172,43.19289,4037,5,10,5,100
48617,mi,-84.71581,43.84683,5334,3,8,5,166.7
48618,mi,-84.5602,43.73725,3528,4,9,5,125
48619,mi,-84.03131,44.82455,1116,2,4,2,100
48621,mi,-83.99443,44.72407,1478,2,4,2,100
48622,mi,-84.8804,43.84005,3480,3,7,4,133.3
48623,mi,-84.13562,43.51985,6011,5,10,5,100
48624,mi,-84.46663,44.06206,18077,3,7,4,133.3
48625,mi,-84.83135,44.05396,7995,2,4,2,100
48626,mi,-84.22537,43.42214,3364,5,11,6,120
48627,mi,-84.7502,44.46192,446,1,3,2,200
48628,mi,-84.32883,43.78352,1666,5,10,5,100
48629,mi,-84.77667,44.31165,10286,1,3,2,200
48630,mi,-84.7725,44.32479,98,1,4,3,300
48631,mi,-84.0008,43.6852,2496,4,8,4,100
48632,mi,-85.02185,43.85754,5663,2,6,4,200
48633,mi,-84.93125,43.93718,52,2,5,3,150
48634,mi,-84.05448,43.75195,2927,3,7,4,133.3
48635,mi,-84.00128,44.39542,1953,2,5,3,150
48636,mi,-84.29314,44.60007,1865,2,4,2,100
48637,mi,-84.33676,43.4133,2212,5,11,6,120
48638,mi,-84.0196,43.41704,5048,6,12,6,100
48640,mi,-84.33576,43.58563,14857,6,12,6,100
48642,mi,-84.22942,43.70613,13413,5,11,6,120
48647,mi,-84.10483,44.65891,5458,2,4,2,100
48649,mi,-84.21538,43.15576,1031,5,10,5,100
48650,mi,-84.00625,43.84811,4878,3,6,3,100
48651,mi,-84.61558,44.25571,5488,1,3,2,200
48652,mi,-84.20511,43.85571,1162,3,7,4,133.3
48653,mi,-84.60048,44.48783,16736,1,3,2,200
48654,mi,-84.13164,44.45598,1646,2,4,2,100
48655,mi,-84.15907,43.29224,3798,5,11,6,120
48656,mi,-84.4488,44.34821,5887,1,3,2,200
48657,mi,-84.42066,43.7109,5070,5,10,5,100
48658,mi,-83.93405,43.98023,3894,2,5,3,150
48659,mi,-84.05046,44.06689,2128,2,5,3,150
48661,mi,-84.24083,44.32884,5862,2,4,2,100
48662,mi,-84.41099,43.41114,1133,5,11,6,120
48667,mi,-84.23413,43.60222,54,6,11,5,83.3
48701,mi,-83.55635,43.58946,1288,5,10,5,100
48703,mi,-83.67169,44.06072,4968,2,4,2,100
48705,mi,-83.6536,44.7009,1516,2,5,3,150
48706,mi,-83.95159,43.6008,18717,4,9,5,125
48708,mi,-83.84506,43.56189,11967,4,9,5,125
48710,mi,-83.98767,43.55651,2,4,10,6,150
48720,mi,-83.3522,43.83353,1016,5,9,4,80
48721,mi,-83.34246,44.80759,819,2,4,2,100
48722,mi,-83.84179,43.3483,1764,5,11,6,120
48723,mi,-83.387,43.48559,6952,6,11,5,83.3
48724,mi,-83.92279,43.46001,258,6,12,6,100
48725,mi,-83.21119,43.9417,3903,3,7,4,133.3
48726,mi,-83.16913,43.60768,4164,6,11,5,83.3
48727,mi,-83.17566,43.30974,856,5,10,5,100
48728,mi,-83.82747,44.73605,1503,2,4,2,100
48729,mi,-83.17845,43.49492,1195,6,11,5,83.3
48731,mi,-83.1587,43.84084,1253,4,8,4,100
48732,mi,-83.7809,43.61235,4401,4,8,4,100
48733,mi,-83.59251,43.53402,1423,5,10,5,100
48734,mi,-83.74436,43.35439,3890,5,11,6,120
48735,mi,-83.27346,43.66825,894,5,11,6,120
48737,mi,-83.6988,44.55041,2242,2,4,2,100
48738,mi,-83.33064,44.55216,2246,2,4,2,100
48739,mi,-83.84004,44.3729,2712,2,4,2,100
48740,mi,-83.36717,44.66876,2894,2,4,2,100
48741,mi,-83.18343,43.40514,1597,5,11,6,120
48742,mi,-83.44359,44.72836,3048,3,5,2,66.7
48744,mi,-83.36062,43.34767,3094,5,10,5,100
48745,mi,-83.4727,44.56995,1484,2,4,2,100
48746,mi,-83.5428,43.26501,4503,4,10,6,150
48747,mi,-83.76123,43.52178,1143,4,9,5,125
48749,mi,-83.88722,44.05459,1021,2,5,3,150
48750,mi,-83.4501,44.44261,61,2,5,3,150
48754,mi,-83.23593,43.73368,820,5,10,5,100
48755,mi,-83.28124,43.84465,3473,4,8,4,100
48756,mi,-83.97407,44.22942,6487,2,4,2,100
48757,mi,-83.67944,43.4694,2386,5,10,5,100
48759,mi,-83.39469,43.72928,2546,5,10,5,100
48760,mi,-83.25751,43.32115,1635,5,10,5,100
48761,mi,-83.89241,44.51194,791,2,4,2,100
48762,mi,-83.48873,44.81746,2046,2,5,3,150
48763,mi,-83.60971,44.25085,624,2,4,2,100
48765,mi,-83.7179,44.15242,562,2,5,3,150
48766,mi,-83.84698,44.11107,1058,2,5,3,150
48767,mi,-83.46617,43.64859,2188,5,10,5,100
48768,mi,-83.5779,43.37135,5576,5,11,6,120
48801,mi,-84.67971,43.37768,5527,5,11,6,120
48806,mi,-84.49754,43.18499,1334,5,11,6,120
48807,mi,-84.40483,43.15302,716,5,11,6,120
48808,mi,-84.44828,42.82561,2795,4,9,5,125
48809,mi,-85.25825,43.06537,5373,4,10,6,150
48811,mi,-84.85499,43.1811,2114,5,11,6,120
48813,mi,-84.84538,42.58015,10047,4,9,5,125
48815,mi,-85.2571,42.84129,1505,4,10,6,150
48816,mi,-83.95462,42.76412,64,4,9,5,125
48817,mi,-84.03861,43.0179,2738,4,10,6,150
48818,mi,-84.89216,43.27547,2438,5,11,6,120
48819,mi,-84.28544,42.54641,1486,3,8,5,166.7
48820,mi,-84.59289,42.86303,7548,4,9,5,125
48821,mi,-84.64709,42.63939,2649,4,9,5,125
48822,mi,-84.76068,42.83333,1676,4,9,5,125
48823,mi,-84.45381,42.76197,12428,4,9,5,125
48825,mi,-84.48089,42.72702,13,4,9,5,125
48827,mi,-84.65979,42.50911,7666,4,9,5,125
48829,mi,-85.02021,43.40121,2210,4,8,4,100
48831,mi,-84.37165,43.10287,2221,5,10,5,100
48832,mi,-84.78013,43.41469,871,5,10,5,100
48834,mi,-85.02948,43.13225,1550,5,10,5,100
48835,mi,-84.74685,43.0283,1682,5,11,6,120
48836,mi,-84.07464,42.67079,6668,4,9,5,125
48837,mi,-84.76842,42.74647,8400,4,9,5,125
48838,mi,-85.25748,43.18391,9860,5,11,6,120
48840,mi,-84.37067,42.769,4905,4,9,5,125
48841,mi,-84.23693,43.11433,565,5,10,5,100
48842,mi,-84.53876,42.63383,7206,3,9,6,200
48843,mi,-83.92632,42.56903,18849,3,8,5,166.7
48845,mi,-84.8479,43.10441,780,5,11,6,120
48846,mi,-85.05754,42.98705,7328,4,10,6,150
48847,mi,-84.57472,43.2711,3848,5,11,6,120
48848,mi,-84.35564,42.88724,4103,4,9,5,125
48849,mi,-85.13204,42.80091,3617,4,11,7,175
48850,mi,-85.25416,43.43783,3793,3,8,5,166.7
48851,mi,-84.93978,42.95567,1437,5,10,5,100
48852,mi,-85.04607,43.35169,121,4,9,5,125
48853,mi,-84.69018,43.10128,347,5,11,6,120
48854,mi,-84.45164,42.58202,8419,3,8,5,166.7
48855,mi,-83.91399,42.68706,8040,3,8,5,166.7
48856,mi,-84.73662,43.19999,700,5,11,6,120
48857,mi,-84.1553,42.84248,1011,4,9,5,125
48858,mi,-84.79618,43.61519,14693,4,9,5,125
48860,mi,-84.91093,43.05231,949,5,10,5,100
48861,mi,-84.92032,42.73056,887,4,10,6,150
48864,mi,-84.40676,42.70132,7486,4,9,5,125
48865,mi,-85.10559,43.08699,1192,5,10,5,100
48866,mi,-84.37436,42.99487,2534,5,10,5,100
48867,mi,-84.18862,43.00312,12708,4,10,6,150
48870,mi,-84.98475,43.11041,69,5,11,6,120
48871,mi,-84.67546,43.15437,1836,5,11,6,120
48872,mi,-84.21802,42.80071,3362,4,9,5,125
48873,mi,-84.84343,42.9963,1029,5,10,5,100
48874,mi,-84.59494,43.18645,107,5,12,7,140
48875,mi,-84.92966,42.85931,4828,4,10,6,150
48876,mi,-84.73572,42.64558,1528,4,9,5,125
48877,mi,-84.84286,43.40174,1478,5,10,5,100
48878,mi,-84.77685,43.71228,994,4,9,5,125
48879,mi,-84.57906,43.00429,9230,5,10,5,100
48880,mi,-84.56831,43.45759,3616,5,11,6,120
48881,mi,-85.20151,42.93283,2871,4,10,6,150
48883,mi,-84.66857,43.54189,4181,5,10,5,100
48884,mi,-85.04322,43.2083,2980,5,11,6,120
48885,mi,-85.14442,43.24984,631,5,11,6,120
48886,mi,-85.16184,43.41908,2450,4,9,5,125
48888,mi,-85.09553,43.31038,4909,5,10,5,100
48889,mi,-84.79759,43.29163,828,5,11,6,120
48890,mi,-84.96874,42.76962,1265,4,10,6,150
48891,mi,-84.91362,43.39592,2142,4,9,5,125
48892,mi,-84.1745,42.63652,2238,4,9,5,125
48893,mi,-84.97789,43.68301,5277,3,8,5,166.7
48894,mi,-84.78569,42.92452,1152,4,10,6,150
48895,mi,-84.27958,42.68874,5193,4,9,5,125
48896,mi,-84.90103,43.52128,104,4,9,5,125
48897,mi,-85.13217,42.70686,946,5,11,6,120
48906,mi,-84.58763,42.78454,12089,4,9,5,125
48910,mi,-84.523,42.69852,13878,4,9,5,125
48911,mi,-84.57083,42.67444,11439,4,9,5,125
48912,mi,-84.52354,42.7402,7412,4,9,5,125
48915,mi,-84.57098,42.73827,4192,4,9,5,125
48917,mi,-84.63995,42.72377,11238,4,9,5,125
48921,mi,-84.5625,42.72194,27,4,9,5,125
48933,mi,-84.55429,42.73252,845,4,9,5,125
49001,mi,-85.56244,42.26474,8542,6,13,7,116.7
49002,mi,-85.56092,42.19737,7664,6,13,7,116.7
49004,mi,-85.56208,42.35182,6356,6,14,8,133.3
49006,mi,-85.63018,42.29533,5488,6,14,8,133.3
49007,mi,-85.58821,42.30237,4335,6,14,8,133.3
49008,mi,-85.6151,42.26288,5161,6,13,7,116.7
49009,mi,-85.69404,42.30762,15571,6,14,8,133.3
49010,mi,-85.87432,42.53465,10723,5,11,6,120
49011,mi,-85.22291,42.10525,1223,6,13,7,116.7
49012,mi,-85.34645,42.36121,2142,5,13,8,160
49013,mi,-86.10843,42.30568,3560,6,12,6,100
49014,mi,-85.10612,42.31104,10052,5,11,6,120
49015,mi,-85.2261,42.27127,10883,5,11,6,120
49017,mi,-85.21205,42.39987,9241,5,11,6,120
49021,mi,-85.064,42.45916,3439,5,11,6,120
49022,mi,-86.3674,42.11456,16635,8,16,8,100
49024,mi,-85.61903,42.20271,10230,6,13,7,116.7
49026,mi,-85.96538,42.3772,1831,6,13,7,116.7
49027,mi,-86.06878,42.34804,123,6,13,7,116.7
49028,mi,-85.18652,41.84817,4170,6,14,8,133.3
49029,mi,-85.09246,42.14346,961,5,12,7,140
49030,mi,-85.33175,41.85649,1719,6,13,7,116.7
49031,mi,-85.98732,41.89837,6623,7,15,8,114.3
49032,mi,-85.50947,41.91822,1558,7,15,8,114.3
49033,mi,-85.09109,42.22618,1028,5,12,7,140
49034,mi,-85.33689,42.23118,1260,5,12,7,140
49036,mi,-85.02321,41.90285,13316,6,13,7,116.7
49037,mi,-85.24825,42.33246,9588,4,11,7,175
49038,mi,-86.32743,42.20322,6731,7,14,7,100
49040,mi,-85.32896,41.96419,2722,6,14,8,133.3
49042,mi,-85.66659,41.85735,2543,7,15,8,114.3
49043,mi,-86.27108,42.28599,1920,5,12,7,140
49045,mi,-86.00064,42.10529,3845,7,14,7,100
49046,mi,-85.40322,42.51237,5058,5,13,8,160
49047,mi,-86.12196,42.00405,11275,7,15,8,114.3
49048,mi,-85.49847,42.27284,9873,6,13,7,116.7
49050,mi,-85.23699,42.50593,1000,5,12,7,140
49051,mi,-85.24046,42.18349,1247,5,12,7,140
49052,mi,-85.32074,42.11426,649,6,13,7,116.7
49053,mi,-85.41627,42.28896,3150,6,13,7,116.7
49055,mi,-85.85327,42.37015,4123,6,13,7,116.7
49056,mi,-86.06054,42.4022,3917,5,12,7,140
49057,mi,-86.16402,42.18367,3155,7,14,7,100
49058,mi,-85.29209,42.63188,9592,5,12,7,140
49060,mi,-85.39528,42.42652,1339,6,14,8,133.3
49061,mi,-85.82278,41.87901,1317,7,15,8,114.3
49064,mi,-86.04886,42.22106,2466,6,14,8,133.3
49065,mi,-85.84014,42.13619,4048,7,15,8,114.3
49066,mi,-85.34999,42.03443,550,6,14,8,133.3
49067,mi,-85.80198,42.02405,3345,7,15,8,114.3
49068,mi,-84.94083,42.27681,7645,5,11,6,120
49070,mi,-85.63116,42.54047,1264,5,12,7,140
49071,mi,-85.78171,42.2274,4125,7,14,7,100
49072,mi,-85.46057,42.01201,2188,7,15,8,114.3
49073,mi,-85.11774,42.57744,2475,4,11,7,175
49074,mi,-85.53872,42.31747,2,6,14,8,133.3
49075,mi,-85.4486,41.91751,42,6,14,8,133.3
49076,mi,-84.88759,42.43181,2200,4,10,6,150
49078,mi,-85.72804,42.46506,4534,5,13,8,160
49079,mi,-85.90805,42.24057,7402,6,14,8,133.3
49080,mi,-85.57503,42.46104,7566,6,13,7,116.7
49082,mi,-84.87578,41.94437,4084,5,12,7,140
49083,mi,-85.46063,42.37754,3970,6,14,8,133.3
49084,mi,-86.38206,42.18255,23,8,16,8,100
49085,mi,-86.46323,42.05313,10688,8,15,7,87.5
49087,mi,-85.6882,42.12188,3394,6,14,8,133.3
49088,mi,-85.42889,42.18513,2002,6,13,7,116.7
49089,mi,-85.23596,42.00466,1521,6,14,8,133.3
49090,mi,-86.2179,42.40787,12979,4,9,5,125
49091,mi,-85.44606,41.8244,10089,6,13,7,116.7
49092,mi,-84.97577,42.10005,1546,5,12,7,140
49093,mi,-85.64976,41.97257,10733,7,16,9,128.6
49094,mi,-85.11417,42.04733,2600,6,13,7,116.7
49095,mi,-85.8804,41.90702,2329,7,15,8,114.3
49096,mi,-85.01574,42.64164,2064,4,10,6,150
49097,mi,-85.48818,42.11459,5768,6,14,8,133.3
49098,mi,-86.24275,42.16874,3537,7,15,8,114.3
49099,mi,-85.67799,41.79176,3911,7,15,8,114.3
49101,mi,-86.48295,41.94282,1451,7,14,7,100
49102,mi,-86.2611,41.95231,777,8,16,8,100
49103,mi,-86.37648,41.94692,4636,7,15,8,114.3
49104,mi,-86.35897,41.9637,4,7,15,8,114.3
49106,mi,-86.55383,41.93975,2566,7,13,6,85.7
49107,mi,-86.41373,41.84568,5408,6,14,8,133.3
49111,mi,-86.28779,42.02474,2054,8,17,9,112.5
49112,mi,-86.03362,41.79762,5249,7,16,9,128.6
49113,mi,-86.50087,41.8024,1304,6,14,8,133.3
49115,mi,-86.6329,41.87714,598,6,13,7,116.7
49116,mi,-86.66565,41.85043,813,6,14,8,133.3
49117,mi,-86.7301,41.78182,4876,6,14,8,133.3
49119,mi,-86.54905,41.87436,83,7,14,7,100
49120,mi,-86.23078,41.83237,17331,6,14,8,133.3
49125,mi,-86.5797,41.88909,2209,6,13,7,116.7
49126,mi,-86.36879,42.02587,724,8,15,7,87.5
49127,mi,-86.51633,42.00732,4624,7,14,7,100
49128,mi,-86.60332,41.81652,2426,7,15,8,114.3
49129,mi,-86.68879,41.81809,1262,6,13,7,116.7
49130,mi,-85.85947,41.78192,1339,8,16,8,100
49201,mi,-84.38153,42.2498,18169,4,10,6,150
49202,mi,-84.41035,42.26859,8554,4,10,6,150
49203,mi,-84.4011,42.22151,17370,4,10,6,150
49220,mi,-84.3424,41.99459,1527,4,10,6,150
49221,mi,-84.0636,41.903,9309,6,14,8,133.3
49224,mi,-84.75178,42.28107,6936,4,10,6,150
49227,mi,-84.7712,41.95189,832,4,11,7,175
49228,mi,-83.88344,41.80433,3280,5,13,8,160
49229,mi,-83.82836,41.9868,2018,6,13,7,116.7
49230,mi,-84.22069,42.09469,8702,4,10,6,150
49232,mi,-84.66857,41.74048,2786,6,14,8,133.3
49233,mi,-84.36282,42.06223,2239,4,9,5,125
49234,mi,-84.36864,42.11857,2028,4,9,5,125
49235,mi,-84.21466,41.86357,1335,6,13,7,116.7
49236,mi,-83.951,42.07839,2321,5,12,7,140
49237,mi,-84.65156,42.17571,1857,4,10,6,150
49238,mi,-83.78597,41.9055,1100,4,11,7,175
49240,mi,-84.17873,42.27979,5287,4,9,5,125
49241,mi,-84.60228,42.10323,1390,4,10,6,150
49242,mi,-84.61636,41.88333,8215,4,10,6,150
49245,mi,-84.81757,42.14002,2739,5,11,6,120
49246,mi,-84.50883,42.12626,2143,4,9,5,125
49247,mi,-84.34249,41.84786,3619,5,13,8,160
49248,mi,-84.01119,41.75643,774,6,14,8,133.3
49249,mi,-84.45831,42.02285,3614,4,9,5,125
49250,mi,-84.62274,42.01915,3733,4,10,6,150
49251,mi,-84.41006,42.46596,3250,3,9,6,200
49252,mi,-84.76731,42.03686,1590,5,11,6,120
49253,mi,-84.27104,41.96684,3203,4,10,6,150
49254,mi,-84.31606,42.22713,1888,4,10,6,150
49255,mi,-84.85054,41.77275,1433,5,12,7,140
49256,mi,-84.21859,41.74995,2236,6,14,8,133.3
49259,mi,-84.25302,42.3789,1296,3,9,6,200
49261,mi,-84.23834,42.16094,154,4,10,6,150
49262,mi,-84.46744,41.96147,829,4,9,5,125
49263,mi,-84.18462,42.15932,46,4,10,6,150
49264,mi,-84.55143,42.44355,1064,4,9,5,125
49265,mi,-84.1727,42.00731,3405,5,12,7,140
49266,mi,-84.54781,41.84224,2215,4,11,7,175
49267,mi,-83.72257,41.76087,2277,7,15,8,114.3
49268,mi,-83.92627,41.8729,751,6,14,8,133.3
49269,mi,-84.58789,42.29296,3115,4,10,6,150
49270,mi,-83.68328,41.86973,2936,6,13,7,116.7
49271,mi,-84.45551,41.83697,1440,5,12,7,140
49272,mi,-84.34663,42.39405,1571,4,9,5,125
49274,mi,-84.76281,41.8385,3071,5,11,6,120
49276,mi,-83.78456,41.79741,708,5,12,7,140
49277,mi,-84.4653,42.38736,2018,4,9,5,125
49279,mi,-84.10396,41.78081,596,6,14,8,133.3
49282,mi,-84.40596,42.03878,578,4,9,5,125
49283,mi,-84.55077,42.20695,1422,4,10,6,150
49284,mi,-84.69322,42.38673,1907,4,10,6,150
49285,mi,-84.21008,42.47064,3230,3,9,6,200
49286,mi,-83.93603,42.01361,3501,6,14,8,133.3
49287,mi,-84.08141,42.02109,1365,5,12,7,140
49288,mi,-84.43004,41.73464,1013,6,14,8,133.3
49289,mi,-84.10781,41.76807,110,6,14,8,133.3
49301,mi,-85.47659,42.97647,7610,4,9,5,125
49302,mi,-85.39861,42.82286,3688,4,9,5,125
49303,mi,-85.85484,43.27726,618,3,8,5,166.7
49304,mi,-85.87004,43.91371,12210,4,8,4,100
49305,mi,-85.14971,43.75074,2590,2,6,4,200
49306,mi,-85.56776,43.07326,3671,4,9,5,125
49307,mi,-85.48913,43.69892,8281,3,7,4,133.3
49309,mi,-85.88091,43.75941,6044,3,8,5,166.7
49310,mi,-85.05651,43.51564,2272,3,8,5,166.7
49312,mi,-85.80555,43.68822,626,3,7,4,133.3
49315,mi,-85.73627,42.80013,8064,4,9,5,125
49316,mi,-85.55403,42.7968,8112,4,9,5,125
49318,mi,-85.82911,43.22347,802,3,8,5,166.7
49319,mi,-85.52637,43.22715,7031,4,9,5,125
49320,mi,-85.27547,43.75359,53,2,6,4,200
49321,mi,-85.68085,43.07429,4880,4,9,5,125
49322,mi,-85.35114,43.35672,1114,4,9,5,125
49323,mi,-85.78724,42.72535,4270,4,10,6,150
49325,mi,-85.29825,42.76052,1077,4,11,7,175
49326,mi,-85.32061,43.24982,2485,5,10,5,100
49327,mi,-85.84616,43.33538,4948,3,8,5,166.7
49328,mi,-85.7592,42.63168,2161,4,11,7,175
49329,mi,-85.48344,43.40631,5435,3,7,4,133.3
49330,mi,-85.73739,43.24505,2358,3,8,5,166.7
49331,mi,-85.35215,42.95144,7575,4,9,5,125
49332,mi,-85.24588,43.6244,3748,3,7,4,133.3
49333,mi,-85.46103,42.69563,5608,5,11,6,120
49335,mi,-85.66845,42.7385,165,4,10,6,150
49336,mi,-85.43178,43.50868,2953,3,7,4,133.3
49337,mi,-85.71359,43.43534,9749,3,8,5,166.7
49338,mi,-85.60851,43.75951,1465,3,7,4,133.3
49339,mi,-85.49032,43.33241,2125,3,8,5,166.7
49340,mi,-85.11395,43.62149,2269,3,7,4,133.3
49341,mi,-85.49193,43.12432,14067,4,9,5,125
49342,mi,-85.32223,43.69242,1895,2,6,4,200
49343,mi,-85.53557,43.29647,3552,4,8,4,100
49344,mi,-85.5914,42.59298,2418,5,12,7,140
49345,mi,-85.70372,43.154,5222,4,9,5,125
49346,mi,-85.42191,43.58573,7862,3,7,4,133.3
49347,mi,-85.34854,43.31472,1142,4,9,5,125
49348,mi,-85.6146,42.68565,5756,4,11,7,175
49349,mi,-85.74293,43.58204,7161,3,7,4,133.3
49401,mi,-85.94146,42.9762,4317,4,9,5,125
49402,mi,-86.03447,43.93327,2663,4,8,4,100
49403,mi,-85.85194,43.13498,1499,3,8,5,166.7
49404,mi,-85.95068,43.06584,3677,3,8,5,166.7
49405,mi,-86.19147,43.9143,1782,3,6,3,100
49406,mi,-86.20317,42.64191,1092,3,7,4,133.3
49408,mi,-86.11447,42.57037,6494,4,9,5,125
49410,mi,-86.1298,44.03192,2563,3,7,4,133.3
49411,mi,-86.25066,44.10658,2124,2,5,3,150
49412,mi,-85.94816,43.46859,6168,3,8,5,166.7
49415,mi,-86.11802,43.1511,3302,2,5,3,150
49417,mi,-86.15474,43.01564,12578,2,6,4,200
49418,mi,-85.77136,42.878,8880,3,9,6,200
49419,mi,-85.98103,42.67889,4139,4,10,6,150
49420,mi,-86.28303,43.7182,4472,3,6,3,100
49421,mi,-86.06115,43.60245,4651,3,7,4,133.3
49423,mi,-86.08941,42.74046,17444,4,10,6,150
49424,mi,-86.13287,42.84233,14698,4,10,6,150
49425,mi,-86.09885,43.43849,2335,3,6,3,100
49426,mi,-85.88834,42.86322,12171,3,9,6,200
49428,mi,-85.83771,42.92004,8785,3,8,5,166.7
49431,mi,-86.40565,43.98241,10794,3,6,3,100
49434,mi,-86.21689,42.76987,140,3,8,5,166.7
49435,mi,-85.84072,43.027,1785,3,8,5,166.7
49436,mi,-86.47201,43.68055,3387,2,5,3,150
49437,mi,-86.39572,43.4614,5360,1,4,3,300
49440,mi,-86.2538,43.23852,511,2,5,3,150
49441,mi,-86.28625,43.18293,16088,2,5,3,150
49442,mi,-86.12891,43.24205,15956,2,5,3,150
49444,mi,-86.19888,43.17906,11631,2,5,3,150
49445,mi,-86.28428,43.29541,10587,2,5,3,150
49446,mi,-86.38687,43.55469,1935,2,5,3,150
49448,mi,-86.07324,43.09073,2108,2,6,4,200
49449,mi,-86.38461,43.79599,4651,2,5,3,150
49450,mi,-86.08276,42.48438,2886,4,10,6,150
49451,mi,-85.96945,43.21199,3169,3,7,4,133.3
49452,mi,-86.25365,43.51202,1763,2,4,2,100
49453,mi,-86.1724,42.66316,2396,3,8,5,166.7
49454,mi,-86.28808,43.95136,3075,3,6,3,100
49455,mi,-86.37692,43.60905,4383,2,6,4,200
49456,mi,-86.20643,43.0892,8279,2,5,3,150
49457,mi,-86.1483,43.35366,7121,2,5,3,150
49458,mi,-86.09668,43.92615,186,3,7,4,133.3
49459,mi,-86.11274,43.74096,1552,3,7,4,133.3
49460,mi,-86.14373,42.93561,4525,3,8,5,166.7
49461,mi,-86.32589,43.38181,5316,2,4,2,100
49464,mi,-85.98617,42.84714,10374,4,10,6,150
49503,mi,-85.65923,42.96257,10807,3,9,6,200
49504,mi,-85.70939,42.98038,13927,3,9,6,200
49505,mi,-85.63691,42.99839,10549,4,9,5,125
49506,mi,-85.61399,42.94509,10884,3,9,6,200
49507,mi,-85.65518,42.93066,12367,3,9,6,200
49508,mi,-85.6253,42.87347,9956,3,9,6,200
49509,mi,-85.69295,42.8975,8683,3,9,6,200
49512,mi,-85.54675,42.88141,3799,3,9,6,200
49519,mi,-85.71861,42.89798,7055,3,9,6,200
49525,mi,-85.59169,43.02115,9590,4,9,5,125
49534,mi,-85.78828,42.9709,7451,3,9,6,200
49544,mi,-85.74193,43.04595,2784,3,9,6,200
49546,mi,-85.53744,42.9276,8372,3,9,6,200
49548,mi,-85.66279,42.86966,9143,3,9,6,200
49601,mi,-85.50746,44.24975,14231,1,3,2,200
49611,mi,-84.97446,44.97367,214,1,3,2,200
49612,mi,-85.24243,44.87133,1571,2,4,2,100
49613,mi,-86.20991,44.4998,1273,2,4,2,100
49614,mi,-86.11645,44.43875,3378,2,5,3,150
49615,mi,-85.20641,44.97084,7156,2,4,2,100
49616,mi,-86.081,44.57439,1805,2,5,3,150
49617,mi,-86.03256,44.6441,3806,2,5,3,150
49618,mi,-85.60236,44.29284,708,1,3,2,200
49619,mi,-85.9819,44.30262,1300,3,6,3,100
49620,mi,-85.6938,44.52136,2035,2,5,3,150
49621,mi,-85.77806,44.86631,3155,2,4,2,100
49622,mi,-85.26135,45.07734,2840,2,4,2,100
49623,mi,-85.68348,43.9048,1499,2,6,4,200
49625,mi,-85.87983,44.43223,1691,2,5,3,150
49626,mi,-86.29323,44.23783,293,2,4,2,100
49627,mi,-85.34988,45.09599,327,1,3,2,200
49628,mi,-86.23896,44.61816,371,2,4,2,100
49629,mi,-85.39975,44.91408,2298,2,5,3,150
49630,mi,-85.99995,44.81437,2365,2,4,2,100
49631,mi,-85.26183,43.91413,3858,2,5,3,150
49632,mi,-84.96937,44.23889,3,2,4,2,100
49633,mi,-85.20284,44.55959,4318,2,4,2,100
49634,mi,-86.2903,44.21484,77,2,5,3,150
49635,mi,-86.19347,44.61844,4878,2,4,2,100
49636,mi,-85.99634,44.88193,1457,2,4,2,100
49637,mi,-85.70591,44.62639,2172,2,5,3,150
49638,mi,-85.75112,44.29046,1189,2,4,2,100
49639,mi,-85.39847,43.84589,1593,2,6,4,200
49640,mi,-86.04028,44.7171,2264,3,6,3,100
49642,mi,-85.76051,43.86674,5930,4,8,4,100
49643,mi,-85.83377,44.63959,4438,2,5,3,150
49644,mi,-85.92198,44.10624,4602,3,7,4,133.3
49645,mi,-86.02603,44.36961,1753,2,6,4,200
49646,mi,-85.05848,44.72793,9685,1,3,2,200
49648,mi,-85.35251,44.99763,3147,2,4,2,100
49649,mi,-85.5348,44.56776,3761,2,5,3,150
49650,mi,-85.87879,44.73314,2330,2,5,3,150
49651,mi,-85.11291,44.394,2936,1,4,3,300
49653,mi,-85.7322,44.97542,2030,1,3,2,200
49654,mi,-85.98961,45.07929,1224,1,2,1,100
49655,mi,-85.4435,44.02602,2064,2,4,2,100
49656,mi,-85.69764,44.06548,2348,2,6,4,200
49657,mi,-85.17353,44.21438,35,1,4,3,300
49659,mi,-85.02412,44.89943,9982,1,3,2,200
49660,mi,-86.21028,44.2267,10473,2,5,3,150
49663,mi,-85.38844,44.42994,3397,2,4,2,100
49664,mi,-85.89002,44.87027,2304,2,5,3,150
49665,mi,-85.12697,44.09686,3175,2,4,2,100
49666,mi,-85.55414,44.62205,88,2,5,3,150
49668,mi,-85.70439,44.40582,3468,2,5,3,150
49670,mi,-85.62654,45.15402,3207,1,2,1,100
49674,mi,-85.59094,45.05087,153,1,2,1,100
49675,mi,-86.22069,44.3781,2170,2,4,2,100
49676,mi,-85.28922,44.83305,4200,2,4,2,100
49677,mi,-85.54822,43.89682,2952,2,5,3,150
49679,mi,-85.14655,43.87757,1242,2,6,4,200
49680,mi,-85.25245,44.64126,1748,2,4,2,100
49682,mi,-85.62648,44.97178,3567,1,3,2,200
49683,mi,-85.93056,44.53935,2810,2,5,3,150
49684,mi,-85.69997,44.76568,20125,2,5,3,150
49686,mi,-85.50864,44.75773,17607,2,5,3,150
49688,mi,-85.44676,44.12052,1982,1,4,3,300
49689,mi,-85.90757,44.21426,2820,3,6,3,100
49690,mi,-85.40088,44.78532,5177,2,5,3,150
49701,mi,-84.73599,45.7674,1490,0,0,0,NA
49705,mi,-84.46129,45.35583,960,1,4,3,300
49706,mi,-84.78041,45.44029,4067,1,2,1,100
49707,mi,-83.48095,45.09074,15235,2,4,2,100
49709,mi,-84.15845,45.01524,8772,2,4,2,100
49710,mi,-84.18196,46.27606,1059,0,1,1,NA
49712,mi,-85.00997,45.2101,7249,3,6,3,100
49713,mi,-84.85254,45.21437,3110,3,6,3,100
49715,mi,-84.69862,46.39685,3361,0,1,1,NA
49716,mi,-84.74935,45.51118,981,1,2,1,100
49717,mi,-84.69814,45.43897,147,1,3,2,200
49718,mi,-84.86003,45.72477,1218,0,1,1,NA
49719,mi,-84.32601,46.00451,2705,0,0,0,NA
49720,mi,-85.24453,45.2811,8993,0,1,1,NA
49721,mi,-84.46092,45.58392,14116,1,2,1,100
49722,mi,-84.86318,45.42352,216,1,2,1,100
49724,mi,-84.38782,46.32696,898,0,1,1,NA
49725,mi,-84.01758,45.99229,2568,0,1,1,NA
49726,mi,-83.67568,46.01345,3350,0,1,1,NA
49727,mi,-85.10348,45.13064,6366,2,5,3,150
49728,mi,-85.01363,46.4088,1136,1,1,0,0
49729,mi,-85.29442,45.16158,1941,1,3,2,200
49730,mi,-84.87387,45.046,7141,1,3,2,200
49733,mi,-84.70099,44.80863,3807,1,3,2,200
49735,mi,-84.67101,44.9953,19449,1,3,2,200
49736,mi,-84.08742,46.07576,1254,0,1,1,NA
49738,mi,-84.60641,44.69373,11283,1,4,3,300
49740,mi,-85.00619,45.52512,10488,0,1,1,NA
49743,mi,-83.89648,45.27347,1649,2,5,3,150
49744,mi,-83.66624,45.00021,725,2,4,2,100
49745,mi,-84.54258,46.04909,1858,0,0,0,NA
49746,mi,-83.95313,45.06386,5600,2,5,3,150
49747,mi,-83.64205,44.85112,2714,3,5,2,66.7
49748,mi,-85.1912,46.37785,789,1,2,1,100
49749,mi,-84.57445,45.41965,5836,1,3,2,200
49751,mi,-84.41516,44.99833,4144,1,3,2,200
49752,mi,-84.46861,46.28288,447,0,1,1,NA
49753,mi,-83.77217,45.01888,2814,2,5,3,150
49755,mi,-84.80023,45.63579,2254,0,1,1,NA
49756,mi,-84.28071,44.82343,9431,2,4,2,100
49757,mi,-84.62193,45.85613,1059,0,0,0,NA
49759,mi,-84.09959,45.42218,4915,1,4,3,300
49760,mi,-84.89493,46.05362,1301,0,0,0,NA
49762,mi,-85.33362,46.10448,2154,0,1,1,NA
49764,mi,-84.8274,45.42417,75,1,2,1,100
49765,mi,-84.24542,45.3284,5022,2,5,3,150
49766,mi,-83.43795,44.90953,2041,2,5,3,150
49768,mi,-85.1204,46.65346,2025,1,1,0,0
49769,mi,-84.85924,45.56746,1458,0,1,1,NA
49770,mi,-84.895,45.34624,11947,1,3,2,200
49774,mi,-84.32095,46.16311,2456,0,0,0,NA
49775,mi,-84.46118,45.77025,1750,0,1,1,NA
49776,mi,-83.69065,45.24544,2219,2,4,2,100
49777,mi,-83.5023,45.2969,5545,1,3,2,200
49779,mi,-83.86157,45.40564,5023,1,3,2,200
49780,mi,-84.72556,46.2121,2648,0,1,1,NA
49781,mi,-84.79776,45.94319,3476,0,0,0,NA
49782,mi,-85.54867,45.68213,3634,0,1,1,NA
49783,mi,-84.28543,46.41509,4856,0,1,1,NA
49788,mi,-84.46741,46.26396,1303,0,0,0,NA
49791,mi,-84.59577,45.48675,513,1,3,2,200
49793,mi,-85.06101,46.20922,880,0,1,1,NA
49795,mi,-84.57647,45.15878,2321,1,3,2,200
49796,mi,-84.94537,45.26297,499,3,7,4,133.3
49799,mi,-84.58198,45.26106,3521,1,3,2,200
49801,mi,-87.98222,45.96725,2722,2,4,2,100
49802,mi,-88.07727,45.80057,134,2,4,2,100
49805,mi,-88.3714,47.35634,500,0,1,1,NA
49806,mi,-86.88995,46.44836,1151,1,2,1,100
49807,mi,-87.36341,45.77735,3862,2,3,1,50
49812,mi,-87.49821,45.59335,800,2,4,2,100
49815,mi,-87.96489,46.18671,691,1,3,2,200
49816,mi,-86.89421,46.28461,818,2,4,2,100
49817,mi,-86.46314,45.96726,192,1,1,0,0
49818,mi,-87.34612,45.97522,1503,2,4,2,100
49820,mi,-85.6906,46.20385,672,1,2,1,100
49821,mi,-87.63266,45.53014,1442,2,4,2,100
49822,mi,-87.03808,46.45066,676,1,2,1,100
49825,mi,-86.98529,46.34491,364,2,4,2,100
49826,mi,-87.03927,46.34074,173,2,3,1,50
49827,mi,-85.55771,46.16917,2088,0,1,1,NA
49829,mi,-87.1528,45.76091,3446,1,2,1,100
49831,mi,-87.7294,46.06704,1020,2,4,2,100
49834,mi,-87.75837,45.94376,649,2,4,2,100
49835,mi,-86.57877,45.73344,1949,0,1,1,NA
49836,mi,-85.88416,46.19796,962,1,2,1,100
49837,mi,-87.09004,45.87128,3552,1,3,2,200
49838,mi,-85.74773,46.06219,1411,0,1,1,NA
49839,mi,-86.10183,46.61327,1503,2,4,2,100
49847,mi,-87.63186,45.70541,527,2,4,2,100
49848,mi,-87.63642,45.37825,71,1,3,2,200
49852,mi,-87.81789,45.78405,53,3,5,2,66.7
49853,mi,-85.74507,46.35941,2729,1,3,2,200
49854,mi,-86.33796,46.12143,137,1,3,2,200
49855,mi,-87.45466,46.57872,6052,1,3,2,200
49858,mi,-87.57824,45.21985,1526,2,3,1,50
49862,mi,-86.69823,46.39937,3812,2,3,1,50
49863,mi,-87.55157,45.6134,12,2,5,3,150
49864,mi,-86.67259,45.87148,128,1,1,0,0
49868,mi,-85.50695,46.50007,7208,1,2,1,100
49870,mi,-87.90539,45.86817,2241,2,5,3,150
49872,mi,-87.08435,46.02108,339,2,4,2,100
49873,mi,-87.5379,45.87947,720,2,4,2,100
49874,mi,-87.50306,45.70196,537,3,5,2,66.7
49876,mi,-87.98214,45.80256,106,2,5,3,150
49877,mi,-87.70888,46.14913,1021,2,3,1,50
49878,mi,-86.85822,45.94639,6461,1,2,1,100
49879,mi,-88.03167,46.36209,52,1,2,1,100
49880,mi,-87.22179,46.11281,1513,2,4,2,100
49881,mi,-88.03349,46.07833,477,1,3,2,200
49883,mi,-86.01337,46.4352,273,3,5,2,66.7
49884,mi,-86.34171,46.42611,930,2,4,2,100
49885,mi,-87.20743,46.33662,160,2,3,1,50
49886,mi,-87.52701,45.73915,181,2,5,3,150
49887,mi,-87.55523,45.43419,1948,2,3,1,50
49891,mi,-87.01695,46.22514,1310,2,4,2,100
49892,mi,-87.78641,45.78926,2349,2,5,3,150
49893,mi,-87.59796,45.29681,1082,1,3,2,200
49894,mi,-87.07442,45.78193,438,1,2,1,100
49895,mi,-86.66581,46.16742,1956,2,4,2,100
49896,mi,-87.38994,45.67437,887,2,4,2,100
49901,mi,-88.39521,47.3078,339,0,1,1,NA
49902,mi,-88.37988,46.043,5,1,2,1,100
49903,mi,-88.42993,46.3281,1207,1,3,2,200
49905,mi,-88.73501,47.125,1708,1,2,1,100
49911,mi,-90.04989,46.49002,2941,0,1,1,NA
49913,mi,-88.45875,47.24394,5431,0,1,1,NA
49916,mi,-88.5902,46.97986,2667,1,2,1,100
49917,mi,-88.35913,47.28136,208,0,1,1,NA
49918,mi,-87.82134,47.42494,573,0,1,1,NA
49920,mi,-88.29236,46.15515,5031,1,3,2,200
49921,mi,-88.58235,47.09249,195,1,2,1,100
49922,mi,-88.48497,47.10391,802,1,2,1,100
49927,mi,-88.56433,46.04516,252,1,3,2,200
49930,mi,-88.53998,47.16249,4236,1,2,1,100
49931,mi,-88.60376,47.13046,1724,1,2,1,100
49934,mi,-88.43774,47.17077,663,1,1,0,0
49935,mi,-88.74484,46.19924,4646,1,3,2,200
49938,mi,-90.11806,46.54441,7716,1,1,0,0
49942,mi,-88.4071,47.27446,150,0,1,1,NA
49945,mi,-88.29733,47.17841,3757,0,1,1,NA
49947,mi,-89.5972,46.38705,2484,1,2,1,100
49950,mi,-88.11891,47.38261,2629,0,1,1,NA
49952,mi,-88.78871,46.69701,616,2,3,1,50
49955,mi,-88.7078,47.00441,293,1,2,1,100
49958,mi,-88.66929,46.82734,1270,2,3,1,50
49959,mi,-89.99835,46.47065,258,1,1,0,0
49961,mi,-88.72198,46.5226,420,1,3,2,200
49963,mi,-88.66481,47.05328,693,1,2,1,100
49965,mi,-88.85509,46.95047,1477,1,2,1,100
49967,mi,-88.93683,46.49554,824,2,3,1,50
49968,mi,-89.893,46.49225,3536,1,1,0,0
49969,mi,-89.22103,46.24632,2244,1,3,2,200
50001,ia,-93.43262,41.36151,973,14,26,12,85.7
50002,ia,-94.64689,41.51429,2735,12,23,11,91.7
50003,ia,-94.04272,41.61059,5924,13,24,11,84.6
50005,ia,-93.02627,42.12927,866,11,22,11,100
50006,ia,-93.39914,42.51426,3272,9,18,9,100
50007,ia,-93.60161,41.80596,350,11,23,12,109.1
50008,ia,-93.38471,40.6807,2054,12,23,11,91.7
50009,ia,-93.4579,41.64444,8214,12,24,12,100
50010,ia,-93.58829,42.03361,10419,11,22,11,100
50011,ia,-93.63645,42.02403,1,11,22,11,100
50012,ia,-93.64525,42.02719,21,11,22,11,100
50014,ia,-93.69447,42.04858,7150,11,22,11,100
50020,ia,-94.74809,41.43235,2441,12,23,11,91.7
50021,ia,-93.56817,41.72117,11119,12,23,11,91.7
50022,ia,-95.00172,41.41599,6898,13,24,11,84.6
50023,ia,-93.631,41.73148,16620,12,24,12,100
50025,ia,-94.92355,41.75797,5356,12,23,11,91.7
50026,ia,-94.4496,41.85853,1313,12,23,11,91.7
50027,ia,-92.47317,41.475,750,14,26,12,85.7
50028,ia,-93.14751,41.81523,1622,13,24,11,84.6
50029,ia,-94.55057,41.82585,1181,12,23,11,91.7
50032,ia,-93.54239,41.66652,281,12,24,12,100
50033,ia,-93.79286,41.36303,32,14,26,12,85.7
50034,ia,-93.64746,42.52378,1410,8,17,9,112.5
50035,ia,-93.45742,41.7253,4479,12,23,11,91.7
50036,ia,-93.85661,42.08722,12113,11,22,11,100
50038,ia,-93.90271,41.52346,145,13,24,11,84.6
50039,ia,-94.00522,41.81981,621,12,23,11,91.7
50041,ia,-93.24811,42.63848,102,8,18,10,125
50042,ia,-94.90151,41.53345,817,12,23,11,91.7
50044,ia,-92.88237,41.203,1301,15,27,12,80
50046,ia,-93.52358,41.89392,1546,11,22,11,100
50047,ia,-93.47381,41.4683,4035,14,26,12,85.7
50048,ia,-94.52015,41.51328,2085,12,23,11,91.7
50049,ia,-93.30097,41.03565,6960,14,26,12,85.7
50050,ia,-94.50664,42.16155,1778,11,22,11,100
50051,ia,-93.14127,42.13451,595,11,21,10,90.9
50052,ia,-93.44219,40.64205,473,12,23,11,91.7
50054,ia,-93.23501,41.68833,2737,14,26,12,85.7
50055,ia,-93.29041,41.88526,1324,11,21,10,90.9
50056,ia,-93.2974,42.01691,1594,9,18,9,100
50057,ia,-93.14675,41.17832,471,15,27,12,80
50058,ia,-94.6903,41.85606,3812,12,22,10,83.3
50060,ia,-93.31815,40.75342,4624,13,24,11,84.6
50061,ia,-93.78804,41.48514,1779,13,24,11,84.6
50062,ia,-93.2439,41.23454,911,15,27,12,80
50063,ia,-93.93613,41.6993,2403,12,23,11,91.7
50064,ia,-94.23663,42.10773,357,12,23,11,91.7
50065,ia,-93.78633,40.60806,1559,14,27,13,92.9
50066,ia,-94.22582,41.80488,629,12,23,11,91.7
50067,ia,-93.85995,40.71567,884,14,26,12,85.7
50068,ia,-93.46984,40.94511,1007,13,25,12,92.3
50069,ia,-94.03027,41.52071,514,13,24,11,84.6
50070,ia,-94.2382,41.45566,2747,12,23,11,91.7
50071,ia,-93.503,42.64941,2820,8,17,9,112.5
50072,ia,-94.12249,41.46964,2751,12,24,12,100
50073,ia,-93.52467,41.7939,1124,11,23,12,109.1
50074,ia,-94.07585,40.85682,2315,11,22,11,100
50075,ia,-93.5598,42.33528,1323,9,19,10,111.1
50076,ia,-94.85853,41.59356,2837,12,23,11,91.7
50078,ia,-92.86291,41.9386,87,11,21,10,90.9
50101,ia,-93.63446,42.66748,253,8,16,8,100
50102,ia,-93.40019,42.24554,85,9,18,9,100
50103,ia,-93.60823,40.7959,1556,13,24,11,84.6
50104,ia,-92.38666,41.4868,292,14,26,12,85.7
50105,ia,-93.63728,42.11029,678,11,22,11,100
50106,ia,-92.81346,41.88171,1568,10,21,11,110
50107,ia,-94.22474,42.03836,1633,13,24,11,84.6
50108,ia,-93.95516,40.83227,1706,13,24,11,84.6
50109,ia,-93.80394,41.76604,2040,13,24,11,84.6
50111,ia,-93.80429,41.6918,7118,12,23,11,91.7
50112,ia,-92.71479,41.73134,7319,10,20,10,100
50115,ia,-94.55867,41.68715,4511,12,22,10,83.3
50116,ia,-92.97599,41.17968,567,15,27,12,80
50117,ia,-94.85987,41.66822,616,12,23,11,91.7
50118,ia,-93.37297,41.4637,813,14,26,12,85.7
50119,ia,-92.94749,41.31665,639,15,28,13,86.7
50120,ia,-92.98285,41.93375,418,11,21,10,90.9
50122,ia,-93.31257,42.30332,2321,9,19,10,111.1
50123,ia,-93.50482,40.83778,1900,12,23,11,91.7
50124,ia,-93.60407,41.8856,1976,11,21,10,90.9
50125,ia,-93.57966,41.33364,11792,14,26,12,85.7
50126,ia,-93.24705,42.50703,6019,9,19,10,111.1
50127,ia,-93.20581,41.77714,18,13,25,12,92.3
50128,ia,-94.29899,41.85088,741,12,23,11,91.7
50129,ia,-94.37681,42.01446,5880,13,24,11,84.6
50130,ia,-93.67217,42.3025,2178,10,20,10,100
50131,ia,-93.71696,41.69339,8485,13,24,11,84.6
50132,ia,-93.69152,42.39167,801,10,19,9,90
50133,ia,-94.06858,40.71536,1699,13,24,11,84.6
50134,ia,-93.67161,41.93947,647,11,21,10,90.9
50135,ia,-92.88742,41.74404,2194,11,22,11,100
50136,ia,-92.29085,41.47086,959,14,26,12,85.7
50138,ia,-93.10423,41.30073,8845,15,28,13,86.7
50139,ia,-93.3676,41.1932,2328,15,27,12,80
50140,ia,-93.9821,40.64214,2939,14,26,12,85.7
50141,ia,-92.95534,41.86871,858,11,22,11,100
50142,ia,-92.77561,42.00667,391,11,21,10,90.9
50143,ia,-92.79911,41.34323,1035,14,26,12,85.7
50144,ia,-93.741,40.73879,4364,13,25,12,92.3
50146,ia,-94.24304,41.68413,737,12,23,11,91.7
50147,ia,-93.54917,40.62714,1833,13,25,12,92.3
50148,ia,-92.99282,42.18131,584,11,21,10,90.9
50149,ia,-94.08066,41.15115,2023,13,24,11,84.6
50150,ia,-92.96933,41.12766,1781,15,27,12,80
50151,ia,-93.49839,41.0838,1863,14,26,12,85.7
50153,ia,-92.80202,41.57548,1041,12,24,12,100
50154,ia,-93.39278,42.17227,642,9,19,10,111.1
50155,ia,-94.20032,41.20804,701,13,24,11,84.6
50156,ia,-93.79847,41.903,4064,12,23,11,91.7
50157,ia,-92.56146,41.74492,1434,13,24,11,84.6
50158,ia,-92.90061,42.0503,15786,11,22,11,100
50160,ia,-93.73865,41.37378,259,14,26,12,85.7
50161,ia,-93.40231,41.84822,2230,11,22,11,100
50162,ia,-93.06919,41.92488,1374,11,22,11,100
50163,ia,-93.24099,41.22242,510,15,27,12,80
50164,ia,-94.41877,41.50131,1387,12,23,11,91.7
50165,ia,-93.28363,40.84366,132,13,25,12,92.3
50166,ia,-93.42663,41.2808,1922,14,26,12,85.7
50167,ia,-94.04802,41.74419,1091,12,23,11,91.7
50168,ia,-93.27444,41.78068,1213,13,25,12,92.3
50169,ia,-93.35257,41.65845,1885,13,24,11,84.6
50170,ia,-93.12125,41.5259,2914,14,26,12,85.7
50171,ia,-92.52498,41.58604,4296,13,25,12,92.3
50173,ia,-92.71418,41.973,943,11,22,11,100
50174,ia,-93.96154,41.0377,2611,12,24,12,100
50201,ia,-93.44454,42.03505,5295,10,19,9,90
50206,ia,-93.18959,42.25172,1206,10,20,10,100
50207,ia,-92.63752,41.4347,3975,13,25,12,92.3
50208,ia,-93.0383,41.71024,11329,14,25,11,78.6
50210,ia,-93.69763,41.18833,2210,14,26,12,85.7
50211,ia,-93.69177,41.45582,7028,13,25,12,92.3
50212,ia,-94.06756,42.03659,4017,12,22,10,83.3
50213,ia,-93.76615,41.03205,6936,14,25,11,78.6
50214,ia,-93.05127,41.46196,1181,15,27,12,80
50216,ia,-94.34838,41.69626,4314,12,23,11,91.7
50217,ia,-94.2494,42.17386,1522,11,21,10,90.9
50218,ia,-93.8804,41.34835,90,14,25,11,78.6
50219,ia,-92.89834,41.42364,8215,14,26,12,85.7
50220,ia,-94.12297,41.83608,5674,12,23,11,91.7
50222,ia,-93.9472,41.22119,1080,13,24,11,84.6
50223,ia,-94.03002,42.16891,995,11,21,10,90.9
50225,ia,-93.26902,41.3846,2950,15,27,12,80
50226,ia,-93.70235,41.7927,4125,12,23,11,91.7
50227,ia,-93.42785,42.59745,79,9,18,9,100
50228,ia,-93.24225,41.57868,2313,14,26,12,85.7
50229,ia,-93.7768,41.37648,1276,14,26,12,85.7
50230,ia,-93.44749,42.30376,2189,9,18,9,100
50231,ia,-93.60258,42.23703,137,10,20,10,100
50232,ia,-92.96697,41.55649,911,14,26,12,85.7
50233,ia,-94.21136,41.6129,1683,12,23,11,91.7
50234,ia,-93.18449,41.89144,977,12,22,10,83.3
50235,ia,-94.21031,41.92962,1054,12,23,11,91.7
50236,ia,-93.48324,42.16802,1277,10,20,10,100
50237,ia,-93.37016,41.54004,2816,14,26,12,85.7
50238,ia,-93.17103,40.96943,2733,14,25,11,78.6
50239,ia,-93.19937,42.14872,427,10,20,10,100
50240,ia,-93.79479,41.29504,2702,13,25,12,92.3
50242,ia,-92.69397,41.56251,954,13,24,11,84.6
50243,ia,-93.69415,41.86596,170,11,22,11,100
50244,ia,-93.65231,41.85729,1179,11,22,11,100
50246,ia,-93.78214,42.27536,1280,10,20,10,100
50247,ia,-93.16506,42.017,2506,10,20,10,100
50248,ia,-93.61094,42.19267,3363,11,21,10,90.9
50249,ia,-93.90138,42.27289,2213,10,20,10,100
50250,ia,-94.33903,41.48281,3339,12,23,11,91.7
50251,ia,-92.87124,41.56875,1407,12,24,12,100
50252,ia,-93.30104,41.46358,249,14,26,12,85.7
50254,ia,-94.07012,40.98705,1100,12,24,12,100
50255,ia,-92.33218,41.45603,76,14,26,12,85.7
50256,ia,-92.9123,41.26854,826,15,27,12,80
50257,ia,-93.84721,41.18952,1140,13,25,12,92.3
50258,ia,-93.0769,42.22712,1777,11,21,10,90.9
50261,ia,-93.92069,41.4699,2451,13,24,11,84.6
50262,ia,-93.81567,40.85525,923,13,24,11,84.6
50263,ia,-93.87241,41.59565,10972,12,23,11,91.7
50264,ia,-93.7026,40.90135,1511,13,24,11,84.6
50265,ia,-93.73735,41.55553,11577,13,24,11,84.6
50266,ia,-93.79939,41.56938,8381,12,24,12,100
50268,ia,-92.3634,41.40701,1593,14,27,13,92.9
50271,ia,-93.54146,42.48278,1605,9,18,9,100
50272,ia,-93.25595,41.09564,161,14,26,12,85.7
50273,ia,-94.05413,41.32936,7415,13,24,11,84.6
50274,ia,-94.85351,41.3814,1046,12,23,11,91.7
50275,ia,-93.58963,41.03766,1185,14,25,11,78.6
50276,ia,-93.92344,41.8624,2539,12,23,11,91.7
50277,ia,-94.34908,41.77733,999,12,22,10,83.3
50278,ia,-93.29754,42.15019,1376,9,18,9,100
50309,ia,-93.62069,41.58485,2383,13,24,11,84.6
50310,ia,-93.67322,41.6278,12376,13,24,11,84.6
50311,ia,-93.67289,41.60104,4704,13,24,11,84.6
50312,ia,-93.67599,41.58092,6005,13,24,11,84.6
50313,ia,-93.62156,41.65463,9100,13,24,11,84.6
50314,ia,-93.63127,41.60533,4188,13,24,11,84.6
50315,ia,-93.62106,41.54562,14563,12,24,12,100
50316,ia,-93.59763,41.60866,6499,13,25,12,92.3
50317,ia,-93.54714,41.61632,17471,13,25,12,92.3
50319,ia,-93.60429,41.59091,19,13,24,11,84.6
50320,ia,-93.57064,41.52876,6564,13,25,12,92.3
50321,ia,-93.67288,41.53944,2789,12,23,11,91.7
50322,ia,-93.73617,41.63368,11922,12,24,12,100
50323,ia,-93.81379,41.63469,5599,12,24,12,100
50324,ia,-93.71283,41.60446,2270,13,24,11,84.6
50325,ia,-93.79826,41.61467,6879,12,24,12,100
50327,ia,-93.48478,41.58155,5180,13,25,12,92.3
50401,ia,-93.20017,43.15363,16797,8,16,8,100
50420,ia,-93.46039,42.80421,1081,7,15,8,114.3
50421,ia,-93.62004,42.84308,3445,7,16,9,128.6
50423,ia,-93.81264,43.10932,3998,7,16,9,128.6
50424,ia,-93.93384,43.39448,3093,7,15,8,114.3
50426,ia,-93.01713,43.41548,40,6,14,8,133.3
50428,ia,-93.38988,43.13773,7606,7,15,8,114.3
50430,ia,-93.95397,42.98157,1413,8,17,9,112.5
50431,ia,-93.36822,42.73711,204,7,16,9,128.6
50432,ia,-93.79802,43.22396,225,7,16,9,128.6
50433,ia,-93.05021,42.92326,944,9,18,9,100
50434,ia,-93.45351,43.25907,483,7,15,8,114.3
50435,ia,-92.76702,43.15803,700,9,18,9,100
50436,ia,-93.66339,43.26288,5008,7,15,8,114.3
50438,ia,-93.61742,43.10938,4276,7,15,8,114.3
50439,ia,-93.63521,42.94568,739,7,16,9,128.6
50440,ia,-93.07262,43.33158,845,6,14,8,133.3
50441,ia,-93.22108,42.74141,5971,9,18,9,100
50444,ia,-93.38693,43.29323,653,7,15,8,114.3
50446,ia,-93.45256,43.34257,1062,7,15,8,114.3
50447,ia,-93.80102,42.92664,2275,8,16,8,100
50448,ia,-93.2482,43.35001,1498,6,14,8,133.3
50449,ia,-93.55877,42.99906,1059,7,15,8,114.3
50450,ia,-93.52388,43.42176,3043,7,15,8,114.3
50451,ia,-94.08841,43.3786,1455,7,15,8,114.3
50452,ia,-93.37264,42.7854,1419,7,16,9,128.6
50453,ia,-93.65238,43.36605,1078,7,15,8,114.3
50454,ia,-92.73727,43.38189,238,7,14,7,100
50455,ia,-92.64985,43.45696,596,6,12,6,100
50456,ia,-93.21754,43.28806,1747,7,15,8,114.3
50457,ia,-93.49361,42.91635,913,7,15,8,114.3
50458,ia,-93.00755,43.16088,1901,8,17,9,112.5
50459,ia,-93.25416,43.44542,4324,6,14,8,133.3
50460,ia,-92.68883,43.22783,516,8,17,9,112.5
50461,ia,-92.81896,43.2994,4945,7,16,9,128.6
50464,ia,-93.08079,43.2534,801,7,16,9,128.6
50465,ia,-93.91223,43.48655,274,7,15,8,114.3
50466,ia,-92.54184,43.38532,2882,6,13,7,116.7
50467,ia,-93.08661,43.21171,83,8,16,8,100
50468,ia,-92.95479,43.0467,1770,9,18,9,100
50469,ia,-93.19417,42.9987,2359,8,17,9,112.5
50470,ia,-93.5604,42.74578,715,8,16,8,100
50471,ia,-92.8764,43.16658,695,8,17,9,112.5
50472,ia,-92.94688,43.42213,3357,6,14,8,133.3
50473,ia,-93.67885,43.46622,762,7,15,8,114.3
50475,ia,-93.2185,42.87942,2671,9,18,9,100
50476,ia,-92.76417,43.45246,908,6,14,8,133.3
50477,ia,-93.32709,42.98926,614,8,16,8,100
50478,ia,-93.78475,43.40166,1734,7,15,8,114.3
50479,ia,-93.40988,42.93947,1415,7,16,9,128.6
50480,ia,-94.05026,43.25039,1585,7,15,8,114.3
50482,ia,-93.47865,43.11568,1093,7,15,8,114.3
50483,ia,-94.00091,43.11258,1745,7,16,9,128.6
50484,ia,-93.91357,43.23407,992,7,15,8,114.3
50501,ia,-94.19256,42.49283,16350,9,18,9,100
50510,ia,-94.98478,42.76089,2124,8,16,8,100
50511,ia,-94.22015,43.07391,6045,7,16,9,128.6
50514,ia,-94.47191,43.41601,2907,6,14,8,133.3
50515,ia,-94.87099,43.02092,945,7,16,9,128.6
50516,ia,-94.1365,42.62335,844,8,17,9,112.5
50517,ia,-94.22974,43.30281,1954,7,15,8,114.3
50518,ia,-94.38602,42.51492,825,8,18,10,125
50519,ia,-94.26287,42.90173,1592,8,17,9,112.5
50520,ia,-94.39545,42.8052,691,8,17,9,112.5
50521,ia,-94.10282,42.34622,107,10,19,9,90
50522,ia,-94.18829,43.18773,1618,7,16,9,128.6
50523,ia,-94.29574,42.36799,1163,9,19,10,111.1
50524,ia,-94.35585,42.60256,1429,8,17,9,112.5
50525,ia,-93.74724,42.73649,4654,8,17,9,112.5
50527,ia,-94.78541,42.965,1147,8,16,8,100
50528,ia,-94.54082,43.13392,1630,7,16,9,128.6
50529,ia,-94.1993,42.72139,817,8,16,8,100
50530,ia,-94.04241,42.268,1967,10,20,10,100
50531,ia,-94.61122,43.45789,933,6,14,8,133.3
50532,ia,-94.00534,42.46165,1832,9,19,10,111.1
50533,ia,-93.91181,42.65194,4189,9,18,9,100
50535,ia,-95.16232,42.4525,1892,8,16,8,100
50536,ia,-94.70155,43.11741,4978,8,17,9,112.5
50538,ia,-94.42963,42.27657,914,10,20,10,100
50539,ia,-94.41997,43.23699,1301,7,15,8,114.3
50540,ia,-94.84215,42.59656,2965,8,18,10,125
50541,ia,-94.44913,42.71549,2958,8,17,9,112.5
50542,ia,-93.9449,42.77764,1979,8,17,9,112.5
50543,ia,-94.30464,42.2747,2407,10,20,10,100
50544,ia,-94.17055,42.25073,880,10,20,10,100
50545,ia,-94.08118,42.7995,931,8,17,9,112.5
50546,ia,-94.70278,42.83787,1471,8,17,9,112.5
50548,ia,-94.22542,42.71507,6244,8,16,8,100
50551,ia,-94.75112,42.47957,689,9,18,9,100
50554,ia,-94.84292,42.84554,3329,8,16,8,100
50556,ia,-94.19597,43.45242,889,7,15,8,114.3
50557,ia,-94.04048,42.35618,1590,10,20,10,100
50558,ia,-94.16519,42.86111,1803,8,17,9,112.5
50559,ia,-94.32925,43.20884,897,7,16,9,128.6
50560,ia,-94.10804,42.9606,2092,8,17,9,112.5
50561,ia,-94.84989,42.42412,1219,9,18,9,100
50562,ia,-94.64178,42.96155,1498,8,17,9,112.5
50563,ia,-94.52737,42.52772,3686,9,18,9,100
50565,ia,-94.99574,42.85771,1203,7,16,9,128.6
50566,ia,-94.32966,42.43881,1002,9,18,9,100
50567,ia,-95.09626,42.52308,685,8,16,8,100
50568,ia,-94.99351,42.62218,2387,8,17,9,112.5
50569,ia,-94.13878,42.40305,873,9,19,10,111.1
50570,ia,-94.36847,42.89455,1033,8,17,9,112.5
50571,ia,-94.57869,42.63097,1316,8,18,10,125
50573,ia,-94.62395,42.8767,284,8,17,9,112.5
50574,ia,-94.69862,42.71666,4120,8,18,10,125
50575,ia,-94.70051,42.56037,1965,9,18,9,100
50576,ia,-95.17526,42.80328,836,7,15,8,114.3
50577,ia,-93.97709,42.85882,1218,8,17,9,112.5
50578,ia,-94.54586,43.29969,1855,7,15,8,114.3
50579,ia,-94.63852,42.39404,4180,9,19,10,111.1
50581,ia,-94.54303,42.84799,2894,8,17,9,112.5
50582,ia,-94.30159,42.79502,683,8,17,9,112.5
50583,ia,-94.98654,42.43267,4305,9,17,8,88.9
50585,ia,-95.13808,42.91315,1989,7,15,8,114.3
50586,ia,-94.4317,42.40408,911,9,19,10,111.1
50588,ia,-95.16437,42.65777,7042,6,13,7,116.7
50590,ia,-94.30543,43.40747,1997,7,15,8,114.3
50591,ia,-94.05567,42.67605,815,8,17,9,112.5
50593,ia,-94.89874,42.6576,188,8,17,9,112.5
50594,ia,-94.04013,42.58521,660,9,18,9,100
50595,ia,-93.82263,42.46183,7429,10,19,9,90
50597,ia,-94.45097,42.97603,2432,8,17,9,112.5
50598,ia,-94.41704,43.08187,1756,7,16,9,128.6
50599,ia,-93.81382,42.57894,1185,9,18,9,100
50601,ia,-93.05643,42.56684,3677,9,19,10,111.1
50602,ia,-92.80315,42.74109,1588,10,21,11,110
50603,ia,-92.4595,43.18773,707,7,15,8,114.3
50604,ia,-92.90395,42.6034,1576,10,20,10,100
50605,ia,-93.02098,42.83176,346,10,20,10,100
50606,ia,-91.68386,42.7473,1082,7,14,7,100
50607,ia,-91.74983,42.61059,965,7,15,8,114.3
50609,ia,-92.80989,42.22991,579,10,19,9,90
50611,ia,-92.90897,42.8155,512,10,20,10,100
50612,ia,-92.38604,42.28344,547,10,21,11,110
50613,ia,-92.48893,42.53313,17612,9,19,10,111.1
50616,ia,-92.66094,43.08123,6008,10,19,9,90
50619,ia,-92.65563,42.80177,2029,10,20,10,100
50620,ia,-92.591,43.15817,46,8,17,9,112.5
50621,ia,-92.92103,42.25112,1299,10,19,9,90
50622,ia,-92.33516,42.67303,2070,9,18,9,100
50624,ia,-92.65871,42.46783,1138,9,19,10,111.1
50625,ia,-92.98613,42.7482,1269,10,21,11,110
50626,ia,-92.17092,42.57816,1815,9,18,9,100
50627,ia,-93.09575,42.35057,3822,10,20,10,100
50628,ia,-92.39068,43.26721,2543,6,14,8,133.3
50629,ia,-92.08069,42.64239,2532,8,17,9,112.5
50630,ia,-92.21271,42.95623,1506,8,17,9,112.5
50632,ia,-92.70331,42.07527,1483,11,21,10,90.9
50633,ia,-93.1286,42.67127,1052,9,18,9,100
50634,ia,-92.21456,42.41893,480,10,20,10,100
50635,ia,-92.69932,42.20207,2383,10,20,10,100
50636,ia,-92.80923,42.89517,2187,10,20,10,100
50638,ia,-92.79394,42.35674,2439,9,18,9,100
50641,ia,-91.91991,42.59932,1641,8,16,8,100
50642,ia,-92.81273,42.43981,594,9,18,9,100
50643,ia,-92.46868,42.36195,2438,9,19,10,111.1
50644,ia,-91.89355,42.47639,6989,10,19,9,90
50645,ia,-92.45139,43.02009,1167,9,18,9,100
50647,ia,-92.48338,42.64887,1720,9,19,10,111.1
50648,ia,-92.09252,42.45222,3393,9,19,10,111.1
50650,ia,-91.65463,42.61903,1022,7,14,7,100
50651,ia,-92.19693,42.3172,3674,11,21,10,90.9
50652,ia,-92.69431,42.26429,116,9,19,10,111.1
50653,ia,-92.89216,42.96593,764,10,19,9,90
50654,ia,-91.60912,42.45206,879,7,16,9,128.6
50655,ia,-91.90032,42.77292,626,7,14,7,100
50658,ia,-92.53564,42.95699,1991,9,19,10,111.1
50659,ia,-92.32257,43.08812,3712,8,17,9,112.5
50660,ia,-92.63269,42.58306,1099,9,19,10,111.1
50662,ia,-91.93487,42.69039,4285,7,15,8,114.3
50664,ia,-92.07619,42.70125,40,8,16,8,100
50665,ia,-92.77189,42.5804,2460,9,19,10,111.1
50666,ia,-92.50691,42.86443,1453,9,19,10,111.1
50667,ia,-92.22644,42.4702,430,9,19,10,111.1
50668,ia,-92.22648,42.69072,1193,8,17,9,112.5
50669,ia,-92.60772,42.33212,2273,10,19,9,90
50670,ia,-92.61612,42.68689,1702,9,19,10,111.1
50671,ia,-91.80089,42.65235,381,7,14,7,100
50672,ia,-93.06315,42.42519,1169,10,20,10,100
50673,ia,-92.71126,42.52495,101,9,19,10,111.1
50674,ia,-92.11883,42.84095,4014,8,16,8,100
50675,ia,-92.49168,42.20104,3228,10,21,11,110
50676,ia,-92.27961,42.79627,2202,8,17,9,112.5
50677,ia,-92.4327,42.76265,7459,9,18,9,100
50680,ia,-92.92302,42.4521,1077,9,18,9,100
50681,ia,-92.00937,42.77762,409,7,15,8,114.3
50682,ia,-91.69677,42.45332,2310,8,16,8,100
50701,ia,-92.34135,42.41584,13657,9,19,10,111.1
50702,ia,-92.31243,42.45746,8352,9,19,10,111.1
50703,ia,-92.28045,42.54848,12042,9,19,10,111.1
50707,ia,-92.27905,42.47938,4497,10,19,9,90
50801,ia,-94.39125,41.07975,8753,13,24,11,84.6
50830,ia,-94.19088,41.02717,3093,12,24,12,100
50833,ia,-94.70074,40.67043,6262,15,27,12,80
50835,ia,-94.36887,40.70816,415,14,26,12,85.7
50836,ia,-94.49635,40.62781,2575,16,29,13,81.3
50837,ia,-94.6811,41.22896,1192,13,25,12,92.3
50839,ia,-94.82397,41.04974,113,13,24,11,84.6
50840,ia,-94.48521,40.79132,1531,13,25,12,92.3
50841,ia,-94.76342,41.00972,5945,13,24,11,84.6
50842,ia,-94.4618,41.03991,93,13,24,11,84.6
50843,ia,-94.88903,41.23975,1621,12,24,12,100
50845,ia,-94.35234,40.81875,2379,13,25,12,92.3
50846,ia,-94.56979,41.30952,2507,13,25,12,92.3
50847,ia,-94.98172,41.14109,148,15,27,12,80
50848,ia,-94.76523,40.78371,1402,14,26,12,85.7
50849,ia,-94.39945,41.30327,3754,13,25,12,92.3
50851,ia,-94.5376,40.90323,3708,13,24,11,84.6
50853,ia,-94.77069,41.23978,1679,12,23,11,91.7
50854,ia,-94.2153,40.6911,3661,13,24,11,84.6
50857,ia,-94.87878,40.94357,1132,14,26,12,85.7
50858,ia,-94.41292,41.21056,1884,13,24,11,84.6
50859,ia,-94.60107,41.06717,1722,13,24,11,84.6
50860,ia,-94.34053,40.6238,967,15,28,13,86.7
50861,ia,-94.25646,40.9116,948,12,23,11,91.7
50862,ia,-94.65332,40.81278,621,14,25,11,78.6
50863,ia,-94.16796,40.84244,742,12,22,10,83.3
50864,ia,-94.98214,40.97372,4076,15,28,13,86.7
51001,ia,-96.52251,42.83308,3419,10,20,10,90.45
51002,ia,-95.31991,42.6979,3172,6,14,8,133.3
51003,ia,-95.98663,42.98512,2255,9,17,8,88.9
51004,ia,-95.91479,42.37611,2013,10,20,10,100
51005,ia,-95.42489,42.72152,2399,7,15,8,114.3
51006,ia,-95.61559,42.31588,1960,9,19,10,111.1
51007,ia,-96.18707,42.40395,895,11,22,11,100
51008,ia,-96.2667,42.81093,118,11,22,11,100
51009,ia,-95.55147,42.94441,144,8,16,8,100
51010,ia,-95.90928,42.08962,1801,12,22,10,83.3
51011,ia,-96.5145,42.9163,79,10,19,9,90
51012,ia,-95.56188,42.74448,6135,8,17,9,112.5
51014,ia,-95.71068,42.78535,1223,8,17,9,112.5
51016,ia,-95.80618,42.47069,2580,9,19,10,111.1
51018,ia,-95.68228,42.44719,859,9,18,9,100
51019,ia,-95.72792,42.27019,1979,10,20,10,100
51020,ia,-95.41164,42.51063,1362,8,17,9,112.5
51022,ia,-95.84999,42.977,1854,8,16,8,100
51023,ia,-96.4539,43.01341,3634,10,19,9,90
51024,ia,-96.26665,42.61838,2648,10,20,10,100
51025,ia,-95.55757,42.49747,2933,8,17,9,112.5
51026,ia,-96.07446,42.2506,2506,13,25,12,92.3
51027,ia,-96.32778,42.96556,2407,9,17,8,88.9
51028,ia,-95.98656,42.60005,3405,9,19,10,111.1
51029,ia,-95.53785,42.88055,553,8,16,8,100
51030,ia,-96.19253,42.49797,1696,11,21,10,90.9
51031,ia,-96.17914,42.80162,9853,11,20,9,81.8
51033,ia,-95.2503,42.9171,1513,7,15,8,114.3
51034,ia,-95.78911,42.15944,3347,11,21,10,90.9
51035,ia,-95.79937,42.77894,2843,8,17,9,112.5
51036,ia,-96.19002,42.96896,1281,9,18,9,100
51037,ia,-95.64313,42.82667,620,8,17,9,112.5
51038,ia,-96.31436,42.70553,2493,10,20,10,100
51039,ia,-96.05388,42.45693,2500,10,20,10,100
51040,ia,-96.0804,42.03646,5435,15,27,12,80
51041,ia,-96.07793,43.02613,3892,9,17,8,88.9
51044,ia,-95.92024,42.29928,841,11,21,10,90.9
51046,ia,-95.67831,42.96437,2581,8,17,9,112.5
51047,ia,-95.36125,42.93565,1779,8,15,7,87.5
51048,ia,-95.86177,42.5751,897,9,18,9,100
51049,ia,-95.64804,42.62946,1098,8,17,9,112.5
51050,ia,-95.94593,42.79368,3937,9,18,9,100
51051,ia,-95.97016,42.20448,184,13,23,10,76.9
51052,ia,-96.26502,42.31467,1588,13,24,11,84.6
51053,ia,-95.28547,42.4938,2256,7,15,8,114.3
51054,ia,-96.33023,42.37975,2677,12,23,11,91.7
51055,ia,-96.25673,42.2158,1950,15,26,11,73.3
51056,ia,-95.95346,42.23548,953,11,21,10,90.9
51058,ia,-95.47088,42.98157,2163,8,16,8,100
51060,ia,-95.69795,42.0416,1615,11,21,10,90.9
51061,ia,-95.71807,42.57854,1103,9,18,9,100
51062,ia,-96.5362,42.70694,1314,11,21,10,90.9
51063,ia,-96.17469,42.14717,1784,16,27,11,68.8
51101,ia,-96.39353,42.49409,702,11,21,10,90.9
51103,ia,-96.44288,42.51806,7021,11,22,11,100
51104,ia,-96.40416,42.53545,7423,11,21,10,90.9
51105,ia,-96.36645,42.50871,3403,11,21,10,90.9
51106,ia,-96.3208,42.46618,11057,11,21,10,90.9
51108,ia,-96.35244,42.56692,2933,11,21,10,90.9
51109,ia,-96.47838,42.59464,1809,11,22,11,100
51111,ia,-96.38648,42.41,224,11,22,11,100
51201,ia,-95.86578,43.18334,5275,9,17,8,88.9
51230,ia,-96.32364,43.36034,474,8,16,8,100
51231,ia,-95.7422,43.10314,684,9,17,8,88.9
51232,ia,-95.81759,43.30166,1481,8,16,8,100
51234,ia,-96.02002,43.19399,1645,8,17,9,112.5
51235,ia,-96.21837,43.29453,1124,9,17,8,88.9
51237,ia,-96.00068,43.33667,1807,8,16,8,100
51238,ia,-95.8946,43.0767,1629,9,17,8,88.9
51239,ia,-96.14584,43.20123,2822,8,17,9,112.5
51240,ia,-96.45729,43.30967,1976,8,17,9,112.5
51241,ia,-96.45989,43.44964,1660,7,15,8,114.3
51242,ia,-96.33485,43.44112,148,8,16,8,100
51243,ia,-95.904,43.44249,994,6,13,7,116.7
51244,ia,-95.93549,43.24477,66,9,17,8,88.9
51245,ia,-95.59996,43.07472,2281,9,17,8,88.9
51246,ia,-96.16714,43.42825,3296,9,17,8,88.9
51247,ia,-96.33958,43.19141,4561,9,18,9,100
51248,ia,-95.65788,43.20555,2480,8,16,8,100
51249,ia,-95.73204,43.41257,4542,6,12,6,100
51250,ia,-96.2125,43.08428,4420,9,18,9,100
51301,ia,-95.14724,43.15293,8665,7,16,9,128.6
51331,ia,-95.12809,43.3638,1806,6,13,7,116.7
51333,ia,-94.99965,43.12799,1372,7,15,8,114.3
51334,ia,-94.80516,43.40372,7586,6,13,7,116.7
51338,ia,-95.32193,43.20599,1831,7,15,8,114.3
51341,ia,-95.03875,43.01428,71,7,16,9,128.6
51342,ia,-94.73787,43.24396,2218,7,15,8,114.3
51343,ia,-95.10569,43.01583,583,7,15,8,114.3
51345,ia,-95.42918,43.41263,1233,6,13,7,116.7
51346,ia,-95.46081,43.18233,4022,7,15,8,114.3
51347,ia,-95.31421,43.4233,2838,6,13,7,116.7
51350,ia,-95.60083,43.31097,1088,7,14,7,100
51351,ia,-95.18695,43.31659,5976,6,13,7,116.7
51354,ia,-95.53986,43.41213,2460,6,13,7,116.7
51355,ia,-95.13674,43.38872,1376,6,13,7,116.7
51357,ia,-95.28063,43.06078,1152,7,15,8,114.3
51358,ia,-94.89974,43.13126,2354,7,15,8,114.3
51360,ia,-95.08748,43.44256,10078,6,13,7,116.7
51363,ia,-94.94727,43.43309,198,6,13,7,116.7
51364,ia,-94.96545,43.29957,1664,6,14,8,133.3
51365,ia,-94.73681,43.30796,857,6,14,8,133.3
51366,ia,-95.00772,42.95918,1304,7,15,8,114.3
51401,ia,-94.86958,42.06617,9080,10,20,10,100
51430,ia,-95.02557,42.08604,1200,9,19,10,111.1
51431,ia,-95.35169,42.34486,917,8,17,9,112.5
51433,ia,-94.87114,42.27619,1640,10,20,10,100
51436,ia,-95.01677,42.1852,1708,9,19,10,111.1
51439,ia,-95.58491,42.08472,2375,10,19,9,90
51440,ia,-94.81297,41.91333,770,11,22,11,100
51441,ia,-95.31678,42.12102,672,10,19,9,90
51442,ia,-95.35837,42.03036,7025,10,20,10,100
51443,ia,-94.70248,42.08043,2935,11,21,10,90.9
51444,ia,-94.97312,42.00484,164,10,19,9,90
51445,ia,-95.46454,42.32446,3902,9,18,9,100
51446,ia,-95.19185,41.77509,934,11,21,10,90.9
51447,ia,-95.19599,41.72209,758,11,21,10,90.9
51448,ia,-95.30769,42.2035,1427,9,19,10,111.1
51449,ia,-94.73448,42.26814,2842,10,20,10,100
51450,ia,-95.03106,42.31322,2779,9,19,10,111.1
51451,ia,-94.69471,42.1846,246,11,21,10,90.9
51453,ia,-94.54715,42.26944,2161,10,20,10,100
51454,ia,-95.2071,41.87382,2703,10,20,10,100
51455,ia,-95.05564,41.91149,3299,10,20,10,100
51458,ia,-95.2359,42.32056,2742,8,17,9,112.5
51459,ia,-94.63795,42.04522,98,11,22,11,100
51461,ia,-95.48098,42.16978,1558,9,18,9,100
51462,ia,-94.55635,42.01066,2565,12,23,11,91.7
51463,ia,-94.91274,41.90747,962,11,21,10,90.9
51465,ia,-95.202,42.09186,1415,9,19,10,111.1
51466,ia,-95.10381,42.25639,1689,9,18,9,100
51467,ia,-95.11509,42.07193,1576,9,18,9,100
51501,ia,-95.87891,41.22802,17499,16,29,13,81.3
51503,ia,-95.7781,41.23197,19848,14,27,13,92.9
51510,ia,-95.91693,41.28845,1934,17,30,13,76.5
51520,ia,-95.46144,41.96955,562,11,22,11,100
51521,ia,-95.34463,41.47834,3889,12,24,12,100
51523,ia,-96.06791,41.91325,1246,16,29,13,81.3
51525,ia,-95.41641,41.23381,2648,14,26,12,85.7
51526,ia,-95.8773,41.36882,2322,14,26,12,85.7
51527,ia,-95.34813,41.82571,1019,11,21,10,90.9
51528,ia,-95.50197,41.92757,1919,11,21,10,90.9
51529,ia,-95.62573,41.86034,3514,12,23,11,91.7
51530,ia,-95.43021,41.78449,1472,11,21,10,90.9
51531,ia,-95.08721,41.58868,1004,12,22,10,83.3
51532,ia,-95.11251,41.1352,1656,15,27,12,80
51533,ia,-95.3804,41.03617,2098,16,30,14,87.5
51534,ia,-95.71684,41.04283,6656,16,29,13,81.3
51535,ia,-95.13,41.22412,4059,14,26,12,85.7
51536,ia,-95.36074,41.38616,1893,12,24,12,100
51537,ia,-95.29295,41.64755,6430,12,23,11,91.7
51540,ia,-95.49899,41.02445,1366,17,31,14,82.4
51541,ia,-95.41762,41.1345,1107,15,28,13,86.7
51542,ia,-95.84137,41.43793,1754,14,26,12,85.7
51543,ia,-95.07592,41.65674,640,11,21,10,90.9
51544,ia,-95.10897,41.31058,1478,13,25,12,92.3
51545,ia,-96.02558,41.8403,2484,16,28,12,75
51546,ia,-95.77517,41.64249,3961,13,25,12,92.3
51548,ia,-95.63693,41.31794,1055,13,25,12,92.3
51549,ia,-95.4532,41.18292,1407,15,27,12,80
51550,ia,-95.87416,41.69214,223,14,26,12,85.7
51551,ia,-95.58939,40.99213,2782,18,32,14,77.8
51552,ia,-95.11351,41.49077,811,12,24,12,100
51553,ia,-95.54651,41.42089,1963,12,23,11,91.7
51554,ia,-95.68136,41.14739,204,15,28,13,86.7
51555,ia,-95.91927,41.55844,6911,14,27,13,92.9
51556,ia,-96.0312,41.64293,1199,16,28,12,75
51557,ia,-95.99266,41.73048,2017,16,28,12,80.65
51558,ia,-95.8623,41.90491,2082,12,23,11,91.7
51559,ia,-95.66368,41.46344,3696,13,25,12,92.3
51560,ia,-95.40168,41.31713,4448,13,24,11,84.6
51561,ia,-95.80869,41.00926,2538,17,31,14,82.4
51562,ia,-95.50277,41.72568,866,11,21,10,90.9
51563,ia,-95.59369,41.57496,1337,12,23,11,91.7
51564,ia,-95.91192,41.81609,1240,13,24,11,84.6
51565,ia,-95.5207,41.64472,1171,11,22,11,100
51566,ia,-95.23129,41.0163,7172,16,30,14,87.5
51570,ia,-95.45763,41.52349,2007,12,23,11,91.7
51571,ia,-95.60919,41.14533,1486,15,28,13,86.7
51572,ia,-95.78752,41.99121,1151,12,22,10,83.3
51573,ia,-95.09533,40.97949,1742,15,28,13,86.7
51575,ia,-95.60304,41.24193,2314,14,26,12,85.7
51576,ia,-95.7098,41.37727,2723,13,25,12,92.3
51577,ia,-95.20484,41.46336,2886,12,23,11,91.7
51578,ia,-95.39456,41.71936,59,10,20,10,100
51579,ia,-95.70341,41.7467,3767,13,24,11,84.6
51601,ia,-95.34981,40.72615,5094,20,34,14,70
51630,ia,-95.19134,40.60101,633,17,31,14,82.4
51631,ia,-95.00781,40.60218,882,17,31,14,82.4
51632,ia,-95.04956,40.74693,7079,16,30,14,87.5
51636,ia,-95.23256,40.66728,1304,18,32,14,77.8
51637,ia,-95.11568,40.62484,201,17,30,13,76.5
51638,ia,-95.27166,40.84261,2156,18,32,14,77.8
51639,ia,-95.47489,40.71982,1696,20,35,15,75
51640,ia,-95.65649,40.6229,3265,20,35,16,79.45
51645,ia,-95.43253,40.88191,926,19,34,15,78.9
51646,ia,-94.87582,40.74654,1907,15,27,12,80
51647,ia,-95.31972,40.60887,456,18,32,14,77.8
51648,ia,-95.80883,40.73381,1226,18,32,14,77.8
51649,ia,-95.5361,40.8526,999,20,35,15,75
51650,ia,-95.55376,40.66663,967,20,35,15,75
51652,ia,-95.62755,40.7703,2529,19,35,16,84.2
51653,ia,-95.67203,40.8842,1404,18,32,14,77.8
51654,ia,-95.76449,40.83123,1610,18,32,14,77.8
51656,ia,-95.15623,40.73459,71,16,29,13,81.3
52001,ia,-90.69394,42.54509,17061,11,21,10,90.9
52002,ia,-90.77322,42.52479,6749,9,18,9,100
52003,ia,-90.6752,42.43439,7036,9,17,8,88.9
52030,ia,-90.59193,42.15322,223,9,19,10,111.1
52031,ia,-90.48859,42.24885,5802,9,18,9,100
52032,ia,-90.84194,42.29109,2880,8,16,8,100
52033,ia,-91.00123,42.27906,3661,10,18,8,80
52035,ia,-91.19094,42.66072,1648,7,15,8,114.3
52037,ia,-90.62863,41.96714,1767,10,20,10,100
52038,ia,-91.55837,42.58566,554,7,15,8,114.3
52039,ia,-90.86098,42.53918,1240,8,16,8,100
52040,ia,-91.13599,42.50817,3705,8,15,7,87.5
52041,ia,-91.25695,42.50614,1263,8,16,8,100
52042,ia,-91.36808,42.68116,2388,7,15,8,114.3
52043,ia,-91.41922,42.84522,3891,9,18,9,100
52044,ia,-91.32349,42.76901,438,10,19,9,90
52045,ia,-90.93756,42.46086,1968,7,15,8,114.3
52046,ia,-91.01311,42.43838,1854,7,15,8,114.3
52047,ia,-91.34989,42.9655,1070,7,15,8,114.3
52048,ia,-91.25719,42.74215,1060,8,17,9,112.5
52049,ia,-91.20423,42.88544,2648,9,17,8,88.9
52050,ia,-91.33476,42.60479,655,7,14,7,100
52052,ia,-91.11951,42.74042,4556,10,18,8,80
52053,ia,-90.96506,42.61162,1604,7,15,8,114.3
52054,ia,-90.62709,42.30541,1446,7,15,8,114.3
52057,ia,-91.45471,42.4898,5900,8,16,8,100
52060,ia,-90.68144,42.10333,6832,10,20,10,100
52064,ia,-90.31242,42.08858,1224,10,19,9,90
52065,ia,-91.1062,42.58296,1347,7,14,7,100
52066,ia,-90.95184,42.67833,146,9,17,8,88.9
52068,ia,-90.81718,42.42288,2873,6,14,8,133.3
52069,ia,-90.4325,42.0584,1794,10,20,10,100
52070,ia,-90.21855,42.08164,1500,11,21,10,90.9
52072,ia,-91.37783,42.922,914,8,16,8,100
52073,ia,-90.82175,42.62513,1770,9,18,9,100
52074,ia,-90.47242,42.10943,671,10,20,10,100
52076,ia,-91.51013,42.69984,3358,7,15,8,114.3
52077,ia,-91.55697,42.8225,1057,9,17,8,88.9
52078,ia,-91.11604,42.39467,1121,9,17,8,88.9
52079,ia,-90.71622,42.28553,1406,7,15,8,114.3
52101,ia,-91.76473,43.3537,11302,6,13,7,116.7
52132,ia,-91.92321,43.20621,2243,6,13,7,116.7
52133,ia,-91.66625,43.10743,978,6,12,6,100
52134,ia,-92.41121,43.46955,762,5,12,7,140
52135,ia,-91.66824,43.0194,771,8,16,8,100
52136,ia,-92.11114,43.37407,6292,5,12,7,140
52140,ia,-91.53668,43.44341,971,6,13,7,116.7
52141,ia,-91.63088,42.93933,2043,8,16,8,100
52142,ia,-91.7916,42.82875,1398,7,14,7,100
52144,ia,-91.96241,43.13915,1980,7,14,7,100
52146,ia,-91.19787,43.18967,2019,10,19,9,90
52147,ia,-91.96288,42.95106,1070,7,15,8,114.3
52151,ia,-91.2779,43.34391,2772,8,15,7,87.5
52154,ia,-92.16538,43.12259,1118,7,15,8,114.3
52155,ia,-92.29668,43.41483,2530,5,12,7,140
52156,ia,-91.46233,43.05256,1008,7,14,7,100
52157,ia,-91.23437,43.01877,2863,10,18,8,80
52158,ia,-91.1867,43.04382,320,12,21,9,75
52159,ia,-91.35867,43.07791,2245,7,14,7,100
52160,ia,-91.36394,43.46599,842,8,16,8,100
52161,ia,-91.75711,43.12955,1566,6,12,6,100
52162,ia,-91.55164,43.1076,2435,6,13,7,116.7
52163,ia,-92.10315,43.21976,268,6,13,7,116.7
52164,ia,-91.89516,42.85016,315,7,14,7,100
52165,ia,-91.98341,43.30679,1425,6,13,7,116.7
52166,ia,-91.93329,43.06571,121,7,15,8,114.3
52168,ia,-91.95244,43.20546,136,6,14,8,133.3
52169,ia,-91.66427,42.85318,529,8,16,8,100
52170,ia,-91.30519,43.2239,713,7,15,8,114.3
52171,ia,-92.05101,43.07366,1329,7,15,8,114.3
52172,ia,-91.48446,43.27081,4355,6,12,6,100
52175,ia,-91.82565,42.99397,2703,7,14,7,100
52201,ia,-91.54616,41.3323,1739,16,31,15,93.8
52202,ia,-91.63775,42.15778,945,11,22,11,100
52203,ia,-91.88647,41.81229,1866,13,25,12,92.3
52205,ia,-91.28542,42.11849,6231,11,21,10,90.9
52206,ia,-91.88546,41.99159,1190,11,21,10,90.9
52207,ia,-90.83168,42.09511,982,10,19,9,90
52208,ia,-92.25766,41.88285,2502,12,23,11,91.7
52209,ia,-92.09943,41.90668,800,12,23,11,91.7
52210,ia,-92.00458,42.33988,1023,10,20,10,100
52211,ia,-92.44768,41.76035,4279,14,26,12,85.7
52212,ia,-91.08571,42.10883,624,10,19,9,90
52213,ia,-91.77263,42.19788,3093,11,22,11,100
52214,ia,-91.50686,42.19096,3133,11,21,10,90.9
52215,ia,-92.39559,41.9087,2399,12,23,11,91.7
52216,ia,-91.04236,41.88702,1723,11,22,11,100
52217,ia,-92.4079,42.07996,1344,11,22,11,100
52218,ia,-91.53608,42.2925,2053,9,19,10,111.1
52219,ia,-91.42573,42.23754,113,9,18,9,100
52220,ia,-91.99837,41.72823,142,12,24,12,100
52221,ia,-92.33238,41.64195,498,13,25,12,92.3
52222,ia,-92.34078,41.57304,1828,13,25,12,92.3
52223,ia,-91.32428,42.41325,2075,8,16,8,100
52224,ia,-92.29962,42.16565,2168,10,21,11,110
52225,ia,-92.32682,42.01083,863,11,22,11,100
52227,ia,-91.56278,41.90002,1695,12,23,11,91.7
52228,ia,-91.7915,41.90257,1949,11,22,11,100
52229,ia,-92.16769,42.14562,716,10,21,11,110
52231,ia,-92.05639,41.36253,814,15,28,13,86.7
52232,ia,-92.33596,41.80268,406,13,25,12,92.3
52233,ia,-91.6869,42.04675,2065,13,24,11,84.6
52235,ia,-91.53197,41.57217,412,17,31,14,82.4
52236,ia,-91.87613,41.73278,818,13,25,12,92.3
52237,ia,-91.24828,42.34467,1605,9,18,9,100
52240,ia,-91.50165,41.63548,12424,16,29,13,81.3
52241,ia,-91.59482,41.6987,5555,15,29,14,93.3
52242,ia,-91.54783,41.66264,34,16,30,14,87.5
52245,ia,-91.50767,41.67078,6750,15,29,14,93.3
52246,ia,-91.56961,41.65164,4731,16,30,14,87.5
52247,ia,-91.71885,41.51489,3956,16,29,13,81.3
52248,ia,-91.9358,41.34689,2992,16,30,14,87.5
52249,ia,-92.20542,42.01416,832,11,22,11,100
52251,ia,-92.20224,41.70988,1077,13,25,12,92.3
52253,ia,-91.35123,41.89659,2276,12,23,11,91.7
52254,ia,-90.80119,41.95211,1440,11,21,10,90.9
52255,ia,-90.96124,41.86364,1492,12,23,11,91.7
52257,ia,-92.17822,41.92096,258,11,22,11,100
52301,ia,-92.08411,41.78838,4267,13,25,12,92.3
52302,ia,-91.57058,42.06552,15189,13,24,11,84.6
52305,ia,-91.33922,42.0192,947,11,21,10,90.9
52306,ia,-91.25346,41.89842,2191,11,22,11,100
52307,ia,-91.89876,41.79309,68,13,25,12,92.3
52308,ia,-92.15877,41.57234,100,13,25,12,92.3
52309,ia,-90.88874,42.12354,1319,10,19,9,90
52310,ia,-91.19723,42.22069,6255,10,20,10,100
52312,ia,-91.24588,42.00615,103,11,22,11,100
52313,ia,-92.09499,42.25906,623,12,23,11,91.7
52314,ia,-91.44865,41.93376,3057,12,23,11,91.7
52315,ia,-91.97008,42.00092,742,11,21,10,90.9
52316,ia,-92.08861,41.5431,2320,14,27,13,92.9
52317,ia,-91.63097,41.76243,6452,14,26,12,85.7
52318,ia,-91.89273,41.88929,831,12,23,11,91.7
52320,ia,-91.14854,41.99769,1902,11,22,11,100
52321,ia,-90.98322,42.14723,820,10,19,9,90
52322,ia,-91.76015,41.69115,2439,14,26,12,85.7
52323,ia,-90.95979,41.98445,1591,12,22,10,83.3
52324,ia,-91.80538,42.06363,1794,12,23,11,91.7
52325,ia,-91.924,41.57949,1285,14,27,13,92.9
52326,ia,-91.75734,42.39021,439,9,19,10,111.1
52327,ia,-91.58101,41.47638,3142,16,30,14,87.5
52328,ia,-91.66611,42.07163,1260,12,23,11,91.7
52329,ia,-91.85576,42.35764,1353,9,19,10,111.1
52330,ia,-91.50049,42.34947,736,8,17,9,112.5
52332,ia,-91.88844,42.09884,1257,12,23,11,91.7
52333,ia,-91.49268,41.80617,4587,13,24,11,84.6
52334,ia,-91.94111,41.74019,475,13,25,12,92.3
52335,ia,-92.0637,41.46227,1517,14,27,13,92.9
52336,ia,-91.43978,42.06927,1960,11,21,10,90.9
52337,ia,-91.14205,41.88021,939,11,22,11,100
52338,ia,-91.70869,41.82957,2026,12,24,12,100
52339,ia,-92.58864,41.92295,3683,12,23,11,91.7
52340,ia,-91.68473,41.70834,1788,15,27,12,80
52341,ia,-91.73534,42.10382,747,12,23,11,91.7
52342,ia,-92.55776,42.05136,3050,11,22,11,100
52345,ia,-91.89166,42.23486,724,11,22,11,100
52346,ia,-92.08065,42.01004,857,11,22,11,100
52347,ia,-92.28451,41.71258,1860,13,25,12,92.3
52348,ia,-92.38139,41.99017,81,11,22,11,100
52349,ia,-92.00557,42.17244,4461,11,22,11,100
52351,ia,-91.8315,41.87784,542,11,22,11,100
52352,ia,-91.77572,42.28788,2028,10,19,9,90
52353,ia,-91.71327,41.29845,6972,18,33,15,83.3
52354,ia,-91.98776,41.91599,371,12,23,11,91.7
52355,ia,-92.18291,41.45998,846,14,27,13,92.9
52356,ia,-91.84517,41.47376,2995,16,29,13,81.3
52358,ia,-91.3192,41.69607,2982,14,26,12,85.7
52359,ia,-91.80748,41.35851,440,17,31,14,82.4
52361,ia,-92.01394,41.64758,4346,13,25,12,92.3
52362,ia,-90.99686,42.06569,1969,10,20,10,100
52401,ia,-91.65855,41.97544,1005,12,24,12,100
52402,ia,-91.65975,42.0228,13798,13,24,11,84.6
52403,ia,-91.5804,41.96873,9868,13,24,11,84.6
52404,ia,-91.6942,41.92377,13672,12,23,11,91.7
52405,ia,-91.74656,41.98682,9849,12,23,11,91.7
52411,ia,-91.72713,42.05147,3712,12,24,12,100
52501,ia,-92.43151,41.03572,22994,16,29,13,81.3
52530,ia,-92.29204,40.99232,962,16,29,13,81.3
52531,ia,-92.81437,41.02676,8130,15,27,12,80
52533,ia,-92.15247,41.01758,2543,17,31,14,82.4
52534,ia,-92.68193,41.27195,169,14,26,12,85.7
52535,ia,-91.96055,40.86515,1599,19,34,15,78.9
52536,ia,-92.61953,40.95553,1729,15,27,12,80
52537,ia,-92.41216,40.73624,8590,16,30,14,87.5
52540,ia,-91.82219,41.15763,2870,18,32,14,77.8
52542,ia,-92.05186,40.62799,1054,19,34,15,78.9
52543,ia,-92.51993,41.20072,526,14,26,12,85.7
52544,ia,-92.91074,40.71755,7964,14,26,12,85.7
52548,ia,-92.53023,41.08595,105,15,28,13,86.7
52549,ia,-92.94644,40.61377,1568,15,26,11,73.3
52550,ia,-92.35997,41.31383,1124,15,28,13,86.7
52551,ia,-92.10194,40.82487,1505,20,34,14,70
52552,ia,-92.53677,40.83572,1258,16,29,13,81.3
52553,ia,-92.65514,41.14836,2829,15,27,12,80
52554,ia,-92.22926,40.92594,1828,18,32,14,77.8
52555,ia,-92.81519,40.63962,894,15,27,12,80
52556,ia,-91.92901,41.01983,10043,18,33,15,83.3
52557,ia,-91.96477,41.02215,10,19,33,14,73.7
52560,ia,-92.24682,40.85156,817,18,32,14,77.8
52561,ia,-92.44618,41.21991,1146,14,26,12,85.7
52563,ia,-92.28309,41.17495,3129,15,28,13,86.7
52565,ia,-91.94192,40.74007,3601,21,36,15,71.4
52566,ia,-92.50254,41.14799,185,14,26,12,85.7
52567,ia,-92.07781,40.93033,976,18,33,15,83.3
52569,ia,-93.04228,40.98568,4102,14,25,11,78.6
52570,ia,-92.15077,40.68523,1812,19,33,14,73.7
52571,ia,-92.83779,40.87712,3779,14,25,11,78.6
52572,ia,-92.69196,40.67728,3028,15,27,12,80
52573,ia,-91.93869,40.63301,628,20,35,16,79.6
52574,ia,-92.96643,40.80373,2133,14,25,11,78.6
52576,ia,-92.1112,41.21355,1216,16,29,13,81.3
52577,ia,-92.66045,41.27193,10493,14,26,12,85.7
52580,ia,-92.08762,41.12324,941,17,30,13,76.5
52581,ia,-93.06283,40.80585,956,14,25,11,78.6
52583,ia,-93.15264,40.80032,985,13,24,11,84.6
52584,ia,-92.25362,40.64519,561,18,32,14,77.8
52585,ia,-91.98201,41.19239,1741,17,31,14,82.4
52586,ia,-92.4704,41.34679,1261,15,27,12,80
52588,ia,-92.1732,40.86419,280,19,33,14,73.7
52590,ia,-93.13237,40.66438,2142,14,25,11,78.6
52591,ia,-92.19298,41.32086,4178,15,28,13,86.7
52593,ia,-92.73953,40.77365,465,14,26,12,85.7
52594,ia,-92.6497,40.83569,1184,15,28,13,86.7
52595,ia,-92.61497,41.28862,200,13,25,12,92.3
52601,ia,-91.11199,40.85504,17687,15,30,15,100
52619,ia,-91.56519,40.5252,1023,19,35,16,84.2
52620,ia,-91.79694,40.69792,1592,19,35,16,84.2
52621,ia,-91.53101,41.20911,1213,17,31,14,82.4
52623,ia,-91.33836,40.85735,1951,16,31,15,93.8
52624,ia,-91.33772,40.73642,197,16,32,16,100
52625,ia,-91.56941,40.66547,3596,17,33,16,94.1
52626,ia,-91.72835,40.62632,2356,19,35,16,84.2
52627,ia,-91.34874,40.66822,7915,17,33,16,94.1
52630,ia,-91.70707,40.80228,1024,18,33,15,83.3
52632,ia,-91.44079,40.4391,8191,19,36,17,89.5
52635,ia,-91.75773,40.99525,1209,18,33,15,83.3
52637,ia,-91.13682,41.02005,2692,15,30,15,100
52638,ia,-91.24571,40.79853,442,15,30,15,100
52639,ia,-91.45634,40.52992,2016,18,35,17,94.4
52640,ia,-91.28484,41.09975,2127,16,30,14,87.5
52641,ia,-91.58719,40.98969,8602,18,32,14,77.8
52644,ia,-91.41498,41.03999,824,16,30,14,87.5
52645,ia,-91.40302,40.91362,2813,16,31,15,93.8
52646,ia,-91.00145,41.0667,1621,17,32,15,88.2
52647,ia,-91.54455,41.13513,157,17,31,14,82.4
52649,ia,-91.60359,40.84075,1285,17,33,16,94.1
52650,ia,-91.15729,40.94885,1257,15,30,15,100
52651,ia,-91.81413,40.85844,1543,18,33,15,83.3
52653,ia,-91.15657,41.1672,4014,17,31,14,82.4
52654,ia,-91.66822,41.13748,1879,18,32,14,77.8
52655,ia,-91.21328,40.84803,2240,15,29,14,93.3
52656,ia,-91.46351,40.73892,3203,17,32,15,88.2
52657,ia,-91.51881,40.76785,75,17,32,15,88.2
52658,ia,-91.22548,40.69986,1769,17,33,16,94.1
52659,ia,-91.44119,41.1294,1738,17,31,14,82.4
52660,ia,-91.29766,40.99257,556,16,30,14,87.5
52701,ia,-90.24906,41.98198,73,10,20,10,100
52720,ia,-91.166,41.59255,1214,15,28,13,86.7
52721,ia,-90.95969,41.75694,1096,13,24,11,84.6
52722,ia,-90.4666,41.56601,15398,13,26,13,100
52726,ia,-90.78389,41.50252,2785,13,27,14,107.7
52727,ia,-90.33341,41.9583,553,10,19,9,90
52728,ia,-90.74179,41.45627,551,14,28,14,100
52729,ia,-90.74745,41.80405,1253,12,24,12,100
52730,ia,-90.34336,41.77258,2978,12,24,12,100
52731,ia,-90.48641,41.96692,1348,10,20,10,100
52732,ia,-90.25081,41.90212,14652,12,23,11,91.7
52737,ia,-91.3746,41.25926,225,16,30,14,87.5
52738,ia,-91.37901,41.27159,4178,17,31,14,82.4
52739,ia,-91.36864,41.37285,999,17,31,14,82.4
52742,ia,-90.51082,41.83627,5313,11,22,11,100
52745,ia,-90.76063,41.71354,819,13,25,12,92.3
52746,ia,-90.67105,41.72089,907,12,24,12,100
52747,ia,-90.91153,41.61015,1300,13,26,13,100
52748,ia,-90.55684,41.66653,4094,11,23,12,109.1
52749,ia,-91.13079,41.34562,378,18,33,15,83.3
52750,ia,-90.39101,41.93223,799,10,20,10,100
52751,ia,-90.68185,41.85114,1337,12,23,11,91.7
52752,ia,-91.19123,41.27471,254,16,31,15,93.8
52753,ia,-90.39046,41.62526,3397,12,25,13,108.3
52754,ia,-91.23803,41.34305,1953,17,31,14,82.4
52755,ia,-91.43112,41.4785,1942,16,30,14,87.5
52756,ia,-90.53967,41.73072,1622,12,23,11,91.7
52757,ia,-90.37932,41.80386,142,12,23,11,91.7
52758,ia,-90.43935,41.74578,134,12,24,12,100
52760,ia,-91.09908,41.58172,717,15,28,13,86.7
52761,ia,-91.0585,41.43871,15148,17,32,15,88.2
52765,ia,-90.87149,41.72548,735,13,25,12,92.3
52766,ia,-91.29612,41.46613,1265,17,31,14,82.4
52767,ia,-90.4222,41.56566,232,13,26,13,100
52768,ia,-90.38986,41.69897,1213,12,24,12,100
52769,ia,-90.84655,41.61021,983,13,26,13,100
52772,ia,-91.14063,41.75037,5006,13,24,11,84.6
52773,ia,-90.75669,41.62198,1949,13,25,12,92.3
52774,ia,-90.59524,41.90696,110,10,20,10,100
52776,ia,-91.2701,41.57746,3344,15,29,14,93.3
52777,ia,-90.85612,41.85404,1731,12,24,12,100
52778,ia,-90.9926,41.6059,3214,14,27,13,92.9
52801,ia,-90.57449,41.52079,297,13,26,13,100
52802,ia,-90.63498,41.49751,5090,14,27,13,92.9
52803,ia,-90.55607,41.53871,9121,13,26,13,100
52804,ia,-90.67858,41.53259,10367,13,26,13,100
52806,ia,-90.62589,41.58969,10155,13,25,12,92.3
52807,ia,-90.51682,41.61067,4929,12,25,13,108.3
53001,wi,-88.05511,43.60613,1380,6,10,4,66.7
53002,wi,-88.35697,43.4701,1582,6,11,5,83.3
53003,wi,-88.50968,43.20657,101,7,13,6,85.7
53004,wi,-87.87808,43.49949,1964,4,8,4,100
53005,wi,-88.09924,43.06261,7972,8,14,6,75
53006,wi,-88.53645,43.62009,1433,5,10,5,100
53007,wi,-88.0712,43.10838,796,8,14,6,75
53010,wi,-88.27704,43.60985,5682,6,11,5,83.3
53011,wi,-88.07896,43.65816,1983,6,10,4,66.7
53012,wi,-88.03769,43.31468,7507,5,10,5,100
53013,wi,-87.85097,43.56634,2230,4,7,3,75
53014,wi,-88.17505,44.02433,6437,6,10,4,66.7
53015,wi,-87.78658,43.90802,2157,3,7,4,133.3
53016,wi,-88.71444,43.31069,188,7,13,6,85.7
53017,wi,-88.25544,43.20381,2485,6,10,4,66.7
53018,wi,-88.39207,43.04708,2952,7,13,6,85.7
53019,wi,-88.31258,43.69406,1688,5,10,5,100
53020,wi,-88.01049,43.86341,3650,5,9,4,80
53021,wi,-88.00162,43.49466,2411,6,10,4,66.7
53022,wi,-88.11352,43.23062,6215,6,10,4,66.7
53023,wi,-88.10639,43.78231,1446,6,10,4,66.7
53024,wi,-87.93055,43.33213,6474,4,8,4,100
53027,wi,-88.37298,43.31791,9420,6,11,5,83.3
53029,wi,-88.34689,43.14519,7979,7,13,6,85.7
53031,wi,-87.91563,43.63914,17,6,10,4,66.7
53032,wi,-88.62613,43.45042,2502,6,11,5,83.3
53033,wi,-88.25569,43.23611,2636,5,10,5,100
53034,wi,-88.60912,43.34066,1155,7,13,6,85.7
53035,wi,-88.5451,43.39211,1552,6,11,5,83.3
53036,wi,-88.57684,43.17008,1777,8,15,7,87.5
53037,wi,-88.16244,43.31227,3324,6,10,4,66.7
53038,wi,-88.78704,43.08337,2242,9,16,7,77.8
53039,wi,-88.71293,43.37,3019,7,12,5,71.4
53040,wi,-88.19073,43.5208,4120,6,11,5,83.3
53042,wi,-87.98166,43.95132,4691,5,9,4,80
53044,wi,-87.78227,43.74232,1305,4,8,4,100
53045,wi,-88.15148,43.06089,7081,7,12,5,71.4
53046,wi,-88.16177,43.15221,496,6,10,4,66.7
53047,wi,-88.63012,43.25712,42,8,14,6,75
53048,wi,-88.45128,43.57947,1604,6,11,5,83.3
53049,wi,-88.28655,43.88523,2518,5,10,5,100
53050,wi,-88.54777,43.51166,3809,6,11,5,83.3
53051,wi,-88.1227,43.14875,13388,7,12,5,71.4
53057,wi,-88.24521,43.78931,1589,6,10,4,66.7
53058,wi,-88.40345,43.11003,1351,7,13,6,85.7
53059,wi,-88.52972,43.28862,1260,7,12,5,71.4
53061,wi,-88.12166,43.94409,3300,6,11,5,83.3
53063,wi,-87.79844,43.96363,1677,3,6,3,100
53065,wi,-88.56883,43.68396,2009,5,10,5,100
53066,wi,-88.48992,43.11313,15630,8,14,6,75
53069,wi,-88.43304,43.11372,402,7,13,6,85.7
53070,wi,-87.80642,43.62017,3191,4,6,2,50
53072,wi,-88.26661,43.08111,8522,7,13,6,85.7
53073,wi,-87.98877,43.75212,8303,5,9,4,80
53074,wi,-87.88074,43.42533,5194,4,7,3,75
53075,wi,-87.99128,43.56636,2324,6,10,4,66.7
53076,wi,-88.20703,43.2684,1966,5,10,5,100
53078,wi,-88.46009,43.31939,1252,6,11,5,83.3
53079,wi,-88.18454,43.80909,1536,6,10,4,66.7
53080,wi,-87.98743,43.40943,2458,5,9,4,80
53081,wi,-87.73584,43.71026,17739,3,7,4,133.3
53083,wi,-87.76595,43.81767,10007,4,8,4,100
53085,wi,-87.8512,43.73591,6591,4,8,4,100
53086,wi,-88.27197,43.32337,3458,6,10,4,66.7
53088,wi,-88.30067,44.07006,254,5,9,4,80
53089,wi,-88.23478,43.14718,6814,6,11,5,83.3
53090,wi,-88.18525,43.45568,7936,6,11,5,83.3
53091,wi,-88.43668,43.4961,1189,6,11,5,83.3
53092,wi,-87.95074,43.22123,7239,5,9,4,80
53093,wi,-87.94228,43.65999,1408,5,9,4,80
53094,wi,-88.73035,43.14563,8836,9,16,7,77.8
53095,wi,-88.15787,43.38903,10329,6,11,5,83.3
53097,wi,-88.00465,43.24614,2692,6,10,4,66.7
53098,wi,-88.71308,43.24959,5894,9,15,6,66.7
53103,wi,-88.21372,42.88165,1859,8,14,6,75
53104,wi,-88.03501,42.55727,2625,7,14,7,100
53105,wi,-88.27986,42.66415,14280,9,16,7,77.8
53108,wi,-87.94644,42.81979,1881,5,10,5,100
53110,wi,-87.86102,42.94693,5620,4,8,4,100
53114,wi,-88.75082,42.59731,1669,9,17,8,88.9
53115,wi,-88.67311,42.65543,9282,10,17,7,70
53118,wi,-88.49085,42.97131,3019,9,15,6,66.7
53119,wi,-88.48552,42.8849,2694,9,16,7,77.8
53120,wi,-88.41663,42.80061,5229,10,17,7,70
53121,wi,-88.52932,42.70882,11362,10,18,8,80
53122,wi,-88.08678,43.04809,2218,8,14,6,75
53125,wi,-88.56178,42.54786,2395,10,18,8,80
53126,wi,-87.99666,42.78836,3964,6,11,5,83.3
53128,wi,-88.33954,42.53081,5528,10,17,7,70
53129,wi,-88.00006,42.938,4386,6,12,6,100
53130,wi,-88.04891,42.94103,2446,7,13,6,85.7
53132,wi,-88.01087,42.8856,10434,6,11,5,83.3
53137,wi,-88.66872,43.00567,1336,9,16,7,77.8
53139,wi,-88.11955,42.68595,2071,8,14,6,75
53140,wi,-87.82916,42.62178,8822,4,7,3,75
53142,wi,-87.94232,42.54275,11188,5,10,5,100
53143,wi,-87.8295,42.56094,7477,4,8,4,100
53144,wi,-87.9232,42.61952,7794,5,9,4,80
53146,wi,-88.15884,42.97189,3449,7,13,6,85.7
53147,wi,-88.45148,42.57097,11784,11,20,9,81.8
53149,wi,-88.34106,42.87777,8246,9,16,7,77.8
53150,wi,-88.12766,42.88429,9438,8,13,5,62.5
53151,wi,-88.09872,42.9741,10226,7,13,6,85.7
53153,wi,-88.40787,42.93381,954,9,15,6,66.7
53154,wi,-87.89815,42.8798,10059,4,8,4,100
53156,wi,-88.59077,42.88766,1993,9,16,7,77.8
53158,wi,-87.88552,42.52434,7557,5,9,4,80
53167,wi,-88.2253,42.74122,171,9,15,6,66.7
53168,wi,-88.13144,42.58199,4934,8,15,7,87.5
53170,wi,-88.16139,42.55197,1116,8,15,7,87.5
53172,wi,-87.8594,42.91187,6523,4,8,4,100
53177,wi,-87.9354,42.70246,2943,5,10,5,100
53178,wi,-88.59833,43.02243,1603,9,16,7,77.8
53179,wi,-88.13127,42.51321,3354,8,15,7,87.5
53181,wi,-88.2446,42.5163,4488,9,16,7,77.8
53182,wi,-88.04168,42.6989,3560,7,14,7,100
53183,wi,-88.37323,43.00426,1155,8,14,6,75
53184,wi,-88.60668,42.53108,2276,10,18,8,80
53185,wi,-88.19531,42.79491,8637,8,14,6,75
53186,wi,-88.20314,43.02334,9444,8,13,5,62.5
53188,wi,-88.29139,43.02215,10793,8,14,6,75
53189,wi,-88.2822,42.95325,9252,8,14,6,75
53190,wi,-88.73338,42.80593,7564,9,16,7,77.8
53191,wi,-88.54524,42.57945,2379,11,19,8,72.7
53192,wi,-88.1869,42.50525,155,8,15,7,87.5
53195,wi,-88.49018,42.51399,63,10,18,8,80
53202,wi,-87.89486,43.04395,2168,5,8,3,60
53203,wi,-87.91613,43.03872,187,5,8,3,60
53204,wi,-87.92548,43.01828,7681,5,8,3,60
53205,wi,-87.93379,43.05347,2496,5,9,4,80
53206,wi,-87.9337,43.07513,8601,5,10,5,100
53207,wi,-87.89864,42.97632,12717,5,8,3,60
53208,wi,-87.96566,43.04664,7918,6,10,4,66.7
53209,wi,-87.94712,43.12841,13782,6,10,4,66.7
53210,wi,-87.97377,43.06884,7589,6,11,5,83.3
53211,wi,-87.88196,43.08241,7838,4,8,4,100
53212,wi,-87.90848,43.07465,7936,5,9,4,80
53213,wi,-88.00152,43.04881,8807,7,12,5,71.4
53214,wi,-88.01466,43.02077,11055,7,12,5,71.4
53215,wi,-87.94683,42.99922,13122,5,9,4,80
53216,wi,-87.97638,43.08639,9963,6,12,6,100
53217,wi,-87.91268,43.15582,10368,5,9,4,80
53218,wi,-87.99314,43.11474,11476,7,12,5,71.4
53219,wi,-87.99226,42.9955,11803,6,11,5,83.3
53220,wi,-87.99136,42.9652,7047,6,12,6,100
53221,wi,-87.94394,42.95406,9558,5,10,5,100
53222,wi,-88.03553,43.08242,8906,8,14,6,75
53223,wi,-87.9905,43.16341,7010,6,12,6,100
53224,wi,-88.03958,43.1633,4442,7,13,6,85.7
53225,wi,-88.04186,43.11496,5509,8,14,6,75
53226,wi,-88.04218,43.04944,6216,8,14,6,75
53227,wi,-88.04253,42.99563,6701,8,13,5,62.5
53228,wi,-88.04339,42.96684,3989,7,13,6,85.7
53233,wi,-87.93384,43.03692,1172,5,9,4,80
53235,wi,-87.86871,42.97314,2887,4,8,4,100
53295,wi,-87.9761,43.02247,5,5,10,5,100
53402,wi,-87.81609,42.79704,12991,3,7,4,133.3
53403,wi,-87.81536,42.68831,9617,3,7,4,133.3
53404,wi,-87.81128,42.75386,4801,3,7,4,133.3
53405,wi,-87.82542,42.72611,9700,3,7,4,133.3
53406,wi,-87.86487,42.72985,8611,4,8,4,100
53501,wi,-89.0655,42.60621,14,10,19,9,90
53502,wi,-89.4419,42.73289,2427,9,17,8,88.9
53503,wi,-89.95616,43.1393,2426,7,14,7,100
53504,wi,-89.86003,42.7042,2916,8,16,8,100
53505,wi,-88.8189,42.65696,255,9,17,8,88.9
53506,wi,-90.2877,43.15082,2168,7,13,6,85.7
53507,wi,-89.90262,43.00235,2739,6,12,6,100
53508,wi,-89.56425,42.86883,3886,8,14,6,75
53510,wi,-90.31825,42.73729,1510,7,14,7,100
53511,wi,-89.09499,42.54558,19480,10,18,8,80
53515,wi,-89.75134,43.11686,1959,6,13,7,116.7
53516,wi,-89.86333,42.80167,3100,7,15,8,114.3
53517,wi,-89.83173,43.03594,1845,6,12,6,100
53518,wi,-90.594,43.24519,2287,8,15,7,87.5
53520,wi,-89.35854,42.59969,4992,9,18,9,100
53521,wi,-89.4027,42.84111,2258,7,13,6,85.7
53522,wi,-89.79022,42.5564,996,8,17,9,112.5
53523,wi,-89.03204,42.98408,3740,9,15,6,66.7
53525,wi,-88.85534,42.54797,2101,9,17,8,88.9
53526,wi,-90.34364,42.9741,528,5,11,6,120
53527,wi,-89.19265,43.0617,4623,7,14,7,100
53528,wi,-89.6388,43.11867,3200,6,12,6,100
53529,wi,-89.51551,43.24151,1533,6,12,6,100
53530,wi,-90.10587,42.69384,5000,8,15,7,87.5
53531,wi,-89.10167,43.06124,2936,8,15,7,87.5
53532,wi,-89.32467,43.24903,7076,6,12,6,100
53533,wi,-90.14677,42.99397,7136,6,12,6,100
53534,wi,-89.08748,42.84999,8228,9,16,7,77.8
53536,wi,-89.26548,42.76194,4265,8,15,7,87.5
53537,wi,-89.21051,42.6724,362,10,19,9,90
53538,wi,-88.86439,42.92089,9992,9,16,7,77.8
53540,wi,-90.28491,43.22926,132,7,14,7,100
53541,wi,-90.02936,42.56615,1701,8,16,8,100
53543,wi,-90.36073,43.05435,2641,6,12,6,100
53544,wi,-89.91447,42.88254,1388,7,14,7,100
53545,wi,-89.04051,42.7355,8952,11,19,8,72.7
53546,wi,-88.94912,42.65266,11460,11,19,8,72.7
53548,wi,-89.12871,42.68536,8181,11,19,8,72.7
53549,wi,-88.77676,42.99113,5200,9,16,7,77.8
53550,wi,-89.49341,42.55963,1547,8,16,8,100
53551,wi,-88.91611,43.0816,4367,10,17,7,70
53553,wi,-90.30217,42.90784,503,6,12,6,100
53554,wi,-90.45064,42.90148,1496,7,14,7,100
53555,wi,-89.55908,43.32155,5658,7,13,6,85.7
53556,wi,-90.24297,43.23809,2363,7,14,7,100
53557,wi,-88.79874,43.34212,325,8,14,6,75
53558,wi,-89.2827,43.00374,5047,7,14,7,100
53559,wi,-89.07994,43.16522,3384,8,14,6,75
53560,wi,-89.75669,43.19327,3026,7,13,6,85.7
53561,wi,-89.64148,43.39963,2353,7,13,6,85.7
53562,wi,-89.54159,43.11643,8462,6,12,6,100
53563,wi,-88.93363,42.79167,5280,9,17,8,88.9
53565,wi,-90.1651,42.8391,6784,6,13,7,116.7
53566,wi,-89.64888,42.60869,9119,8,16,8,100
53569,wi,-90.43314,42.98164,1591,6,13,7,116.7
53570,wi,-89.61866,42.73922,2872,8,16,8,100
53571,wi,-89.35327,43.27802,146,7,13,6,85.7
53572,wi,-89.73561,42.96144,6232,6,12,6,100
53573,wi,-90.46751,43.18538,4222,7,14,7,100
53574,wi,-89.65017,42.81656,2340,7,14,7,100
53575,wi,-89.39002,42.93373,6944,7,13,6,85.7
53576,wi,-89.23482,42.62424,1216,9,17,8,88.9
53577,wi,-90.07104,43.31432,1487,7,13,6,85.7
53578,wi,-89.77609,43.32209,3358,7,14,7,100
53579,wi,-88.87892,43.29013,1485,8,15,7,87.5
53580,wi,-90.37804,42.85982,748,7,14,7,100
53581,wi,-90.41142,43.37272,9702,7,14,7,100
53582,wi,-89.99178,43.01837,1503,6,12,6,100
53583,wi,-89.80014,43.25424,3989,7,13,6,85.7
53585,wi,-88.71559,42.52963,1252,9,17,8,88.9
53586,wi,-90.22668,42.57311,3218,7,15,8,114.3
53587,wi,-89.90321,42.57813,1734,8,16,8,100
53588,wi,-90.07965,43.19262,5190,7,13,6,85.7
53589,wi,-89.21279,42.92693,9533,8,14,6,75
53590,wi,-89.20594,43.20078,14665,6,12,6,100
53593,wi,-89.57813,42.98451,11286,6,12,6,100
53594,wi,-88.97217,43.18705,3324,9,16,7,77.8
53597,wi,-89.45692,43.18257,7913,6,12,6,100
53598,wi,-89.33761,43.20618,1428,6,12,6,100
53599,wi,-89.86003,42.64768,62,9,17,8,88.9
53702,wi,-88.23064,43.06093,3,8,13,5,62.5
53703,wi,-89.37705,43.07983,3651,7,13,6,85.7
53704,wi,-89.3473,43.13689,13119,6,12,6,100
53705,wi,-89.46333,43.07363,6378,7,12,5,71.4
53706,wi,-89.41059,43.0748,36,7,13,6,85.7
53711,wi,-89.40921,43.01505,15190,7,13,6,85.7
53713,wi,-89.38561,43.03714,3657,7,13,6,85.7
53714,wi,-89.31225,43.09868,5356,7,13,6,85.7
53715,wi,-89.39727,43.06033,1991,7,13,6,85.7
53716,wi,-89.31401,43.06446,7168,7,13,6,85.7
53717,wi,-89.51962,43.07383,2836,6,12,6,100
53718,wi,-89.27338,43.09839,5272,7,13,6,85.7
53719,wi,-89.50152,43.02753,6781,6,12,6,100
53726,wi,-89.4225,43.06978,1099,7,13,6,85.7
53792,wi,-89.43064,43.07756,1,7,13,6,85.7
53801,wi,-91.06959,42.92506,2071,9,17,8,88.9
53802,wi,-90.88856,42.80579,83,9,17,8,88.9
53803,wi,-90.35369,42.55949,1080,8,17,9,112.5
53804,wi,-90.90785,42.87495,1721,8,15,7,87.5
53805,wi,-90.68729,43.14472,5759,8,15,7,87.5
53806,wi,-90.93027,42.73846,2661,10,18,8,80
53807,wi,-90.47017,42.61174,4824,8,16,8,100
53808,wi,-90.59307,42.62611,517,8,17,9,112.5
53809,wi,-90.63363,42.99376,3919,7,14,7,100
53810,wi,-90.9995,42.82151,988,8,16,8,100
53811,wi,-90.51389,42.53602,2675,9,17,8,88.9
53813,wi,-90.71955,42.84393,5889,8,15,7,87.5
53816,wi,-90.85439,42.97885,1736,7,14,7,100
53817,wi,-90.96767,42.94509,160,7,14,7,100
53818,wi,-90.48893,42.74737,8302,8,16,8,100
53820,wi,-90.71113,42.69557,3623,9,18,9,100
53821,wi,-91.05839,43.05201,6551,10,19,9,90
53825,wi,-90.59058,42.91822,971,7,15,8,114.3
53826,wi,-90.91347,43.12235,1419,9,17,8,88.9
53827,wi,-90.83354,43.05208,906,8,15,7,87.5
53901,wi,-89.48645,43.55707,9364,8,14,6,75
53910,wi,-89.80451,43.89015,3418,6,11,5,83.3
53911,wi,-89.36303,43.32545,1490,7,13,6,85.7
53913,wi,-89.72882,43.49601,11017,7,13,6,85.7
53916,wi,-88.85943,43.45547,10399,7,13,6,85.7
53919,wi,-88.77597,43.7348,2530,6,11,5,83.3
53920,wi,-89.59602,43.66696,714,7,13,6,85.7
53922,wi,-88.7098,43.5246,1023,6,12,6,100
53923,wi,-89.13718,43.57355,2494,7,12,5,71.4
53924,wi,-90.25623,43.48544,1999,6,12,6,100
53925,wi,-89.05209,43.33474,5657,7,14,7,100
53926,wi,-89.21166,43.67073,1577,8,14,6,75
53928,wi,-89.15359,43.42635,76,7,13,6,85.7
53929,wi,-90.2844,43.75091,3037,5,10,5,100
53930,wi,-89.49072,43.6835,1474,7,14,7,100
53931,wi,-88.85987,43.74158,154,6,11,5,83.3
53932,wi,-89.0671,43.42085,1959,7,13,6,85.7
53933,wi,-88.88298,43.57309,2483,7,12,5,71.4
53934,wi,-89.81915,43.98194,8209,6,11,5,83.3
53935,wi,-89.06696,43.58859,200,6,12,6,100
53936,wi,-89.70867,43.87433,2870,5,10,5,100
53937,wi,-90.15233,43.38662,1342,6,12,6,100
53939,wi,-89.1306,43.69168,210,7,13,6,85.7
53941,wi,-90.1377,43.57394,5155,6,12,6,100
53943,wi,-90.03058,43.39382,1314,6,12,6,100
53944,wi,-89.92578,43.68668,3153,6,12,6,100
53946,wi,-89.02486,43.71576,5482,7,12,5,71.4
53947,wi,-89.13995,43.74677,215,7,13,6,85.7
53948,wi,-90.04819,43.77531,7199,6,11,5,83.3
53949,wi,-89.33589,43.78296,8904,7,13,6,85.7
53950,wi,-90.13636,43.90181,6330,6,11,5,83.3
53951,wi,-89.87219,43.39199,2319,6,13,7,116.7
53952,wi,-89.59852,43.78323,5192,6,12,6,100
53953,wi,-89.46814,43.77264,254,7,13,6,85.7
53954,wi,-89.31313,43.55254,4921,7,14,7,100
53955,wi,-89.40619,43.40406,4581,7,13,6,85.7
53956,wi,-89.01822,43.54181,3074,7,12,5,71.4
53959,wi,-89.99902,43.53422,7882,7,13,6,85.7
53960,wi,-89.23354,43.42133,3130,7,13,6,85.7
53961,wi,-89.93562,43.46256,913,6,13,7,116.7
53963,wi,-88.74391,43.63945,5883,6,11,5,83.3
53964,wi,-89.50934,43.90959,4883,6,11,5,83.3
53965,wi,-89.7556,43.67535,11476,7,12,5,71.4
53968,wi,-90.2291,43.64265,2659,5,11,6,120
53969,wi,-89.3043,43.49392,210,7,14,7,100
54001,wi,-92.38721,45.33476,7277,4,8,4,100
54002,wi,-92.37134,44.96251,3997,5,10,5,100
54003,wi,-92.43924,44.79026,906,6,12,6,100
54004,wi,-92.12589,45.30863,2544,4,7,3,75
54005,wi,-92.23201,45.23564,2762,4,8,4,100
54006,wi,-92.65028,45.59161,1036,5,9,4,80
54007,wi,-92.35799,45.1883,1411,5,9,4,80
54009,wi,-92.57798,45.35279,2148,5,10,5,100
54010,wi,-92.46563,44.73432,30,6,12,6,100
54011,wi,-92.45861,44.71611,4846,6,12,6,100
54013,wi,-92.23065,45.08089,3113,5,9,4,80
54014,wi,-92.56767,44.64665,2264,7,14,7,100
54015,wi,-92.45625,44.96468,2225,5,11,6,120
54016,wi,-92.69323,44.97894,13972,7,14,7,100
54017,wi,-92.52062,45.1189,10301,6,11,5,83.3
54020,wi,-92.65081,45.27891,5594,6,12,6,100
54021,wi,-92.70976,44.73905,3933,6,13,7,116.7
54022,wi,-92.60812,44.84792,10499,6,12,6,100
54023,wi,-92.55493,44.98114,2429,6,12,6,100
54024,wi,-92.64643,45.49739,5387,5,9,4,80
54025,mn,-92.68939,45.14311,4199,8,14,6,86.6
54026,wi,-92.5305,45.22608,1853,5,11,6,120
54027,wi,-92.19591,44.92415,1070,5,10,5,100
54028,wi,-92.27951,44.95433,1827,5,10,5,100
54082,wi,-92.75135,45.07197,1350,8,15,7,87.5
54101,wi,-88.06276,44.78961,2257,3,5,2,66.7
54102,wi,-87.98365,45.5001,3242,2,5,3,150
54103,wi,-88.50157,45.65034,1538,1,2,1,100
54104,wi,-88.26249,45.44819,6276,2,4,2,100
54106,wi,-88.45863,44.48472,4185,5,8,3,60
54107,wi,-88.4474,44.69818,3187,4,8,4,100
54110,wi,-88.07538,44.18831,3694,6,10,4,66.7
54111,wi,-88.38449,44.81457,2265,4,8,4,100
54112,wi,-88.04584,45.04582,2328,2,4,2,100
54113,wi,-88.30641,44.26417,1599,5,9,4,80
54114,wi,-88.12948,45.25284,12172,2,5,3,150
54115,wi,-88.09194,44.40463,17837,4,8,4,100
54119,wi,-88.16742,45.61152,2335,2,4,2,100
54120,wi,-88.49612,45.76088,1714,1,2,1,100
54121,wi,-88.31981,45.86473,7456,1,3,2,200
54123,wi,-88.143,44.21129,168,5,9,4,80
54124,wi,-88.36667,44.90708,3840,4,7,3,75
54125,wi,-88.37506,45.60066,1633,1,2,1,100
54126,wi,-88.03123,44.29008,2916,5,9,4,80
54127,wi,-88.2696,44.79639,44,4,7,3,75
54128,wi,-88.80488,44.86849,2167,4,7,3,75
54129,wi,-88.20043,44.13196,3100,5,9,4,80
54130,wi,-88.24168,44.31236,12775,5,9,4,80
54135,wi,-88.62654,44.92489,3783,4,8,4,100
54136,wi,-88.33888,44.26827,2630,5,9,4,80
54137,wi,-88.25502,44.75681,1082,4,7,3,75
54138,wi,-88.42997,45.32941,2529,2,4,2,100
54139,wi,-88.07504,44.95602,3118,2,5,3,150
54140,wi,-88.31132,44.28664,3132,5,9,4,80
54141,wi,-87.99562,44.73242,1921,2,5,3,150
54143,wi,-87.69673,45.08436,8279,2,4,2,100
54149,wi,-88.48297,45.19972,3420,2,5,3,150
54150,wi,-88.84347,44.98714,637,3,6,3,100
54151,wi,-87.98806,45.72487,4676,2,5,3,150
54153,wi,-87.91775,44.9019,5554,2,4,2,100
54154,wi,-88.18843,44.86804,4047,3,6,3,100
54155,wi,-88.19816,44.52251,3078,4,7,3,75
54156,wi,-88.0129,45.62475,4459,2,5,3,150
54157,wi,-87.81028,45.04799,4124,2,4,2,100
54159,wi,-87.82775,45.19396,1989,2,3,1,50
54160,wi,-88.10047,44.12053,157,6,10,4,66.7
54161,wi,-88.15939,45.12332,4440,3,5,2,66.7
54162,wi,-88.27929,44.66273,5393,4,8,4,100
54165,wi,-88.32053,44.51881,4991,4,8,4,100
54166,wi,-88.63248,44.77713,12504,5,9,4,80
54169,wi,-88.27791,44.17645,1504,5,9,4,80
54170,wi,-88.57598,44.51357,4140,5,9,4,80
54171,wi,-88.1167,44.71736,2024,3,6,3,100
54173,wi,-88.03176,44.64348,2055,2,4,2,100
54174,wi,-88.4295,45.03769,4820,3,7,4,133.3
54175,wi,-88.623,45.30654,2972,2,3,1,50
54177,wi,-87.88794,45.35539,6463,2,5,3,150
54180,wi,-88.17474,44.32638,1309,5,9,4,80
54201,wi,-87.49146,44.62104,4392,1,2,1,100
54202,wi,-87.13831,45.0772,3361,1,2,1,100
54204,wi,-87.62029,44.75868,2122,1,3,2,200
54205,wi,-87.62522,44.6009,1833,2,4,2,100
54207,wi,-87.98502,44.08779,125,4,7,3,75
54208,wi,-87.79668,44.36408,4503,3,6,3,100
54209,wi,-87.27004,45.01161,4005,1,2,1,100
54210,wi,-87.03301,45.25182,2838,1,1,0,0
54211,wi,-87.16765,45.15935,1132,1,2,1,100
54212,wi,-87.22861,45.12113,3149,1,2,1,100
54213,wi,-87.52148,44.69963,1387,1,3,2,200
54214,wi,-87.71302,44.19754,202,1,3,2,200
54216,wi,-87.57644,44.43883,5109,2,4,2,100
54217,wi,-87.71537,44.55187,5744,2,4,2,100
54220,wi,-87.72681,44.09621,18737,2,4,2,100
54227,wi,-87.80782,44.28014,1391,3,5,2,66.7
54228,wi,-87.64874,44.27675,2256,2,4,2,100
54229,wi,-87.8231,44.56155,2754,4,7,3,75
54230,wi,-87.9129,44.15773,4585,4,7,3,75
54232,wi,-87.92428,44.0074,375,4,8,4,100
54234,wi,-87.09234,45.18273,3580,1,1,0,0
54235,wi,-87.37404,44.84088,18113,1,2,1,100
54241,wi,-87.59166,44.21838,8293,1,3,2,200
54245,wi,-87.89611,44.02709,2127,4,7,3,75
54246,wi,-86.89731,45.3753,2316,1,1,0,0
54247,wi,-87.78512,44.19704,1919,2,5,3,150
54301,wi,-88.02033,44.48208,8590,4,6,2,50
54302,wi,-87.97616,44.50769,8442,4,7,3,75
54303,wi,-88.05004,44.53875,8963,3,6,3,100
54304,wi,-88.06785,44.49396,10495,4,6,2,50
54307,wi,-88.03664,44.47043,1,4,7,3,75
54311,wi,-87.89608,44.48328,12670,4,8,4,100
54313,wi,-88.11043,44.58594,15643,3,6,3,100
54401,wi,-89.70676,44.96559,14321,2,5,3,150
54403,wi,-89.51355,45.03149,12162,2,4,2,100
54405,wi,-90.28744,44.96139,1825,2,5,3,150
54406,wi,-89.31085,44.4096,3297,4,7,3,75
54407,wi,-89.29328,44.52628,2001,4,7,3,75
54408,wi,-89.31054,45.02919,1258,2,4,2,100
54409,wi,-89.16981,45.11916,10308,2,4,2,100
54410,wi,-90.03024,44.542,2040,4,7,3,75
54411,wi,-90.02759,45.04987,5058,2,5,3,150
54412,wi,-89.98054,44.66905,2001,4,7,3,75
54413,wi,-90.13185,44.28434,416,5,9,4,80
54414,wi,-89.17886,44.95707,3687,3,5,2,66.7
54416,wi,-88.94171,44.87672,2137,3,6,3,100
54417,wi,-89.65169,45.02552,75,2,4,2,100
54418,wi,-88.94498,45.22115,2628,2,3,1,50
54420,wi,-90.35351,44.61227,1226,4,7,3,75
54421,wi,-90.295,44.89899,2579,3,5,2,66.7
54422,wi,-90.45653,44.98442,1033,2,5,3,150
54423,wi,-89.42147,44.58236,2223,3,6,3,100
54424,wi,-89.18117,45.28773,4290,1,3,2,200
54425,wi,-90.33972,45.00926,1633,2,5,3,150
54426,wi,-89.98575,44.90583,3446,3,5,2,66.7
54427,wi,-89.26013,44.82473,1405,3,5,2,66.7
54428,wi,-89.14756,45.43254,2847,1,2,1,100
54430,wi,-88.88288,45.15078,215,2,4,2,100
54433,wi,-90.81676,45.20012,3643,2,5,3,150
54435,wi,-89.43911,45.35637,4700,1,3,2,200
54436,wi,-90.42881,44.53927,2718,4,8,4,100
54437,wi,-90.63825,44.77496,3434,3,7,4,133.3
54440,wi,-89.38641,44.80889,3034,3,5,2,66.7
54441,wi,-90.10481,44.6425,411,4,7,3,75
54442,wi,-89.65449,45.36572,1863,1,3,2,200
54443,wi,-89.75356,44.61206,2903,4,7,3,75
54446,wi,-90.47184,44.75324,2716,3,6,3,100
54447,wi,-90.7399,45.08445,884,2,5,3,150
54448,wi,-89.83362,44.93372,3269,2,5,3,150
54449,wi,-90.19929,44.63689,13534,4,7,3,75
54450,wi,-89.04066,45.00432,314,3,5,2,66.7
54451,wi,-90.40552,45.19522,10788,2,4,2,100
54452,wi,-89.7685,45.20991,15742,2,4,2,100
54454,wi,-89.8849,44.60711,1322,4,7,3,75
54455,wi,-89.68463,44.76576,11996,3,5,2,66.7
54456,wi,-90.63591,44.54706,6751,4,9,5,125
54457,wi,-89.89148,44.22747,11827,5,9,4,80
54458,wi,-89.30804,44.49572,133,4,7,3,75
54459,wi,-90.27398,45.42578,3159,1,3,2,200
54460,wi,-90.53903,44.94241,2735,3,5,2,66.7
54462,wi,-88.99397,45.39566,1260,1,2,1,100
54463,wi,-89.21788,45.51041,2382,1,2,1,100
54465,wi,-88.89119,45.38308,1707,1,2,1,100
54466,wi,-90.30733,44.38422,4716,4,8,4,100
54467,wi,-89.5418,44.41622,6440,3,7,4,133.3
54469,wi,-89.87036,44.34597,917,4,8,4,100
54470,wi,-90.14041,45.29271,2835,1,3,2,200
54471,wi,-89.41637,44.93871,1591,2,5,3,150
54473,wi,-89.35586,44.65014,3438,3,6,3,100
54474,wi,-89.62088,44.87484,1851,3,5,2,66.7
54475,wi,-89.78893,44.48239,1382,4,7,3,75
54476,wi,-89.52406,44.88808,7674,2,5,3,150
54479,wi,-90.32153,44.75636,3179,3,6,3,100
54480,wi,-90.27664,45.05987,1345,2,5,3,150
54481,wi,-89.63778,44.51577,12063,4,7,3,75
54482,wi,-89.51818,44.55628,5953,4,7,3,75
54484,wi,-90.07838,44.79947,3956,3,6,3,100
54485,wi,-89.22155,45.39507,701,1,2,1,100
54486,wi,-89.05165,44.72524,3650,4,7,3,75
54487,wi,-89.76292,45.50666,14022,1,3,2,200
54488,wi,-90.3324,44.84317,1149,3,6,3,100
54489,wi,-89.99993,44.45929,1436,4,8,4,100
54490,wi,-90.4024,45.33804,2090,1,3,2,200
54491,wi,-88.75194,45.24007,5393,2,4,2,100
54493,wi,-90.80355,44.70188,1614,4,8,4,100
54494,wi,-89.73762,44.33915,15648,4,8,4,100
54495,wi,-89.95751,44.38629,5319,4,8,4,100
54498,wi,-90.62445,45.03348,3150,3,5,2,66.7
54499,wi,-89.17808,44.79123,3718,3,6,3,100
54501,wi,-89.34499,45.65304,19304,1,3,2,200
54511,wi,-88.83413,45.72764,4362,1,2,1,100
54512,wi,-89.67091,46.09528,2304,1,2,1,100
54513,wi,-90.11672,45.56603,1644,1,3,2,200
54514,wi,-90.47657,46.04323,4295,1,3,2,200
54515,wi,-90.49685,45.51803,1403,1,3,2,200
54517,wi,-90.93303,46.14744,957,2,3,1,50
54519,wi,-89.2623,46.04991,3182,1,3,2,200
54520,wi,-88.91082,45.53291,6094,1,2,1,100
54521,wi,-89.28501,45.93408,13456,1,3,2,200
54524,wi,-90.3317,45.84562,1274,1,3,2,200
54525,wi,-90.22012,46.42886,277,0,1,1,NA
54526,wi,-90.85902,45.50556,2597,2,4,2,100
54527,wi,-90.66433,46.12331,2717,1,3,2,200
54529,wi,-89.66341,45.67827,2988,1,2,1,100
54530,wi,-90.72531,45.53071,2433,2,4,2,100
54531,wi,-89.7858,45.74851,3594,1,2,1,100
54534,wi,-90.22857,46.34891,3863,1,1,0,0
54536,wi,-90.35433,46.32858,920,1,2,1,100
54537,wi,-90.60605,45.52697,1231,1,3,2,200
54538,wi,-89.90891,45.97045,4702,1,2,1,100
54539,wi,-89.5678,45.80542,3355,1,2,1,100
54540,mi,-89.38225,46.15614,4001,1,3,2,200
54541,wi,-88.64351,45.55472,2809,1,2,1,100
54542,wi,-88.71963,45.9223,3362,1,3,2,200
54545,wi,-89.85903,46.12875,2426,1,2,1,100
54546,wi,-90.70274,46.3023,3356,1,3,2,200
54547,wi,-90.102,46.19232,5787,1,2,1,100
54548,wi,-89.82107,45.85982,9032,1,2,1,100
54550,wi,-90.26063,46.36211,1073,1,1,0,0
54552,wi,-90.31189,45.94079,8292,1,3,2,200
54554,mi,-89.05676,46.05229,2642,2,3,1,50
54555,wi,-90.39767,45.70661,8537,1,3,2,200
54556,wi,-90.2996,45.53563,2245,1,3,2,200
54557,wi,-89.75774,46.21921,5058,1,2,1,100
54558,wi,-89.50135,45.9234,3989,1,2,1,100
54559,wi,-90.47829,46.49263,1957,1,1,0,0
54560,wi,-89.5451,46.01509,1710,1,2,1,100
54561,wi,-89.51405,46.08689,453,1,2,1,100
54562,wi,-89.08347,45.80977,5646,1,2,1,100
54563,wi,-90.97365,45.46545,1375,2,5,3,150
54564,wi,-89.97157,45.61398,3444,1,3,2,200
54565,wi,-90.44836,46.30126,1043,1,2,1,100
54566,wi,-88.62051,45.43215,3063,1,2,1,100
54568,wi,-89.67523,45.94648,6082,1,2,1,100
54601,wi,-91.14245,43.80437,17298,7,14,7,100
54603,wi,-91.24703,43.85701,5994,8,16,8,100
54610,wi,-91.83454,44.37169,4111,6,13,7,116.7
54611,wi,-90.95221,44.44773,1676,5,10,5,100
54612,wi,-91.50053,44.24806,6021,6,13,7,116.7
54613,wi,-89.92135,44.075,4848,6,11,5,83.3
54614,wi,-90.97038,43.90088,2900,6,13,7,116.7
54615,wi,-90.78615,44.26092,10258,6,12,6,100
54616,wi,-91.23186,44.29962,3158,6,12,6,100
54618,wi,-90.28806,43.96745,2914,5,10,5,100
54619,wi,-90.77702,43.75716,4016,5,11,6,120
54621,wi,-91.08283,43.65802,1440,6,12,6,100
54622,wi,-91.77149,44.26717,2953,7,14,7,100
54623,wi,-91.01906,43.73041,2108,6,12,6,100
54624,wi,-91.13958,43.46795,3220,7,13,6,85.7
54625,wi,-91.525,44.13342,345,8,15,7,87.5
54626,wi,-91.03848,43.21699,2579,7,14,7,100
54627,wi,-91.2405,44.16764,2688,7,13,6,85.7
54628,wi,-91.02464,43.37292,2664,7,14,7,100
54629,wi,-91.66429,44.15869,4396,7,14,7,100
54630,wi,-91.35795,44.10095,4076,7,14,7,100
54631,wi,-90.8342,43.2856,3226,6,13,7,116.7
54632,wi,-91.14605,43.56414,1791,6,13,7,116.7
54634,wi,-90.42654,43.59666,5399,5,11,6,120
54635,wi,-91.04455,44.40442,2710,5,11,6,120
54636,wi,-91.22658,44.0076,7586,7,15,8,114.3
54637,wi,-90.27021,43.87873,145,5,10,5,100
54638,wi,-90.38604,43.796,2039,5,10,5,100
54639,wi,-90.63969,43.60654,3889,6,11,5,83.3
54641,wi,-90.33977,44.27697,72,4,8,4,100
54642,wi,-91.0532,44.15149,3145,7,13,6,85.7
54643,wi,-90.63862,44.18707,27,5,10,5,100
54644,wi,-91.04235,44.03085,1955,6,12,6,100
54645,wi,-90.93264,43.32115,3,6,12,6,100
54646,wi,-90.08961,44.09,6562,7,12,5,71.4
54648,wi,-90.6373,43.834,2428,5,10,5,100
54650,wi,-91.22519,43.91066,9739,8,15,7,87.5
54651,wi,-90.56471,43.72534,1991,5,11,6,120
54652,wi,-90.7623,43.46065,1630,6,12,6,100
54653,wi,-90.90829,43.81755,828,6,12,6,100
54654,wi,-90.96341,43.26814,153,6,13,7,116.7
54655,wi,-90.76602,43.37945,2954,6,13,7,116.7
54656,wi,-90.81101,44.00279,12593,7,13,6,85.7
54657,wi,-90.89831,43.19309,684,8,15,7,87.5
54658,wi,-91.17662,43.67904,2337,6,13,7,116.7
54659,wi,-91.10773,44.29445,1710,6,11,5,83.3
54660,wi,-90.49016,43.98254,10763,5,10,5,100
54661,wi,-91.47064,44.05967,4098,7,15,8,114.3
54664,wi,-90.63693,43.49889,2644,6,12,6,100
54665,wi,-90.92658,43.52852,8211,5,11,6,120
54666,wi,-90.44516,44.17462,5712,4,8,4,100
54667,wi,-90.85913,43.66724,4211,5,10,5,100
54669,wi,-91.09105,43.91173,4151,7,14,7,100
54670,wi,-90.48584,43.83738,2004,5,10,5,100
54701,wi,-91.51059,44.74438,14155,5,10,5,100
54703,wi,-91.51608,44.83443,18467,5,10,5,100
54720,wi,-91.43551,44.80406,3432,5,10,5,100
54721,wi,-92.06964,44.62933,2188,7,14,7,100
54722,wi,-91.10304,44.71501,4620,5,9,4,80
54723,wi,-92.43233,44.60886,1191,7,14,7,100
54724,wi,-91.48785,45.10644,6963,5,9,4,80
54725,wi,-92.01216,45.0701,3345,5,10,5,100
54726,wi,-91.01739,44.93123,2353,4,7,3,75
54727,wi,-91.15772,44.95516,4728,4,8,4,100
54728,wi,-91.6393,45.30833,6876,4,8,4,100
54729,wi,-91.39499,44.94404,18879,5,9,4,80
54730,wi,-91.72343,45.02008,5279,5,10,5,100
54731,wi,-91.08193,45.35093,1430,3,6,3,100
54732,wi,-91.17261,45.14306,3510,4,7,3,75
54733,wi,-91.85682,45.2779,1370,4,8,4,100
54734,wi,-92.11775,45.09872,1076,5,10,5,100
54736,wi,-91.90719,44.59976,4873,6,13,7,116.7
54737,wi,-91.98217,44.71519,771,7,14,7,100
54738,wi,-91.48015,44.59183,3553,5,11,6,120
54739,wi,-91.70139,44.86291,4257,6,11,5,83.3
54740,wi,-92.16173,44.74435,2632,6,12,6,100
54741,wi,-90.97801,44.6153,2425,4,8,4,100
54742,wi,-91.27074,44.76501,3741,5,9,4,80
54745,wi,-91.12562,45.25007,5036,3,7,4,133.3
54746,wi,-90.87588,44.54445,1034,5,9,4,80
54747,wi,-91.50509,44.39029,3932,6,12,6,100
54748,wi,-91.26288,45.07821,1577,4,8,4,100
54749,wi,-92.09663,44.94767,1356,6,11,5,83.3
54750,wi,-92.29379,44.61431,1760,7,13,6,85.7
54751,wi,-91.93037,44.85059,14015,7,13,6,85.7
54754,wi,-90.76367,44.43413,3185,6,11,5,83.3
54755,wi,-91.68452,44.57628,9360,6,13,7,116.7
54756,wi,-91.94812,44.46805,2012,6,13,7,116.7
54757,wi,-91.52431,45.2317,5730,4,8,4,100
54758,wi,-91.21872,44.54859,5580,5,10,5,100
54759,wi,-92.12779,44.48664,2353,7,15,8,114.3
54760,wi,-91.20637,44.42404,127,5,11,6,120
54761,wi,-92.17998,44.63047,1324,6,13,7,116.7
54762,wi,-91.99097,45.24796,1404,4,8,4,100
54763,wi,-91.88155,45.17955,1540,4,8,4,100
54765,wi,-91.68559,45.16913,32,4,9,5,125
54766,wi,-90.85768,45.33875,3218,2,5,3,150
54767,wi,-92.26146,44.82854,3223,5,11,6,120
54768,wi,-90.92922,44.95701,4422,3,7,4,133.3
54769,wi,-92.23738,44.51414,1325,7,14,7,100
54770,wi,-91.37612,44.54828,2453,5,11,6,120
54771,wi,-90.80677,44.93238,4235,3,6,3,100
54772,wi,-91.87386,45.09973,1657,5,10,5,100
54773,wi,-91.29406,44.39252,3265,6,12,6,100
54801,wi,-91.93448,45.87254,9992,4,7,3,75
54805,wi,-92.02159,45.4128,1371,4,8,4,100
54806,wi,-90.86482,46.55324,9659,2,4,2,100
54810,wi,-92.38176,45.46026,3806,4,8,4,100
54812,wi,-91.88239,45.3968,3751,4,8,4,100
54813,wi,-92.03198,45.65596,1337,4,8,4,100
54814,wi,-90.91688,46.8626,4269,2,3,1,50
54817,wi,-91.54276,45.67316,8228,3,6,3,100
54819,wi,-91.30593,45.48398,4921,3,6,3,100
54820,wi,-91.56071,46.57184,1952,2,4,2,100
54821,wi,-91.16296,46.22156,5457,2,4,2,100
54822,wi,-91.69652,45.39374,3422,4,8,4,100
54824,wi,-92.54195,45.47417,2048,4,8,4,100
54826,wi,-92.16715,45.50282,1709,4,8,4,100
54827,wi,-91.10786,46.79954,993,2,4,2,100
54828,wi,-91.28361,45.84069,1939,2,5,3,150
54829,wi,-92.05232,45.55906,6195,4,8,4,100
54830,wi,-92.21851,46.108,11897,3,6,3,100
54832,wi,-91.32791,46.3267,1363,2,5,3,150
54835,wi,-91.24133,45.67991,3454,2,5,3,150
54836,wi,-92.19457,46.43038,1747,2,5,3,150
54837,wi,-92.35449,45.67294,6138,4,8,4,100
54838,wi,-91.81071,46.25155,4577,3,6,3,100
54839,wi,-91.14146,46.36034,909,3,5,2,66.7
54840,wi,-92.68906,45.75624,6555,4,8,4,100
54841,wi,-91.77863,45.60662,168,4,7,3,75
54842,wi,-91.85623,46.49512,222,3,6,3,100
54843,wi,-91.29721,46.02609,21040,3,5,2,66.7
54844,wi,-91.23002,46.79286,1573,2,5,3,150
54845,wi,-92.17534,45.8004,196,4,7,3,75
54846,wi,-90.72112,46.37911,766,2,3,1,50
54847,wi,-91.40235,46.58715,5118,2,4,2,100
54848,wi,-91.09802,45.51791,7609,3,6,3,100
54849,wi,-91.72471,46.47651,2899,2,5,3,150
54850,wi,-90.62333,46.92009,1581,1,3,2,200
54853,wi,-92.44639,45.57002,5352,4,8,4,100
54854,wi,-91.67225,46.64855,1607,2,5,3,150
54855,wi,-90.8436,46.37431,1197,2,4,2,100
54856,wi,-91.13185,46.43988,4429,3,5,2,66.7
54857,wi,-91.60307,45.59492,77,3,7,4,133.3
54858,wi,-92.46416,45.5143,1620,4,8,4,100
54859,wi,-91.80168,46.1264,6607,3,6,3,100
54861,wi,-90.65668,46.61497,39,1,2,1,100
54862,wi,-91.11842,45.77724,1293,2,4,2,100
54864,wi,-91.79231,46.60494,1545,3,5,2,66.7
54865,wi,-91.37925,46.74665,1669,3,5,2,66.7
54867,wi,-91.22061,45.78494,1221,2,5,3,150
54868,wi,-91.71353,45.52597,10986,4,7,3,75
54870,wi,-91.77107,45.71622,4031,3,6,3,100
54871,wi,-92.01356,45.74345,4364,4,7,3,75
54872,wi,-92.39995,45.77021,4057,4,7,3,75
54873,wi,-91.67542,46.34637,7531,3,5,2,66.7
54874,wi,-91.94385,46.56696,5585,2,4,2,100
54875,wi,-91.69433,45.97002,3248,3,6,3,100
54876,wi,-91.50266,45.83049,5027,3,6,3,100
54880,wi,-92.12739,46.5906,21333,2,4,2,100
54888,wi,-91.88302,45.98085,4135,3,7,4,133.3
54889,wi,-92.17147,45.41584,3494,4,8,4,100
54891,wi,-90.96459,46.70051,3224,2,4,2,100
54893,wi,-92.30639,45.87114,8243,3,7,4,133.3
54895,wi,-91.44722,45.45095,2977,3,6,3,100
54896,wi,-90.88561,45.81336,7141,2,3,1,50
54901,wi,-88.53314,44.06285,11844,5,9,4,80
54902,wi,-88.53971,43.94927,10303,5,9,4,80
54904,wi,-88.62507,44.02152,10936,5,9,4,80
54909,wi,-89.35464,44.28417,3035,4,7,3,75
54911,wi,-88.38162,44.28166,9684,5,9,4,80
54913,wi,-88.39992,44.34148,9321,5,8,3,60
54914,wi,-88.47529,44.26387,11090,5,8,3,60
54915,wi,-88.35641,44.24247,14867,5,9,4,80
54921,wi,-89.56442,44.30245,2006,4,7,3,75
54922,wi,-88.74314,44.54247,1601,5,9,4,80
54923,wi,-88.96728,43.99779,6828,6,11,5,83.3
54927,wi,-88.65401,44.10168,329,5,9,4,80
54928,wi,-88.88736,44.73803,446,4,7,3,75
54929,wi,-88.74006,44.63664,6712,5,9,4,80
54930,wi,-89.5561,44.02805,3209,6,10,4,66.7
54931,wi,-88.67913,44.2745,186,5,9,4,80
54932,wi,-88.61351,43.83078,1188,5,9,4,80
54933,wi,-88.70533,44.66816,162,5,9,4,80
54934,wi,-88.83926,44.00281,123,6,10,4,66.7
54935,wi,-88.43516,43.77425,14716,5,9,4,80
54937,wi,-88.43035,43.76132,10842,5,9,4,80
54940,wi,-88.84424,44.22489,4975,5,10,5,100
54941,wi,-88.99317,43.84447,2961,7,12,5,71.4
54942,wi,-88.54784,44.29121,4558,4,8,4,100
54943,wi,-89.58365,44.12527,4197,5,10,5,100
54944,wi,-88.6278,44.32502,5719,5,8,3,60
54945,wi,-89.13692,44.57651,4435,4,8,4,100
54946,wi,-89.1444,44.3366,1,5,9,4,80
54947,wi,-88.68858,44.19997,2816,5,9,4,80
54948,wi,-88.86998,44.77715,530,4,7,3,75
54949,wi,-88.91258,44.4836,2933,5,9,4,80
54950,wi,-88.90538,44.65491,3268,4,8,4,100
54952,wi,-88.32888,44.20035,11075,5,9,4,80
54956,wi,-88.52766,44.18253,19503,5,9,4,80
54960,wi,-89.22341,43.94702,4911,6,12,6,100
54961,wi,-88.76119,44.40925,8934,5,9,4,80
54962,wi,-89.02257,44.48571,1695,5,9,4,80
54963,wi,-88.77451,44.04307,5696,5,10,5,100
54964,wi,-88.71957,43.92076,1342,5,10,5,100
54965,wi,-89.0327,44.16618,2087,5,10,5,100
54966,wi,-89.50418,44.2122,2459,4,8,4,100
54967,wi,-88.98359,44.13101,330,6,10,4,66.7
54968,wi,-89.13054,43.8492,3565,7,12,5,71.4
54970,wi,-89.09307,44.07209,3209,6,11,5,83.3
54971,wi,-88.82982,43.85611,7000,6,10,4,66.7
54974,wi,-88.66132,43.78366,1208,5,10,5,100
54977,wi,-89.16596,44.45795,1621,4,8,4,100
54979,wi,-88.5375,43.86868,1284,5,9,4,80
54980,wi,-88.76984,43.98381,214,6,10,4,66.7
54981,wi,-89.12441,44.32666,11421,5,9,4,80
54982,wi,-89.29135,44.07215,8509,6,11,5,83.3
54983,wi,-88.93356,44.31924,4245,6,10,4,66.7
54984,wi,-89.21755,44.1883,4672,5,10,5,100
54985,wi,-88.51847,44.07507,1,5,9,4,80
54986,wi,-88.74762,44.12075,4086,5,10,5,100
55001,mn,-92.81892,44.90172,1820,7,13,6,85.7
55003,mn,-92.77887,45.01185,1215,9,16,7,77.8
55005,mn,-93.21873,45.39245,2000,6,11,5,83.3
55006,mn,-93.20864,45.73821,2322,5,9,4,80
55007,mn,-93.12282,45.97514,2060,4,7,3,75
55008,mn,-93.27004,45.57272,8170,5,9,4,80
55009,mn,-92.86486,44.48303,5266,6,13,7,116.7
55011,mn,-93.25326,45.34074,4610,6,11,5,83.3
55012,mn,-92.79169,45.43784,1254,6,12,6,100
55013,mn,-92.89821,45.35437,3375,7,13,6,85.7
55014,mn,-93.12315,45.1642,10447,7,14,7,100
55016,mn,-92.9346,44.8177,13266,6,12,6,100
55017,mn,-93.43364,45.68015,608,5,9,4,80
55018,mn,-92.99563,44.42217,937,6,13,7,116.7
55019,mn,-93.24801,44.41447,1194,6,14,8,133.3
55020,mn,-93.36954,44.57626,1874,6,13,7,116.7
55021,mn,-93.27717,44.29979,12658,7,14,7,100
55024,mn,-93.13428,44.62994,11970,7,14,7,100
55025,mn,-93.02272,45.26258,11508,7,13,6,85.7
55026,mn,-92.34866,44.52648,461,8,15,7,87.5
55027,mn,-92.62089,44.40951,2101,7,14,7,100
55029,mn,-93.19836,45.63834,25,5,9,4,80
55030,mn,-93.11392,45.83954,1008,4,8,4,100
55031,mn,-92.96227,44.60805,1344,6,13,7,116.7
55032,mn,-92.9915,45.5882,2448,5,10,5,100
55033,mn,-92.86376,44.71292,12561,6,13,7,116.7
55036,mn,-93.11964,45.87122,96,4,8,4,100
55037,mn,-92.77545,46.013,6083,4,7,3,75
55038,mn,-92.97935,45.1687,9526,7,13,6,85.7
55040,mn,-93.27984,45.46854,7277,5,10,5,100
55041,mn,-92.32022,44.39402,5776,7,15,8,114.3
55042,mn,-92.89873,44.99194,5589,7,14,7,100
55043,mn,-92.76965,44.94087,2235,8,14,6,75
55044,mn,-93.27979,44.64092,21328,7,13,6,85.7
55045,mn,-92.83219,45.39476,4027,7,13,6,85.7
55046,mn,-93.41896,44.44863,2992,6,13,7,116.7
55047,mn,-92.82399,45.20245,2385,7,14,7,100
55049,mn,-93.22796,44.1766,1432,8,15,7,87.5
55051,mn,-93.30438,45.92779,4212,4,8,4,100
55052,mn,-93.43947,44.23221,1411,7,14,7,100
55053,mn,-93.06401,44.34656,813,6,14,8,133.3
55054,mn,-93.3503,44.57008,944,6,13,7,116.7
55055,mn,-92.99772,44.87382,1784,6,12,6,100
55056,mn,-92.95268,45.50873,6700,6,11,5,83.3
55057,mn,-93.17614,44.47129,8849,7,14,7,100
55060,mn,-93.22291,44.05901,14244,8,16,8,100
55063,mn,-92.90418,45.8363,7012,4,8,4,100
55065,mn,-93.01637,44.54686,928,7,14,7,100
55066,mn,-92.54502,44.51827,9442,7,14,7,100
55068,mn,-93.06863,44.73782,10678,7,13,6,85.7
55069,mn,-92.96547,45.69343,3353,5,9,4,80
55070,mn,-93.3881,45.41252,3180,5,10,5,100
55071,mn,-92.99653,44.82145,2488,6,12,6,100
55072,mn,-92.61831,46.14109,4559,3,6,3,100
55073,mn,-92.8251,45.27291,2085,7,13,6,85.7
55074,mn,-92.73342,45.38453,1494,7,13,6,85.7
55075,mn,-93.04089,44.88741,8124,6,12,6,100
55076,mn,-93.03398,44.83631,6492,6,12,6,100
55077,mn,-93.07362,44.81831,4075,6,12,6,100
55079,mn,-93.03308,45.41321,4262,7,13,6,85.7
55080,mn,-93.21459,45.66147,2146,5,9,4,80
55082,mn,-92.84041,45.07278,15493,8,15,7,87.5
55084,mn,-92.70623,45.45955,1255,6,12,6,100
55085,mn,-92.9631,44.67264,208,6,13,7,116.7
55087,mn,-93.3949,44.24854,140,7,14,7,100
55088,mn,-93.38696,44.53088,1141,6,13,7,116.7
55089,mn,-92.71596,44.58136,1445,6,13,7,116.7
55090,mn,-92.95727,45.05363,306,7,13,6,85.7
55092,mn,-93.07867,45.33658,4912,7,14,7,100
55101,mn,-93.09033,44.95127,330,7,13,6,85.7
55102,mn,-93.12157,44.93206,4595,7,13,6,85.7
55103,mn,-93.12443,44.9642,3046,7,14,7,100
55104,mn,-93.16216,44.95448,12278,7,13,6,85.7
55105,mn,-93.16805,44.93456,8159,7,13,6,85.7
55106,mn,-93.04828,44.9635,14577,7,13,6,85.7
55107,mn,-93.07955,44.93111,4444,6,12,6,100
55108,mn,-93.17541,44.98094,3601,7,14,7,100
55109,mn,-93.0261,45.01463,10397,7,13,6,85.7
55110,mn,-93.00625,45.09025,14742,7,14,7,100
55111,mn,-93.19855,44.87904,15,6,12,6,100
55112,mn,-93.18894,45.07659,13764,8,14,6,75
55113,mn,-93.15556,45.01302,12554,8,14,6,75
55114,mn,-93.19437,44.96609,594,7,13,6,85.7
55115,mn,-92.95334,45.06767,3755,7,13,6,85.7
55116,mn,-93.17035,44.9097,6670,7,13,6,85.7
55117,mn,-93.09689,44.99937,11545,7,14,7,100
55118,mn,-93.10357,44.89657,9151,6,12,6,100
55119,mn,-93.00939,44.93792,11650,6,12,6,100
55120,mn,-93.14911,44.87252,1730,6,12,6,100
55121,mn,-93.15428,44.84706,2128,6,12,6,100
55122,mn,-93.19768,44.80468,9647,6,12,6,100
55123,mn,-93.13753,44.80466,8523,6,13,7,116.7
55124,mn,-93.20075,44.74557,15872,7,13,6,85.7
55125,mn,-92.94395,44.91989,14357,6,12,6,100
55126,mn,-93.13254,45.08481,9579,8,14,6,75
55127,mn,-93.08265,45.08412,7131,8,14,6,75
55128,mn,-92.96393,44.98799,9807,7,13,6,85.7
55129,mn,-92.90677,44.89404,9971,6,13,7,116.7
55130,mn,-93.08261,44.97306,3446,7,14,7,100
55150,mn,-93.16415,44.88687,169,6,12,6,100
55155,mn,-93.08268,44.95603,21,7,14,7,100
55301,mn,-93.65865,45.24783,5511,6,11,5,83.3
55302,mn,-94.11895,45.24267,5883,5,11,6,120
55303,mn,-93.42304,45.28859,18499,6,12,6,100
55304,mn,-93.26546,45.25575,18451,6,12,6,100
55305,mn,-93.43228,44.95473,5396,6,12,6,100
55306,mn,-93.29201,44.73072,3910,6,13,7,116.7
55307,mn,-94.1024,44.60336,2158,7,14,7,100
55308,mn,-93.83602,45.43027,4207,5,11,6,120
55309,mn,-93.73907,45.37997,8861,6,11,5,83.3
55310,mn,-94.88072,44.7592,1588,7,13,6,85.7
55311,mn,-93.49479,45.10486,12501,6,11,5,83.3
55312,mn,-94.34221,44.70468,1326,7,14,7,100
55313,mn,-93.85146,45.17379,11215,6,11,5,83.3
55314,mn,-94.59938,44.76935,1312,7,13,6,85.7
55315,mn,-93.68695,44.71846,2484,8,15,7,87.5
55316,mn,-93.39035,45.17023,8131,6,12,6,100
55317,mn,-93.55195,44.85806,8934,6,13,7,116.7
55318,mn,-93.63668,44.81107,11616,7,14,7,100
55319,mn,-93.94421,45.47351,3388,5,10,5,100
55320,mn,-94.08708,45.39592,3259,5,10,5,100
55321,mn,-94.19275,45.08407,3331,6,11,5,83.3
55322,mn,-93.78576,44.77014,1831,6,12,6,100
55324,mn,-94.42347,45.05612,1248,6,11,5,83.3
55325,mn,-94.31908,45.08377,3594,6,11,5,83.3
55327,mn,-93.47576,45.19867,2583,6,12,6,100
55328,mn,-93.81318,45.03576,4375,6,11,5,83.3
55329,mn,-94.57185,45.30923,1531,5,11,6,120
55330,mn,-93.56788,45.33433,16612,6,11,5,83.3
55331,mn,-93.60396,44.8995,8713,6,12,6,100
55332,mn,-94.70944,44.52043,1942,7,14,7,100
55333,mn,-94.86712,44.56021,1019,7,14,7,100
55334,mn,-94.20761,44.54168,1952,8,15,7,87.5
55335,mn,-94.54719,44.52994,1687,7,14,7,100
55336,mn,-94.18115,44.77083,4585,7,14,7,100
55337,mn,-93.27503,44.77671,12707,6,12,6,100
55338,mn,-93.99814,44.66946,968,7,13,6,85.7
55339,mn,-93.95635,44.72706,554,6,13,7,116.7
55340,mn,-93.57576,45.07622,3910,5,11,6,120
55341,mn,-93.65916,45.15922,1271,5,11,6,120
55342,mn,-94.73173,44.74278,2182,7,13,6,85.7
55343,mn,-93.41635,44.91432,6515,6,12,6,100
55344,mn,-93.43081,44.86426,2458,6,12,6,100
55345,mn,-93.48378,44.91526,8400,6,12,6,100
55346,mn,-93.48326,44.87844,5920,6,12,6,100
55347,mn,-93.46637,44.82934,11194,6,13,7,116.7
55349,mn,-94.07407,45.05959,2732,6,11,5,83.3
55350,mn,-94.3939,44.89538,9014,6,13,7,116.7
55352,mn,-93.58765,44.655,4181,6,12,6,100
55353,mn,-94.31536,45.32195,2363,5,10,5,100
55354,mn,-94.06874,44.88304,1479,6,13,7,116.7
55355,mn,-94.53993,45.09863,6356,5,11,6,120
55356,mn,-93.58802,44.99306,2623,5,11,6,120
55357,mn,-93.65973,45.09913,1488,5,10,5,100
55358,mn,-93.99592,45.25161,3694,6,11,5,83.3
55359,mn,-93.70127,45.00503,2993,5,11,6,120
55360,mn,-93.9196,44.90863,1574,6,12,6,100
55362,mn,-93.83156,45.30048,8261,6,11,5,83.3
55363,mn,-93.91388,45.04415,2342,6,11,5,83.3
55364,mn,-93.67277,44.93742,6942,6,11,5,83.3
55366,mn,-94.23206,44.67265,305,7,14,7,100
55367,mn,-93.97726,44.89508,634,6,12,6,100
55368,mn,-93.89419,44.74171,1135,6,12,6,100
55369,mn,-93.44632,45.12648,13821,6,12,6,100
55370,mn,-94.03897,44.77739,576,7,13,6,85.7
55371,mn,-93.59086,45.58009,8989,5,10,5,100
55372,mn,-93.41126,44.67754,14260,6,12,6,100
55373,mn,-93.72377,45.08819,2204,5,10,5,100
55374,mn,-93.5796,45.17644,6277,6,12,6,100
55375,mn,-93.74284,44.89694,1609,6,12,6,100
55376,mn,-93.68729,45.21059,7055,6,11,5,83.3
55378,mn,-93.36307,44.7574,11411,6,13,7,116.7
55379,mn,-93.51621,44.75419,16047,7,13,6,85.7
55381,mn,-94.18751,44.92665,1386,6,12,6,100
55382,mn,-94.20459,45.30635,3375,5,10,5,100
55384,mn,-93.63201,44.93681,394,6,11,5,83.3
55385,mn,-94.49125,44.73836,1306,7,14,7,100
55386,mn,-93.66789,44.86265,3306,6,12,6,100
55387,mn,-93.77568,44.85671,5703,6,12,6,100
55388,mn,-93.84551,44.94944,2618,6,12,6,100
55389,mn,-94.43976,45.29688,1871,5,10,5,100
55390,mn,-93.97955,45.06522,2060,6,11,5,83.3
55391,mn,-93.54204,44.95942,7234,6,11,5,83.3
55395,mn,-94.06547,44.95342,1518,6,12,6,100
55396,mn,-94.367,44.54552,1965,8,15,7,87.5
55397,mn,-93.93413,44.81566,1397,6,12,6,100
55398,mn,-93.59846,45.46403,7972,5,10,5,100
55401,mn,-93.26945,44.98481,583,7,14,7,100
55402,mn,-93.27144,44.97604,119,7,13,6,85.7
55403,mn,-93.28574,44.97003,1287,7,13,6,85.7
55404,mn,-93.26121,44.962,2452,7,13,6,85.7
55405,mn,-93.30476,44.97024,3615,6,13,7,116.7
55406,mn,-93.22109,44.93961,12312,7,13,6,85.7
55407,mn,-93.25285,44.93501,10323,6,13,7,116.7
55408,mn,-93.29206,44.93993,5121,7,13,6,85.7
55409,mn,-93.28148,44.93033,3592,6,12,6,100
55410,mn,-93.31964,44.91182,7656,6,12,6,100
55411,mn,-93.29838,44.99928,7962,7,13,6,85.7
55412,mn,-93.29981,45.02702,8251,7,13,6,85.7
55413,mn,-93.24177,44.99893,3631,7,14,7,100
55414,mn,-93.22648,44.97936,3730,7,14,7,100
55415,mn,-93.25765,44.9748,197,7,13,6,85.7
55416,mn,-93.33883,44.94928,8301,6,12,6,100
55417,mn,-93.23093,44.9041,9707,6,12,6,100
55418,mn,-93.24283,45.0212,11023,8,14,6,75
55419,mn,-93.28734,44.90596,9586,6,12,6,100
55420,mn,-93.27781,44.83585,6791,6,12,6,100
55421,mn,-93.25314,45.0509,8989,7,14,7,100
55422,mn,-93.33952,45.00906,10415,7,13,6,85.7
55423,mn,-93.2821,44.87625,10652,6,12,6,100
55424,mn,-93.33977,44.90521,3557,6,12,6,100
55425,mn,-93.23645,44.84221,2091,6,12,6,100
55426,mn,-93.38087,44.95529,7991,6,12,6,100
55427,mn,-93.38027,45.00627,7726,6,12,6,100
55428,mn,-93.38122,45.06321,8368,6,12,6,100
55429,mn,-93.34138,45.06453,7060,6,12,6,100
55430,mn,-93.30129,45.06396,6821,7,14,7,100
55431,mn,-93.31242,44.82608,6392,6,12,6,100
55432,mn,-93.25471,45.09697,10848,7,14,7,100
55433,mn,-93.31642,45.16133,11584,7,13,6,85.7
55434,mn,-93.25045,45.16809,10216,7,13,6,85.7
55435,mn,-93.33469,44.87351,1847,6,11,5,83.3
55436,mn,-93.37406,44.90342,4442,6,11,5,83.3
55437,mn,-93.34525,44.82458,5663,6,12,6,100
55438,mn,-93.3782,44.82496,5278,6,12,6,100
55439,mn,-93.37566,44.87513,3193,6,11,5,83.3
55441,mn,-93.42834,45.00461,5375,6,12,6,100
55442,mn,-93.42691,45.04855,3938,6,12,6,100
55443,mn,-93.33714,45.11949,10662,6,12,6,100
55444,mn,-93.30217,45.10593,4990,7,13,6,85.7
55445,mn,-93.37972,45.12326,4173,6,12,6,100
55446,mn,-93.48754,45.04405,9170,5,11,6,120
55447,mn,-93.48917,45.00112,7030,5,11,6,120
55448,mn,-93.30206,45.19072,10550,7,13,6,85.7
55449,mn,-93.19459,45.17278,12324,7,13,6,85.7
55450,mn,-93.22709,44.87902,50,6,12,6,100
55454,mn,-93.24212,44.96964,446,7,13,6,85.7
55455,mn,-93.23307,44.97365,30,7,13,6,85.7
55601,mn,-91.36017,47.23656,590,0,1,1,NA
55602,mn,-91.87937,47.34149,1474,1,1,0,0
55603,mn,-91.26393,47.5584,7055,0,1,1,NA
55604,mn,-90.56459,47.96001,6839,0,0,0,NA
55605,mn,-89.73947,47.96458,474,0,0,0,NA
55606,mn,-89.99775,47.93524,1425,0,0,0,NA
55607,mn,-91.51829,47.62179,9275,1,1,0,0
55609,mn,-91.78106,46.97064,525,1,2,1,100
55612,mn,-90.70131,47.77267,2182,0,0,0,NA
55613,mn,-90.95746,47.60686,743,0,0,0,NA
55614,mn,-91.38213,47.36677,6163,0,1,1,NA
55615,mn,-90.83287,47.73509,926,0,0,0,NA
55616,mn,-91.65901,47.18649,10362,1,1,0,0
55702,mn,-92.67355,46.95297,968,1,3,2,200
55703,mn,-92.78148,47.74204,1766,1,2,1,100
55704,mn,-92.7683,46.20398,1124,3,5,2,66.7
55705,mn,-92.20302,47.44901,4009,1,2,1,100
55706,mn,-91.96488,47.7248,2499,1,2,1,100
55707,mn,-92.64833,46.54616,4526,2,4,2,100
55708,mn,-92.33915,47.57195,879,1,2,1,100
55709,mn,-93.37108,47.42659,6453,1,3,2,200
55710,mn,-92.71535,47.6255,2248,1,2,1,100
55711,mn,-92.69909,46.84447,1045,1,3,2,200
55712,mn,-92.49977,46.29373,1356,2,4,2,100
55713,mn,-92.76722,47.49063,820,1,2,1,100
55716,mn,-93.26724,47.31918,302,1,3,2,200
55717,mn,-92.39246,47.05817,1005,1,2,1,100
55718,mn,-92.48532,46.62315,3209,2,4,2,100
55719,mn,-92.87243,47.55559,4310,1,2,1,100
55720,mn,-92.54073,46.75458,10903,2,4,2,100
55721,mn,-93.68695,47.21984,3673,2,3,1,50
55722,mn,-93.43921,47.27937,794,2,3,1,50
55723,mn,-92.93523,47.82292,9447,1,2,1,100
55724,mn,-92.36187,47.17903,2678,1,2,1,100
55725,mn,-92.30229,48.25998,1202,1,2,1,100
55726,mn,-92.83129,46.67405,2270,2,4,2,100
55731,mn,-91.65214,47.97734,20813,1,2,1,100
55732,mn,-92.21365,47.67763,3079,1,2,1,100
55733,mn,-92.36295,46.70914,3015,1,3,2,200
55734,mn,-92.47244,47.35764,5149,1,2,1,100
55735,mn,-93.02395,46.21685,2967,3,5,2,66.7
55736,mn,-92.93799,46.96359,3695,1,3,2,200
55738,mn,-92.67241,47.27435,1424,1,2,1,100
55741,mn,-92.39794,47.46336,3300,1,2,1,100
55742,mn,-93.13651,47.19557,912,1,3,2,200
55744,mn,-93.51152,47.23484,16427,2,3,1,50
55746,mn,-92.95285,47.36126,12834,1,2,1,100
55748,mn,-93.62391,47.00804,2386,2,3,1,50
55749,mn,-92.42723,46.44527,1574,2,4,2,100
55750,mn,-91.96586,47.52208,2861,1,2,1,100
55751,mn,-92.66105,47.39856,1577,1,2,1,100
55752,mn,-93.27739,46.95313,2254,2,4,2,100
55753,mn,-93.08157,47.39544,602,1,2,1,100
55756,mn,-92.59252,46.36669,811,2,4,2,100
55757,mn,-92.93708,46.51487,2322,2,4,2,100
55758,mn,-92.72583,47.50953,213,1,2,1,100
55760,mn,-93.24356,46.64188,10983,2,4,2,100
55763,mn,-92.14925,47.32619,2214,1,2,1,100
55764,mn,-93.31057,47.32772,446,1,3,2,200
55765,mn,-92.76077,47.10841,1798,1,3,2,200
55766,mn,-92.42746,47.25814,274,1,2,1,100
55767,mn,-92.75918,46.4507,3379,2,5,3,150
55768,mn,-92.68649,47.4867,3101,1,2,1,100
55769,mn,-93.18887,47.48495,3900,1,2,1,100
55771,mn,-92.85611,48.14378,11094,1,3,2,200
55772,mn,-93.1554,48.09478,197,1,3,2,200
55775,mn,-93.16782,47.31309,2245,1,2,1,100
55779,mn,-92.44457,46.91577,3635,1,2,1,100
55780,mn,-92.69274,46.68308,605,2,4,2,100
55781,mn,-93.04239,47.66709,2083,1,2,1,100
55782,mn,-92.20489,47.82308,594,1,2,1,100
55783,mn,-92.88291,46.39641,3518,2,5,3,150
55784,mn,-93.18747,47.05252,454,2,3,1,50
55785,mn,-93.74636,46.92316,1332,2,4,2,100
55786,mn,-93.39041,47.31638,301,2,3,1,50
55787,mn,-93.11218,46.68002,1596,2,4,2,100
55790,mn,-92.2844,47.93487,6021,1,2,1,100
55792,mn,-92.48722,47.60046,6461,1,2,1,100
55793,mn,-93.28404,47.11592,1371,2,3,1,50
55795,mn,-92.86288,46.3139,1981,3,5,2,66.7
55797,mn,-92.36875,46.56512,1922,2,4,2,100
55798,mn,-92.98051,46.71836,1942,2,3,1,50
55802,mn,-92.07015,46.75153,2755,2,3,1,50
55803,mn,-92.05549,47.04748,12208,1,2,1,100
55804,mn,-91.93177,46.93022,9727,1,2,1,100
55805,mn,-92.09579,46.80082,3789,1,3,2,200
55806,mn,-92.12835,46.76817,5968,1,3,2,200
55807,mn,-92.1685,46.73523,8083,1,3,2,200
55808,mn,-92.23804,46.67676,5152,1,3,2,200
55810,mn,-92.27301,46.7596,6342,1,2,1,100
55811,mn,-92.22245,46.84221,14440,1,2,1,100
55812,mn,-92.07109,46.80831,3076,1,3,2,200
55814,mn,-92.19768,46.83371,2,1,1,0,0
55901,mn,-92.50689,44.06975,19101,6,13,7,116.7
55902,mn,-92.51586,43.96723,9916,5,11,6,120
55904,mn,-92.40058,43.95992,10794,5,11,6,120
55905,mn,-92.52591,44.05595,7,6,13,7,116.7
55906,mn,-92.4053,44.10732,8131,6,13,7,116.7
55909,mn,-92.73367,43.56208,1054,5,11,6,120
55910,mn,-91.97332,44.13294,1585,7,13,6,85.7
55912,mn,-92.99022,43.68156,13989,5,12,7,140
55917,mn,-93.07101,43.87833,2919,6,13,7,116.7
55918,mn,-92.84647,43.74083,719,5,11,6,120
55919,mn,-91.29394,43.61876,936,7,15,8,114.3
55920,mn,-92.62203,44.01381,4085,6,13,7,116.7
55921,mn,-91.46262,43.62304,4220,5,11,6,120
55922,mn,-91.90093,43.55897,950,5,11,6,120
55923,mn,-92.1861,43.85103,3207,5,11,6,120
55924,mn,-93.01689,44.03027,1153,7,14,7,100
55925,mn,-91.46228,43.90904,816,6,12,6,100
55926,mn,-92.70687,43.74323,762,4,10,6,150
55927,mn,-92.87104,44.0343,2348,7,14,7,100
55929,mn,-92.1397,43.97679,855,5,11,6,120
55931,mn,-91.39582,43.51402,463,6,12,6,100
55932,mn,-92.30189,44.13909,1225,6,13,7,116.7
55933,mn,-92.68059,43.646,289,4,10,6,150
55934,mn,-92.26426,44.00401,1926,5,11,6,120
55935,mn,-92.12606,43.74892,1020,5,11,6,120
55936,mn,-92.58372,43.71379,1390,4,10,6,150
55939,mn,-92.09168,43.5434,1826,5,11,6,120
55940,mn,-92.80425,43.89492,1683,5,12,7,140
55941,mn,-91.34829,43.72567,794,6,12,6,100
55943,mn,-91.58399,43.79081,3227,6,13,7,116.7
55944,mn,-92.73787,43.98771,3504,7,14,7,100
55945,mn,-92.06608,44.2709,1681,7,15,8,114.3
55946,mn,-92.96188,44.26965,2490,7,14,7,100
55947,mn,-91.35786,43.82475,4088,8,15,7,87.5
55949,mn,-91.9379,43.71261,2190,5,12,7,140
55950,mn,-92.96448,43.7471,109,5,12,7,140
55951,mn,-92.48139,43.53644,1433,5,12,7,140
55952,mn,-91.84358,43.94334,1428,5,11,6,120
55953,mn,-92.9666,43.52661,751,6,13,7,116.7
55954,mn,-91.78082,43.56469,1509,5,11,6,120
55955,mn,-92.73983,44.08927,1388,7,15,8,114.3
55956,mn,-92.52954,44.28345,1518,7,14,7,100
55957,mn,-92.2827,44.25104,660,7,14,7,100
55959,mn,-91.78448,44.11014,1143,7,14,7,100
55960,mn,-92.53734,44.14077,2007,7,14,7,100
55961,mn,-92.47377,43.60841,434,5,11,6,120
55962,mn,-91.84181,43.76171,1049,5,11,6,120
55963,mn,-92.66251,44.18981,3202,7,15,8,114.3
55964,mn,-92.15669,44.16444,2698,6,13,7,116.7
55965,mn,-92.12661,43.62845,2576,5,11,6,120
55967,mn,-92.51339,43.79516,674,4,10,6,150
55968,mn,-92.08934,44.39774,167,7,14,7,100
55969,mn,-91.87729,44.08248,808,6,13,7,116.7
55970,mn,-92.83193,43.59524,934,5,12,7,140
55971,mn,-91.75539,43.81589,2299,5,11,6,120
55972,mn,-92.04896,43.99622,2795,5,11,6,120
55973,mn,-92.77286,43.80625,329,5,11,6,120
55974,mn,-91.64952,43.58031,1971,5,11,6,120
55975,mn,-92.37188,43.67539,3814,5,10,5,100
55976,mn,-92.48737,43.86432,3832,4,10,6,150
55977,mn,-92.64805,43.5558,253,5,11,6,120
55979,mn,-91.95093,43.9204,831,5,11,6,120
55981,mn,-92.067,44.35553,3839,7,14,7,100
55982,mn,-92.88475,43.81577,408,5,11,6,120
55983,mn,-92.80942,44.28609,1283,7,15,8,114.3
55985,mn,-92.90357,44.15828,1528,7,15,8,114.3
55987,mn,-91.63468,43.98521,13959,7,13,6,85.7
55990,mn,-92.26179,43.73221,1024,5,11,6,120
55991,mn,-92.41929,44.25816,1486,7,14,7,100
55992,mn,-92.68208,44.30606,3093,7,15,8,114.3
56001,mn,-93.977,44.13203,17537,7,14,7,100
56003,mn,-94.08858,44.2127,5975,7,15,8,114.3
56007,mn,-93.32526,43.66037,11626,6,13,7,116.7
56009,mn,-93.55582,43.66367,1595,6,13,7,116.7
56010,mn,-94.17808,43.89116,1305,8,16,8,100
56011,mn,-93.77421,44.60235,4696,6,12,6,100
56013,mn,-94.10562,43.62263,4137,7,15,8,114.3
56014,mn,-93.82583,43.58271,1052,7,15,8,114.3
56016,mn,-93.34549,43.76362,765,6,13,7,116.7
56017,mn,-93.82022,44.30705,1571,7,13,6,85.7
56019,mn,-94.89323,44.11269,1228,7,14,7,100
56020,mn,-93.53817,43.60813,113,6,13,7,116.7
56021,mn,-94.31381,44.28391,987,8,15,7,87.5
56022,mn,-94.83936,44.05355,60,7,15,8,114.3
56023,mn,-94.01337,43.77552,799,7,15,8,114.3
56024,mn,-93.84781,44.15131,1463,6,13,7,116.7
56025,mn,-93.91077,43.75162,747,7,15,8,114.3
56026,mn,-93.29277,43.87554,2038,6,14,8,133.3
56027,ia,-94.11985,43.51152,1499,7,15,8,114.3
56028,mn,-93.70933,44.22506,1364,7,14,7,100
56029,mn,-93.52423,43.52654,735,6,14,8,133.3
56031,mn,-94.46737,43.62216,6731,6,13,7,116.7
56032,mn,-93.55979,43.76281,199,6,14,8,133.3
56033,mn,-93.93077,43.56018,606,7,15,8,114.3
56034,mn,-94.18334,44.03066,574,8,16,8,100
56035,mn,-93.2687,43.8215,332,6,14,8,133.3
56036,mn,-93.2205,43.55142,2067,6,13,7,116.7
56037,mn,-94.04886,44.01868,1434,8,16,8,100
56039,mn,-94.32584,43.66114,1138,6,14,8,133.3
56041,mn,-94.52892,44.15271,1221,8,15,7,87.5
56042,mn,-93.48355,43.80418,786,6,13,7,116.7
56043,mn,-93.22321,43.64832,447,6,13,7,116.7
56044,mn,-93.93487,44.56176,1936,7,14,7,100
56045,mn,-93.21301,43.75944,999,6,13,7,116.7
56046,mn,-93.27145,43.96452,79,7,15,8,114.3
56047,mn,-94.23349,43.73226,105,6,13,7,116.7
56048,mn,-93.7189,44.09288,3126,7,14,7,100
56050,mn,-93.95312,44.26484,1119,6,13,7,116.7
56051,mn,-93.71057,43.5375,667,7,14,7,100
56052,mn,-93.55361,44.32009,890,7,14,7,100
56054,mn,-94.37375,44.43522,945,8,15,7,87.5
56055,mn,-94.24571,44.12821,2991,8,16,8,100
56056,mn,-94.57957,44.0727,95,8,16,8,100
56057,mn,-93.71552,44.39455,2533,6,13,7,116.7
56058,mn,-93.91542,44.44501,3989,7,15,8,114.3
56060,mn,-94.44547,43.93274,430,8,16,8,100
56062,mn,-94.41483,44.0474,2265,8,16,8,100
56063,mn,-93.82016,44.21913,2540,6,13,7,116.7
56065,mn,-93.91869,43.93682,2300,8,16,8,100
56068,mn,-93.80599,43.86448,1143,8,15,7,87.5
56069,mn,-93.55375,44.41823,2922,6,13,7,116.7
56071,mn,-93.58185,44.53702,6045,5,12,7,140
56072,mn,-93.51481,43.89744,2146,6,14,8,133.3
56073,mn,-94.46741,44.30582,10074,8,15,7,87.5
56074,mn,-94.20065,44.32303,1630,7,15,8,114.3
56075,mn,-94.43669,43.73505,99,6,14,8,133.3
56078,mn,-93.76565,44.00595,389,7,15,8,114.3
56080,mn,-93.8545,44.08042,334,7,15,8,114.3
56081,mn,-94.62912,43.99128,3753,8,16,8,100
56082,mn,-94.03246,44.35225,5618,7,15,8,114.3
56083,mn,-95.13522,44.20557,855,6,13,7,116.7
56085,mn,-94.7362,44.29334,4605,7,15,8,114.3
56087,mn,-94.97456,44.24007,2626,6,13,7,116.7
56088,mn,-94.44567,43.82612,1839,7,15,8,114.3
56089,mn,-93.4309,43.56101,94,6,13,7,116.7
56090,mn,-94.23975,43.95748,783,9,17,8,88.9
56091,mn,-93.6857,43.92733,393,7,15,8,114.3
56093,mn,-93.51474,44.06461,6963,7,14,7,100
56096,mn,-93.59753,44.24278,2334,7,14,7,100
56097,mn,-93.71626,43.72404,3411,7,15,8,114.3
56098,mn,-94.18565,43.77415,2340,7,14,7,100
56101,mn,-95.13731,43.88313,4417,7,15,8,114.3
56110,mn,-95.94211,43.62071,1567,6,12,6,100
56111,mn,-94.88191,43.63928,542,6,13,7,116.7
56113,mn,-96.15365,44.39938,352,4,9,5,125
56114,mn,-95.59836,43.97699,355,5,11,6,120
56115,mn,-95.8983,44.21648,1567,4,10,6,150
56116,mn,-96.38156,43.61495,580,6,12,6,100
56117,mn,-95.6853,43.52855,386,5,11,6,120
56118,mn,-95.03208,43.93825,669,7,15,8,114.3
56119,mn,-95.46885,43.71169,1175,5,11,6,120
56120,mn,-94.79217,43.96233,1159,7,15,8,114.3
56121,mn,-94.61116,43.53782,708,6,14,8,133.3
56122,mn,-95.95323,43.89662,349,4,10,6,150
56123,mn,-95.59616,44.08548,576,5,11,6,120
56125,mn,-95.55287,44.05819,8,5,11,6,120
56127,mn,-94.77439,43.5478,588,6,13,7,116.7
56128,mn,-96.1156,43.88148,1819,5,10,5,100
56129,mn,-96.04066,43.52818,744,7,15,8,114.3
56131,mn,-95.57783,43.86004,1546,5,11,6,120
56132,mn,-95.75857,44.2056,835,5,10,5,100
56134,mn,-96.23841,43.7957,519,5,11,6,120
56136,mn,-96.39684,44.50244,1366,4,8,4,100
56137,mn,-95.32683,43.83492,1426,6,12,6,100
56138,mn,-96.38768,43.53379,653,7,14,7,100
56139,mn,-96.17725,44.10293,523,4,9,5,125
56140,mn,-96.3681,43.90892,79,5,10,5,100
56141,mn,-95.7901,43.87878,312,5,10,5,100
56142,mn,-96.23253,44.47156,1102,4,9,5,125
56143,mn,-95.00407,43.63212,3709,6,12,6,100
56144,mn,-96.39176,43.85182,1187,5,10,5,100
56145,mn,-95.17572,44.05473,687,6,13,7,116.7
56146,mn,-96.10343,43.58006,40,7,14,7,100
56147,mn,-96.06163,43.75939,284,5,11,6,120
56149,mn,-96.30745,44.30096,1482,3,8,5,166.7
56150,mn,-95.21106,43.63561,2617,5,12,7,140
56151,mn,-95.92804,44.03238,693,4,10,6,150
56152,mn,-95.27344,44.23054,1088,6,13,7,116.7
56153,mn,-96.01099,43.83312,198,5,10,5,100
56155,mn,-95.94076,43.76848,519,5,11,6,120
56156,mn,-96.226,43.66278,3956,6,13,7,116.7
56157,mn,-95.94807,44.39636,704,5,10,5,100
56158,mn,-96.07366,43.63907,449,6,13,7,116.7
56159,mn,-94.93217,43.94159,2378,7,14,7,100
56160,mn,-94.80802,43.83476,285,6,14,8,133.3
56161,mn,-95.3236,43.70867,426,5,12,7,140
56162,mn,-94.66875,43.8417,335,7,14,7,100
56164,mn,-96.33917,44.05662,4499,5,10,5,100
56165,mn,-95.71049,43.7247,377,5,11,6,120
56166,mn,-95.37236,44.19998,260,5,12,7,140
56167,mn,-95.40262,43.55151,752,5,12,7,140
56168,mn,-95.80622,43.61749,1036,6,12,6,100
56169,mn,-96.00497,44.33379,723,4,9,5,125
56170,mn,-96.0871,44.1682,809,4,9,5,125
56171,mn,-94.76518,43.66765,1671,6,13,7,116.7
56172,mn,-95.77084,44.00889,1396,5,10,5,100
56173,mn,-96.24598,43.52471,422,7,15,8,114.3
56174,mn,-95.30553,44.01598,526,6,13,7,116.7
56175,mn,-95.63527,44.25516,2524,4,10,6,150
56176,mn,-94.72411,43.78443,1019,6,14,8,133.3
56177,mn,-96.25287,43.88913,49,5,10,5,100
56178,mn,-96.13123,44.28482,1481,4,8,4,100
56180,mn,-95.46529,44.24593,827,5,12,7,140
56181,mn,-94.61732,43.67986,1066,6,13,7,116.7
56183,mn,-95.42782,44.02939,1488,5,12,7,140
56185,mn,-95.82542,43.79205,633,5,11,6,120
56186,mn,-96.08164,44.0303,541,4,9,5,125
56187,mn,-95.58288,43.62387,1633,5,11,6,120
56201,mn,-95.04193,45.10157,10528,5,10,5,100
56207,mn,-96.06942,45.49683,429,6,10,4,66.7
56208,mn,-96.0042,45.2425,2407,7,13,6,85.7
56209,mn,-94.80078,45.12427,2331,5,11,6,120
56210,mn,-96.56538,45.5599,57,6,11,5,83.3
56211,mn,-96.69187,45.57995,1199,7,12,5,71.4
56212,mn,-96.33199,45.13696,590,8,13,5,62.5
56214,mn,-95.32623,44.60675,546,7,14,7,100
56215,mn,-95.57231,45.31145,3780,6,11,5,83.3
56216,mn,-95.05654,44.93657,615,6,12,6,100
56218,mn,-95.94558,44.82442,992,7,13,6,85.7
56219,mn,-96.81994,45.59973,1176,7,12,5,71.4
56220,mn,-96.29413,44.73184,3003,6,12,6,100
56221,mn,-96.19632,45.55514,1217,6,10,4,66.7
56222,mn,-95.36162,44.98416,1630,6,12,6,100
56223,mn,-95.81929,44.76193,1591,7,13,6,85.7
56224,mn,-95.05105,44.37436,339,6,13,7,116.7
56225,mn,-96.4369,45.45314,1273,6,11,5,83.3
56226,mn,-95.67231,45.41613,375,6,11,5,83.3
56227,mn,-96.16584,45.29285,671,6,11,5,83.3
56228,mn,-94.67708,44.93687,876,6,12,6,100
56229,mn,-95.71811,44.59329,1621,7,13,6,85.7
56230,mn,-95.09239,44.79298,823,6,13,7,116.7
56231,mn,-95.76136,45.28237,774,6,12,6,100
56232,mn,-96.03834,44.93054,2230,8,14,6,75
56235,mn,-96.01917,45.70422,920,6,10,4,66.7
56236,mn,-96.41059,45.65975,811,6,11,5,83.3
56237,mn,-95.43249,44.61646,749,7,13,6,85.7
56239,mn,-95.91042,44.5042,498,5,11,6,120
56240,mn,-96.47539,45.56403,1425,6,11,5,83.3
56241,mn,-95.57913,44.79695,3648,8,15,7,87.5
56243,mn,-94.68214,45.16767,1538,5,11,6,120
56244,mn,-95.78306,45.48195,1477,6,10,4,66.7
56245,mn,-95.68116,44.68439,649,7,14,7,100
56248,mn,-96.13681,45.79566,1196,6,11,5,83.3
56249,mn,-95.89862,45.31551,584,6,12,6,100
56251,mn,-94.91823,45.14244,743,5,10,5,100
56252,mn,-95.30208,45.18112,1012,6,11,5,83.3
56253,mn,-94.87981,44.96365,1589,6,12,6,100
56255,mn,-95.41861,44.39596,335,6,13,7,116.7
56256,mn,-96.19794,45.02505,2456,9,15,6,66.7
56257,mn,-96.39806,44.97107,668,7,13,6,85.7
56258,mn,-95.76042,44.44391,7074,5,11,6,120
56260,mn,-95.48297,44.96583,1152,7,13,6,85.7
56262,mn,-95.86474,45.11815,926,7,13,6,85.7
56263,mn,-95.54374,44.41485,400,6,12,6,100
56264,mn,-95.97941,44.57051,1942,6,11,5,83.3
56265,mn,-95.69633,45.00481,6552,7,12,5,71.4
56266,mn,-94.91733,44.42394,1129,7,14,7,100
56267,mn,-95.93005,45.58457,4265,6,10,4,66.7
56270,mn,-94.99142,44.56742,813,8,15,7,87.5
56271,mn,-95.41172,45.2447,1538,6,11,5,83.3
56273,mn,-94.96526,45.3213,4134,6,11,5,83.3
56274,mn,-96.24571,45.90222,493,6,11,5,83.3
56276,mn,-96.31462,45.24266,560,6,12,6,100
56277,mn,-94.99499,44.76531,2353,7,13,6,85.7
56278,mn,-96.37811,45.34714,2887,6,11,5,83.3
56279,mn,-95.17397,45.21738,1135,5,10,5,100
56280,mn,-96.16852,44.63289,624,6,11,5,83.3
56281,mn,-95.16927,44.95323,428,6,12,6,100
56282,mn,-95.22591,45.03884,1358,6,12,6,100
56283,mn,-95.14208,44.53276,1789,7,14,7,100
56284,mn,-95.20233,44.78467,2089,7,13,6,85.7
56285,mn,-95.34904,44.78885,1478,7,13,6,85.7
56287,mn,-95.32624,44.47543,10,7,13,6,85.7
56288,mn,-94.95238,45.2418,4277,6,11,5,83.3
56289,mn,-95.22659,45.33177,945,5,10,5,100
56291,mn,-96.06834,44.62354,659,6,12,6,100
56292,mn,-95.45712,44.49818,494,6,13,7,116.7
56293,mn,-95.26533,44.41691,685,6,13,7,116.7
56294,mn,-95.21303,44.3149,5,6,13,7,116.7
56295,mn,-95.83403,45.04121,478,7,12,5,71.4
56296,mn,-96.46749,45.82867,2736,7,12,5,71.4
56297,mn,-95.54301,44.6368,902,7,14,7,100
56301,mn,-94.24234,45.48813,10326,4,9,5,125
56303,mn,-94.2116,45.57442,9434,4,8,4,100
56304,mn,-94.05286,45.52536,5400,4,8,4,100
56307,mn,-94.58872,45.62796,2848,5,9,4,80
56308,mn,-95.3867,45.87903,17888,3,6,3,100
56309,mn,-95.80639,46.0812,1429,4,8,4,100
56310,mn,-94.44332,45.63405,2910,5,9,4,80
56311,mn,-95.89763,45.89725,1069,5,9,4,80
56312,mn,-94.95259,45.4635,2262,5,10,5,100
56313,mn,-93.55275,45.78402,123,4,8,4,100
56314,mn,-94.4331,45.81167,1034,5,9,4,80
56315,mn,-95.58904,45.98473,2018,3,7,4,133.3
56316,mn,-95.15271,45.49548,1829,5,9,4,80
56318,mn,-94.67231,45.85448,1654,4,9,5,125
56319,mn,-95.22746,46.00202,1311,4,7,3,75
56320,mn,-94.41872,45.46476,4214,5,9,4,80
56321,mn,-94.39315,45.58048,7,5,10,5,100
56323,mn,-95.72517,45.63222,563,5,9,4,80
56324,mn,-95.90517,46.16609,1466,4,7,3,75
56325,mn,-94.94638,45.5631,142,5,10,5,100
56326,mn,-95.68728,46.02288,1883,4,7,3,75
56327,mn,-95.6127,45.75741,1201,4,8,4,100
56328,mn,-94.51759,45.95474,110,5,9,4,80
56329,mn,-93.90574,45.70875,5023,4,9,5,125
56330,mn,-93.74922,45.74973,1164,4,8,4,100
56331,mn,-94.67653,45.6773,1334,5,9,4,80
56332,mn,-95.50576,45.96516,1451,3,7,4,133.3
56334,mn,-95.34547,45.58338,6448,5,9,4,80
56335,mn,-94.86169,45.60044,136,5,10,5,100
56336,mn,-94.76154,45.82325,1774,5,9,4,80
56338,mn,-93.87846,46.0087,3309,3,6,3,100
56339,mn,-95.81688,45.82768,1262,4,8,4,100
56340,mn,-94.44617,45.75602,1434,5,9,4,80
56342,mn,-93.40818,46.18135,4915,2,4,2,100
56343,mn,-95.69966,45.7887,1343,4,8,4,100
56345,mn,-94.37484,45.98883,9426,5,9,4,80
56347,mn,-94.87197,45.96754,4570,4,8,4,100
56349,mn,-95.51186,45.72518,810,4,8,4,100
56350,mn,-93.23485,46.31571,2363,2,4,2,100
56352,mn,-94.80222,45.65043,3183,5,10,5,100
56353,mn,-93.62818,45.79735,5438,4,8,4,100
56354,mn,-95.26479,46.06301,1842,3,7,4,133.3
56355,mn,-95.23554,45.94006,598,4,7,3,75
56356,mn,-94.7533,45.62902,209,5,10,5,100
56357,mn,-93.80077,45.69729,750,5,9,4,80
56358,mn,-93.45215,45.84358,1677,4,8,4,100
56359,mn,-93.66387,46.0837,3792,3,5,2,66.7
56360,mn,-95.12728,45.87375,4191,4,8,4,100
56361,mn,-95.33728,46.1603,2729,3,6,3,100
56362,mn,-94.71422,45.40327,4572,5,10,5,100
56363,mn,-93.64977,45.69652,118,4,9,5,125
56364,mn,-94.06562,46.01121,4622,4,7,3,75
56367,mn,-94.17012,45.7614,4050,4,8,4,100
56368,mn,-94.53891,45.45213,3353,5,10,5,100
56369,mn,-94.34536,45.46701,188,5,9,4,80
56371,mn,-94.63668,45.43317,82,5,10,5,100
56373,mn,-94.23643,45.85576,2303,5,9,4,80
56374,mn,-94.33584,45.60712,4069,5,9,4,80
56375,mn,-94.2743,45.70088,422,4,8,4,100
56376,mn,-94.6796,45.50563,208,5,10,5,100
56377,mn,-94.22924,45.64143,6341,4,8,4,100
56378,mn,-94.98829,45.72276,5359,5,9,4,80
56379,mn,-94.08444,45.63993,7862,4,8,4,100
56381,mn,-95.54993,45.55256,3041,5,10,5,100
56382,mn,-94.61091,45.91891,1566,5,9,4,80
56384,mn,-94.56718,45.80949,227,5,9,4,80
56385,mn,-95.22277,45.70507,1310,4,8,4,100
56386,mn,-93.52011,46.11176,1039,2,5,3,150
56387,mn,-94.23969,45.53289,2265,4,9,5,125
56389,mn,-95.08924,45.79888,72,4,9,5,125
56401,mn,-94.11508,46.32008,23235,2,5,3,150
56425,mn,-94.28218,46.34284,4446,3,5,2,66.7
56431,mn,-93.64272,46.48195,16943,2,4,2,100
56433,mn,-94.69685,46.97333,2912,2,3,1,50
56434,mn,-94.93465,46.33848,269,4,7,3,75
56435,mn,-94.53794,46.80841,4654,2,4,2,100
56436,mn,-94.68882,47.1617,37,1,3,2,200
56437,mn,-95.05906,46.24888,1069,3,6,3,100
56438,mn,-94.80896,46.13804,4728,4,8,4,100
56440,mn,-94.95756,46.14562,1124,4,7,3,75
56441,mn,-93.98314,46.57021,5501,2,4,2,100
56442,mn,-94.1018,46.67504,5931,3,5,2,66.7
56443,mn,-94.61829,46.17889,3404,3,7,4,133.3
56444,mn,-93.87478,46.41915,5882,2,4,2,100
56446,mn,-95.08927,46.12553,1568,4,7,3,75
56447,mn,-93.91682,46.73518,4113,2,5,3,150
56448,mn,-94.09042,46.76794,1461,2,5,3,150
56449,mn,-94.27161,46.17577,2256,3,6,3,100
56450,mn,-93.83412,46.23144,4526,2,5,3,150
56452,mn,-94.46366,46.94727,5207,2,4,2,100
56453,mn,-95.16055,46.31416,876,3,6,3,100
56455,mn,-94.00737,46.44864,1921,2,4,2,100
56456,mn,-94.33729,46.63774,157,1,3,2,200
56458,mn,-94.98967,47.19908,619,1,3,2,200
56461,mn,-94.8516,47.2361,5205,1,3,2,200
56464,mn,-95.10484,46.76328,4766,2,4,2,100
56465,mn,-94.11215,46.53527,3145,2,5,3,150
56466,mn,-94.63598,46.40903,5147,3,6,3,100
56467,mn,-94.84327,46.97949,4727,2,4,2,100
56468,mn,-94.29761,46.49294,6755,2,5,3,150
56469,mn,-93.54597,46.77906,4435,2,4,2,100
56470,mn,-95.09812,47.02289,12570,2,4,2,100
56472,mn,-94.35576,46.57397,14978,2,4,2,100
56473,mn,-94.48953,46.3607,3046,3,6,3,100
56474,mn,-94.40301,46.71988,6372,2,4,2,100
56475,mn,-94.54157,46.08323,2076,4,8,4,100
56477,mn,-95.00671,46.64356,2880,3,5,2,66.7
56479,mn,-94.79024,46.44002,4293,4,8,4,100
56481,mn,-94.93256,46.4735,1913,3,6,3,100
56482,mn,-95.1428,46.46532,4379,3,6,3,100
56484,mn,-94.46763,47.0991,4562,2,3,1,50
56501,mn,-95.80907,46.84065,13457,3,5,2,66.7
56510,mn,-96.52542,47.36032,2579,5,8,3,60
56511,mn,-96.00118,46.86136,2377,3,5,2,66.7
56514,mn,-96.43138,46.64812,3058,5,8,3,60
56515,mn,-95.70828,46.28823,5589,4,7,3,75
56516,mn,-95.97611,47.44187,559,3,5,2,66.7
56517,mn,-96.54958,47.56034,621,4,7,3,75
56518,mn,-95.24512,46.48907,319,3,6,3,100
56519,mn,-96.48889,47.16307,605,5,8,3,60
56520,mn,-96.5048,46.28545,2844,6,11,5,83.3
56521,mn,-95.89678,46.99834,868,2,5,3,150
56522,mn,-96.38811,46.13636,1204,5,9,4,80
56523,mn,-96.8134,47.65028,916,4,7,3,75
56524,mn,-95.61021,46.21381,1474,3,7,4,133.3
56525,mn,-96.75005,46.66634,104,5,9,4,80
56527,mn,-95.31723,46.37874,896,3,6,3,100
56528,mn,-95.81163,46.52868,3235,3,6,3,100
56529,mn,-96.68951,46.87654,1712,5,8,3,60
56531,mn,-95.98582,45.98788,2280,5,9,4,80
56533,mn,-96.15675,46.40955,362,4,7,3,75
56534,mn,-96.01096,46.46114,1402,3,6,3,100
56535,mn,-96.03919,47.67929,1791,2,4,2,100
56536,mn,-96.52562,47.04721,726,5,8,3,60
56537,mn,-96.09041,46.27605,12053,3,7,4,133.3
56540,mn,-96.27995,47.55102,2306,3,5,2,66.7
56541,mn,-96.13092,47.15881,50,3,5,2,66.7
56542,mn,-95.73005,47.55565,2744,2,4,2,100
56543,mn,-96.33834,46.28705,612,5,8,3,60
56544,mn,-95.59381,46.7576,4735,2,5,3,150
56545,mn,-96.23912,47.38575,1242,3,6,3,100
56546,mn,-96.72752,47.1038,492,5,9,4,80
56547,mn,-96.54948,46.88959,2064,5,8,3,60
56548,mn,-96.75349,47.37051,949,5,8,3,60
56549,mn,-96.31025,46.84852,3614,4,7,3,75
56550,mn,-96.73672,47.27138,702,5,8,3,60
56551,mn,-95.44551,46.31819,2682,3,7,4,133.3
56552,mn,-96.2122,46.98812,543,4,7,3,75
56553,mn,-96.61831,46.42883,605,6,11,5,83.3
56554,mn,-96.11471,46.88346,3321,3,5,2,66.7
56556,mn,-95.88331,47.6635,1248,2,4,2,100
56557,mn,-95.80372,47.31671,2378,2,5,3,150
56560,mn,-96.73562,46.84233,15635,5,8,3,60
56565,mn,-96.29764,46.04958,219,5,9,4,80
56566,mn,-95.61133,47.24014,332,1,3,2,200
56567,mn,-95.3673,46.54686,2881,3,6,3,100
56568,mn,-96.76864,47.53383,317,4,8,4,100
56569,mn,-95.85773,47.08057,1851,2,4,2,100
56570,mn,-95.3559,46.90877,1769,2,4,2,100
56571,mn,-95.54195,46.43786,3520,4,8,4,100
56572,mn,-96.08206,46.60304,7064,3,6,3,100
56573,mn,-95.55126,46.61554,6022,3,6,3,100
56574,mn,-96.71303,47.19527,567,5,9,4,80
56575,mn,-95.43874,47.0422,1792,1,3,2,200
56576,mn,-95.69738,46.46682,1683,4,7,3,75
56577,mn,-95.80321,46.97353,55,2,4,2,100
56578,mn,-95.65269,46.9404,1264,2,4,2,100
56579,mn,-96.34341,46.46996,1835,5,8,3,60
56580,mn,-96.60712,46.73586,920,5,9,4,80
56581,mn,-96.76908,47.46082,487,4,8,4,100
56583,mn,-96.41108,46.01056,571,5,10,5,100
56584,mn,-96.22909,47.22949,1800,3,6,3,100
56585,mn,-96.24572,47.09215,1081,4,7,3,75
56586,mn,-95.84146,46.32272,2566,3,7,4,133.3
56587,mn,-95.86143,46.64127,2339,3,5,2,66.7
56588,mn,-95.50605,46.2195,965,3,6,3,100
56589,mn,-95.72989,47.17859,3188,2,4,2,100
56590,mn,-96.16181,46.03683,655,5,9,4,80
56591,mn,-95.84475,47.0888,94,2,4,2,100
56592,mn,-96.00753,47.5364,705,3,5,2,66.7
56593,mn,-95.35347,46.80354,24,2,4,2,100
56594,mn,-96.64304,46.54828,808,6,10,4,66.7
56601,mn,-94.85693,47.51241,22744,1,2,1,100
56621,mn,-95.40752,47.4186,4120,1,3,2,200
56623,mn,-94.57001,48.60059,5726,2,3,1,50
56626,mn,-94.24492,47.33948,701,2,4,2,100
56627,mn,-94.05494,48.23393,13867,2,4,2,100
56628,mn,-93.59341,47.68667,5440,1,2,1,100
56629,mn,-94.11759,48.54426,3846,1,3,2,200
56630,mn,-94.49916,47.757,4669,1,3,2,200
56633,mn,-94.50844,47.31972,4206,1,3,2,200
56634,mn,-95.40298,47.68272,1475,1,3,2,200
56636,mn,-93.90402,47.40865,9087,2,3,1,50
56637,mn,-93.8361,47.61074,560,1,3,2,200
56639,mn,-93.52206,47.90615,5047,1,3,2,200
56641,mn,-94.24341,47.20639,613,2,4,2,100
56644,mn,-95.51086,47.79095,1119,2,4,2,100
56646,mn,-95.63717,47.77588,598,2,4,2,100
56647,mn,-94.61997,47.69009,1553,1,3,2,200
56649,mn,-93.13274,48.53455,9046,1,2,1,100
56650,mn,-94.56319,47.99757,2150,2,4,2,100
56651,mn,-95.62103,47.43869,1051,2,3,1,50
56652,mn,-95.24814,47.73337,816,1,3,2,200
56653,mn,-93.49876,48.26066,9831,1,3,2,200
56654,mn,-93.93952,48.47266,1944,1,3,2,200
56655,mn,-94.2275,47.00363,4030,2,4,2,100
56657,mn,-93.61658,47.57471,1404,1,2,1,100
56658,mn,-93.82917,48.0904,1216,2,4,2,100
56659,mn,-94.0164,47.64693,227,2,3,1,50
56660,mn,-94.17424,47.98994,2924,2,3,1,50
56661,mn,-94.12813,47.85835,6060,2,3,1,50
56662,mn,-93.89664,46.84416,1978,2,4,2,100
56663,mn,-94.46759,47.51783,654,1,3,2,200
56666,mn,-94.83362,48.03178,2,2,4,2,100
56667,mn,-94.94018,47.7366,1521,1,3,2,200
56668,mn,-93.346,48.61268,127,1,2,1,100
56669,mn,-93.19199,48.40848,3810,1,2,1,100
56670,mn,-94.86601,47.84885,162,2,3,1,50
56672,mn,-94.01537,47.07436,6202,2,3,1,50
56673,mn,-95.11185,48.82792,1266,2,3,1,50
56676,mn,-95.19278,47.53457,2831,1,3,2,200
56678,mn,-95.11981,47.42227,1792,1,3,2,200
56680,mn,-93.94113,47.64806,610,1,3,2,200
56681,mn,-94.25259,47.61,1748,2,3,1,50
56683,mn,-94.75212,47.71835,1546,1,3,2,200
56684,mn,-95.69618,47.85999,729,2,4,2,100
56685,mn,-94.52106,48.23835,1222,2,4,2,100
56686,mn,-94.91375,48.78522,2030,2,3,1,50
56687,mn,-94.99632,47.4993,93,1,2,1,100
56688,mn,-93.91311,47.76741,1300,1,3,2,200
56701,mn,-96.19244,48.12211,8126,3,5,2,66.7
56710,mn,-97.00184,48.21542,595,3,6,3,100
56711,mn,-95.00177,49.32765,747,1,2,1,100
56713,mn,-96.81339,48.34841,1752,3,6,3,100
56714,mn,-96.00593,48.78554,1584,2,4,2,100
56715,mn,-95.94129,47.80896,447,2,4,2,100
56716,mn,-96.55257,47.74542,5528,3,6,3,100
56720,mn,-96.89298,48.57197,169,3,6,3,100
56721,mn,-96.94392,47.97358,5731,4,7,3,75
56722,mn,-96.64513,47.98391,1000,3,6,3,100
56723,mn,-96.8064,47.80943,1239,3,6,3,100
56724,mn,-95.73584,48.44585,577,3,5,2,66.7
56725,mn,-95.80058,48.15045,1838,3,5,2,66.7
56726,mn,-96.23099,48.74708,2059,2,4,2,100
56727,mn,-95.40167,48.29351,3726,2,4,2,100
56728,mn,-96.99732,48.79186,2471,3,6,3,100
56729,mn,-96.55743,48.66388,406,3,5,2,66.7
56731,mn,-97.06738,48.90928,313,3,5,2,66.7
56732,mn,-96.48707,48.57625,1548,3,5,2,66.7
56733,mn,-96.89647,48.63239,1167,3,6,3,100
56734,mn,-96.59524,48.76781,1254,3,5,2,66.7
56735,mn,-96.63669,48.91539,1966,2,4,2,100
56736,mn,-96.19228,47.71411,2153,3,5,2,66.7
56737,mn,-96.03508,48.43413,1551,3,5,2,66.7
56738,mn,-96.33509,48.33513,1792,3,5,2,66.7
56741,mn,-94.85785,49.28397,274,1,2,1,100
56742,mn,-95.80979,47.9282,999,2,4,2,100
56744,mn,-97.11367,48.24562,1403,4,6,2,50
56748,mn,-96.01025,47.92198,645,3,5,2,66.7
56750,mn,-96.29926,47.89262,2089,3,6,3,100
56751,mn,-95.73292,48.81136,4567,2,4,2,100
56754,mn,-96.19218,47.99349,630,3,5,2,66.7
56755,mn,-97.10481,48.97103,556,3,5,2,66.7
56756,mn,-95.54786,48.89228,746,2,4,2,100
56757,mn,-96.89201,48.47459,1819,3,6,3,100
56758,mn,-96.51587,48.46663,948,3,5,2,66.7
56759,mn,-96.0879,48.54586,835,2,5,3,150
56760,mn,-96.45328,48.24359,623,3,5,2,66.7
56761,mn,-95.69629,48.60267,816,3,5,2,66.7
56762,mn,-96.73961,48.16877,3344,3,6,3,100
56763,mn,-95.35641,48.80896,3385,2,3,1,50
57001,sd,-96.63971,42.98448,2171,9,18,9,100
57002,sd,-96.67696,44.29649,946,3,8,5,166.7
57003,sd,-96.75995,43.73546,1192,6,12,6,100
57004,sd,-96.79148,43.07768,3245,8,16,8,100
57005,sd,-96.58602,43.59261,4432,7,15,8,114.3
57006,sd,-96.79636,44.31514,8675,3,7,4,133.3
57010,sd,-96.82083,42.8183,855,14,25,11,78.6
57012,sd,-97.27318,43.5957,1126,7,15,8,114.3
57013,sd,-96.62011,43.28295,3035,9,18,9,100
57014,sd,-96.95271,43.11296,1745,10,18,8,80
57015,sd,-96.98002,43.41841,633,9,16,7,77.8
57016,sd,-96.96176,43.89299,849,5,10,5,100
57017,sd,-96.82926,44.01211,1194,5,9,4,80
57018,sd,-96.98275,43.79803,1146,6,11,5,83.3
57020,sd,-96.83055,43.67853,730,6,12,6,100
57021,sd,-96.97793,43.27024,368,10,19,9,90
57022,sd,-96.72324,43.8454,2913,6,11,5,83.3
57024,sd,-96.67923,43.98853,418,5,9,4,80
57025,sd,-96.69194,42.72722,2947,13,24,11,84.6
57026,mn,-96.51238,44.25926,1399,4,8,4,116.65
57027,sd,-96.49771,43.1863,130,10,18,8,80
57028,sd,-96.60565,44.06041,2357,4,9,5,125
57029,sd,-97.48026,43.33753,2610,9,17,8,88.9
57030,mn,-96.52244,43.73699,2221,6,11,6,101.65
57031,sd,-97.18351,42.87451,753,11,21,10,90.9
57032,sd,-96.68678,43.42188,3611,8,15,7,87.5
57033,sd,-96.95758,43.61912,2748,6,12,6,100
57034,sd,-96.55144,43.12199,978,10,18,8,80
57035,sd,-97.07453,43.63221,1067,6,12,6,100
57036,sd,-97.14118,43.27298,1103,10,19,9,90
57037,sd,-97.25569,43.10295,1034,9,18,9,100
57038,sd,-96.58086,42.58246,1495,12,23,11,91.7
57039,sd,-96.86951,43.33696,2122,9,17,8,88.9
57040,sd,-97.58623,43.06376,663,10,19,9,90
57041,sd,-96.86763,43.72977,104,6,11,5,83.3
57042,sd,-97.15073,43.9797,5393,5,9,4,80
57043,sd,-97.31155,43.41629,1672,8,16,8,100
57045,sd,-97.53003,43.20783,1608,11,20,9,81.8
57046,sd,-97.30793,42.95911,710,10,19,9,90
57047,sd,-97.21196,43.52067,255,8,16,8,100
57048,sd,-97.19197,43.74272,1243,7,13,6,85.7
57049,sd,-96.50741,42.52493,3737,12,22,10,83.3
57050,sd,-97.01466,44.15725,384,4,9,5,125
57051,sd,-97.33507,44.22941,603,5,9,4,80
57052,sd,-97.71244,43.29366,627,12,21,9,75
57053,sd,-97.14025,43.4101,1970,10,18,8,80
57054,sd,-97.25469,44.12936,867,4,8,4,100
57055,sd,-96.74058,43.66729,654,6,13,7,116.7
57057,sd,-96.95956,44.1017,255,5,9,4,80
57058,sd,-97.40168,43.73944,1877,8,15,7,87.5
57059,sd,-97.75789,43.12567,1946,11,21,10,90.9
57061,sd,-97.04401,44.24235,91,4,9,5,125
57062,sd,-97.95469,42.85029,1862,14,24,10,71.4
57063,sd,-97.6851,42.92366,1285,10,19,9,90
57064,sd,-96.87381,43.45593,2817,7,14,7,100
57065,sd,-96.6156,43.90458,381,5,11,6,120
57066,sd,-97.86921,42.99041,2000,12,21,9,75
57067,sd,-97.47612,43.04059,641,10,18,8,80
57068,mn,-96.49223,43.57541,1050,6,13,6,101.2
57069,sd,-96.97313,42.83943,5309,15,25,10,66.7
57070,sd,-97.17437,43.1829,1506,10,18,8,80
57071,sd,-96.96065,44.27355,1993,4,8,4,100
57072,sd,-97.19356,42.98223,907,10,19,9,90
57073,sd,-97.05586,43.00393,903,10,18,8,80
57075,sd,-96.96351,44.00186,1689,5,10,5,100
57076,sd,-97.35971,43.99287,905,6,11,5,83.3
57077,sd,-96.75785,43.32009,984,9,17,8,88.9
57078,ne,-97.44364,42.91596,9083,10,19,9,90
57103,sd,-96.68897,43.54647,11566,7,13,6,85.7
57104,sd,-96.70744,43.60472,8780,7,13,6,85.7
57105,sd,-96.73534,43.52066,9064,7,13,6,85.7
57106,sd,-96.839,43.51053,13254,7,13,6,85.7
57107,sd,-96.82123,43.59486,3814,7,13,6,85.7
57108,sd,-96.7041,43.47751,10958,7,14,7,100
57110,sd,-96.63774,43.54323,6561,7,14,7,100
57117,sd,-96.75497,43.53124,2,7,14,7,100
57197,sd,-96.73861,43.52455,7,7,13,6,85.7
57201,sd,-97.09464,44.93792,13031,4,8,4,100
57212,sd,-97.14331,44.37943,2928,5,9,4,80
57213,sd,-96.52257,44.54863,973,3,8,5,166.7
57214,sd,-97.2048,44.50187,89,5,10,5,100
57216,sd,-96.52621,45.30019,1162,6,12,6,100
57217,sd,-97.66113,45.07846,683,4,8,4,100
57218,sd,-96.59174,44.65769,625,4,8,4,100
57219,sd,-97.80863,45.28803,1415,4,9,5,125
57220,sd,-96.9204,44.46797,1046,4,8,4,100
57221,sd,-97.45311,44.59542,1163,4,8,4,100
57223,sd,-97.00843,44.71569,1563,4,9,5,125
57224,sd,-97.13703,45.86235,377,6,11,5,83.3
57225,sd,-97.72532,44.88511,2421,4,8,4,100
57226,sd,-96.71859,44.78759,2348,4,8,4,100
57227,sd,-96.71798,45.36223,61,6,12,6,100
57231,sd,-97.59031,44.36449,2700,5,10,5,100
57232,sd,-97.38424,45.61754,1212,4,8,4,100
57233,sd,-97.39826,44.51194,301,4,9,5,125
57234,sd,-96.89277,44.60293,1791,4,9,5,125
57235,sd,-97.30875,45.07402,1135,4,8,4,100
57236,sd,-97.58136,44.98412,242,4,8,4,100
57237,sd,-96.51687,44.79483,1245,5,10,5,100
57238,sd,-96.86078,44.87543,677,3,7,4,133.3
57239,sd,-97.30923,45.50966,958,4,8,4,100
57241,sd,-97.21353,44.6989,1219,4,9,5,125
57242,sd,-97.36289,44.77385,671,4,8,4,100
57243,sd,-97.41931,44.91284,907,4,8,4,100
57245,sd,-96.91819,44.89758,94,4,7,3,75
57246,sd,-96.66703,45.05844,292,6,11,5,83.3
57247,sd,-97.43098,45.72004,1573,5,9,4,80
57248,sd,-97.18941,44.5798,1556,5,9,4,80
57249,sd,-97.36306,44.3733,1634,5,10,5,100
57251,sd,-96.93513,45.27887,413,4,9,5,125
57252,sd,-96.61171,45.20386,3506,7,12,5,71.4
57255,sd,-96.94131,45.85816,762,6,11,5,83.3
57256,sd,-97.19246,45.2657,133,4,7,3,75
57257,sd,-97.02627,45.4971,80,5,10,5,100
57258,sd,-97.91988,44.8864,594,6,11,5,83.3
57259,sd,-96.5658,44.99959,1128,6,11,5,83.3
57260,sd,-96.71844,45.83608,1088,6,11,5,83.3
57261,sd,-97.49161,45.5406,753,5,9,4,80
57262,sd,-97.07146,45.67323,1294,6,10,4,66.7
57263,sd,-97.00218,45.13748,702,4,7,3,75
57264,sd,-96.80461,45.11134,272,5,9,4,80
57265,sd,-96.78995,44.99022,500,4,8,4,100
57266,sd,-97.09698,45.27912,451,3,7,4,133.3
57268,sd,-96.69077,44.56976,707,3,7,4,133.3
57269,sd,-96.81447,45.2209,652,6,10,4,66.7
57270,sd,-97.34059,45.84321,2134,5,9,4,80
57271,sd,-97.53072,44.7362,525,4,8,4,100
57272,sd,-97.46794,45.10326,325,4,8,4,100
57273,sd,-97.27352,45.33583,2162,4,8,4,100
57274,sd,-97.56294,45.30334,4140,4,8,4,100
57276,sd,-96.61358,44.43016,1190,3,7,4,133.3
57278,sd,-97.69544,44.63909,958,5,9,4,80
57279,sd,-96.87486,45.41983,163,6,11,5,83.3
57301,sd,-98.04728,43.7138,9705,10,18,8,80
57311,sd,-97.7617,43.65292,1832,11,20,9,81.8
57312,sd,-98.3763,44.20049,924,9,17,8,88.9
57313,sd,-98.36579,43.31032,1818,15,24,9,60
57314,sd,-97.98519,44.05024,2089,10,18,8,80
57315,sd,-98.04666,42.99323,1470,13,22,9,69.2
57317,sd,-98.98069,43.12623,1094,11,19,8,72.7
57319,sd,-97.48282,43.53604,1580,9,16,7,77.8
57321,sd,-97.55065,43.87235,1009,8,15,7,87.5
57322,sd,-97.97403,44.6307,887,7,13,6,85.7
57323,sd,-97.71393,44.14587,798,8,15,7,87.5
57324,sd,-98.05401,44.29849,658,9,15,6,66.7
57325,sd,-99.29633,43.75601,2956,12,20,8,66.7
57328,sd,-98.44022,43.4324,1581,14,23,9,64.3
57330,sd,-98.16563,43.25185,840,14,23,9,64.3
57331,sd,-98.0372,43.47321,688,12,21,9,75
57332,sd,-97.64736,43.54801,1130,10,18,8,80
57334,sd,-97.99434,43.5464,953,12,21,9,75
57335,sd,-98.77377,43.06139,707,11,20,9,81.8
57337,sd,-97.79217,44.00977,554,9,17,8,88.9
57339,sd,-99.4125,44.11604,655,10,17,7,70
57340,sd,-97.84512,43.79558,562,10,19,9,90
57341,sd,-99.08814,44.08986,1469,10,18,8,80
57342,sd,-98.70179,43.24661,1699,13,22,9,69.2
57344,sd,-98.63395,43.45075,324,13,22,9,69.2
57345,sd,-99.45352,44.57397,3660,9,15,6,66.7
57346,sd,-99.55249,44.2351,237,8,15,7,87.5
57348,sd,-98.3644,44.62176,1705,8,14,6,75
57349,sd,-97.57575,44.03031,2587,7,13,6,85.7
57350,sd,-98.20051,44.40228,9737,8,15,7,87.5
57353,sd,-97.84422,44.35869,2145,7,14,7,100
57355,sd,-98.94937,43.77869,2457,12,20,8,66.7
57356,sd,-98.52729,43.15886,2993,14,23,9,64.3
57358,sd,-98.42192,44.07535,92,10,18,8,80
57359,sd,-98.17525,43.89807,1326,10,18,8,80
57363,sd,-98.25577,43.67844,1378,11,19,8,72.7
57364,sd,-98.6069,43.4291,57,13,22,9,69.2
57365,sd,-99.41637,43.81172,714,13,22,9,69.2
57366,sd,-97.94404,43.38347,2758,12,22,10,83.3
57367,sd,-98.52208,43.06396,215,13,23,10,76.9
57368,sd,-98.4775,43.75132,2065,12,20,8,66.7
57369,sd,-98.94794,43.42506,3489,13,21,8,61.5
57370,sd,-99.1691,43.80156,1302,12,21,9,75
57374,sd,-97.60162,43.75612,695,9,17,8,88.9
57375,sd,-98.48037,43.56191,1228,12,21,9,75
57376,sd,-97.94059,43.21569,1811,12,21,9,75
57379,sd,-98.55124,44.25833,401,9,16,7,77.8
57380,sd,-98.30762,43.03052,689,15,24,9,60
57381,sd,-98.73308,44.39089,899,9,16,7,77.8
57382,sd,-98.66739,44.06163,3197,9,17,8,88.9
57383,sd,-98.71458,43.71956,1905,13,21,8,61.5
57384,sd,-98.49126,44.41467,1734,9,15,6,66.7
57385,sd,-98.28845,44.05082,2131,10,18,8,80
57386,sd,-98.00366,44.51319,458,8,14,6,75
57401,sd,-98.52755,45.47649,14327,7,11,4,57.1
57420,sd,-100.1414,45.28684,504,5,10,5,100
57421,sd,-97.91627,45.75366,298,7,12,5,71.4
57422,sd,-97.91161,45.42183,755,6,10,4,66.7
57424,sd,-98.53829,45.01658,1052,8,14,6,75
57426,sd,-98.49559,45.73796,90,6,10,4,66.7
57427,sd,-98.31718,45.48372,703,7,12,5,71.4
57428,sd,-99.67791,45.45235,1720,4,8,4,100
57429,sd,-98.29745,45.17478,227,8,13,5,62.5
57430,sd,-97.71082,45.81548,3891,7,12,5,71.4
57432,sd,-98.0337,45.68238,789,7,11,4,57.1
57433,sd,-98.31582,45.65116,991,6,10,4,66.7
57434,sd,-98.07475,45.16923,1882,7,12,5,71.4
57435,sd,-98.91273,45.17657,1126,8,13,5,62.5
57436,sd,-98.08627,44.8567,1282,7,13,6,85.7
57437,sd,-99.59801,45.79139,4668,4,8,4,100
57438,sd,-99.16238,45.0637,4194,8,13,5,62.5
57439,sd,-98.06511,45.33167,98,7,13,6,85.7
57440,sd,-98.26192,44.85002,1001,8,14,6,75
57441,sd,-98.52455,45.82889,1872,6,10,4,66.7
57445,sd,-98.11898,45.46108,2446,7,12,5,71.4
57446,sd,-98.14614,45.86828,1138,6,11,5,83.3
57448,sd,-99.40675,45.61283,1389,4,8,4,100
57449,sd,-98.1829,45.73821,509,6,10,4,66.7
57450,sd,-99.83955,45.22525,445,6,11,5,83.3
57451,sd,-98.94763,45.4347,4061,6,12,6,100
57452,sd,-99.86623,45.53201,1358,4,8,4,100
57454,sd,-97.77845,45.61118,1237,6,10,4,66.7
57456,sd,-98.98196,45.73709,3306,5,9,4,80
57457,sd,-99.16021,45.88665,910,3,7,4,133.3
57460,sd,-98.67411,45.27418,917,7,13,6,85.7
57461,sd,-98.43203,45.1569,897,8,13,5,62.5
57465,sd,-98.68102,45.14219,1126,8,13,5,62.5
57466,sd,-99.4641,45.2116,1026,6,11,5,83.3
57467,sd,-99.14148,44.83337,303,8,14,6,75
57468,sd,-97.75551,45.50011,636,5,10,5,100
57469,sd,-98.57442,44.86141,3206,8,14,6,75
57470,sd,-98.86686,44.87672,495,8,14,6,75
57471,sd,-99.3257,45.39943,2410,5,9,4,80
57472,sd,-100.07288,45.4477,2121,4,8,4,100
57473,sd,-99.50197,44.9961,1049,7,13,6,85.7
57474,sd,-98.26885,45.29864,534,7,13,6,85.7
57475,sd,-99.63212,45.22192,327,5,10,5,100
57476,sd,-98.61704,44.71423,900,8,14,6,75
57477,sd,-98.1615,45.04037,561,7,13,6,85.7
57479,sd,-98.44324,45.30296,604,7,13,6,85.7
57481,sd,-98.66767,45.65044,1153,6,11,5,83.3
57501,sd,-100.30251,44.52933,8567,12,20,8,66.7
57521,sd,-101.20701,43.80981,2023,10,18,8,80
57522,sd,-99.99683,44.4774,572,10,17,7,70
57523,sd,-99.23925,43.23659,1815,10,19,9,90
57528,sd,-99.76548,43.19157,1214,9,17,8,88.9
57529,sd,-99.56771,43.23145,1242,10,18,8,80
57531,sd,-100.49109,43.97066,1042,11,19,8,72.7
57532,sd,-100.61772,44.38993,234,11,19,8,72.7
57533,sd,-99.43178,43.37412,3042,11,19,8,72.7
57534,sd,-99.68739,43.58106,707,11,20,9,81.8
57536,sd,-99.76166,44.39914,1389,9,16,7,77.8
57538,sd,-99.14445,43.12033,875,10,18,8,80
57540,sd,-99.60731,44.51892,647,8,15,7,87.5
57541,sd,-99.8958,43.60317,425,11,20,9,81.8
57543,sd,-101.51687,43.75285,2486,8,16,8,100
57544,sd,-99.88777,43.94553,1516,13,22,9,69.2
57547,sd,-101.42949,43.47539,1127,6,14,8,133.3
57548,sd,-99.65888,44.08835,376,10,18,8,80
57551,sd,-101.69767,43.17882,3054,3,8,5,166.7
57552,sd,-101.19563,44.27145,4453,9,17,8,88.9
57553,sd,-101.64204,44.48115,1310,7,14,7,100
57555,sd,-100.63208,43.24342,1837,4,10,6,150
57559,sd,-100.72532,43.935,1598,10,18,8,80
57560,sd,-101.19697,43.43963,684,6,14,8,133.3
57562,sd,-100.95266,43.89385,446,10,18,8,80
57563,sd,-100.38094,43.36326,132,8,16,8,100
57564,sd,-99.99248,44.7122,56,8,14,6,75
57566,sd,-101.09302,43.32465,447,5,12,7,140
57567,sd,-101.73082,44.11885,5296,8,16,8,100
57568,sd,-100.08534,43.88745,2116,12,21,9,75
57569,sd,-99.57534,43.85794,1881,12,20,8,66.7
57570,sd,-100.87588,43.23712,119,4,10,6,150
57571,sd,-99.09251,43.08522,66,9,17,8,88.9
57572,sd,-101.03103,43.14944,408,4,10,6,150
57574,sd,-101.35614,43.105,590,3,9,6,200
57576,sd,-100.30095,43.92021,972,12,20,8,66.7
57577,sd,-101.67958,43.54168,1397,6,14,8,133.3
57579,sd,-100.79477,43.59156,3803,10,19,9,90
57580,sd,-100.05857,43.27796,6234,10,18,8,80
57584,sd,-100.07102,43.53325,580,11,20,9,81.8
57585,sd,-100.40354,43.53994,2119,10,19,9,90
57601,sd,-100.50954,45.44469,2407,5,9,4,80
57620,sd,-102.5487,45.38243,2000,3,7,4,133.3
57621,sd,-101.07485,45.74913,219,4,8,4,100
57626,sd,-102.20968,44.9926,3795,4,9,5,125
57631,sd,-100.28243,45.53361,1134,5,9,4,80
57632,sd,-100.03959,45.83659,1670,5,9,4,80
57633,sd,-101.45468,45.46013,852,4,8,4,100
57634,sd,-101.88427,45.75278,515,4,8,4,100
57638,nd,-102.21442,45.8862,5405,4,6,3,87.5
57639,sd,-100.77179,45.70354,72,4,8,4,100
57640,sd,-102.72037,45.78018,2016,3,6,3,100
57641,nd,-101.32173,45.87393,1438,4,8,4,87.5
57642,nd,-100.74292,45.81093,2121,4,8,4,87.5
57644,sd,-102.05857,45.44864,2478,4,8,4,100
57645,nd,-101.74267,45.98434,1213,3,6,4,116.65
57646,sd,-100.08382,45.69015,869,5,9,4,80
57648,nd,-100.36468,45.91059,1441,5,10,4,90
57649,sd,-102.86106,45.51719,2187,3,6,3,100
57650,sd,-103.02244,45.83845,161,2,5,3,150
57651,sd,-103.10015,45.50936,670,2,5,3,150
57656,sd,-101.07767,45.38802,219,4,8,4,100
57657,sd,-100.81216,45.50667,519,4,8,4,100
57658,sd,-100.49451,45.67892,484,5,9,4,80
57660,nd,-101.56817,45.80341,836,4,8,4,116.65
57701,sd,-103.20517,44.14148,15000,1,3,2,200
57702,sd,-103.39047,44.03377,16025,0,1,1,NA
57703,sd,-103.0438,44.00285,7336,2,5,3,150
57706,sd,-103.09355,44.15719,23,2,5,3,150
57714,sd,-101.93309,43.30248,752,3,8,5,166.7
57716,sd,-102.20058,43.10847,771,3,7,4,133.3
57717,sd,-103.88833,44.95183,3949,2,4,2,125
57718,sd,-103.36475,44.17891,2788,1,2,1,100
57719,sd,-102.98162,44.23339,3470,2,5,3,150
57720,sd,-103.61301,45.56635,3255,2,4,2,100
57722,sd,-102.93333,43.46359,2415,4,9,5,125
57724,mt,-104.02779,45.64027,976,2,4,2,125
57725,sd,-102.80951,43.94011,399,4,8,4,100
57730,sd,-103.63167,43.7196,5605,0,0,0,NA
57732,sd,-103.65394,44.24611,2611,0,0,0,NA
57735,sd,-103.85449,43.30068,4339,1,4,3,300
57738,sd,-103.1242,43.65074,868,2,6,4,200
57741,sd,-103.46663,44.40497,5,1,3,2,200
57744,sd,-103.03643,43.77403,3713,2,4,2,100
57745,sd,-103.77988,44.0216,2639,0,0,0,NA
57747,sd,-103.52905,43.38506,6690,1,4,3,300
57748,sd,-102.0229,44.58384,725,7,14,7,100
57750,sd,-101.95411,43.59157,1360,8,17,9,112.5
57751,sd,-103.38649,43.85542,1227,0,0,0,NA
57752,sd,-102.19314,43.4645,2126,5,11,6,120
57754,sd,-103.87121,44.26303,5075,0,0,0,NA
57755,sd,-103.34913,45.83665,540,2,4,2,100
57756,sd,-102.49784,43.23566,772,3,9,6,200
57758,sd,-102.69674,44.97066,1489,3,7,4,133.3
57759,sd,-103.55983,44.22401,426,0,0,0,NA
57760,sd,-103.25478,44.97608,1522,2,5,3,150
57761,sd,-102.7376,44.22943,1968,3,8,5,166.7
57762,sd,-103.61061,44.75332,340,2,5,3,150
57763,sd,-103.25662,43.11476,1318,3,8,5,166.7
57764,sd,-102.8333,43.18658,1801,4,9,5,125
57766,sd,-103.20227,43.39823,524,3,8,5,166.7
57767,sd,-102.57965,44.13479,560,4,9,5,125
57769,sd,-103.30187,44.24852,2386,1,2,1,100
57770,sd,-102.5898,43.07027,1232,3,7,4,133.3
57772,sd,-102.52544,43.50742,2612,4,11,7,175
57773,sd,-103.56817,43.59212,174,0,0,0,NA
57775,sd,-102.01593,44.10352,1427,7,14,7,100
57776,sd,-103.49577,45.26376,271,2,4,2,100
57779,sd,-103.75781,44.56279,485,1,2,1,100
57780,sd,-102.50359,43.78205,903,5,12,7,140
57782,sd,-103.11206,43.30237,427,3,8,5,166.7
57783,sd,-103.92835,44.45602,8776,0,1,1,NA
57785,sd,-103.22842,44.42543,6815,1,2,1,100
57787,sd,-102.65547,44.68207,1378,3,6,3,100
57788,sd,-103.1941,44.62972,482,2,5,3,150
57790,sd,-102.21557,44.0829,2545,6,12,6,100
57791,sd,-102.43111,44.22496,737,6,13,7,116.7
57792,sd,-102.41632,44.53919,779,5,10,5,100
57793,sd,-103.58516,44.52047,1962,1,2,1,100
57794,sd,-102.39482,43.12405,290,3,7,4,133.3
57799,sd,-103.87241,44.49872,14,0,1,1,NA
58001,nd,-96.71999,46.44518,32,6,11,5,83.3
58002,nd,-97.40689,46.97633,51,5,9,4,80
58004,nd,-97.26252,47.0257,533,6,9,3,50
58005,nd,-96.95085,47.05288,1023,5,9,4,80
58006,nd,-97.2098,47.10155,536,5,9,4,80
58007,nd,-97.46867,47.02436,364,5,8,3,60
58008,nd,-97.00055,46.30933,447,6,10,4,66.7
58009,nd,-97.24658,47.32769,305,5,8,3,60
58011,nd,-97.54216,46.91872,851,5,8,3,60
58012,nd,-97.16923,46.93888,1532,6,9,3,50
58013,nd,-97.36281,46.06162,612,6,11,5,83.3
58015,nd,-96.81649,46.59526,374,5,9,4,80
58016,nd,-97.46176,47.36712,506,4,8,4,100
58017,nd,-97.84258,46.04115,1340,6,11,5,83.3
58018,nd,-96.89647,46.43599,704,6,10,4,66.7
58021,nd,-97.08524,46.73763,689,5,9,4,80
58027,nd,-97.6115,46.6334,1131,5,10,5,100
58029,nd,-97.39992,47.11671,324,5,8,3,60
58030,nd,-96.67007,46.03009,1182,6,10,4,66.7
58031,nd,-97.68083,46.76302,1171,5,9,4,80
58032,nd,-97.64171,46.07638,1022,6,10,4,66.7
58033,nd,-97.92796,46.43679,883,6,10,4,66.7
58035,nd,-97.42,47.25455,676,4,8,4,100
58036,nd,-96.9481,47.15557,620,5,9,4,80
58038,nd,-96.99575,47.2451,658,5,9,4,80
58040,nd,-97.76732,46.21454,1045,6,10,4,66.7
58041,nd,-96.91448,46.04974,2389,6,10,4,66.7
58042,nd,-96.9549,46.97099,1009,5,8,3,60
58043,nd,-97.54133,45.97688,550,6,10,4,66.7
58045,nd,-97.024,47.38295,2483,5,8,3,60
58046,nd,-97.72642,47.3265,1860,4,7,3,75
58047,nd,-96.8802,46.71741,3964,5,9,4,80
58048,nd,-97.22005,47.19835,901,5,9,4,80
58049,nd,-97.99857,46.65531,942,5,9,4,80
58051,nd,-97.03049,46.64144,1621,5,9,4,80
58052,nd,-97.27877,46.63503,1110,6,9,3,50
58053,nd,-97.17987,46.06409,1936,6,11,5,83.3
58054,nd,-97.66951,46.4253,1942,6,10,4,66.7
58056,nd,-97.93133,47.23183,749,3,6,3,100
58057,nd,-97.25724,46.42448,414,6,11,5,83.3
58058,nd,-96.96337,46.18254,217,6,10,4,66.7
58059,nd,-97.11661,46.84412,1581,5,9,4,80
58060,nd,-97.43417,46.26494,2102,6,11,5,83.3
58061,nd,-96.89757,46.27907,626,6,11,5,83.3
58062,nd,-97.82841,46.63601,370,5,9,4,80
58063,nd,-97.80407,46.96543,777,4,8,4,100
58064,nd,-97.61578,47.15063,1113,4,8,4,100
58065,nd,-97.76046,47.18618,126,4,7,3,75
58067,nd,-97.48784,46.06476,589,6,11,5,83.3
58068,nd,-97.40452,46.54296,661,6,10,4,66.7
58069,nd,-97.83254,46.25186,394,6,10,4,66.7
58071,nd,-97.67831,46.95521,828,5,8,3,60
58072,nd,-98.00689,46.92569,2620,4,7,3,75
58075,nd,-96.72615,46.27436,5587,6,11,5,83.3
58076,nd,-96.60758,46.27283,3,6,11,5,83.3
58077,nd,-96.9751,46.52482,1287,6,10,4,66.7
58078,nd,-96.93126,46.86307,12937,5,8,3,60
58079,nd,-97.34535,46.86671,1069,5,9,4,80
58081,nd,-97.14137,46.31073,1373,6,11,5,83.3
58102,nd,-96.83178,46.92088,9571,5,8,3,60
58103,nd,-96.82211,46.85614,10652,5,8,3,60
58104,nd,-96.83968,46.79325,13600,5,8,3,60
58105,nd,-96.80785,46.89539,4,5,8,3,60
58201,nd,-97.14105,47.87116,12188,4,7,3,75
58202,nd,-97.0735,47.92147,11,4,7,3,75
58203,nd,-97.15497,47.97219,5598,4,7,3,75
58204,nd,-97.3868,47.955,44,3,6,3,100
58205,nd,-97.37899,47.95147,1,3,6,3,100
58210,nd,-98.10709,48.40897,925,2,4,2,100
58212,nd,-97.99944,47.70511,1104,3,5,2,66.7
58214,nd,-97.49966,47.92459,613,3,6,3,100
58216,nd,-97.43449,48.88189,487,2,5,3,150
58218,nd,-97.04584,47.59479,1219,4,8,4,100
58219,nd,-96.87897,47.47763,132,5,8,3,60
58220,nd,-97.71426,48.79351,2702,2,5,3,150
58222,nd,-97.68159,48.61523,641,3,6,3,100
58223,nd,-97.03445,47.50865,561,5,8,3,60
58224,nd,-97.94361,48.17233,77,3,5,2,66.7
58225,mn,-97.21565,48.61036,2320,4,6,2,62.5
58227,nd,-97.90322,48.5451,944,2,5,3,150
58228,nd,-97.35233,47.87861,1105,3,6,3,100
58229,nd,-98.24333,48.49868,416,1,3,2,200
58230,nd,-97.83357,47.4841,1489,3,6,3,100
58231,nd,-97.82621,48.20017,699,3,5,2,66.7
58233,nd,-97.52573,48.22615,450,4,7,3,75
58235,nd,-97.47474,48.09901,737,3,6,3,100
58237,nd,-97.4054,48.41407,2535,4,7,3,75
58238,nd,-97.39878,48.7809,591,3,5,2,66.7
58239,nd,-98.7067,48.94038,807,1,2,1,100
58240,nd,-97.4828,47.63421,1824,4,7,3,75
58241,nd,-97.67745,48.69841,381,3,5,2,66.7
58243,nd,-97.68088,48.5127,753,4,7,3,75
58244,nd,-97.61474,48.14306,607,3,6,3,100
58249,nd,-98.32852,48.82341,4597,1,2,1,100
58250,nd,-98.00778,48.2787,511,2,5,3,150
58251,nd,-97.69115,47.94934,2361,3,6,3,100
58254,nd,-98.14238,47.77265,611,3,6,3,100
58256,nd,-97.20734,48.09055,1203,4,7,3,75
58257,nd,-97.28184,47.49738,1919,5,8,3,60
58258,nd,-97.34085,48.01989,502,4,6,2,50
58259,nd,-98.1244,48.02371,909,3,5,2,66.7
58260,nd,-98.03471,48.63512,1445,2,3,1,50
58261,nd,-97.31189,48.23978,1158,4,7,3,75
58262,nd,-97.87632,48.68219,209,2,5,3,150
58265,nd,-97.60767,48.95102,1186,2,4,2,100
58266,nd,-97.84852,48.00322,781,3,5,2,66.7
58267,nd,-97.6351,47.75391,2294,3,6,3,100
58269,nd,-98.16743,48.69321,865,1,2,1,100
58270,nd,-97.78373,48.39439,1121,4,7,3,75
58271,nd,-97.29401,48.91101,1283,3,5,2,66.7
58272,nd,-97.98126,48.01702,600,3,5,2,66.7
58273,nd,-97.66857,48.29609,401,4,7,3,75
58274,nd,-97.4875,47.49305,1470,4,8,4,100
58275,nd,-97.11641,47.68516,1000,4,7,3,75
58276,nd,-97.45134,48.63079,822,3,6,3,100
58277,nd,-97.8308,47.60894,766,3,5,2,66.7
58278,nd,-97.12863,47.77311,1834,4,7,3,75
58281,nd,-98.61023,48.85827,918,1,2,1,100
58282,nd,-97.94871,48.90453,2945,2,3,1,50
58301,nd,-98.87376,48.1315,8007,2,3,1,50
58311,nd,-98.57947,48.65245,882,1,2,1,100
58316,nd,-99.77379,48.82807,1541,1,2,1,100
58317,nd,-99.38179,48.61861,645,2,3,1,50
58318,nd,-100.41884,48.8546,5641,1,2,1,100
58321,nd,-98.33809,48.20003,751,2,4,2,100
58323,nd,-98.88077,48.851,541,1,2,1,100
58324,nd,-99.22157,48.48026,1218,2,3,1,50
58325,nd,-99.15467,48.28447,844,2,4,2,100
58327,nd,-98.58805,48.09378,1413,2,4,2,100
58329,nd,-100.08085,48.87327,2205,1,2,1,100
58330,nd,-98.46956,48.44669,1214,2,3,1,50
58331,nd,-99.09432,48.6374,512,1,3,2,200
58332,nd,-99.76171,48.04185,1271,3,6,3,100
58335,nd,-99.02635,47.98111,235,2,4,2,100
58338,nd,-98.62031,48.5344,579,1,3,2,200
58339,nd,-99.44564,48.89579,137,1,2,1,100
58341,nd,-99.84998,47.77527,3554,4,7,3,75
58343,nd,-99.72224,48.29736,385,2,4,2,100
58344,nd,-98.34368,48.02428,1142,2,5,3,150
58345,nd,-98.36942,48.30538,837,2,4,2,100
58346,nd,-99.42858,48.28751,1152,2,4,2,100
58348,nd,-99.52237,47.96684,1568,3,5,2,66.7
58351,nd,-99.27911,48.0987,1022,2,4,2,100
58352,nd,-98.86931,48.70752,2043,1,2,1,100
58353,nd,-99.59573,48.63289,588,1,3,2,200
58355,nd,-98.36627,48.59092,536,1,2,1,100
58356,nd,-99.07125,47.6733,2786,3,6,3,100
58357,nd,-99.23268,47.94119,660,2,5,3,150
58361,nd,-98.3462,47.75735,711,3,6,3,100
58362,nd,-99.08927,48.2144,267,2,4,2,100
58363,nd,-99.45142,48.758,304,1,2,1,100
58365,nd,-99.25216,48.85836,1404,1,3,2,200
58366,nd,-99.87119,48.65869,1738,2,3,1,50
58367,nd,-99.58665,48.86929,922,1,2,1,100
58368,nd,-100.04444,48.25644,4293,3,5,2,66.7
58369,nd,-99.79911,48.94812,821,1,1,0,0
58370,nd,-98.84404,47.98312,573,2,4,2,100
58372,nd,-98.99641,48.94529,842,1,2,1,100
58374,nd,-99.09494,47.83246,2025,3,5,2,66.7
58377,nd,-98.86286,48.45841,1433,1,3,2,200
58379,nd,-98.84512,47.90599,209,2,4,2,100
58380,nd,-98.51521,47.83164,1183,3,5,2,66.7
58381,nd,-98.74062,47.83268,1335,2,5,3,150
58382,nd,-98.78496,48.31165,862,2,3,1,50
58384,nd,-100.25676,48.60285,2916,2,4,2,100
58385,nd,-99.66355,48.47849,726,2,4,2,100
58386,nd,-99.59652,48.30903,676,2,4,2,100
58401,nd,-98.76401,46.88251,4741,4,7,3,75
58402,nd,-98.6872,46.88035,1,4,8,4,100
58413,nd,-99.30706,46.03467,3398,3,6,3,100
58415,nd,-98.4916,46.37119,395,5,9,4,80
58416,nd,-98.35019,47.54152,876,3,6,3,100
58418,nd,-99.64579,47.42098,1185,3,5,2,66.7
58420,nd,-98.86769,47.06138,1135,4,7,3,75
58421,nd,-99.06887,47.44201,2037,3,6,3,100
58422,nd,-99.4033,47.59795,875,3,6,3,100
58423,nd,-99.82584,47.411,541,3,5,2,66.7
58424,nd,-99.11088,46.88847,1289,3,6,3,100
58425,nd,-98.12431,47.45618,1186,3,6,3,100
58426,nd,-98.58676,47.21921,1062,4,7,3,75
58428,nd,-99.75152,46.84846,686,3,6,3,100
58429,nd,-98.16377,47.18486,921,3,6,3,100
58430,nd,-100.26125,47.51471,532,3,6,3,100
58431,nd,-98.48496,46.5077,542,5,8,3,60
58433,nd,-98.713,46.37031,2385,4,7,3,75
58436,nd,-98.57872,46.08758,1799,6,10,4,66.7
58438,nd,-99.5963,47.66352,1029,3,6,3,100
58439,nd,-98.83449,45.98237,751,5,9,4,80
58440,nd,-99.16719,46.26933,1443,3,6,3,100
58441,nd,-98.37128,46.1764,778,6,10,4,66.7
58442,nd,-99.1791,46.56467,1293,3,7,4,133.3
58443,nd,-98.67203,47.45541,441,3,6,3,100
58444,nd,-100.12974,47.49942,961,3,5,2,66.7
58445,nd,-98.80248,47.56402,283,3,5,2,66.7
58448,nd,-98.22015,47.31124,760,3,6,3,100
58451,nd,-99.95298,47.45155,760,2,5,3,150
58452,nd,-98.23124,47.54776,12,3,6,3,100
58454,nd,-98.93533,46.59647,1727,4,7,3,75
58455,nd,-98.74301,47.30171,1022,4,8,4,100
58456,nd,-98.94603,46.26554,1966,3,6,3,100
58458,nd,-98.29872,46.36959,2137,5,9,4,80
58460,nd,-99.33674,46.30803,1257,2,5,3,150
58461,nd,-98.19499,46.65293,1143,5,8,3,60
58463,nd,-100.47236,47.49071,2159,3,6,3,100
58464,nd,-98.58105,47.60517,977,3,5,2,66.7
58466,nd,-98.36749,46.61781,1093,5,8,3,60
58467,nd,-99.33366,46.88117,1763,3,5,2,66.7
58472,nd,-98.66532,46.64266,1115,4,8,4,100
58474,nd,-98.13355,46.0955,2565,6,10,4,66.7
58475,nd,-99.53946,47.16548,727,3,6,3,100
58476,nd,-99.01679,47.19771,1610,4,7,3,75
58477,nd,-100.50914,47.21579,790,3,5,2,66.7
58478,nd,-99.74566,47.17486,651,3,6,3,100
58479,nd,-98.1846,47.09529,513,3,6,3,100
58480,nd,-98.26049,46.9532,873,4,7,3,75
58481,nd,-98.42113,46.93134,1012,4,7,3,75
58482,nd,-99.89895,46.8552,1044,3,6,3,100
58483,nd,-99.40803,46.65253,1338,3,5,2,66.7
58484,nd,-98.47813,47.37515,287,3,6,3,100
58486,nd,-99.39131,47.39046,881,3,5,2,66.7
58487,nd,-99.59723,46.85759,1110,3,5,2,66.7
58488,nd,-99.9963,47.17816,1038,3,5,2,66.7
58490,nd,-98.05818,46.37964,828,5,9,4,80
58492,nd,-98.43794,47.15446,858,3,7,4,133.3
58494,nd,-100.28026,47.1565,1967,3,5,2,66.7
58495,nd,-99.60083,46.27701,2446,2,4,2,100
58496,nd,-99.3291,47.14744,1470,3,6,3,100
58497,nd,-98.54582,46.76725,786,4,8,4,100
58501,nd,-100.70202,46.81871,10827,4,7,3,75
58503,nd,-100.75055,46.90434,13724,3,7,4,133.3
58504,nd,-100.67796,46.7231,11365,4,7,3,75
58505,nd,-100.78092,46.82021,3,4,7,3,75
58520,nd,-101.54686,46.68175,957,3,7,4,133.3
58521,nd,-100.69198,47.02467,1272,3,5,2,66.7
58523,nd,-101.77837,47.25854,1960,3,6,3,100
58524,nd,-100.08083,46.59189,573,3,6,3,100
58528,nd,-100.63636,46.33615,1492,5,9,4,80
58529,nd,-101.55515,46.2999,2187,3,5,2,66.7
58530,nd,-101.15011,47.12921,2132,3,6,3,100
58531,nd,-101.19519,47.57372,1105,3,5,2,66.7
58532,nd,-100.10998,46.85213,1196,4,7,3,75
58533,nd,-101.79674,46.4019,1820,2,5,3,150
58535,nd,-101.24525,46.49994,1772,3,6,3,100
58538,nd,-100.693,46.11243,3023,5,9,4,80
58540,nd,-101.71679,47.62988,3913,2,4,2,100
58541,nd,-102.06549,47.3651,1073,3,5,2,66.7
58542,nd,-100.01431,46.05015,1228,4,7,3,75
58544,nd,-100.36921,46.50855,1733,3,6,3,100
58545,nd,-101.58061,47.35584,2648,3,5,2,66.7
58549,nd,-99.93628,46.47465,1048,3,5,2,66.7
58552,nd,-100.30106,46.23896,3912,4,8,4,100
58554,nd,-100.94024,46.738,13723,3,7,4,133.3
58558,nd,-100.51063,46.82635,1348,4,7,3,75
58559,nd,-100.72766,47.48817,1295,3,6,3,100
58560,nd,-100.25939,46.67951,636,5,8,3,60
58561,nd,-99.68329,46.48708,2121,2,5,3,150
58562,nd,-102.00451,46.3749,1649,3,5,2,66.7
58563,nd,-101.43497,46.90333,3310,3,6,3,100
58564,nd,-101.35225,46.26616,621,3,6,3,100
58565,nd,-101.38313,47.48681,428,2,4,2,100
58566,nd,-100.92538,46.58322,444,3,6,3,100
58568,nd,-101.04728,46.0878,4777,4,8,4,100
58569,nd,-101.19049,46.26228,664,4,8,4,100
58570,nd,-100.88829,46.38368,2420,5,9,4,80
58571,nd,-101.40095,47.27588,941,3,6,3,100
58572,nd,-100.33647,46.85638,1239,4,7,3,75
58573,nd,-100.20331,46.10012,1441,4,8,4,100
58575,nd,-100.90178,47.56335,1895,3,5,2,66.7
58576,nd,-101.21652,47.43867,1676,3,6,3,100
58577,nd,-101.05549,47.32195,2236,4,7,3,75
58579,nd,-100.74002,47.18202,2039,2,4,2,100
58580,nd,-101.93177,47.25981,992,3,6,3,100
58581,nd,-99.78126,46.03987,885,3,6,3,100
58601,nd,-102.83434,46.91587,16190,2,4,2,100
58620,nd,-103.33088,46.50433,566,2,4,2,100
58621,nd,-103.92812,47.08302,1953,2,4,2,100
58622,nd,-103.27058,46.89612,3133,2,4,2,100
58623,nd,-103.42572,46.18905,3086,2,4,2,75
58625,nd,-102.19438,47.26787,817,3,5,2,66.7
58626,nd,-102.62034,47.38149,1350,3,5,2,66.7
58627,nd,-103.30555,47.23289,567,2,4,2,100
58630,nd,-102.57917,46.9446,1396,2,5,3,150
58631,nd,-101.81891,46.79977,2874,3,5,2,66.7
58632,nd,-103.95635,46.66891,353,2,4,2,100
58634,nd,-103.34243,47.43418,1204,3,5,2,66.7
58636,nd,-102.36033,47.38629,4446,2,5,3,150
58638,nd,-102.04408,46.94033,2454,2,4,2,100
58639,nd,-102.61402,46.09173,1814,2,5,3,150
58640,nd,-102.90251,47.45233,3839,2,5,3,150
58641,nd,-102.49859,46.66843,409,2,4,2,100
58642,nd,-102.84268,47.20864,1239,2,5,3,150
58643,nd,-103.94447,46.32967,823,2,4,2,100
58645,nd,-103.56315,46.93876,1230,4,7,3,75
58646,nd,-102.28251,46.3939,3408,2,5,3,150
58647,nd,-102.93452,46.52223,2474,2,4,2,100
58649,nd,-102.91361,46.12102,981,2,4,2,125
58650,nd,-102.58755,46.43682,1754,2,5,3,150
58651,nd,-103.7353,46.2555,2658,2,4,2,100
58652,nd,-102.26786,46.86881,2502,2,5,3,150
58653,nd,-103.13542,46.09161,1824,2,4,2,100
58654,nd,-103.77789,46.8809,1063,2,5,3,150
58655,nd,-103.03396,46.77524,838,2,4,2,100
58656,nd,-102.45829,46.94406,1190,2,4,2,100
58701,nd,-101.32137,48.14258,14957,2,4,2,100
58702,nd,-101.29379,48.23214,1,2,4,2,100
58703,nd,-101.31557,48.33056,11069,2,4,2,100
58704,nd,-101.32091,48.4252,9,2,4,2,100
58705,nd,-101.33391,48.42234,1,2,4,2,100
58707,nd,-101.30051,48.24623,3,2,5,3,150
58710,nd,-100.22952,47.87231,1481,3,6,3,100
58711,nd,-101.28452,48.93083,810,2,4,2,100
58712,nd,-100.53095,47.97637,844,3,6,3,100
58713,nd,-100.59543,48.5351,245,2,5,3,150
58716,nd,-101.07155,47.81788,496,2,5,3,150
58718,nd,-101.81064,48.3124,3439,2,3,1,50
58721,nd,-102.28081,48.80591,1696,1,3,2,200
58722,nd,-101.49502,48.23734,1468,2,4,2,100
58723,nd,-100.60479,47.75864,1590,3,6,3,100
58725,nd,-101.68352,48.49193,1017,2,4,2,100
58727,nd,-102.79795,48.84344,1630,1,3,2,200
58730,nd,-103.31433,48.86467,2158,2,4,2,100
58731,nd,-100.97984,48.4397,762,3,5,2,66.7
58733,nd,-101.58701,48.17479,743,2,4,2,100
58734,nd,-101.94468,48.51539,1287,1,3,2,200
58735,nd,-101.48226,47.87381,1461,2,4,2,100
58736,nd,-100.38191,47.93384,1361,3,6,3,100
58737,nd,-102.39141,48.92153,947,1,2,1,100
58740,nd,-101.22972,48.47179,1265,2,5,3,150
58741,nd,-100.82447,48.27754,1311,3,6,3,100
58744,nd,-100.6232,48.11917,780,3,6,3,100
58746,nd,-102.08517,48.71821,3439,1,3,2,200
58748,nd,-100.6517,48.67956,965,2,4,2,100
58750,nd,-101.39827,48.61615,1498,2,4,2,100
58752,nd,-102.58466,48.83339,576,1,3,2,200
58755,nd,-102.94593,48.62399,694,1,3,2,200
58756,nd,-101.81016,47.9681,627,2,4,2,100
58757,nd,-102.55688,47.69116,5516,2,5,3,150
58758,nd,-100.10824,47.77614,797,4,7,3,75
58759,nd,-101.24674,47.85567,1701,2,4,2,100
58760,nd,-101.14773,48.70279,1085,2,4,2,100
58761,nd,-101.53291,48.78319,2381,2,3,1,50
58762,nd,-100.94159,48.67301,814,2,5,3,150
58763,nd,-102.57569,47.99291,3960,2,4,2,100
58765,nd,-103.03987,48.87733,1090,2,3,1,50
58768,nd,-101.01063,48.2322,562,3,6,3,100
58769,nd,-102.22117,48.32324,1256,1,3,2,200
58770,nd,-102.15788,47.88441,1957,2,4,2,100
58771,nd,-101.9755,48.08426,1757,2,4,2,100
58772,nd,-102.62396,48.9655,474,1,3,2,200
58773,nd,-102.6589,48.5808,2171,1,2,1,100
58775,nd,-101.8708,47.70824,463,2,3,1,50
58776,nd,-102.61388,48.24276,1154,1,3,2,200
58778,nd,-100.92714,47.7784,1123,3,5,2,66.7
58779,nd,-101.76726,47.86321,1703,2,3,1,50
58781,nd,-101.12694,48.02107,1066,3,5,2,66.7
58782,nd,-101.70108,48.93922,1227,1,3,2,200
58783,nd,-100.75674,48.89222,2069,2,4,2,100
58784,nd,-102.42438,48.36438,3735,1,2,1,100
58785,nd,-101.09064,48.30897,1157,2,5,3,150
58787,nd,-101.80564,48.75721,986,1,3,2,200
58788,nd,-100.48052,48.34231,3747,3,6,3,100
58789,nd,-100.81613,48.559,1012,2,5,3,150
58790,nd,-100.92966,48.03419,2008,3,6,3,100
58792,nd,-100.74331,47.97113,1090,3,6,3,100
58793,nd,-101.05388,48.8689,1501,2,5,3,150
58794,nd,-102.77084,48.26297,845,2,3,1,50
58795,nd,-103.15883,48.64333,1398,1,2,1,100
58801,nd,-103.75321,48.21309,20246,3,6,3,100
58830,nd,-103.46565,48.60605,1923,2,3,1,50
58831,nd,-103.65459,47.79473,2130,3,6,3,100
58833,nd,-103.52299,48.89118,620,2,3,1,50
58835,nd,-103.44091,47.77461,2075,3,6,3,100
58838,nd,-103.90176,47.77635,915,4,7,3,75
58843,nd,-103.37921,48.23389,2497,2,4,2,100
58844,nd,-103.74149,48.88133,1313,1,3,2,200
58845,nd,-103.92544,48.64846,1776,2,4,2,100
58847,nd,-102.89833,47.90636,1127,3,5,2,66.7
58849,nd,-103.19967,48.31884,2763,2,4,2,100
58852,nd,-102.95363,48.35673,4513,2,3,1,50
58853,nd,-103.83688,48.07543,224,4,8,4,100
58854,nd,-103.14545,47.81095,6742,3,5,2,66.7
58856,nd,-103.71718,48.58635,1598,2,4,2,100
59001,mt,-109.5245,45.52642,1573,0,0,0,NA
59002,mt,-108.67405,45.98439,288,1,2,1,100
59003,mt,-106.19541,45.46674,1466,2,4,2,100
59006,mt,-108.08044,45.9086,667,2,4,2,100
59007,mt,-109.14144,45.13859,404,0,0,0,NA
59008,mt,-109.0588,45.07285,718,0,0,0,NA
59010,mt,-107.30996,45.99696,656,2,5,3,150
59011,mt,-109.97902,45.9299,3389,0,1,1,NA
59012,mt,-106.49275,45.27314,622,2,4,2,100
59013,mt,-109.08714,45.45607,98,0,1,1,NA
59014,mt,-108.7699,45.19432,2808,0,1,1,NA
59015,mt,-108.8314,46.0752,973,0,1,1,NA
59016,mt,-106.96213,45.41063,916,1,2,1,100
59018,mt,-110.56344,45.86106,790,0,0,0,NA
59019,mt,-109.24568,45.65096,3596,0,1,1,NA
59020,mt,-110.02574,45.09559,744,0,0,0,NA
59022,mt,-107.2843,45.54103,955,2,5,3,150
59024,mt,-107.71123,46.20103,1138,2,5,3,150
59025,mt,-106.63033,45.09481,1278,1,3,2,200
59026,mt,-108.80059,45.47228,204,0,2,2,NA
59027,mt,-110.90627,45.24023,1107,0,0,0,NA
59028,mt,-109.68504,45.34493,1002,0,0,0,NA
59029,mt,-108.80094,45.40727,835,0,1,1,NA
59030,mt,-110.57225,45.08463,1471,0,0,0,NA
59031,mt,-107.42004,45.50147,288,3,6,3,100
59032,mt,-108.74432,47.02271,1369,1,1,0,0
59033,mt,-109.70195,45.72865,350,0,1,1,NA
59034,mt,-107.68069,45.69787,4223,4,8,4,100
59035,mt,-107.96717,45.29235,923,1,2,1,100
59036,mt,-109.93491,46.48582,1872,0,0,0,NA
59037,mt,-108.21283,45.80627,1666,1,3,2,200
59038,mt,-107.22707,46.19049,1915,2,5,3,150
59039,mt,-107.2902,46.69459,743,3,5,2,66.7
59041,mt,-108.97692,45.49742,1818,0,1,1,NA
59043,mt,-106.65038,45.52619,766,1,3,2,200
59044,mt,-108.74533,45.63605,6388,1,2,1,100
59046,mt,-109.00849,46.40143,1298,1,2,1,100
59047,mt,-110.56903,45.54808,9297,0,0,0,NA
59050,mt,-107.5271,45.24091,2187,1,2,1,100
59052,mt,-110.18336,45.43118,1320,0,0,0,NA
59053,mt,-110.45489,46.44501,1529,0,0,0,NA
59054,mt,-107.73314,46.64229,1585,3,6,3,100
59055,mt,-109.78073,46.10401,371,0,0,0,NA
59057,mt,-108.94184,45.85207,1052,0,1,1,NA
59058,mt,-107.78963,47.0811,1004,3,6,3,100
59059,mt,-108.07475,46.40736,567,2,4,2,100
59061,mt,-109.87708,45.35007,1075,0,0,0,NA
59062,mt,-106.14997,45.09024,249,1,3,2,200
59063,mt,-108.9638,45.66518,1432,1,2,1,100
59064,mt,-107.90786,45.88237,664,2,5,3,150
59065,mt,-110.73091,45.27873,329,0,0,0,NA
59066,mt,-108.49501,45.33738,904,0,0,0,NA
59067,mt,-109.23884,45.98266,694,0,1,1,NA
59068,mt,-109.44984,45.15834,5354,0,0,0,NA
59069,mt,-109.60075,45.7189,1036,0,1,1,NA
59070,mt,-109.18416,45.36908,1732,0,0,0,NA
59071,mt,-109.5648,45.26811,513,0,0,0,NA
59072,mt,-108.53763,46.46913,6573,1,3,2,200
59074,mt,-109.31631,46.36791,1332,0,1,1,NA
59075,mt,-107.88927,45.39854,1177,2,5,3,150
59076,mt,-107.07395,46.27874,73,3,6,3,100
59077,mt,-107.58775,47.18377,1096,2,5,3,150
59078,mt,-109.53546,46.34173,780,0,0,0,NA
59079,mt,-108.35363,46.06379,2365,1,3,2,200
59081,mt,-109.97328,45.00844,161,0,0,0,NA
59082,mt,-110.22489,45.7419,29,0,0,0,NA
59085,mt,-110.10732,46.36319,565,0,0,0,NA
59086,mt,-110.56173,46.06708,1301,0,0,0,NA
59087,mt,-108.21159,47.13233,4102,2,5,3,150
59088,mt,-108.04194,46.13051,1283,2,4,2,100
59089,mt,-107.35537,45.07728,904,0,1,1,NA
59101,mt,-108.3868,45.61404,20237,1,3,2,200
59102,mt,-108.5802,45.77566,19524,1,3,2,200
59105,mt,-108.50586,45.88272,14474,1,4,3,300
59106,mt,-108.68335,45.80801,10294,1,2,1,100
59201,mt,-105.66875,48.17289,6401,4,8,4,100
59211,mt,-104.35833,48.69448,481,3,5,2,66.7
59212,mt,-104.19086,48.18721,1525,4,7,3,75
59213,mt,-104.87857,48.18465,1524,4,7,3,75
59214,mt,-106.01366,47.30034,650,3,5,2,66.7
59215,mt,-105.74627,47.50396,2933,3,6,3,100
59217,mt,-104.24947,47.57932,83,5,9,4,80
59218,mt,-104.55204,48.1026,1751,4,8,4,100
59219,mt,-104.17755,48.53853,865,3,5,2,66.7
59221,mt,-104.19224,47.92807,2296,4,8,4,90
59222,mt,-105.14523,48.70416,1029,2,4,2,100
59223,mt,-106.20988,47.89168,1024,3,6,3,100
59225,mt,-105.97931,48.28842,1048,2,5,3,150
59226,mt,-104.58037,48.34851,1427,3,6,3,100
59230,mt,-106.83534,48.09861,6221,2,4,2,100
59231,mt,-106.54786,48.39805,16,1,2,1,100
59240,mt,-106.23572,48.84218,219,0,1,1,NA
59241,mt,-107.05862,48.46973,3395,1,3,2,200
59242,mt,-104.43886,48.43506,235,3,6,3,100
59243,mt,-104.6724,47.75212,948,3,6,3,100
59244,mt,-106.31973,48.60425,541,1,1,0,0
59247,mt,-104.53503,48.51171,922,3,6,3,100
59248,mt,-106.26983,48.26669,2989,3,5,2,66.7
59250,mt,-106.57371,48.85653,1726,1,1,0,0
59252,mt,-104.80943,48.92177,726,2,4,2,100
59253,mt,-105.87628,48.71828,776,1,2,1,100
59254,mt,-104.60752,48.74872,2329,3,6,3,100
59255,mt,-105.16805,48.24458,3064,4,8,4,100
59256,mt,-104.55467,48.91653,248,2,4,2,100
59257,mt,-104.94201,48.75453,559,2,5,3,150
59258,mt,-104.69479,48.57823,664,3,5,2,66.7
59259,mt,-105.0866,47.68493,1345,3,6,3,100
59260,mt,-106.0722,48.82474,976,1,1,0,0
59261,mt,-107.3854,48.58249,2048,1,3,2,200
59262,mt,-104.50349,47.48777,943,5,9,4,80
59263,mt,-105.52671,48.78349,3020,2,4,2,100
59270,mt,-104.08018,47.57574,6676,4,7,4,100
59274,mt,-105.4788,47.82089,1020,3,7,4,133.3
59275,mt,-104.20467,48.87776,1747,2,4,2,100
59276,mt,-105.18487,48.93188,586,1,3,2,200
59301,mt,-105.76128,46.29016,10708,4,8,4,100
59311,mt,-104.43071,45.18077,2369,2,3,1,50
59312,mt,-106.20522,47.0112,323,3,5,2,66.7
59313,mt,-104.24973,46.30564,3410,2,4,2,100
59314,mt,-105.36909,45.07362,708,2,4,2,100
59315,mt,-104.86245,47.44086,522,2,4,2,100
59317,mt,-105.49339,45.3639,4516,2,4,2,100
59318,mt,-107.48346,47.49141,1116,2,4,2,100
59322,mt,-106.67986,47.01456,762,2,5,3,150
59323,mt,-106.67015,45.98495,1153,1,3,2,200
59324,mt,-104.5465,45.78584,4100,2,4,2,100
59326,mt,-104.8433,46.7626,898,5,9,4,80
59327,mt,-106.70621,46.25237,4904,3,6,3,100
59330,mt,-104.75108,47.09683,6589,5,9,4,80
59332,mt,-104.76841,45.36711,1219,1,3,2,200
59333,mt,-106.21825,46.28009,32,4,8,4,100
59336,mt,-105.01484,46.33782,1524,3,7,4,133.3
59337,mt,-106.80161,47.38524,4787,3,6,3,100
59338,mt,-105.65567,46.63605,220,4,7,3,75
59339,mt,-105.18593,47.2637,629,1,4,3,300
59343,mt,-105.43798,45.65674,264,3,5,2,66.7
59344,mt,-104.59529,46.41197,857,3,6,3,100
59347,mt,-106.35203,46.4352,1367,3,7,4,133.3
59349,mt,-105.51126,46.88445,2915,3,6,3,100
59351,mt,-105.76016,45.75295,696,2,5,3,150
59353,mt,-104.24896,46.96536,2215,2,5,3,150
59354,mt,-104.39779,46.20586,104,2,4,2,100
59401,mt,-111.27554,47.51101,5179,0,1,1,NA
59404,mt,-111.34708,47.63057,14356,0,1,1,NA
59405,mt,-111.28923,47.30526,11813,0,1,1,NA
59410,mt,-112.65295,47.48418,2981,0,0,0,NA
59411,mt,-113.40769,48.87244,1084,0,0,0,NA
59412,mt,-110.89221,47.3271,2221,0,0,0,NA
59414,mt,-111.26801,47.52732,589,0,1,1,NA
59416,mt,-111.49621,48.04193,1302,0,1,1,NA
59417,mt,-113.19099,48.67266,4716,0,0,0,NA
59418,mt,-109.91239,46.79847,337,0,0,0,NA
59419,mt,-112.40849,47.98632,375,0,0,0,NA
59420,mt,-111.03341,47.88103,740,1,2,1,100
59421,mt,-111.73644,47.19428,3965,0,1,1,NA
59422,mt,-112.47355,47.81703,4339,0,0,0,NA
59424,mt,-110.09078,47.34668,360,0,1,1,NA
59425,mt,-111.89392,48.18265,3812,0,1,1,NA
59427,mt,-112.54035,48.77066,6271,0,0,0,NA
59430,mt,-109.84057,47.43474,2035,0,1,1,NA
59432,mt,-112.40389,48.16843,278,0,0,0,NA
59433,mt,-111.70629,47.89582,1755,0,1,1,NA
59434,mt,-113.35537,48.48137,1077,0,0,0,NA
59436,mt,-112.07162,47.61496,2034,0,0,0,NA
59440,mt,-111.15713,47.72567,744,1,2,1,100
59441,mt,-108.98012,46.85921,828,0,0,0,NA
59442,mt,-110.61178,47.92932,3749,1,2,1,100
59443,mt,-111.82915,47.5625,585,0,1,1,NA
59444,mt,-111.36527,48.72526,989,0,1,1,NA
59446,mt,-110.19281,47.61928,2293,1,2,1,100
59447,mt,-110.47448,47.26794,1228,0,0,0,NA
59448,mt,-112.81424,48.2586,300,0,0,0,NA
59450,mt,-110.73123,47.59733,1474,0,1,1,NA
59451,mt,-109.38619,47.38993,966,0,1,1,NA
59452,mt,-110.10975,46.86222,1964,0,0,0,NA
59453,mt,-109.63268,46.64953,1391,0,0,0,NA
59454,mt,-112.02463,48.71696,733,0,1,1,NA
59456,mt,-111.38861,48.26442,1034,0,1,1,NA
59457,mt,-109.3605,47.09215,9100,0,0,0,NA
59460,mt,-110.50842,48.08759,1033,1,3,2,200
59461,mt,-111.20669,48.48475,284,0,1,1,NA
59462,mt,-109.88729,47.11792,780,0,0,0,NA
59463,mt,-110.83087,47.03563,1087,0,0,0,NA
59464,mt,-109.65205,46.90447,1113,0,0,0,NA
59465,mt,-110.72029,46.89031,594,0,0,0,NA
59466,mt,-111.66665,48.7584,561,0,1,1,NA
59467,mt,-112.58022,48.07974,730,0,0,0,NA
59468,mt,-111.62165,47.71025,1162,0,1,1,NA
59469,mt,-110.7017,47.20157,492,0,0,0,NA
59471,mt,-108.75951,47.42131,2689,1,3,2,200
59472,mt,-111.16354,47.39846,425,0,1,1,NA
59474,mt,-111.73781,48.51893,4494,0,1,1,NA
59477,mt,-111.9196,47.4551,437,0,1,1,NA
59479,mt,-110.33112,47.01981,2153,0,0,0,NA
59480,mt,-111.17674,47.19327,871,0,0,0,NA
59482,mt,-111.9078,48.87286,1489,0,1,1,NA
59483,mt,-111.6993,47.45537,617,0,1,1,NA
59484,mt,-111.65962,48.96725,590,0,0,0,NA
59485,mt,-111.54369,47.40651,440,0,1,1,NA
59486,mt,-112.38399,48.3158,2880,0,0,0,NA
59487,mt,-111.64357,47.58346,879,0,1,1,NA
59489,mt,-109.23598,47.64038,2213,1,2,1,100
59501,mt,-109.79905,48.68877,8815,1,2,1,100
59520,mt,-109.94555,48.0365,3588,1,3,2,200
59521,mt,-109.94097,48.30096,733,1,2,1,100
59522,mt,-111.00325,48.54173,2978,0,1,1,NA
59523,mt,-109.22977,48.54582,5524,1,2,1,100
59524,mt,-108.3192,48.23564,1711,1,3,2,200
59525,mt,-110.31204,48.69459,1110,1,2,1,100
59526,mt,-108.71498,48.43615,2699,1,4,3,300
59527,mt,-108.74784,48.04657,407,0,1,1,NA
59528,mt,-110.40092,48.56851,693,1,2,1,100
59529,mt,-108.63411,48.82652,1344,0,1,1,NA
59530,mt,-110.6914,48.6251,715,0,1,1,NA
59531,mt,-110.80528,48.78977,833,0,1,1,NA
59532,mt,-110.09665,48.5771,808,1,2,1,100
59535,mt,-109.26745,47.96375,1783,1,1,0,0
59537,mt,-108.04618,48.82808,1058,1,2,1,100
59538,mt,-107.84041,48.07291,7649,2,5,3,150
59540,mt,-110.55555,48.59871,1349,0,2,2,NA
59542,mt,-108.37609,48.78744,774,1,2,1,100
59544,mt,-107.55533,48.84307,1377,1,3,2,200
59545,mt,-111.16862,48.93247,245,0,0,0,NA
59546,mt,-108.592,47.76973,1229,1,2,1,100
59547,mt,-109.01576,48.65704,178,1,4,3,300
59601,mt,-112.17645,46.53982,12479,0,0,0,NA
59602,mt,-111.91252,46.74009,14012,0,1,1,NA
59631,mt,-112.36459,46.31202,1042,0,0,0,NA
59632,mt,-112.02151,46.17685,2876,0,0,0,NA
59633,mt,-112.35918,46.81901,879,0,0,0,NA
59634,mt,-111.97464,46.46896,3314,0,0,0,NA
59635,mt,-111.82803,46.56251,3602,0,0,0,NA
59636,mt,-112.10992,46.61973,10,0,0,0,NA
59638,mt,-111.96818,46.36037,1031,0,0,0,NA
59639,mt,-112.6923,47.09253,2774,0,0,0,NA
59640,mt,-112.3053,46.73549,219,0,0,0,NA
59642,mt,-110.72437,46.28241,300,0,0,0,NA
59643,mt,-111.59006,46.17092,1025,0,0,0,NA
59644,mt,-111.43104,46.42112,4357,0,0,0,NA
59645,mt,-111.04714,46.68044,4182,0,0,0,NA
59647,mt,-111.65805,46.48174,469,0,0,0,NA
59648,mt,-112.11792,47.08191,2233,0,0,0,NA
59701,mt,-112.46687,46.03421,20165,0,0,0,NA
59703,mt,-112.53746,46.04571,46,0,0,0,NA
59710,mt,-112.06067,45.06985,1429,0,0,0,NA
59711,mt,-113.06596,46.1063,8262,0,0,0,NA
59713,mt,-112.59068,46.68003,481,0,0,0,NA
59714,mt,-111.13973,45.97986,9752,0,1,1,NA
59715,mt,-110.90993,45.82855,13346,0,0,0,NA
59716,mt,-111.4868,45.10266,3358,0,0,0,NA
59718,mt,-111.12638,45.57814,15101,0,0,0,NA
59720,mt,-111.64394,44.8782,1587,0,0,0,NA
59721,mt,-111.83655,45.88027,1123,0,0,0,NA
59722,mt,-112.76555,46.36251,3281,0,0,0,NA
59724,mt,-112.7468,44.70974,1067,0,0,0,NA
59725,id,-112.8378,45.08973,8702,0,0,0,NA
59727,mt,-112.8086,45.80307,746,0,0,0,NA
59728,mt,-112.41988,46.51578,687,0,0,0,NA
59729,mt,-111.65894,45.29332,3936,0,0,0,NA
59730,mt,-111.20623,45.22774,2946,0,0,0,NA
59731,mt,-112.77361,46.57901,545,0,0,0,NA
59732,mt,-112.73311,45.48811,331,0,0,0,NA
59733,mt,-112.88581,46.58871,492,0,0,0,NA
59735,mt,-111.86388,45.65028,919,0,0,0,NA
59736,mt,-113.39403,45.3338,753,0,0,0,NA
59739,mt,-112.17089,44.63693,2214,0,0,0,NA
59740,mt,-111.82134,45.47645,901,0,0,0,NA
59741,mt,-111.36073,45.77236,2859,0,1,1,NA
59743,mt,-112.67785,45.66873,444,0,0,0,NA
59745,mt,-111.61383,45.58954,581,0,0,0,NA
59746,mt,-113.05785,45.36589,633,0,0,0,NA
59747,mt,-111.94571,45.71304,533,0,0,0,NA
59748,mt,-112.69923,46.04669,299,0,0,0,NA
59749,mt,-112.12313,45.44577,1949,0,0,0,NA
59750,mt,-112.71841,45.95132,442,0,0,0,NA
59751,mt,-112.47825,45.6329,886,0,0,0,NA
59752,mt,-111.50639,45.9492,4280,0,1,1,NA
59754,mt,-112.33841,45.46329,1506,0,0,0,NA
59755,mt,-111.9379,45.32841,1056,0,0,0,NA
59756,mt,-112.82799,46.17985,16,0,0,0,NA
59758,mt,-111.18796,44.74305,2249,0,0,0,NA
59759,mt,-112.19623,45.84575,3484,0,0,0,NA
59760,mt,-111.6359,45.76446,341,0,0,0,NA
59761,mt,-113.55342,45.6359,1552,0,0,0,NA
59762,mt,-113.1569,45.7864,1278,0,0,0,NA
59801,mt,-114.01489,46.8563,11525,0,1,1,NA
59802,mt,-113.91984,46.90362,8164,0,0,0,NA
59803,mt,-113.96288,46.79394,7082,0,1,1,NA
59804,mt,-114.25098,46.90101,3705,1,2,1,100
59808,mt,-114.0961,46.98299,8994,1,2,1,100
59820,mt,-114.63713,46.89595,1603,0,0,0,NA
59821,mt,-114.06045,47.1726,1601,0,1,1,NA
59823,mt,-113.49471,46.93545,1830,0,0,0,NA
59824,mt,-114.20356,47.42326,1300,1,1,0,0
59825,mt,-113.68308,46.62696,2433,0,0,0,NA
59826,mt,-113.69487,47.43794,1649,0,0,0,NA
59827,mt,-114.04544,45.89488,502,0,0,0,NA
59828,mt,-113.96528,46.33331,4140,0,1,1,NA
59829,mt,-114.28225,45.78632,3676,0,0,0,NA
59830,mt,-115.34366,47.42451,251,0,0,0,NA
59831,mt,-114.35276,47.2775,504,0,1,1,NA
59832,mt,-113.23873,46.68112,1299,0,0,0,NA
59833,mt,-114.06219,46.65157,3929,1,2,1,100
59834,mt,-114.23109,47.07466,1268,1,2,1,100
59837,mt,-113.27506,46.54509,703,0,0,0,NA
59840,mt,-114.18924,46.18544,9445,0,1,1,NA
59841,mt,-114.2232,46.3339,28,0,1,1,NA
59842,mt,-115.41783,47.35378,402,0,0,0,NA
59843,mt,-112.96138,46.83406,1333,0,0,0,NA
59844,mt,-115.96854,48.05721,780,0,0,0,NA
59845,mt,-114.54416,47.65839,2302,0,1,1,NA
59846,mt,-114.51103,47.14826,1290,0,1,1,NA
59847,id,-114.43731,46.70573,3187,0,0,0,0
59848,mt,-114.69129,47.70148,230,1,1,0,0
59851,mt,-113.87795,46.87087,113,0,0,0,NA
59853,mt,-115.76968,48.05709,1217,0,1,1,NA
59854,mt,-113.08417,47.03535,924,0,0,0,NA
59855,mt,-114.11855,47.60547,272,0,1,1,NA
59856,mt,-114.79019,47.33702,581,0,1,1,NA
59858,mt,-113.449,46.2885,3838,0,0,0,NA
59859,mt,-114.82134,47.53049,3725,1,2,1,100
59860,mt,-114.16688,47.71025,8880,0,1,1,NA
59863,mt,-114.17892,47.30955,104,0,1,1,NA
59864,mt,-114.11018,47.52899,3391,0,1,1,NA
59865,mt,-114.01011,47.32886,1738,0,1,1,NA
59866,mt,-115.15641,47.32669,1160,0,1,1,NA
59867,mt,-115.59591,47.42243,239,0,0,0,NA
59868,mt,-113.50499,47.21408,3282,0,0,0,NA
59870,mt,-114.06163,46.5157,7295,1,2,1,100
59871,mt,-113.8321,45.86573,968,0,0,0,NA
59872,mt,-114.90014,47.11283,2450,1,1,0,0
59873,mt,-115.28195,47.70259,3979,1,3,2,200
59874,mt,-115.62682,47.80339,2108,1,2,1,100
59875,mt,-114.26071,46.40792,2785,1,2,1,100
59901,mt,-114.38224,48.22816,31799,0,1,1,NA
59910,mt,-114.30202,47.79525,773,0,1,1,NA
59911,mt,-113.86899,47.88148,10091,0,0,0,NA
59912,mt,-114.16435,48.40466,9371,0,1,1,NA
59913,mt,-113.94616,48.41712,741,0,0,0,NA
59914,mt,-114.28322,47.85968,503,0,1,1,NA
59915,mt,-114.40223,47.84317,418,0,1,1,NA
59916,mt,-113.52858,48.28096,858,0,0,0,NA
59917,mt,-114.92859,48.90264,5018,0,1,1,NA
59918,mt,-114.85672,48.7718,800,0,0,0,NA
59919,mt,-113.32505,47.98886,2268,0,0,0,NA
59920,mt,-114.5327,48.06675,1897,0,0,0,NA
59922,mt,-114.18719,47.99691,2529,0,0,0,NA
59923,mt,-115.32285,48.26411,9025,1,1,0,0
59925,mt,-114.83038,48.0483,2489,0,0,0,NA
59926,mt,-114.00662,48.36304,488,0,0,0,NA
59927,mt,-114.68411,48.57211,854,0,0,0,NA
59928,mt,-114.42468,48.78555,1821,0,0,0,NA
59929,mt,-114.36416,47.92383,438,0,0,0,NA
59930,mt,-115.14316,48.84915,1580,0,1,1,NA
59931,mt,-114.17261,47.91196,582,0,1,1,NA
59932,mt,-114.25407,48.0466,1580,0,1,1,NA
59933,mt,-114.77139,48.68095,45,0,0,0,NA
59934,mt,-114.8965,48.59833,961,0,0,0,NA
59935,mt,-115.86028,48.6438,5219,0,1,1,NA
59936,mt,-113.85538,48.60876,3183,0,0,0,NA
59937,mt,-114.5372,48.41176,13846,0,1,1,NA
60002,il,-88.08683,42.46951,14917,8,14,6,75
60004,il,-87.97916,42.11199,14895,8,15,7,87.5
60005,il,-87.98557,42.06386,7712,8,15,7,87.5
60007,il,-87.99306,42.00757,10974,8,16,8,100
60008,il,-88.02267,42.07446,5740,8,15,7,87.5
60010,il,-88.1635,42.15233,19690,8,15,7,87.5
60012,il,-88.31261,42.27209,4525,8,15,7,87.5
60013,il,-88.23585,42.22033,10708,8,15,7,87.5
60014,il,-88.32729,42.23202,18422,8,16,8,100
60015,il,-87.87477,42.17249,8578,6,12,6,100
60016,il,-87.89167,42.04973,13945,8,14,6,75
60018,il,-87.89697,41.99747,9163,8,15,7,87.5
60020,il,-88.1775,42.39195,4558,7,14,7,100
60021,il,-88.21821,42.19486,2425,8,15,7,87.5
60022,il,-87.7621,42.13662,3371,6,11,5,83.3
60025,il,-87.82038,42.07542,12407,6,12,6,100
60026,il,-87.83745,42.09223,3764,7,12,5,71.4
60029,il,-87.77834,42.05925,201,7,13,6,85.7
60030,il,-88.04462,42.33669,13541,7,14,7,100
60031,il,-87.9411,42.37506,13112,6,12,6,100
60033,il,-88.60764,42.42473,7725,10,18,8,80
60034,il,-88.42006,42.45635,1556,10,17,7,70
60035,il,-87.80539,42.1846,11096,6,11,5,83.3
60040,il,-87.81309,42.20632,1306,6,11,5,83.3
60041,il,-88.15541,42.36837,5091,7,14,7,100
60042,il,-88.19789,42.2791,4278,8,15,7,87.5
60043,il,-87.71458,42.08886,1000,6,11,5,83.3
60044,il,-87.86115,42.28569,4016,5,10,5,100
60045,il,-87.86608,42.23896,8458,6,11,5,83.3
60046,il,-88.06044,42.41608,15206,8,14,6,75
60047,il,-88.04545,42.20224,16846,8,14,6,75
60048,il,-87.9498,42.29524,10773,6,12,6,100
60050,il,-88.29551,42.33118,13716,8,15,7,87.5
60051,il,-88.22932,42.35419,14770,8,15,7,87.5
60053,il,-87.78895,42.04234,8915,7,13,6,85.7
60056,il,-87.93435,42.06653,14796,8,15,7,87.5
60060,il,-88.03974,42.2699,13264,7,14,7,100
60061,il,-87.96071,42.23375,6999,7,13,6,85.7
60062,il,-87.84438,42.12656,13943,6,12,6,100
60064,il,-87.85633,42.32472,4904,5,10,5,100
60067,il,-88.06542,42.1066,13022,8,15,7,87.5
60068,il,-87.84356,42.01252,13505,7,14,7,100
60069,il,-87.92608,42.19762,3293,6,12,6,100
60070,il,-87.93008,42.10343,2734,7,14,7,100
60071,il,-88.31322,42.46355,2338,9,16,7,77.8
60072,il,-88.30591,42.40667,792,9,16,7,77.8
60073,il,-88.10983,42.34811,20320,8,14,6,75
60074,il,-88.02658,42.13153,6970,8,14,6,75
60076,il,-87.72993,42.03526,12328,6,12,6,100
60077,il,-87.75719,42.03475,7601,7,13,6,85.7
60081,il,-88.22628,42.45045,6793,8,15,7,87.5
60083,il,-87.94591,42.43617,4252,5,10,5,100
60084,il,-88.1409,42.26784,6876,8,14,6,75
60085,il,-87.8652,42.35419,16028,5,10,5,100
60087,il,-87.85143,42.40323,9212,5,10,5,100
60088,il,-87.84451,42.30941,36,5,10,5,100
60089,il,-87.96062,42.16695,10946,7,14,7,100
60090,il,-87.92194,42.12948,7307,7,13,6,85.7
60091,il,-87.72021,42.07881,9723,6,11,5,83.3
60093,il,-87.75354,42.10537,7542,6,11,5,83.3
60096,il,-87.82495,42.47945,3430,4,8,4,100
60097,il,-88.36479,42.39606,6704,9,16,7,77.8
60098,il,-88.45788,42.32518,14190,9,16,7,77.8
60099,il,-87.86726,42.46027,11990,4,9,5,125
60101,il,-88.01187,41.93067,11028,10,19,9,90
60102,il,-88.3068,42.16405,12393,8,16,8,100
60103,il,-88.20632,41.97939,13230,10,18,8,80
60104,il,-87.87643,41.88284,6586,8,16,8,100
60106,il,-87.94182,41.96043,6072,8,15,7,87.5
60107,il,-88.17928,42.02216,12664,10,18,8,80
60108,il,-88.09182,41.94931,7190,11,20,9,81.8
60109,il,-88.54586,42.04976,350,9,17,8,88.9
60110,il,-88.28604,42.12294,9854,9,16,7,77.8
60111,il,-88.82814,42.00817,260,9,18,9,100
60112,il,-88.69081,41.92429,2034,8,17,9,112.5
60113,il,-88.96592,41.93227,131,9,18,9,100
60115,il,-88.75479,41.90082,11994,9,17,8,88.9
60118,il,-88.30523,42.10671,6732,9,17,8,88.9
60119,il,-88.47671,41.86048,5412,10,19,9,90
60120,il,-88.23858,42.03449,14106,10,18,8,80
60123,il,-88.31131,42.04022,13292,9,17,8,88.9
60124,il,-88.39712,42.02582,11229,9,16,7,77.8
60126,il,-87.94203,41.89644,15887,9,17,8,88.9
60129,il,-88.95629,42.02644,224,9,18,9,100
60130,il,-87.8174,41.86643,3692,8,16,8,100
60131,il,-87.88428,41.93876,7596,8,15,7,87.5
60133,il,-88.14303,41.97763,9917,10,19,9,90
60134,il,-88.34199,41.87856,11399,10,19,9,90
60135,il,-88.67742,42.11221,3524,9,18,9,100
60136,il,-88.37824,42.10469,2777,8,16,8,100
60137,il,-88.06184,41.8651,12791,13,23,10,76.9
60139,il,-88.07783,41.91932,7358,12,21,9,75
60140,il,-88.50654,42.07838,10404,8,16,8,100
60141,il,-87.83808,41.8579,15,8,16,8,100
60142,il,-88.44255,42.17563,13376,9,16,7,77.8
60143,il,-88.02155,41.97303,3732,9,17,8,88.9
60144,il,-88.52039,41.83569,29,10,20,10,100
60145,il,-88.77656,42.09367,1480,9,18,9,100
60146,il,-88.88131,42.09945,1728,9,18,9,100
60148,il,-88.01816,41.87417,15399,12,22,10,83.3
60150,il,-88.88862,41.92497,1176,9,18,9,100
60151,il,-88.56666,41.91611,3085,9,18,9,100
60152,il,-88.62557,42.23697,7088,10,19,9,90
60153,il,-87.84326,41.87928,7784,8,16,8,100
60154,il,-87.89164,41.84747,8000,9,17,8,88.9
60155,il,-87.85627,41.85768,3222,8,16,8,100
60156,il,-88.34589,42.19142,9763,8,16,8,100
60157,il,-88.05539,41.97453,970,10,19,9,90
60160,il,-87.86066,41.90414,6375,8,16,8,100
60162,il,-87.90212,41.86757,2953,8,16,8,100
60163,il,-87.90906,41.88881,2500,8,16,8,100
60164,il,-87.9007,41.91751,6346,8,15,7,87.5
60165,il,-87.88071,41.90321,1255,8,16,8,100
60169,il,-88.11664,42.05038,8132,10,18,8,80
60171,il,-87.83837,41.92505,3004,8,15,7,87.5
60172,il,-88.08952,41.97972,8382,10,19,9,90
60173,il,-88.05195,42.0516,2174,9,16,7,77.8
60174,il,-88.29935,41.92726,12111,9,17,8,88.9
60175,il,-88.39105,41.94701,10078,9,17,8,88.9
60176,il,-87.86888,41.95812,3555,8,15,7,87.5
60177,il,-88.30994,41.9899,7482,9,17,8,88.9
60178,il,-88.66898,42.00639,10073,8,17,9,112.5
60180,il,-88.52467,42.2252,1234,9,18,9,100
60181,il,-87.97633,41.8782,9910,11,20,9,81.8
60184,il,-88.25363,41.95247,1306,9,18,9,100
60185,il,-88.21264,41.89479,11546,10,20,10,100
60187,il,-88.11229,41.87241,9210,12,22,10,83.3
60188,il,-88.12916,41.91582,10916,11,20,9,81.8
60189,il,-88.11786,41.83977,9056,13,24,11,84.6
60190,il,-88.15697,41.87168,4545,12,22,10,83.3
60191,il,-87.98077,41.96615,4939,8,16,8,100
60192,il,-88.18229,42.07368,5886,9,17,8,88.9
60193,il,-88.0963,42.01176,10443,10,18,8,80
60194,il,-88.11141,42.03364,4455,10,18,8,80
60195,il,-88.09127,42.06709,483,10,17,7,70
60201,il,-87.69213,42.05638,9260,6,12,6,100
60202,il,-87.68541,42.03078,6937,6,12,6,100
60203,il,-87.71746,42.04905,1788,6,12,6,100
60301,il,-87.79894,41.88856,299,8,15,7,87.5
60302,il,-87.7897,41.89461,7755,8,15,7,87.5
60304,il,-87.78948,41.87239,5515,8,15,7,87.5
60305,il,-87.81941,41.895,3435,8,16,8,100
60401,il,-87.61376,41.34396,4312,10,20,10,100
60402,il,-87.79141,41.83473,17444,8,15,7,87.5
60403,il,-88.11386,41.57229,6560,11,22,11,100
60404,il,-88.22307,41.50877,8165,12,24,12,100
60406,il,-87.68186,41.65474,8612,10,19,9,90
60407,il,-88.26934,41.23056,1104,12,25,13,108.3
60408,il,-88.21676,41.26375,2836,12,24,12,100
60409,il,-87.55133,41.61322,14609,10,20,10,100
60410,il,-88.21368,41.42202,5619,12,23,11,91.7
60411,il,-87.59057,41.50868,26151,10,19,9,90
60415,il,-87.77887,41.70297,3041,9,18,9,100
60416,il,-88.28183,41.29314,4510,12,24,12,100
60417,il,-87.59321,41.42887,8897,9,19,10,111.1
60419,il,-87.59939,41.6277,9098,10,20,10,100
60420,il,-88.41719,41.08771,2984,12,25,13,108.3
60421,il,-88.09954,41.43128,2794,11,22,11,100
60422,il,-87.6841,41.53697,3844,10,19,9,90
60423,il,-87.83791,41.47956,12936,10,20,10,100
60424,il,-88.32725,41.16822,1501,12,25,13,108.3
60425,il,-87.6117,41.54551,3277,10,20,10,100
60426,il,-87.6534,41.61034,18500,10,20,10,100
60428,il,-87.69057,41.5998,8959,9,19,10,111.1
60429,il,-87.68413,41.57369,6282,9,19,10,111.1
60430,il,-87.66475,41.55766,7713,10,19,9,90
60431,il,-88.20527,41.53265,10021,12,23,11,91.7
60432,il,-88.04163,41.54034,7894,12,22,10,83.3
60433,il,-88.04319,41.49967,7191,11,22,11,100
60435,il,-88.12988,41.54541,16165,11,22,11,100
60436,il,-88.12259,41.49229,7831,12,23,11,91.7
60437,il,-88.55345,41.16306,324,12,25,13,108.3
60438,il,-87.55086,41.56662,11785,11,21,10,90.9
60439,il,-87.9822,41.67521,10717,10,20,10,100
60440,il,-88.07508,41.70025,15436,11,21,10,90.9
60441,il,-88.0508,41.59297,14550,11,21,10,90.9
60442,il,-87.96352,41.39274,6052,11,22,11,100
60443,il,-87.74675,41.50373,7322,9,19,10,111.1
60444,il,-88.40226,41.24232,1387,12,24,12,100
60445,il,-87.73619,41.63502,8751,9,19,10,111.1
60446,il,-88.10457,41.63181,12905,11,22,11,100
60447,il,-88.32421,41.48821,6164,11,23,12,109.1
60448,il,-87.89376,41.5377,10059,10,20,10,100
60449,il,-87.77244,41.41567,4449,10,20,10,100
60450,il,-88.43288,41.3695,10670,12,23,11,91.7
60451,il,-87.96076,41.50693,13568,11,21,10,90.9
60452,il,-87.75526,41.60762,8869,9,18,9,100
60453,il,-87.75282,41.71427,19901,9,18,9,100
60455,il,-87.80865,41.7421,4574,9,17,8,88.9
60456,il,-87.73113,41.73125,1683,9,18,9,100
60457,il,-87.82805,41.72466,4106,9,18,9,100
60458,il,-87.83461,41.74896,2688,9,17,8,88.9
60459,il,-87.76858,41.74443,9622,8,17,9,112.5
60460,il,-88.53655,41.00119,1418,14,28,14,100
60461,il,-87.69085,41.51667,2099,9,19,10,111.1
60462,il,-87.83242,41.62488,12878,9,19,10,111.1
60463,il,-87.78996,41.66097,4966,9,18,9,100
60464,il,-87.86184,41.66251,3990,9,19,10,111.1
60465,il,-87.82892,41.69843,4755,9,18,9,100
60466,il,-87.68283,41.47905,6493,9,19,10,111.1
60467,il,-87.88989,41.6018,9784,10,20,10,100
60468,il,-87.81131,41.33632,3232,11,22,11,100
60469,il,-87.68706,41.62826,2759,10,19,9,90
60470,il,-88.64105,41.16898,737,12,25,13,108.3
60471,il,-87.73405,41.47956,4287,9,19,10,111.1
60472,il,-87.70869,41.64362,5704,10,19,9,90
60473,il,-87.59982,41.59739,9531,11,20,9,81.8
60474,il,-88.2662,41.18556,485,12,25,13,108.3
60475,il,-87.62777,41.47273,5889,9,19,10,111.1
60476,il,-87.60675,41.56867,1283,10,20,10,100
60477,il,-87.78869,41.57254,12071,9,19,10,111.1
60478,il,-87.72476,41.56367,5768,9,19,10,111.1
60479,il,-88.51789,41.22864,833,12,24,12,100
60480,il,-87.88093,41.72893,2587,9,18,9,100
60481,il,-88.12308,41.28401,8020,12,24,12,100
60482,il,-87.79116,41.6874,3219,9,18,9,100
60484,il,-87.7062,41.44208,2376,9,19,10,111.1
60487,il,-87.83423,41.56354,8641,10,20,10,100
60490,il,-88.14441,41.67476,6696,11,21,10,90.9
60491,il,-87.9599,41.60276,8982,10,20,10,100
60501,il,-87.82395,41.78014,3698,8,16,8,100
60502,il,-88.25904,41.79205,6432,11,21,10,90.9
60503,il,-88.25652,41.71279,4427,11,21,10,90.9
60504,il,-88.23847,41.74637,9670,11,21,10,90.9
60505,il,-88.2941,41.76428,15070,11,21,10,90.9
60506,il,-88.36502,41.76527,16151,11,21,10,90.9
60510,il,-88.30552,41.84211,10776,10,20,10,100
60511,il,-88.55602,41.75778,1322,11,21,10,90.9
60512,il,-88.43977,41.70162,723,11,21,10,90.9
60513,il,-87.84692,41.82457,8642,9,17,8,88.9
60514,il,-87.95692,41.79652,3074,11,20,9,81.8
60515,il,-88.02292,41.80957,10018,12,22,10,83.3
60516,il,-88.01357,41.76237,9811,12,22,10,83.3
60517,il,-88.04225,41.742,8203,11,22,11,100
60518,il,-88.91872,41.59771,3051,10,20,10,100
60519,il,-88.24243,41.77784,74,11,21,10,90.9
60520,il,-88.65813,41.78251,1686,10,20,10,100
60521,il,-87.92877,41.80005,6271,10,19,9,90
60523,il,-87.95403,41.83707,3838,11,20,9,81.8
60525,il,-87.86893,41.78424,10914,9,17,8,88.9
60526,il,-87.87398,41.8318,4550,9,17,8,88.9
60527,il,-87.93336,41.74464,8571,10,20,10,100
60530,il,-88.96065,41.79486,577,8,17,9,112.5
60531,il,-88.7869,41.6157,1447,10,20,10,100
60532,il,-88.08449,41.79238,7473,13,24,11,84.6
60534,il,-87.82207,41.81336,3445,8,16,8,100
60536,il,-88.54987,41.59711,67,10,20,10,100
60537,il,-88.60243,41.562,355,10,20,10,100
60538,il,-88.35914,41.72217,9637,11,21,10,90.9
60539,il,-88.33456,41.82562,14,10,20,10,100
60540,il,-88.14515,41.76365,13981,12,23,11,91.7
60541,il,-88.52539,41.51667,2390,10,20,10,100
60542,il,-88.35069,41.80929,6535,11,21,10,90.9
60543,il,-88.32321,41.66526,14654,11,21,10,90.9
60544,il,-88.21664,41.6134,11137,11,22,11,100
60545,il,-88.53665,41.67737,5839,11,21,10,90.9
60546,il,-87.82129,41.83793,6011,8,16,8,100
60548,il,-88.63618,41.64811,5124,10,21,11,110
60549,il,-88.74239,41.49085,655,10,20,10,100
60550,il,-88.87599,41.77879,980,8,18,10,125
60551,il,-88.68474,41.52537,2655,10,20,10,100
60552,il,-88.70301,41.65989,2378,10,21,11,110
60553,il,-89.02677,41.82788,782,9,19,10,111.1
60554,il,-88.45653,41.77604,5836,11,21,10,90.9
60555,il,-88.18134,41.82272,4713,12,22,10,83.3
60556,il,-88.77349,41.76267,1700,9,19,10,111.1
60557,il,-88.76396,41.44545,104,10,21,11,110
60558,il,-87.90159,41.80613,5288,9,18,9,100
60559,il,-87.97484,41.7939,6906,11,21,10,90.9
60560,il,-88.4297,41.60802,12075,10,21,11,110
60561,il,-87.98231,41.74535,7678,11,21,10,90.9
60563,il,-88.17027,41.7997,8418,12,23,11,91.7
60564,il,-88.19856,41.70822,14036,11,21,10,90.9
60565,il,-88.12387,41.73007,12601,11,22,11,100
60585,il,-88.22413,41.65933,8254,11,21,10,90.9
60586,il,-88.23335,41.57052,15570,12,23,11,91.7
60601,il,-87.62206,41.88529,902,8,15,7,87.5
60602,il,-87.62915,41.88307,148,8,15,7,87.5
60603,il,-87.62551,41.88019,129,8,15,7,87.5
60604,il,-87.62846,41.8781,200,8,15,7,87.5
60605,il,-87.61682,41.86815,1576,8,15,7,87.5
60606,il,-87.63735,41.88207,292,8,15,7,87.5
60607,il,-87.65159,41.87492,4717,7,14,7,100
60608,il,-87.6714,41.84874,16064,8,15,7,87.5
60609,il,-87.65564,41.81251,20491,8,16,8,100
60610,il,-87.63204,41.90697,3229,8,14,6,75
60611,il,-87.61426,41.89385,1043,8,15,7,87.5
60612,il,-87.68774,41.88031,11764,7,14,7,100
60613,il,-87.65436,41.95689,5067,7,13,6,85.7
60614,il,-87.64965,41.92276,10421,7,14,7,100
60615,il,-87.59656,41.80236,4725,8,16,8,100
60616,il,-87.62418,41.84462,9469,8,15,7,87.5
60617,il,-87.55237,41.71811,30018,8,16,8,100
60618,il,-87.70255,41.94696,18605,7,13,6,85.7
60619,il,-87.60552,41.74369,20440,8,16,8,100
60620,il,-87.65252,41.74082,21316,8,16,8,100
60621,il,-87.63957,41.77638,13120,8,16,8,100
60622,il,-87.68333,41.90271,10665,7,14,7,100
60623,il,-87.71783,41.84812,17499,7,15,8,114.3
60624,il,-87.72342,41.88064,10839,7,14,7,100
60625,il,-87.70013,41.97332,11251,7,13,6,85.7
60626,il,-87.66693,42.00982,3960,7,13,6,85.7
60628,il,-87.61795,41.69181,27801,9,17,8,88.9
60629,il,-87.71157,41.77568,24977,8,15,7,87.5
60630,il,-87.75712,41.97212,15283,7,13,6,85.7
60631,il,-87.813,41.99486,9684,7,13,6,85.7
60632,il,-87.71333,41.81137,19416,7,15,8,114.3
60633,il,-87.56133,41.66434,7333,9,18,9,100
60634,il,-87.80607,41.94634,20740,7,14,7,100
60636,il,-87.66906,41.77574,15622,8,16,8,100
60637,il,-87.59949,41.78221,9041,8,16,8,100
60638,il,-87.77052,41.78143,20600,8,15,7,87.5
60639,il,-87.75605,41.92055,16646,7,14,7,100
60640,il,-87.66136,41.97267,5670,7,13,6,85.7
60641,il,-87.74679,41.94661,14945,7,14,7,100
60642,il,-87.658,41.90163,4374,7,14,7,100
60643,il,-87.66279,41.69959,20778,9,18,9,100
60644,il,-87.75749,41.88023,9794,7,15,8,114.3
60645,il,-87.69474,42.00856,7098,6,12,6,100
60646,il,-87.75963,41.99302,10012,7,13,6,85.7
60647,il,-87.70175,41.92073,16083,7,14,7,100
60649,il,-87.56597,41.76409,7030,8,16,8,100
60651,il,-87.74086,41.90209,13588,7,14,7,100
60652,il,-87.7148,41.74793,13172,8,16,8,100
60653,il,-87.60604,41.81987,6577,8,16,8,100
60654,il,-87.63726,41.89228,1308,8,15,7,87.5
60655,il,-87.70378,41.69478,10745,9,18,9,100
60656,il,-87.82713,41.97428,7276,7,14,7,100
60657,il,-87.64926,41.94033,7821,7,13,6,85.7
60659,il,-87.70406,41.99115,6612,6,12,6,100
60660,il,-87.66368,41.99123,3796,7,13,6,85.7
60661,il,-87.6441,41.88303,523,7,14,7,100
60706,il,-87.81624,41.96426,7562,7,14,7,100
60707,il,-87.80728,41.92185,11382,8,15,7,87.5
60712,il,-87.73324,42.00543,5266,7,13,6,85.7
60714,il,-87.81097,42.02806,9485,7,13,6,85.7
60803,il,-87.73567,41.67206,6765,10,19,9,90
60804,il,-87.76017,41.8378,17216,7,15,8,114.3
60805,il,-87.70245,41.722,8812,9,18,9,100
60827,il,-87.63012,41.64958,9044,10,19,9,90
60901,il,-87.8981,41.11083,15597,14,27,13,92.9
60910,il,-87.80867,41.07877,327,13,26,13,100
60911,il,-87.9802,40.87803,1298,13,26,13,100
60912,il,-87.59932,40.97006,1070,12,25,13,108.3
60913,il,-88.06178,41.14699,1202,13,26,13,100
60914,il,-87.86196,41.18672,9858,14,27,13,92.9
60915,il,-87.86111,41.14682,4552,14,27,13,92.9
60917,il,-88.18731,41.04411,630,13,26,13,100
60918,il,-88.03041,40.59616,984,14,28,14,100
60919,il,-88.23832,40.98744,601,13,27,14,107.7
60920,il,-88.30497,41.02926,131,13,26,13,100
60921,il,-88.28787,40.73775,1419,15,30,15,100
60922,il,-87.91866,41.00411,1526,14,27,13,92.9
60924,il,-87.88531,40.55774,1788,14,29,15,107.1
60926,il,-87.80966,40.57234,96,14,28,14,100
60927,il,-87.96802,40.9393,1698,13,26,13,100
60928,il,-87.84902,40.74164,561,13,26,13,100
60929,il,-88.28916,40.87497,765,14,28,14,100
60930,il,-88.00259,40.8299,844,13,27,14,107.7
60931,il,-87.58518,40.8904,762,13,26,13,100
60932,il,-87.80556,40.46331,160,14,28,14,100
60933,il,-88.27191,40.46473,193,13,27,14,107.7
60934,il,-88.35122,40.9617,393,13,27,14,107.7
60935,il,-88.17605,41.17295,818,13,25,12,92.3
60936,il,-88.35707,40.46678,2742,13,28,15,115.4
60938,il,-87.98864,40.7733,1722,14,28,14,100
60940,il,-87.64276,41.2506,2231,11,22,11,100
60941,il,-88.08208,41.042,1434,14,27,13,92.9
60942,il,-87.6609,40.46565,4418,13,28,15,115.4
60945,il,-87.58386,40.82846,156,13,26,13,100
60946,il,-88.20293,40.91652,537,14,27,13,92.9
60948,il,-88.08195,40.52544,1725,13,27,14,107.7
60949,il,-88.10292,40.38216,536,15,30,15,100
60950,il,-87.88438,41.25118,4781,13,25,12,92.3
60951,il,-87.75111,40.92138,937,13,26,13,100
60952,il,-88.25278,40.56447,638,13,28,15,115.4
60953,il,-87.68809,40.62989,2879,13,27,14,107.7
60954,il,-87.62896,41.15338,3977,12,23,11,91.7
60955,il,-87.97656,40.69742,1907,14,28,14,100
60957,il,-88.13626,40.44296,3249,13,28,15,115.4
60958,il,-87.59136,41.06487,4094,12,24,12,100
60959,il,-88.18201,40.78971,1009,15,29,14,93.3
60960,il,-87.88998,40.43871,1385,13,28,15,115.4
60961,il,-88.23084,41.10654,583,13,25,12,92.3
60962,il,-88.18438,40.62281,616,13,28,15,115.4
60963,il,-87.64843,40.36666,1872,14,29,15,107.1
60964,il,-87.73823,41.03552,4149,13,26,13,100
60966,il,-87.58323,40.75152,1622,13,26,13,100
60968,il,-88.12067,40.67239,603,14,29,15,107.1
60969,il,-88.14974,41.11098,60,13,26,13,100
60970,il,-87.73842,40.79338,5078,13,26,13,100
60973,il,-87.66314,40.54168,525,13,27,14,107.7
60974,il,-87.73409,40.71926,204,13,27,14,107.7
61001,il,-90.12453,42.46095,3362,8,16,8,100
61006,il,-89.20952,41.86055,1342,10,20,10,100
61007,il,-89.5895,42.19775,424,9,18,9,100
61008,il,-88.84073,42.24513,12960,10,18,8,80
61010,il,-89.26788,42.13569,3754,10,19,9,90
61011,il,-88.91286,42.38962,1852,9,17,8,88.9
61012,il,-88.75444,42.40741,1384,10,19,9,90
61013,il,-89.63719,42.37446,272,9,17,8,88.9
61014,il,-89.88444,41.97468,1092,11,21,10,90.9
61015,il,-89.20201,41.99297,856,10,20,10,100
61016,il,-88.94718,42.19807,2387,9,18,9,100
61018,il,-89.55524,42.41527,724,8,17,9,112.5
61019,il,-89.41009,42.44152,3329,9,18,9,100
61020,il,-89.09821,42.11019,1625,9,18,9,100
61021,il,-89.47909,41.82967,12402,10,20,10,100
61024,il,-89.29054,42.4365,1933,9,18,9,100
61025,il,-90.56048,42.47138,2827,10,20,10,100
61027,il,-89.75728,42.33091,58,9,17,8,88.9
61028,il,-90.16954,42.29183,1918,8,17,9,112.5
61030,il,-89.58886,42.11514,1581,10,20,10,100
61031,il,-89.31305,41.83081,1100,10,20,10,100
61032,il,-89.63523,42.31633,14940,9,18,9,100
61036,il,-90.39118,42.4152,7961,8,17,9,112.5
61037,il,-89.76029,41.78933,80,11,23,12,109.1
61038,il,-88.73575,42.26346,1166,10,19,9,90
61039,il,-89.46755,42.20887,564,10,19,9,90
61041,il,-90.30157,42.2761,1409,9,19,10,111.1
61042,il,-89.56373,41.68764,692,11,23,12,109.1
61043,il,-89.10524,42.05644,88,9,18,9,100
61044,il,-89.91509,42.3188,215,8,17,9,112.5
61046,il,-89.81367,42.10446,4182,10,20,10,100
61047,il,-89.39589,42.15315,1487,10,19,9,90
61048,il,-89.83554,42.38354,2708,8,17,9,112.5
61049,il,-89.0075,42.04416,425,10,19,9,90
61050,il,-89.73416,42.4403,329,9,18,9,100
61051,il,-89.75486,41.98277,1187,11,21,10,90.9
61052,il,-88.99956,42.11138,734,9,18,9,100
61053,il,-89.98214,42.1143,2191,11,21,10,90.9
61054,il,-89.44945,42.05498,1868,10,20,10,100
61057,il,-89.38205,41.82926,101,9,19,10,111.1
61059,il,-89.94016,42.45316,165,7,15,8,114.3
61060,il,-89.6219,42.47815,1086,8,16,8,100
61061,il,-89.33983,42.00026,4655,10,20,10,100
61062,il,-89.84141,42.25295,1558,9,18,9,100
61063,il,-89.34733,42.31215,2758,9,18,9,100
61064,il,-89.58236,41.98786,2687,10,21,11,110
61065,il,-88.82753,42.40742,5579,9,18,9,100
61067,il,-89.47744,42.30441,642,9,18,9,100
61068,il,-89.06441,41.94846,6751,10,20,10,100
61070,il,-89.4731,42.41684,859,9,17,8,88.9
61071,il,-89.70448,41.72701,7360,11,22,11,100
61072,il,-89.14111,42.4469,4981,10,19,9,90
61073,il,-88.99355,42.42468,7945,9,18,9,100
61074,il,-90.12973,42.12558,3202,11,22,11,100
61075,il,-90.25894,42.46445,901,7,15,8,114.3
61077,il,-89.35781,42.23814,43,9,18,9,100
61078,il,-89.72911,42.16599,1076,10,19,9,90
61079,il,-89.20751,42.43927,124,10,19,9,90
61080,il,-88.98721,42.47974,5086,10,18,8,80
61081,il,-89.73537,41.84392,11364,11,22,11,100
61084,il,-89.1887,42.11846,1778,9,18,9,100
61085,il,-90.0322,42.34184,2676,8,16,8,100
61087,il,-89.99263,42.48021,1182,7,15,8,114.3
61088,il,-89.25569,42.26884,3139,9,18,9,100
61089,il,-89.81933,42.47342,826,9,17,8,88.9
61091,il,-89.52771,41.90687,40,10,20,10,100
61101,il,-89.14849,42.33755,9515,9,18,9,100
61102,il,-89.15729,42.22958,9623,9,18,9,100
61103,il,-89.08222,42.34614,8872,9,18,9,100
61104,il,-89.079,42.25187,6857,9,18,9,100
61107,il,-89.00324,42.28366,11762,9,17,8,88.9
61108,il,-89.004,42.25479,10648,9,17,8,88.9
61109,il,-89.05346,42.19258,11569,9,17,8,88.9
61111,il,-89.00357,42.33536,8615,9,17,8,88.9
61112,il,-88.97518,42.24198,91,9,18,9,100
61114,il,-88.99105,42.30843,5189,9,17,8,88.9
61115,il,-89.02883,42.36374,9758,9,18,9,100
61201,il,-90.57675,41.47782,15440,13,26,13,100
61230,il,-90.21406,41.73897,960,12,24,12,100
61231,il,-90.72477,41.20969,3821,14,28,14,100
61232,il,-90.73247,41.43074,701,13,26,13,100
61234,il,-89.91825,41.42085,1132,12,26,14,116.7
61235,il,-90.02351,41.39967,1164,13,26,13,100
61236,il,-90.36074,41.51378,65,13,26,13,100
61238,il,-90.17386,41.28775,2388,12,26,14,116.7
61239,il,-90.38748,41.48612,370,13,26,13,100
61240,il,-90.42983,41.42551,2997,12,25,13,108.3
61241,il,-90.32097,41.48848,3484,13,26,13,100
61242,il,-90.27859,41.70367,988,12,25,13,108.3
61243,il,-89.68293,41.61878,368,13,25,12,92.3
61244,il,-90.39484,41.52329,9356,13,26,13,100
61250,il,-90.10307,41.6589,2269,13,26,13,100
61251,il,-90.07567,41.73054,425,13,26,13,100
61252,il,-90.11798,41.84312,3813,12,23,11,91.7
61254,il,-90.15086,41.46863,6548,13,27,14,107.7
61256,il,-90.40152,41.5591,867,13,26,13,100
61257,il,-90.22278,41.59055,1215,13,26,13,100
61258,il,-89.91398,41.52183,143,13,26,13,100
61259,il,-90.93155,41.38824,1386,15,29,14,93.3
61260,il,-90.88305,41.24631,857,15,29,14,93.3
61261,il,-89.91586,41.72572,766,13,26,13,100
61262,il,-90.35676,41.28052,917,13,26,13,100
61263,il,-90.60473,41.25885,247,14,28,14,100
61264,il,-90.59174,41.3968,5869,13,26,13,100
61265,il,-90.49028,41.48202,17981,13,26,13,100
61270,il,-89.96635,41.82978,5499,13,25,12,92.3
61272,il,-91.00569,41.24656,1703,16,31,15,93.8
61273,il,-90.39888,41.3629,1878,12,25,13,108.3
61274,il,-90.27696,41.36857,323,12,25,13,108.3
61275,il,-90.29846,41.59981,2400,12,25,13,108.3
61276,il,-90.58992,41.30408,90,13,27,14,107.7
61277,il,-89.93164,41.60673,2871,13,26,13,100
61278,il,-90.33685,41.58202,283,12,25,13,108.3
61279,il,-90.72681,41.32053,849,13,27,14,107.7
61281,il,-90.51972,41.29689,2043,13,27,14,107.7
61282,il,-90.41296,41.49557,3294,13,26,13,100
61283,il,-89.78652,41.59188,1468,12,25,13,108.3
61284,il,-90.74678,41.39363,1623,13,26,13,100
61285,il,-90.05958,41.97811,1460,11,22,11,100
61301,il,-89.08044,41.39491,5545,12,24,12,100
61310,il,-89.34995,41.70001,3792,10,21,11,110
61311,il,-88.86004,41.03778,281,14,28,14,100
61312,il,-89.23303,41.43574,557,11,22,11,100
61313,il,-88.66867,41.07369,495,14,27,13,92.9
61314,il,-89.67409,41.29606,892,12,25,13,108.3
61315,il,-89.36402,41.28764,236,14,28,14,100
61316,il,-89.12499,41.25908,219,11,24,13,118.2
61317,il,-89.20892,41.43145,406,11,22,11,100
61318,il,-89.07968,41.71211,756,8,18,10,125
61319,il,-88.74354,41.01847,1251,14,29,15,107.1
61320,il,-89.17039,41.35524,378,12,24,12,100
61321,il,-88.97313,40.96929,492,15,30,15,100
61322,il,-89.30748,41.31909,821,13,26,13,100
61323,il,-89.39682,41.43296,67,12,24,12,100
61324,il,-89.41389,41.76991,50,10,20,10,100
61325,il,-88.80643,41.23695,985,11,24,13,118.2
61326,il,-89.22431,41.25386,2140,12,24,12,100
61327,il,-89.30942,41.22686,1431,13,26,13,100
61328,il,-89.45926,41.49954,29,12,23,11,91.7
61329,il,-89.19785,41.3803,764,11,23,12,109.1
61330,il,-89.27479,41.53796,1424,10,21,11,110
61331,il,-89.27754,41.7477,24,10,21,11,110
61332,il,-88.98878,41.18877,147,13,26,13,100
61333,il,-88.88808,40.98931,403,15,29,14,93.3
61334,il,-89.09846,41.14511,803,13,27,14,107.7
61335,il,-89.22465,41.16353,723,13,27,14,107.7
61336,il,-89.22011,41.10706,898,14,29,15,107.1
61337,il,-89.32859,41.43639,308,11,23,12,109.1
61338,il,-89.67626,41.45892,200,12,24,12,100
61340,il,-89.25016,41.26125,267,11,24,13,118.2
61341,il,-88.6925,41.34073,7107,10,21,11,110
61342,il,-89.09058,41.54058,5114,10,21,11,110
61344,il,-89.83154,41.41148,459,12,25,13,108.3
61345,il,-89.78979,41.28006,895,11,24,13,118.2
61346,il,-89.71826,41.51154,78,12,25,13,108.3
61348,il,-89.03786,41.28168,3017,12,24,12,100
61349,il,-89.44502,41.55043,1135,11,22,11,100
61350,il,-88.86337,41.37252,13664,11,23,12,109.1
61353,il,-88.9951,41.6965,1033,8,17,9,112.5
61354,il,-89.14286,41.32789,5973,12,24,12,100
61356,il,-89.43817,41.39356,7291,12,25,13,108.3
61358,il,-89.04401,40.97872,640,15,30,15,100
61359,il,-89.27091,41.36247,312,12,24,12,100
61360,il,-88.60481,41.32726,2018,10,22,12,120
61361,il,-89.7638,41.41146,1512,12,25,13,108.3
61362,il,-89.22896,41.3547,3323,12,25,13,108.3
61363,il,-89.18248,41.25425,233,12,24,12,100
61364,il,-88.84216,41.12839,11743,13,27,14,107.7
61367,il,-89.26541,41.62679,6388,9,20,11,122.2
61368,il,-89.52293,41.26305,1654,13,27,14,107.7
61369,il,-89.15506,40.98409,1409,15,30,15,100
61370,il,-89.03162,41.20506,1389,12,25,13,108.3
61372,il,-89.07802,41.4649,116,10,22,12,120
61373,il,-88.99836,41.39895,1795,11,24,13,118.2
61374,il,-89.35872,41.54771,97,10,22,12,120
61375,il,-89.25045,41.03528,2698,15,30,15,100
61376,il,-89.60917,41.53937,1985,12,23,11,91.7
61377,il,-89.03648,41.06,1440,15,29,14,93.3
61378,il,-89.157,41.72446,707,10,20,10,100
61379,il,-89.61609,41.39195,1120,13,26,13,100
61401,il,-90.38466,40.94471,15389,12,26,14,116.7
61410,il,-90.39554,40.798,2235,14,30,16,114.3
61411,il,-90.50503,40.40017,492,18,35,17,94.4
61412,il,-90.57876,41.06971,1367,14,29,15,107.1
61413,il,-90.37352,41.19051,834,12,26,14,116.7
61414,il,-90.15577,41.12469,921,13,27,14,107.7
61415,il,-90.42917,40.6571,2388,17,33,16,94.1
61416,il,-90.56284,40.49929,145,19,36,17,89.5
61417,il,-90.53833,40.77417,402,16,31,15,93.8
61418,il,-90.86118,40.8503,907,16,31,15,93.8
61419,il,-90.11756,41.19976,140,12,26,14,116.7
61420,il,-90.86657,40.54738,1300,19,35,16,84.2
61421,il,-89.64999,41.18016,1591,12,26,14,116.7
61422,il,-90.53478,40.55087,2070,18,35,17,94.4
61423,il,-90.5012,40.88631,782,14,29,15,107.1
61424,il,-89.63498,41.0768,72,11,25,14,127.3
61425,il,-91.03422,40.76201,748,16,32,16,100
61426,il,-89.70698,41.12,96,12,25,13,108.3
61427,il,-90.19417,40.50196,2027,16,33,17,106.3
61428,il,-90.10784,40.93477,3227,14,29,15,107.1
61430,il,-90.31092,40.94016,511,12,26,14,116.7
61431,il,-90.27818,40.60771,533,16,33,17,106.3
61432,il,-90.15862,40.65256,759,13,29,16,123.1
61433,il,-90.16867,40.55753,69,15,32,17,113.3
61434,il,-90.03902,41.17556,2323,12,26,14,116.7
61435,il,-90.5679,40.99242,139,15,30,15,100
61436,il,-90.21682,40.86222,1046,14,29,15,107.1
61437,il,-90.98677,40.84618,856,16,31,15,93.8
61438,il,-90.65166,40.58275,722,19,36,17,89.5
61439,il,-90.35703,41.02847,235,12,26,14,116.7
61440,il,-90.59542,40.30731,912,19,36,17,89.5
61441,il,-90.29336,40.34075,1153,18,36,18,100
61442,il,-90.92277,41.10741,971,17,32,15,88.2
61443,il,-89.94168,41.25995,7559,11,24,13,118.2
61447,il,-90.75367,40.8672,835,16,31,15,93.8
61448,il,-90.24678,40.93361,2365,13,27,14,107.7
61449,il,-89.97472,41.08933,616,12,27,15,125
61450,il,-90.98165,40.57883,1879,19,36,17,89.5
61451,il,-89.93876,40.94577,412,12,26,14,116.7
61452,il,-90.66062,40.2362,508,19,36,17,89.5
61453,il,-90.76413,41.01219,784,16,31,15,93.8
61454,il,-91.04244,40.68015,745,17,33,16,94.1
61455,il,-90.65452,40.43534,8542,19,36,17,89.5
61458,il,-90.18145,40.77963,1141,15,31,16,106.7
61459,il,-90.41586,40.50557,553,18,35,17,94.4
61460,il,-90.82918,40.71668,464,17,32,15,88.2
61462,il,-90.64789,40.92355,6635,16,31,15,93.8
61465,il,-90.46661,41.20782,967,13,26,13,100
61466,il,-90.47967,41.11002,346,13,27,14,107.7
61467,il,-90.23972,41.07374,1000,12,26,14,116.7
61468,il,-90.38778,41.25774,76,13,26,13,100
61469,il,-90.90611,40.96404,1868,16,31,15,93.8
61470,il,-90.50485,40.60385,519,17,34,17,100
61471,il,-90.8349,40.69747,127,17,32,15,88.2
61472,il,-90.38289,41.10211,742,13,26,13,100
61473,il,-90.65273,40.70588,1934,17,33,16,94.1
61474,il,-90.37815,40.7363,439,16,32,16,100
61475,il,-90.75347,40.5979,355,19,35,16,84.2
61476,il,-90.83236,41.09807,508,16,31,15,93.8
61477,il,-90.31544,40.49608,818,17,35,18,105.9
61478,il,-90.76065,40.75787,524,16,32,16,100
61479,il,-89.64476,41.00478,216,11,25,14,127.3
61480,il,-90.92179,40.72539,1227,17,32,15,88.2
61482,il,-90.41172,40.38839,887,17,35,18,105.9
61483,il,-89.87326,41.08673,1885,12,26,14,116.7
61484,il,-90.43642,40.29526,947,18,36,18,100
61485,il,-90.09832,41.02163,737,13,27,14,107.7
61486,il,-90.5761,41.19792,1180,14,28,14,100
61488,il,-90.31835,41.03224,847,12,26,14,116.7
61489,il,-90.02846,40.93399,1037,13,27,14,107.7
61490,il,-90.26557,41.18513,950,12,26,14,116.7
61491,il,-89.72939,41.06053,2142,12,26,14,116.7
61501,il,-90.31648,40.22931,1901,18,36,18,100
61516,il,-89.13521,40.85808,776,15,30,15,100
61517,il,-89.85426,40.82599,2280,13,28,15,115.4
61519,il,-90.08896,40.46007,193,17,35,18,105.9
61520,il,-90.02132,40.54208,9548,15,33,18,120
61523,il,-89.53549,40.91726,5889,15,30,15,100
61524,il,-90.03473,40.49132,175,16,33,17,106.3
61525,il,-89.66906,40.84848,4423,12,27,15,125
61526,il,-89.62434,40.92993,893,13,27,14,107.7
61528,il,-89.72293,40.77896,1738,14,29,15,107.1
61529,il,-89.94199,40.78146,2002,13,29,16,123.1
61530,il,-89.26047,40.71404,3472,15,31,16,106.7
61531,il,-90.03502,40.68321,2291,12,28,16,133.3
61532,il,-89.81878,40.33949,724,18,37,19,105.6
61533,il,-89.83933,40.58653,1717,16,34,18,112.5
61534,il,-89.66606,40.41446,1311,17,35,18,105.9
61535,il,-89.52331,40.58307,996,14,30,16,114.3
61536,il,-89.78698,40.68989,1837,13,29,16,123.1
61537,il,-89.46637,41.11704,2197,15,31,16,106.7
61539,il,-89.76721,40.55517,175,18,37,19,105.6
61540,il,-89.37311,41.01469,2246,16,32,16,100
61541,il,-89.23495,40.98038,96,15,31,16,106.7
61542,il,-90.13461,40.38633,3152,18,37,19,105.6
61543,il,-89.97057,40.42087,284,19,38,19,100
61544,il,-90.24006,40.69175,744,15,32,17,113.3
61545,il,-89.3535,40.87071,745,15,30,15,100
61546,il,-89.79882,40.45396,3568,18,36,18,100
61547,il,-89.73754,40.60633,2192,15,32,17,113.3
61548,il,-89.41399,40.80915,6281,14,29,15,107.1
61550,il,-89.44208,40.61086,7779,14,31,17,121.4
61552,il,-89.56572,40.81766,155,15,32,17,113.3
61553,il,-90.03226,40.62593,168,13,30,17,130.8
61554,il,-89.61861,40.54087,19616,15,32,17,113.3
61559,il,-89.7756,40.92111,2543,12,26,14,116.7
61560,il,-89.40277,41.18771,2359,13,28,15,115.4
61561,il,-89.2009,40.80295,2140,15,30,15,100
61562,il,-89.50154,40.8804,31,14,30,16,114.3
61563,il,-90.05422,40.49202,341,16,33,17,106.3
61564,il,-89.65345,40.4935,512,17,35,18,105.9
61565,il,-89.50991,41.03233,1730,15,31,16,106.7
61567,il,-89.89655,40.35816,1090,18,37,19,105.6
61568,il,-89.47865,40.50537,2773,15,33,18,120
61569,il,-89.89318,40.6842,1001,13,29,16,123.1
61570,il,-89.30774,40.92039,1838,15,31,16,106.7
61571,il,-89.41948,40.70328,10889,14,30,16,114.3
61572,il,-90.0368,40.80043,921,13,29,16,123.1
61602,il,-89.60741,40.67486,903,15,31,16,106.7
61603,il,-89.57725,40.71334,7678,15,32,17,113.3
61604,il,-89.65363,40.70571,12657,14,31,17,121.4
61605,il,-89.6333,40.67659,7955,15,31,16,106.7
61606,il,-89.61145,40.6998,2420,15,31,16,106.7
61607,il,-89.68507,40.63007,5977,16,32,16,100
61610,il,-89.59854,40.64295,2700,14,30,16,114.3
61611,il,-89.53563,40.71059,12831,14,30,16,114.3
61614,il,-89.60491,40.759,10105,13,29,16,123.1
61615,il,-89.64587,40.77427,9084,13,29,16,123.1
61616,il,-89.5719,40.7467,2989,15,31,16,106.7
61625,il,-89.6127,40.69761,27,14,31,17,121.4
61701,il,-88.99303,40.47677,12545,16,33,17,106.3
61704,il,-88.94333,40.47049,11175,16,33,17,106.3
61705,il,-89.00227,40.45996,6274,16,33,17,106.3
61720,il,-88.51447,40.55467,311,13,28,15,115.4
61721,il,-89.32326,40.3537,712,17,35,18,105.9
61722,il,-88.63214,40.41905,751,13,29,16,123.1
61723,il,-89.26689,40.26081,1923,17,35,18,105.9
61724,il,-88.52707,40.33083,550,14,30,16,114.3
61725,il,-89.11985,40.6098,1490,16,32,16,100
61726,il,-88.69721,40.73662,2151,15,30,15,100
61727,il,-88.96084,40.14249,5380,16,33,17,106.3
61728,il,-88.6263,40.57286,1209,14,30,16,114.3
61729,il,-89.22358,40.63068,922,15,31,16,106.7
61730,il,-88.7294,40.53249,502,15,31,16,106.7
61731,il,-88.48552,40.61395,347,13,28,15,115.4
61732,il,-89.20315,40.53118,1479,16,33,17,106.3
61733,il,-89.33199,40.62229,743,14,31,17,121.4
61734,il,-89.52642,40.37342,2154,16,34,18,112.5
61735,il,-88.81805,40.2019,505,14,31,17,121.4
61736,il,-88.83866,40.40209,1090,15,32,17,113.3
61737,il,-88.73955,40.45845,624,14,31,17,121.4
61738,il,-89.03427,40.74606,3108,15,31,16,106.7
61739,il,-88.52044,40.73313,3244,14,29,15,107.1
61740,il,-88.86164,40.88429,1478,15,30,15,100
61741,il,-88.40427,40.75939,1448,14,29,15,107.1
61742,il,-89.27262,40.63331,681,15,31,16,106.7
61743,il,-88.78168,40.87567,268,15,30,15,100
61744,il,-88.88709,40.73999,1839,15,30,15,100
61745,il,-88.97247,40.32221,2411,15,32,17,113.3
61747,il,-89.43075,40.42175,1064,16,33,17,106.3
61748,il,-88.99116,40.61676,1762,16,32,16,100
61749,il,-89.11034,40.09496,540,17,35,18,105.9
61750,il,-88.85965,40.12354,92,15,32,17,113.3
61751,il,-89.29925,40.21456,100,18,36,18,100
61752,il,-88.75481,40.33907,2720,14,31,17,121.4
61753,il,-88.78468,40.63645,2179,15,31,16,106.7
61754,il,-89.16914,40.33034,1076,17,34,17,100
61755,il,-89.33595,40.52792,2966,15,31,16,106.7
61756,il,-88.97345,40.03123,1706,17,35,18,105.9
61759,il,-89.32371,40.43718,1040,17,34,17,100
61760,il,-89.02873,40.88112,2397,15,31,16,106.7
61761,il,-88.95856,40.52957,13876,16,33,17,106.3
61764,il,-88.6282,40.88226,6702,14,29,15,107.1
61769,il,-88.39937,40.88202,603,14,28,14,100
61770,il,-88.52592,40.44317,1197,13,28,15,115.4
61771,il,-89.14116,40.70931,846,15,31,16,106.7
61772,il,-89.06595,40.38128,321,17,34,17,100
61773,il,-88.38325,40.5717,582,13,28,15,115.4
61774,il,-89.20397,40.43069,799,17,34,17,100
61775,il,-88.36711,40.6508,420,14,29,15,107.1
61776,il,-88.86698,40.56943,1032,16,32,16,100
61777,il,-88.9418,40.24249,799,15,32,17,113.3
61778,il,-89.09117,40.23289,596,16,33,17,106.3
61801,il,-88.21127,40.10902,6426,14,31,17,121.4
61802,il,-88.15104,40.12558,6961,15,31,16,106.7
61810,il,-87.91478,39.91613,417,17,33,16,94.1
61811,il,-87.62286,40.29273,800,15,30,15,100
61812,il,-87.88668,40.25009,665,14,30,16,114.3
61813,il,-88.55958,39.91156,1441,17,35,18,105.9
61814,il,-87.57247,40.23061,895,15,30,15,100
61815,il,-88.37658,40.11074,132,14,31,17,121.4
61816,il,-88.00122,39.92281,606,17,33,16,94.1
61817,il,-87.71677,40.03786,1737,15,31,16,106.7
61818,il,-88.71922,39.88031,1117,16,34,18,112.5
61820,il,-88.2435,40.10891,6870,14,30,16,114.3
61821,il,-88.27505,40.10958,10475,14,30,16,114.3
61822,il,-88.30531,40.13577,9713,14,30,16,114.3
61830,il,-88.72251,40.02756,539,16,34,18,112.5
61831,il,-87.79207,40.22509,264,15,31,16,106.7
61832,il,-87.63641,40.13613,20028,16,31,15,93.8
61833,il,-87.64428,40.09806,1500,15,31,16,106.7
61834,il,-87.63785,40.16429,5628,15,31,16,106.7
61839,il,-88.62914,40.13773,588,15,32,17,113.3
61840,il,-88.29895,40.30369,653,15,31,16,106.7
61841,il,-87.82428,40.02636,1646,16,32,16,100
61842,il,-88.66582,40.23925,2235,14,31,17,121.4
61843,il,-88.38394,40.31534,1541,15,31,16,106.7
61844,il,-87.87035,40.13876,1391,16,32,16,100
61845,il,-88.39924,40.37417,464,14,30,16,114.3
61846,il,-87.61241,39.97626,3637,15,30,15,100
61847,il,-88.01539,40.31312,905,15,30,15,100
61848,il,-87.70277,40.30806,194,15,30,15,100
61849,il,-87.96192,40.01114,1653,16,32,16,100
61850,il,-87.73766,39.93246,976,16,32,16,100
61851,il,-88.43471,39.96085,682,17,34,17,100
61852,il,-88.0758,39.90316,423,17,34,17,100
61853,il,-88.41681,40.22145,5458,14,31,17,121.4
61854,il,-88.52403,40.20401,1213,15,31,16,106.7
61855,il,-88.66088,39.92213,155,16,34,18,112.5
61856,il,-88.57953,40.02687,4348,16,33,17,106.3
61857,il,-87.84222,40.11657,119,16,32,16,100
61858,il,-87.76796,40.1328,2221,16,32,16,100
61859,il,-87.96118,40.15412,987,15,31,16,106.7
61862,il,-87.95181,40.30633,665,14,29,15,107.1
61863,il,-88.27961,39.90572,847,18,36,18,100
61864,il,-88.14674,39.9796,976,16,32,16,100
61865,il,-87.80254,40.3045,1854,15,30,15,100
61866,il,-88.154,40.31209,5089,16,32,16,100
61870,il,-87.61836,39.89756,1476,16,32,16,100
61871,il,-87.96804,40.19022,178,15,30,15,100
61872,il,-88.37717,39.93867,764,17,35,18,105.9
61873,il,-88.03923,40.13779,3316,15,31,16,106.7
61874,il,-88.25695,40.05111,1946,14,31,17,121.4
61875,il,-88.41951,40.10053,601,15,32,17,113.3
61876,il,-87.83412,39.90514,985,17,33,16,94.1
61877,il,-88.07871,39.99413,1099,16,32,16,100
61878,il,-88.14943,40.23971,988,15,31,16,106.7
61880,il,-88.24582,39.9736,2254,16,32,16,100
61882,il,-88.75999,40.11349,620,15,32,17,113.3
61883,il,-87.64153,40.03739,3047,14,30,16,114.3
61884,il,-88.48058,40.09067,800,16,33,17,106.3
61910,il,-88.29908,39.67438,3013,18,36,18,100
61911,il,-88.46981,39.70325,2793,18,36,18,100
61912,il,-88.03505,39.52731,1387,18,35,17,94.4
61913,il,-88.46609,39.82756,1523,18,37,19,105.6
61914,il,-88.76476,39.63542,1583,18,36,18,100
61917,il,-87.89771,39.71421,1196,18,36,18,100
61919,il,-88.13945,39.77868,854,19,37,18,94.7
61920,il,-88.16408,39.50365,9656,17,35,18,105.9
61924,il,-87.65455,39.79136,3178,18,35,17,94.4
61925,il,-88.83624,39.72352,816,17,36,19,111.8
61928,il,-88.50409,39.45096,777,17,35,18,105.9
61929,il,-88.62134,39.82481,702,17,35,18,105.9
61930,il,-88.13046,39.6809,682,18,36,18,100
61931,il,-88.35314,39.58979,905,17,35,18,105.9
61932,il,-87.87889,39.80358,528,18,35,17,94.4
61933,il,-87.91706,39.54835,1366,18,35,17,94.4
61936,il,-88.73026,39.80135,181,17,35,18,105.9
61937,il,-88.65052,39.74181,1851,17,35,18,105.9
61938,il,-88.37427,39.48385,11415,16,34,18,112.5
61940,il,-87.81869,39.80775,449,18,35,17,94.4
61941,il,-88.07294,39.80407,116,19,36,17,89.5
61942,il,-88.00611,39.81516,1620,18,35,17,94.4
61943,il,-88.02966,39.66496,2122,19,36,17,89.5
61944,il,-87.70129,39.601,10049,18,35,17,94.4
61949,il,-87.87367,39.63362,156,18,35,17,94.4
61951,il,-88.58679,39.59392,5605,18,36,18,100
61953,il,-88.29123,39.79949,4295,20,38,18,90
61955,il,-87.59087,39.58186,115,18,35,17,94.4
61956,il,-88.14413,39.85127,1897,18,36,18,100
61957,il,-88.61111,39.43961,1990,18,37,19,105.6
62001,il,-89.74848,38.87855,1465,23,43,20,87
62002,il,-90.12763,38.93976,17705,24,44,20,83.3
62006,il,-90.66661,39.0559,358,24,44,20,83.3
62009,il,-89.79844,39.09107,1168,21,41,20,95.2
62010,il,-90.04736,38.92009,5205,25,45,20,80
62011,il,-89.21596,39.12646,582,18,36,18,100
62012,il,-90.15016,39.0428,4045,22,42,20,90.9
62013,il,-90.5696,38.96244,315,27,48,21,77.8
62014,il,-89.95097,39.04303,2671,22,42,20,90.9
62015,il,-89.54334,39.22172,704,22,42,20,90.9
62016,il,-90.417,39.29412,2831,21,41,20,95.2
62017,il,-89.36897,39.06887,1258,21,40,19,90.5
62018,il,-90.08358,38.90708,1817,24,44,20,83.3
62019,il,-89.44927,39.01942,706,21,41,20,95.2
62021,il,-89.97934,38.97737,714,24,44,20,83.3
62022,il,-90.33162,39.00375,702,23,43,20,87
62023,il,-89.7882,39.11071,64,20,40,20,100
62024,il,-90.0956,38.87135,4651,24,45,21,87.5
62025,il,-89.93325,38.83056,16026,25,46,21,84
62027,il,-90.55968,39.25602,750,22,42,20,90.9
62028,il,-90.35411,38.95936,463,26,46,20,76.9
62030,il,-90.16446,39.15461,67,20,40,20,100
62031,il,-90.5357,39.11332,1064,23,43,20,87
62032,il,-89.2885,39.11573,1098,19,38,19,100
62033,il,-89.84426,39.13405,3718,21,41,20,95.2
62034,il,-89.96983,38.75652,6257,25,46,21,84
62035,il,-90.24077,38.9642,7922,23,43,20,87
62036,il,-90.5877,38.91658,424,27,48,21,77.8
62037,il,-90.46758,39.00928,1753,25,45,20,80
62040,il,-90.11064,38.72615,19955,27,49,22,81.5
62044,il,-90.21272,39.36361,1942,20,40,20,100
62045,il,-90.70904,39.26031,502,22,42,20,90.9
62046,il,-89.84569,38.89009,453,24,45,21,87.5
62047,il,-90.62536,39.12106,506,25,46,21,84
62048,il,-90.09655,38.80412,1142,25,46,21,84
62049,il,-89.48517,39.13011,4894,24,45,21,87.5
62050,il,-90.5513,39.44469,702,20,40,20,100
62051,il,-89.40198,39.20177,1160,22,42,20,90.9
62052,il,-90.32187,39.11102,7065,21,41,20,95.2
62053,il,-90.66104,39.32509,550,22,42,20,90.9
62054,il,-90.34505,39.20125,765,22,42,20,90.9
62056,il,-89.67105,39.17869,6390,20,39,19,95
62058,il,-89.76678,38.96896,524,22,42,20,90.9
62059,il,-90.16505,38.65638,563,29,51,22,75.9
62060,il,-90.14696,38.67691,3513,29,51,22,75.9
62061,il,-89.77951,38.78977,1167,24,45,21,87.5
62062,il,-89.96199,38.72738,3731,25,46,21,84
62063,il,-90.14766,39.19781,1032,21,41,20,95.2
62065,il,-90.62896,39.23214,108,24,44,20,83.3
62067,il,-89.98517,38.92987,1356,25,45,20,80
62069,il,-89.73938,39.08834,2699,20,40,20,100
62070,il,-90.73317,39.29648,21,23,42,19,82.6
62074,il,-89.68362,38.95805,1168,21,41,20,95.2
62075,il,-89.29535,39.30114,3238,18,36,18,100
62076,il,-89.21898,39.34322,140,18,37,19,105.6
62077,il,-89.52165,39.02898,306,22,42,20,90.9
62078,il,-90.48608,39.47863,87,19,38,19,100
62079,il,-90.14204,39.1122,243,20,40,20,100
62080,il,-89.10132,39.13701,2822,18,36,18,100
62081,il,-90.237,39.26117,342,22,43,21,95.5
62082,il,-90.3241,39.49462,2645,18,37,19,105.6
62083,il,-89.20143,39.35445,317,18,37,19,105.6
62084,il,-90.06238,38.83662,869,25,46,21,84
62085,il,-89.80246,39.07821,157,21,41,20,95.2
62086,il,-89.58097,38.98251,1538,21,41,20,95.2
62087,il,-90.06608,38.81679,1232,25,46,21,84
62088,il,-89.79867,39.01201,4222,22,41,19,86.4
62089,il,-89.49508,39.1298,351,24,45,21,87.5
62090,il,-90.16938,38.66988,760,29,51,22,75.9
62091,il,-89.60913,39.0569,617,22,42,20,90.9
62092,il,-90.41615,39.41619,2238,20,40,20,100
62093,il,-89.8547,39.06691,299,21,41,20,95.2
62094,il,-89.35262,39.24472,1185,19,38,19,100
62095,il,-90.06926,38.86228,5217,24,45,21,87.5
62097,il,-89.85434,38.93872,2028,24,44,20,83.3
62098,il,-90.30465,39.38607,71,19,38,19,100
62201,il,-90.13864,38.64272,6753,30,51,21,70
62203,il,-90.07746,38.6002,6535,27,48,21,77.8
62204,il,-90.09054,38.63271,8466,29,50,21,72.4
62205,il,-90.12231,38.60938,7687,29,50,21,72.4
62206,il,-90.16669,38.56793,8014,29,49,20,69
62207,il,-90.12291,38.58284,8138,29,50,21,72.4
62208,il,-90.00455,38.59626,8070,26,47,21,80.8
62214,il,-89.61169,38.3781,1973,24,45,21,87.5
62215,il,-89.60735,38.50936,1053,25,45,20,80
62216,il,-89.60248,38.62116,1541,23,44,21,91.3
62217,il,-89.84448,38.17348,962,28,48,20,71.4
62218,il,-89.47291,38.51976,1743,22,42,20,90.9
62219,il,-89.4319,38.60579,530,20,40,20,100
62220,il,-89.98653,38.47335,10742,27,48,21,77.8
62221,il,-89.89921,38.51484,11894,27,48,21,77.8
62223,il,-90.0598,38.53614,8784,27,48,21,77.8
62225,il,-89.85536,38.54558,166,27,48,21,77.8
62226,il,-90.00057,38.53521,12450,27,48,21,77.8
62230,il,-89.52684,38.64034,3807,21,41,20,95.2
62231,il,-89.33028,38.64163,8186,20,40,20,100
62232,il,-90.00272,38.63221,4589,26,47,21,80.8
62233,il,-89.78738,37.94611,4654,30,51,21,70
62234,il,-89.98177,38.68341,14813,26,47,21,80.8
62236,il,-90.21702,38.43642,6301,26,46,20,76.9
62237,il,-89.5691,38.18904,2824,25,45,20,80
62238,il,-89.53262,38.03908,702,27,48,21,77.8
62239,il,-90.18733,38.52567,2475,27,47,20,74.1
62240,il,-90.20743,38.5212,1835,28,49,21,75
62241,il,-89.89062,38.01354,1108,30,50,20,66.7
62242,il,-89.9454,38.09632,1788,31,51,20,64.5
62243,il,-89.89044,38.41941,3678,26,47,21,80.8
62244,il,-90.19817,38.18633,1070,26,46,20,76.9
62245,il,-89.56795,38.54878,1429,23,44,21,91.3
62246,il,-89.42628,38.88877,6195,20,40,20,100
62248,il,-89.9935,38.30446,145,27,48,21,77.8
62249,il,-89.66455,38.75525,8299,23,43,20,87
62250,il,-89.26611,38.5408,257,22,42,20,90.9
62253,il,-89.29754,38.77686,1170,20,39,19,95
62254,il,-89.82139,38.60742,3520,26,47,21,80.8
62255,il,-89.78188,38.31164,1185,27,47,20,74.1
62257,il,-89.73128,38.28411,3310,26,46,20,76.9
62258,il,-89.77252,38.46214,6034,26,47,21,80.8
62260,il,-90.10097,38.45995,4359,26,47,21,80.8
62261,il,-90.0026,38.01316,349,35,55,20,57.1
62262,il,-89.27195,38.94148,2457,20,39,19,95
62263,il,-89.40004,38.33016,6222,23,42,19,82.6
62264,il,-89.9072,38.31629,3065,27,48,21,77.8
62265,il,-89.67066,38.50065,2487,25,46,21,84
62266,il,-89.67707,38.48669,133,25,46,21,84
62268,il,-89.52799,38.27366,1348,24,44,20,83.3
62269,il,-89.91607,38.60335,12963,26,47,21,80.8
62271,il,-89.51561,38.44487,2605,24,44,20,83.3
62272,il,-89.59941,37.98833,1389,28,48,20,71.4
62273,il,-89.58378,38.78685,121,22,42,20,90.9
62274,il,-89.40829,38.09179,4795,27,47,20,74.1
62275,il,-89.54475,38.81168,3243,21,41,20,95.2
62277,il,-90.11562,38.10084,1663,31,51,20,64.5
62278,il,-89.99259,38.20793,4563,29,49,20,69
62279,il,-90.13544,38.15123,42,26,46,20,76.9
62280,il,-89.6596,37.83505,1278,31,51,20,64.5
62281,il,-89.78186,38.7044,1514,25,45,20,80
62282,il,-89.71262,38.36313,463,25,46,21,84
62284,il,-89.31301,38.87654,696,20,39,19,95
62285,il,-90.00775,38.38834,2305,27,48,21,77.8
62286,il,-89.71439,38.11832,4991,26,46,20,76.9
62288,il,-89.68557,37.98829,2244,29,50,21,72.4
62289,il,-89.75147,38.59691,283,25,45,20,80
62292,il,-89.6801,38.21264,598,26,46,20,76.9
62293,il,-89.6975,38.61897,3027,24,45,21,87.5
62294,il,-89.8712,38.70281,6831,25,46,21,84
62295,il,-90.31322,38.27933,1574,26,46,20,76.9
62297,il,-89.81313,38.04986,532,28,49,21,75
62298,il,-90.15225,38.31087,9160,24,45,21,87.5
62301,il,-91.38655,39.93162,13758,20,37,17,85
62305,il,-91.34582,39.92994,9671,19,36,17,89.5
62311,il,-90.91776,40.22198,1111,19,36,17,89.5
62312,il,-91.02782,39.70907,2429,19,36,17,89.5
62313,il,-91.22598,40.31956,647,20,37,17,85
62314,il,-90.89026,39.77067,1215,18,35,17,94.4
62316,il,-91.05504,40.23633,789,19,35,16,84.2
62319,il,-90.73131,40.15245,661,21,38,17,81
62320,il,-91.08047,40.02072,2085,17,33,16,94.1
62321,il,-91.10391,40.4085,4018,20,37,17,85
62323,il,-90.68552,39.81235,808,22,41,19,86.4
62324,il,-90.95897,39.99244,1656,17,34,17,100
62325,il,-91.16606,40.05121,338,17,33,16,94.1
62326,il,-90.81333,40.41722,2128,19,36,17,89.5
62330,il,-91.12552,40.572,2181,18,34,16,88.9
62334,il,-91.24064,40.38791,158,20,37,17,85
62336,il,-91.17138,40.46807,51,20,37,17,85
62338,il,-91.2396,39.99141,1034,17,33,16,94.1
62339,il,-91.04112,40.13162,797,18,34,16,88.9
62340,il,-90.72485,39.72895,2397,21,39,18,85.7
62341,il,-91.30279,40.42577,2565,19,36,17,89.5
62343,il,-91.24228,39.70299,1516,22,40,18,81.8
62344,il,-90.83109,40.16893,449,20,37,17,85
62345,il,-91.12951,39.70497,605,21,38,17,81
62346,il,-90.94749,40.14816,462,18,35,17,94.4
62347,il,-91.08896,39.86592,2196,16,33,17,106.3
62348,il,-91.36733,40.18756,124,20,37,17,85
62349,il,-91.20083,40.16752,796,19,36,17,89.5
62351,il,-91.26757,40.11574,1586,18,35,17,94.4
62352,il,-90.64987,39.56462,218,19,38,19,100
62353,il,-90.75827,39.97251,3436,19,37,18,94.7
62354,il,-91.33178,40.52606,1872,18,34,16,88.9
62355,il,-90.77648,39.4102,1453,21,39,18,85.7
62356,il,-91.0858,39.60141,1144,22,40,18,81.8
62357,il,-90.8674,39.68492,392,19,36,17,89.5
62358,il,-91.25719,40.58204,997,17,33,16,94.1
62359,il,-91.20471,40.0327,134,16,32,16,100
62360,il,-91.26343,39.81628,1135,18,35,17,94.4
62361,il,-90.64628,39.48314,1432,22,41,19,86.4
62362,il,-90.74719,39.78221,304,21,40,19,90.5
62363,il,-90.77425,39.5936,5362,20,38,18,90
62365,il,-91.15939,39.79637,569,19,36,17,89.5
62366,il,-90.89432,39.45998,1873,22,41,19,86.4
62367,il,-90.87611,40.30522,2020,20,37,17,85
62370,il,-91.00191,39.52087,1122,22,41,19,86.4
62373,il,-91.34172,40.24218,482,19,36,17,89.5
62374,il,-90.91204,40.40891,466,20,37,17,85
62375,il,-90.87118,40.00419,570,18,35,17,94.4
62376,il,-91.42043,40.11507,1345,20,38,18,90
62378,il,-90.63513,39.89729,1177,22,40,18,81.8
62379,il,-91.40012,40.28675,2459,19,36,17,89.5
62380,il,-91.19085,40.24001,688,19,36,17,89.5
62401,il,-88.56417,39.1195,10804,20,38,18,90
62410,il,-87.72643,38.53241,1065,27,47,20,74.1
62411,il,-88.72962,39.0706,3127,20,38,18,90
62413,il,-87.83882,39.13962,687,22,40,18,81.8
62414,il,-88.83046,39.17068,1899,19,38,19,100
62417,il,-87.76566,38.70667,2582,25,45,20,80
62418,il,-88.96955,39.01845,2426,19,36,17,89.5
62419,il,-87.98536,38.61999,519,25,45,20,80
62420,il,-88.002,39.29043,4221,19,37,18,94.7
62421,il,-87.94353,38.75361,1076,24,43,19,79.2
62422,il,-88.8832,39.23882,1100,20,38,18,90
62423,il,-87.57964,39.46167,622,18,36,18,100
62424,il,-88.42237,38.98972,2191,21,39,18,85.7
62425,il,-88.09208,38.82852,946,22,41,19,86.4
62426,il,-88.66451,38.90212,1359,21,40,19,90.5
62427,il,-87.6593,38.87214,2369,23,42,19,82.6
62428,il,-88.13124,39.26359,3495,19,38,19,100
62431,il,-88.99105,39.22882,1300,19,37,18,94.7
62432,il,-88.13983,39.13547,1201,21,40,19,90.5
62433,il,-87.70352,39.11197,1037,26,46,20,76.9
62434,il,-88.32511,38.84324,665,23,42,19,82.6
62436,il,-88.25252,39.1799,707,21,40,19,90.5
62438,il,-88.86922,39.32112,521,20,38,18,90
62439,il,-87.63524,38.74656,6852,24,44,20,83.3
62440,il,-88.2679,39.3955,1221,17,35,18,105.9
62441,il,-87.69763,39.3976,5605,20,38,18,90
62442,il,-87.85504,39.31185,3015,19,37,18,94.7
62443,il,-88.62796,38.95411,1691,21,39,18,85.7
62444,il,-88.73928,39.27654,573,19,38,19,100
62445,il,-88.32118,39.16798,1265,20,39,19,95
62446,il,-88.21791,38.4975,1131,26,46,20,76.9
62447,il,-88.44441,39.3155,2783,18,36,18,100
62448,il,-88.18258,38.96893,7241,21,40,19,90.5
62449,il,-87.91068,39.00625,3836,23,42,19,82.6
62450,il,-88.09042,38.71236,8086,23,42,19,82.6
62451,il,-87.60621,38.99263,2011,26,46,20,76.9
62452,il,-88.01718,38.58633,515,26,45,19,73.1
62454,il,-87.75804,38.99866,7511,25,45,20,80
62458,il,-88.85147,39.02469,2084,18,36,18,100
62459,il,-88.02778,38.93002,439,22,41,19,86.4
62460,il,-87.69835,38.6084,1757,27,46,19,70.4
62461,il,-88.67569,39.19733,897,20,38,18,90
62462,il,-88.46392,39.23474,1118,19,38,19,100
62463,il,-88.60536,39.27666,1294,19,37,18,94.7
62465,il,-88.64046,39.34939,898,19,38,19,100
62466,il,-87.84972,38.7258,4059,25,44,19,76
62467,il,-88.435,39.13121,2745,20,38,18,90
62468,il,-88.27034,39.27745,2505,20,38,18,90
62469,il,-88.3405,39.34859,573,18,36,18,100
62471,il,-89.1306,38.9546,6595,19,38,19,100
62473,il,-88.56543,39.02029,855,21,40,19,90.5
62474,il,-87.9965,39.43664,799,18,36,18,100
62475,il,-88.05154,38.88703,927,22,41,19,86.4
62476,il,-88.00935,38.53406,2201,27,47,20,74.1
62477,il,-87.6628,39.23693,1247,22,41,19,86.4
62478,il,-87.74267,39.17838,586,23,42,19,82.6
62479,il,-88.31124,39.03755,1435,21,40,19,90.5
62480,il,-88.0016,38.99865,1766,22,41,19,86.4
62481,il,-88.02201,39.12724,986,21,40,19,90.5
62501,il,-88.80518,39.93397,2202,17,35,18,105.9
62510,il,-89.02694,39.5315,1560,19,37,18,94.7
62512,il,-89.20359,40.145,591,18,36,18,100
62513,il,-89.15082,39.72198,1499,18,37,19,105.6
62514,il,-89.05069,39.76244,170,18,37,19,105.6
62515,il,-89.37652,39.85838,1303,18,37,19,105.6
62517,il,-89.43114,39.59134,137,18,37,19,105.6
62518,il,-89.19141,40.0542,503,18,37,19,105.6
62519,il,-89.39531,39.9288,86,18,36,18,100
62520,il,-89.45595,39.81792,1002,17,37,20,117.6
62521,il,-88.92535,39.81508,18856,18,37,19,105.6
62522,il,-89.05111,39.82901,7632,19,38,19,100
62523,il,-88.95222,39.8441,455,19,38,19,100
62526,il,-88.98791,39.90151,14758,19,37,18,94.7
62530,il,-89.66136,39.56175,1254,18,37,19,105.6
62531,il,-89.37665,39.66695,1634,18,37,19,105.6
62532,il,-88.98925,39.76339,88,18,37,19,105.6
62533,il,-89.62235,39.44421,1140,17,37,20,117.6
62534,il,-88.79855,39.53446,1333,19,37,18,94.7
62535,il,-88.96887,39.92471,1631,19,37,18,94.7
62536,il,-89.65136,39.63017,576,17,37,20,117.6
62537,il,-89.09471,39.85313,51,20,39,19,95
62538,il,-89.51994,39.35642,586,17,36,19,111.8
62539,il,-89.25128,39.86603,1542,19,38,19,100
62540,il,-89.41827,39.58386,845,18,37,19,105.6
62541,il,-89.35515,39.96537,51,18,37,19,105.6
62543,il,-89.15222,39.97141,481,19,38,19,100
62544,il,-88.96787,39.7064,1553,18,36,18,100
62545,il,-89.38949,39.76185,1051,18,37,19,105.6
62546,il,-89.43981,39.43185,1861,16,35,19,118.8
62547,il,-89.24893,39.76895,981,18,38,20,111.1
62548,il,-89.28228,39.97847,2218,18,37,19,105.6
62549,il,-88.86587,39.7705,2715,17,36,19,111.8
62550,il,-88.9919,39.61142,2266,18,37,19,105.6
62551,il,-89.15767,39.85316,779,19,38,19,100
62553,il,-89.10717,39.2663,604,18,36,18,100
62554,il,-88.8715,39.94904,913,18,36,18,100
62555,il,-89.2206,39.46631,667,18,37,19,105.6
62556,il,-89.37327,39.46992,473,17,36,19,111.8
62557,il,-89.1048,39.39705,4989,19,38,19,100
62558,il,-89.54034,39.58973,3179,17,37,20,117.6
62560,il,-89.60114,39.30221,1555,18,37,19,105.6
62561,il,-89.50857,39.86625,2709,17,36,19,111.8
62563,il,-89.50302,39.71568,3562,17,37,20,117.6
62565,il,-88.80428,39.41131,5467,19,38,19,100
62567,il,-89.18986,39.64522,954,18,37,19,105.6
62568,il,-89.29025,39.56083,8383,18,37,19,105.6
62570,il,-89.4484,39.58861,297,17,37,20,117.6
62571,il,-88.96115,39.38064,1462,19,38,19,100
62572,il,-89.70152,39.36093,939,18,38,20,111.1
62573,il,-89.07413,39.94542,1058,19,37,18,94.7
62601,il,-90.04085,39.74872,676,18,37,19,105.6
62610,il,-90.43486,39.55884,138,18,37,19,105.6
62611,il,-90.39934,39.88562,1517,20,39,19,95
62612,il,-90.06704,39.88948,2122,18,37,19,105.6
62613,il,-89.66838,39.99175,2814,16,35,19,118.8
62615,il,-89.75737,39.58507,3515,18,38,20,111.1
62617,il,-90.17886,40.15251,1352,19,37,18,94.7
62618,il,-90.40073,39.98678,4841,21,40,19,90.5
62621,il,-90.53022,39.73137,1411,20,39,19,95
62622,il,-90.35345,39.97819,70,19,38,19,100
62624,il,-90.36216,40.15434,997,19,38,19,100
62625,il,-89.69581,39.91026,762,16,35,19,118.8
62626,il,-89.88404,39.28334,6299,20,39,19,95
62627,il,-90.12893,40.05627,1805,18,37,19,105.6
62628,il,-90.40325,39.77945,889,19,38,19,100
62629,il,-89.71396,39.67824,6125,17,37,20,117.6
62630,il,-90.07839,39.26082,826,21,42,21,100
62631,il,-90.3613,39.82437,326,19,38,19,100
62633,il,-89.87681,40.22646,1283,17,36,19,111.8
62634,il,-89.452,40.01314,1050,18,36,18,100
62635,il,-89.47144,40.2967,751,17,35,18,105.9
62638,il,-90.08183,39.60536,1491,18,38,20,111.1
62639,il,-90.488,40.04263,616,22,41,19,86.4
62640,il,-89.80527,39.43387,3178,19,38,19,100
62642,il,-89.71347,40.08907,1789,17,35,18,105.9
62643,il,-89.4517,40.24299,438,18,36,18,100
62644,il,-90.05435,40.2896,5208,19,37,18,94.7
62649,il,-90.06743,39.36529,764,20,41,21,105
62650,il,-90.22338,39.73454,13284,18,37,19,105.6
62655,il,-89.99407,40.16542,1067,18,37,19,105.6
62656,il,-89.37164,40.13987,8761,18,37,19,105.6
62661,il,-89.84042,39.6657,1260,18,37,19,105.6
62663,il,-90.32893,39.5407,240,18,36,18,100
62664,il,-89.72529,40.21227,2878,17,36,19,111.8
62665,il,-90.5339,39.81729,1605,22,40,18,81.8
62666,il,-89.54342,40.08558,712,17,36,19,111.8
62667,il,-89.99273,39.49451,835,18,38,20,111.1
62668,il,-90.23796,39.57232,1526,18,37,19,105.6
62670,il,-89.89387,39.74137,2881,17,37,20,117.6
62671,il,-89.55844,40.17288,668,17,36,19,111.8
62672,il,-89.80446,39.39801,200,19,39,20,105.3
62673,il,-89.9785,40.0947,886,18,36,18,100
62674,il,-90.02994,39.43467,1946,19,39,20,105.3
62675,il,-89.85911,40.02188,5609,17,36,19,111.8
62677,il,-89.87915,39.84983,2477,17,36,19,111.8
62681,il,-90.55886,40.13619,4748,19,37,18,94.7
62682,il,-89.63595,40.29218,913,17,35,18,105.9
62684,il,-89.58686,39.90926,2617,16,35,19,118.8
62685,il,-90.00355,39.1416,2647,21,41,20,95.2
62688,il,-89.92312,39.94598,1005,17,36,19,111.8
62689,il,-89.76177,39.53385,436,19,38,19,100
62690,il,-89.76318,39.50536,2786,19,39,20,105.3
62691,il,-90.21438,39.95914,3063,19,37,18,94.7
62692,il,-89.93991,39.5814,2236,18,38,20,111.1
62693,il,-89.51729,39.95827,1236,17,36,19,111.8
62694,il,-90.47136,39.62159,3841,20,39,19,95
62695,il,-90.22368,39.62708,127,17,36,19,111.8
62701,il,-89.64881,39.80071,497,16,35,19,118.8
62702,il,-89.64173,39.824,17125,16,35,19,118.8
62703,il,-89.62983,39.76176,16027,16,35,19,118.8
62704,il,-89.68516,39.77394,16708,16,35,19,118.8
62707,il,-89.65437,39.85438,4432,16,35,19,118.8
62711,il,-89.72936,39.76547,7661,16,36,20,125
62712,il,-89.58007,39.75333,4608,17,36,19,111.8
62801,il,-89.14165,38.51278,13040,23,43,20,87
62803,il,-89.29656,38.45286,1471,22,42,20,90.9
62806,il,-88.07485,38.38187,3480,31,50,19,61.3
62807,il,-88.92835,38.7455,1037,21,40,19,90.5
62808,il,-89.18744,38.30206,2282,22,42,20,90.9
62809,il,-88.33991,38.27908,303,27,47,20,74.1
62810,il,-88.74561,38.20309,1302,26,45,19,73.1
62811,il,-87.90561,38.38301,222,29,49,20,69
62812,il,-88.91699,37.99767,8303,30,50,20,66.7
62814,il,-88.73183,38.3783,2186,23,43,20,87
62815,il,-87.987,38.45706,643,29,49,20,69
62816,il,-88.92384,38.18587,1706,27,47,20,74.1
62817,il,-88.47793,37.95349,1233,30,50,20,66.7
62818,il,-87.96535,38.38328,694,30,50,20,66.7
62819,il,-89.0149,37.97951,458,30,50,20,66.7
62820,il,-88.23471,38.24347,604,29,49,20,69
62821,il,-88.13266,38.07341,8442,32,52,20,62.5
62822,il,-89.05652,37.97766,2008,30,49,19,63.3
62823,il,-88.43938,38.51962,2288,24,44,20,83.3
62824,il,-88.34651,38.67115,2676,24,44,20,83.3
62825,il,-89.06791,37.99832,174,28,48,20,71.4
62827,il,-88.04315,38.16914,2014,30,50,20,66.7
62828,il,-88.60683,38.19415,1826,26,46,20,76.9
62829,il,-88.48728,37.97593,92,30,50,20,66.7
62830,il,-88.96331,38.44684,1850,23,43,20,87
62831,il,-89.22125,38.23069,1110,25,45,20,80
62832,il,-89.24994,38.0122,6394,28,48,20,71.4
62833,il,-88.16051,38.36121,927,30,50,20,66.7
62835,il,-88.3203,38.10686,2404,29,49,20,69
62836,il,-88.80093,38.09034,954,28,48,20,71.4
62837,il,-88.35644,38.36803,7788,25,45,20,80
62838,il,-88.75557,38.87289,2110,20,39,19,95
62839,il,-88.49902,38.66519,4638,24,44,20,83.3
62841,il,-89.00017,37.85926,106,29,49,20,69
62842,il,-88.37309,38.47083,1073,25,44,19,76
62843,il,-88.19611,38.38223,211,28,48,20,71.4
62844,il,-88.04628,38.25813,2480,30,50,20,66.7
62846,il,-88.87033,38.14643,914,28,47,19,67.9
62848,il,-89.16483,38.43659,494,22,42,20,90.9
62849,il,-88.77354,38.58706,2355,23,43,20,87
62850,il,-88.59096,38.49534,569,24,44,20,83.3
62851,il,-88.66191,38.42068,566,25,45,20,80
62852,il,-87.86677,38.35013,111,29,49,20,69
62853,il,-88.9127,38.51467,822,23,42,19,82.6
62854,il,-88.80664,38.768,1950,21,40,19,90.5
62856,il,-88.83619,37.95749,319,29,49,20,69
62858,il,-88.4933,38.81474,4090,24,43,19,79.2
62859,il,-88.53396,38.07606,5537,28,48,20,71.4
62860,il,-88.72459,38.04086,823,27,47,20,74.1
62861,il,-88.02832,38.03195,280,31,51,20,64.5
62862,il,-88.2961,38.21731,909,29,49,20,69
62863,il,-87.85599,38.41644,7696,28,48,20,71.4
62864,il,-88.9026,38.33119,15733,23,43,20,87
62865,il,-89.0788,37.972,1854,29,49,20,69
62867,il,-88.10762,37.91638,893,31,50,19,61.3
62868,il,-88.2285,38.68377,2259,23,43,20,87
62869,il,-88.28121,37.96211,3803,30,49,19,63.3
62870,il,-89.05107,38.63491,1917,23,43,20,87
62871,il,-88.26821,37.87598,1259,31,51,20,64.5
62872,il,-88.80382,38.26642,831,24,43,19,79.2
62874,il,-88.97569,37.91936,411,30,49,19,63.3
62875,il,-89.12127,38.75914,1531,21,40,19,90.5
62876,il,-89.19573,38.27643,322,23,43,20,87
62877,il,-89.21306,38.39041,1035,22,41,19,86.4
62878,il,-88.50851,38.57871,815,24,44,20,83.3
62879,il,-88.36072,38.76497,109,24,44,20,83.3
62880,il,-88.8844,38.86699,959,19,37,18,94.7
62881,il,-88.92853,38.63516,6788,23,43,20,87
62882,il,-89.12008,38.63534,1663,23,42,19,82.6
62883,il,-89.11506,38.16329,861,26,46,20,76.9
62884,il,-89.05646,38.08226,2229,28,48,20,71.4
62885,il,-89.05495,38.85758,1146,20,38,18,90
62886,il,-88.53983,38.37887,596,26,46,20,76.9
62887,il,-88.35987,38.1874,766,29,49,20,69
62888,il,-89.23484,38.12849,2103,26,46,20,76.9
62889,il,-88.82919,38.45812,766,22,42,20,90.9
62890,il,-88.73756,37.90644,3333,28,48,20,71.4
62891,il,-89.04303,38.01521,528,29,49,20,69
62892,il,-89.0783,38.80657,544,20,39,19,95
62893,il,-89.03284,38.46704,762,23,43,20,87
62894,il,-89.03685,38.20901,1275,26,46,20,76.9
62895,il,-88.56342,38.31013,2465,27,47,20,74.1
62896,il,-88.91636,37.89103,8362,29,49,20,69
62897,il,-88.90234,38.09633,567,28,48,20,71.4
62898,il,-89.06475,38.35054,1803,24,43,19,79.2
62899,il,-88.64567,38.63187,2686,23,43,20,87
62901,il,-89.20843,37.73825,9395,30,51,21,70
62902,il,-89.11727,37.66361,4114,30,50,20,66.7
62903,il,-89.27783,37.67038,1178,29,50,21,72.4
62905,il,-89.3652,37.574,689,28,48,20,71.4
62906,il,-89.18699,37.45664,4081,30,51,21,70
62907,il,-89.49821,37.86677,2338,28,49,21,75
62908,il,-88.86573,37.30846,893,34,54,20,58.8
62910,il,-88.53346,37.15405,2703,33,54,21,63.6
62912,il,-89.03917,37.4766,1137,32,52,20,62.5
62914,il,-89.22253,37.0655,3459,39,59,20,51.3
62915,il,-89.11965,37.78357,246,29,49,20,69
62916,il,-89.56416,37.92861,939,28,48,20,71.4
62917,il,-88.64887,37.69813,2119,32,52,20,62.5
62918,il,-89.08771,37.79,6897,29,49,20,69
62919,il,-88.14886,37.5208,1222,29,49,20,69
62920,il,-89.23507,37.54895,2266,30,50,20,66.7
62921,il,-89.0842,37.8016,516,29,49,20,69
62922,il,-88.81597,37.62103,3992,29,49,20,69
62923,il,-89.01473,37.34436,607,33,53,20,60.6
62924,il,-89.2047,37.82385,2155,31,51,20,64.5
62926,il,-89.13393,37.36735,1920,33,53,20,60.6
62927,il,-89.24154,37.93535,506,30,50,20,66.7
62928,il,-88.5791,37.48287,471,28,48,20,71.4
62930,il,-88.44117,37.83824,5018,31,51,20,64.5
62931,il,-88.28676,37.52855,2109,28,47,19,67.9
62932,il,-89.21403,37.90345,1676,30,50,20,66.7
62933,il,-89.02484,37.77251,700,28,48,20,71.4
62934,il,-88.36434,37.70452,1654,30,50,20,66.7
62935,il,-88.6338,37.84123,2125,31,51,20,64.5
62938,il,-88.54275,37.38014,4262,30,50,20,66.7
62939,il,-88.98146,37.55119,3751,29,49,20,69
62940,il,-89.47209,37.73167,756,32,52,20,62.5
62941,il,-88.9809,37.24449,815,34,55,21,61.8
62942,il,-89.4692,37.64349,925,33,53,20,60.6
62943,il,-88.74775,37.35643,898,33,53,20,60.6
62946,il,-88.53816,37.70724,9941,32,52,20,62.5
62947,il,-88.44007,37.56336,873,25,45,20,80
62948,il,-89.0295,37.81687,7804,28,47,19,67.9
62949,il,-89.14446,37.82805,703,30,51,21,70
62950,il,-89.56041,37.75546,586,32,53,21,65.6
62951,il,-88.92915,37.82352,4132,27,47,20,74.1
62952,il,-89.33728,37.41825,2431,31,51,20,64.5
62953,il,-88.84993,37.20845,263,35,56,21,60
62954,il,-88.27478,37.69117,947,30,50,20,66.7
62956,il,-88.94231,37.27994,921,34,54,20,58.8
62957,il,-89.42661,37.30788,851,32,52,20,62.5
62958,il,-89.16583,37.59973,1915,29,49,20,69
62959,il,-88.90775,37.71805,18047,29,49,20,69
62960,il,-88.71073,37.22607,7401,35,55,20,57.1
62961,il,-89.25517,37.34029,67,32,53,21,65.6
62962,il,-89.33497,37.07374,284,37,57,20,54.1
62963,il,-89.16241,37.0939,802,38,59,21,55.3
62964,il,-89.21529,37.12855,1687,37,58,21,56.8
62965,il,-88.52021,37.76716,161,32,52,20,62.5
62966,il,-89.35107,37.77509,9902,31,51,20,64.5
62967,il,-88.75178,37.58046,342,28,48,20,71.4
62969,il,-89.34346,37.15792,713,33,54,21,63.6
62970,il,-89.09964,37.21475,817,35,55,20,57.1
62972,il,-88.79126,37.53704,1962,29,49,20,69
62974,il,-88.78464,37.77737,1523,28,48,20,71.4
62975,il,-89.37779,37.63754,493,29,49,20,69
62976,il,-89.20552,37.21898,843,34,54,20,58.8
62977,il,-88.54486,37.85395,757,31,51,20,64.5
62979,il,-88.19176,37.81608,1958,31,51,20,64.5
62982,il,-88.35982,37.42812,881,29,48,19,65.5
62983,il,-89.11721,37.90493,1348,30,50,20,66.7
62984,il,-88.15473,37.71061,2075,31,51,20,64.5
62985,il,-88.68959,37.46084,1119,31,52,21,67.7
62987,il,-88.65423,37.61681,1847,29,49,20,69
62988,il,-89.29748,37.24397,1734,33,54,21,63.6
62990,il,-89.40644,37.23089,1011,31,51,20,64.5
62992,il,-89.16671,37.27904,975,34,55,21,61.8
62994,il,-89.34079,37.90776,941,30,51,21,70
62995,il,-88.87526,37.42601,3202,31,52,21,67.7
62996,il,-89.15445,37.16322,728,35,56,21,60
62997,il,-89.59043,37.9823,448,27,48,21,77.8
62998,il,-89.44744,37.51589,504,33,54,21,63.6
62999,il,-89.05255,37.89169,1103,30,49,19,63.3
63005,mo,-90.64706,38.64438,7639,25,45,20,80
63010,mo,-90.39325,38.4295,13968,27,48,21,77.8
63011,mo,-90.5592,38.60366,13699,25,45,20,80
63012,mo,-90.44741,38.33308,4558,26,46,20,76.9
63013,mo,-91.15209,38.41548,1232,25,45,20,80
63014,mo,-91.31853,38.64698,1070,26,45,19,73.1
63015,mo,-90.75349,38.40363,1924,25,45,20,80
63016,mo,-90.64,38.35305,3890,26,46,20,76.9
63017,mo,-90.53658,38.65121,13808,25,45,20,80
63019,mo,-90.37683,38.22872,2023,27,48,21,77.8
63020,mo,-90.56198,38.10678,12744,23,43,20,87
63021,mo,-90.54649,38.56878,19391,26,47,21,80.8
63023,mo,-90.71319,38.26927,3663,25,45,20,80
63025,mo,-90.61934,38.49051,7357,27,48,21,77.8
63026,mo,-90.4603,38.5028,16165,27,47,20,74.1
63028,mo,-90.39566,38.14639,12564,26,46,20,76.9
63030,mo,-90.74524,38.1278,343,21,41,20,95.2
63031,mo,-90.35301,38.81194,18417,23,43,20,87
63033,mo,-90.27719,38.7956,14302,23,44,21,91.3
63034,mo,-90.28879,38.84809,7221,24,44,20,83.3
63036,mo,-90.37609,37.98044,6005,21,40,19,90.5
63037,mo,-91.3159,38.4275,2562,22,41,19,86.4
63038,mo,-90.67217,38.58138,3061,24,44,20,83.3
63039,mo,-90.83853,38.49478,453,26,47,21,80.8
63040,mo,-90.63504,38.57295,3239,24,43,19,79.2
63041,mo,-90.79012,38.25104,908,22,41,19,86.4
63042,mo,-90.38621,38.78576,5741,23,44,21,91.3
63043,mo,-90.46209,38.72929,7991,24,45,21,87.5
63044,mo,-90.42896,38.76983,5464,23,43,20,87
63045,mo,-90.46626,38.76891,160,24,45,21,87.5
63047,mo,-90.48742,38.1955,14,26,46,20,76.9
63048,mo,-90.39283,38.25911,1909,28,49,21,75
63049,mo,-90.53101,38.47939,6563,24,43,19,79.2
63050,mo,-90.57782,38.25974,10571,24,44,20,83.3
63051,mo,-90.58004,38.39954,6328,24,43,19,79.2
63052,mo,-90.43554,38.39074,11024,26,47,21,80.8
63053,mo,-90.36393,38.36659,48,28,49,21,75
63055,mo,-90.83397,38.53296,1628,26,46,20,76.9
63056,mo,-91.21711,38.38982,2317,24,43,19,79.2
63057,mo,-90.40557,38.3433,1,27,47,20,74.1
63060,mo,-90.86722,38.25889,2182,22,41,19,86.4
63061,mo,-90.81524,38.26987,65,22,42,20,90.9
63068,mo,-91.24177,38.55697,4344,26,45,19,73.1
63069,mo,-90.73041,38.48976,8383,26,46,20,76.9
63070,mo,-90.42115,38.28373,2971,28,48,20,71.4
63071,mo,-90.82493,38.15169,911,20,39,19,95
63072,mo,-90.81345,38.36886,3392,25,45,20,80
63073,mo,-90.76805,38.59364,283,24,44,20,83.3
63074,mo,-90.3887,38.7265,5476,24,44,20,83.3
63077,mo,-90.9863,38.3271,9095,26,46,20,76.9
63079,mo,-91.0998,38.26058,42,24,43,19,79.2
63080,mo,-91.0846,38.20374,16312,23,42,19,82.6
63084,mo,-91.0129,38.41783,9919,30,50,20,66.7
63087,mo,-90.45369,38.01313,569,20,38,18,90
63088,mo,-90.50311,38.54772,3203,26,47,21,80.8
63089,mo,-90.88385,38.45952,3550,29,49,20,69
63090,mo,-91.04848,38.53098,11481,30,50,20,66.7
63091,mo,-91.39035,38.36808,1115,21,39,18,85.7
63101,mo,-90.19261,38.63157,337,31,52,21,67.7
63102,mo,-90.18646,38.63515,947,30,52,22,73.3
63103,mo,-90.21686,38.62971,1425,30,51,21,70
63104,mo,-90.21268,38.61072,6792,30,51,21,70
63105,mo,-90.32826,38.64436,3432,28,49,21,75
63106,mo,-90.20832,38.6444,3715,30,51,21,70
63107,mo,-90.21211,38.66392,7513,30,51,21,70
63108,mo,-90.25342,38.6448,4095,28,50,22,78.6
63109,mo,-90.29576,38.58455,10824,29,50,21,72.4
63110,mo,-90.267,38.6258,7127,29,50,21,72.4
63111,mo,-90.2501,38.5581,7560,30,51,21,70
63112,mo,-90.28267,38.65894,7747,28,49,21,75
63113,mo,-90.2476,38.65802,8403,28,49,21,75
63114,mo,-90.36262,38.70225,15080,25,45,20,80
63115,mo,-90.23998,38.68221,9746,28,49,21,75
63116,mo,-90.26457,38.58028,16065,30,51,21,70
63117,mo,-90.33084,38.63078,3855,28,49,21,75
63118,mo,-90.2257,38.59229,9802,30,51,21,70
63119,mo,-90.35135,38.58847,12639,28,49,21,75
63120,mo,-90.2621,38.69059,5723,28,49,21,75
63121,mo,-90.30133,38.70718,10849,26,47,21,80.8
63122,mo,-90.42017,38.5792,15290,26,47,21,80.8
63123,mo,-90.32757,38.54892,19650,28,49,21,75
63124,mo,-90.38033,38.63804,3914,27,48,21,77.8
63125,mo,-90.29289,38.51856,12025,29,50,21,72.4
63126,mo,-90.37861,38.54963,6414,27,47,20,74.1
63127,mo,-90.41349,38.53325,2241,26,47,21,80.8
63128,mo,-90.38214,38.49298,11174,27,48,21,77.8
63129,mo,-90.32212,38.4563,18292,28,49,21,75
63130,mo,-90.3253,38.6651,10743,27,48,21,77.8
63131,mo,-90.44418,38.61744,7104,26,46,20,76.9
63132,mo,-90.37801,38.67602,4986,26,47,21,80.8
63133,mo,-90.306,38.68092,4183,28,49,21,75
63134,mo,-90.3456,38.74338,5848,24,45,21,87.5
63135,mo,-90.29899,38.75004,8828,25,45,20,80
63136,mo,-90.25977,38.74331,18622,26,47,21,80.8
63137,mo,-90.21121,38.75052,8205,26,48,22,84.6
63138,mo,-90.18236,38.79968,6160,24,45,21,87.5
63139,mo,-90.29172,38.61041,10227,29,50,21,72.4
63140,mo,-90.32307,38.73838,933,24,44,20,83.3
63141,mo,-90.45821,38.65829,6640,25,46,21,84
63143,mo,-90.32017,38.61127,3785,28,49,21,75
63144,mo,-90.34774,38.61913,3288,28,49,21,75
63146,mo,-90.47333,38.69843,8479,25,45,20,80
63147,mo,-90.21589,38.69545,5215,28,49,21,75
63155,mo,-90.20546,38.62787,4,31,52,21,67.7
63301,mo,-90.46747,38.86334,21928,26,47,21,80.8
63303,mo,-90.54284,38.74033,17174,26,47,21,80.8
63304,mo,-90.6654,38.70623,16573,26,47,21,80.8
63330,mo,-90.80654,39.27067,465,26,46,20,76.9
63332,mo,-90.89039,38.59702,1500,27,47,20,74.1
63333,mo,-91.31594,39.03673,777,26,45,19,73.1
63334,mo,-91.18781,39.30167,4315,20,38,18,90
63336,mo,-90.94667,39.33621,1237,23,42,19,82.6
63339,mo,-91.37323,39.34419,1010,20,38,18,90
63341,mo,-90.81186,38.67432,2283,25,44,19,76
63343,mo,-90.82798,39.15853,3231,27,47,20,74.1
63344,mo,-91.00427,39.2369,1319,23,42,19,82.6
63345,mo,-91.57135,39.27807,373,21,40,19,90.5
63347,mo,-90.76706,39.0709,2015,26,46,20,76.9
63348,mo,-90.94272,38.79302,5133,25,45,20,80
63349,mo,-91.1531,38.97757,1254,25,44,19,76
63350,mo,-91.36094,38.89933,608,26,46,20,76.9
63351,mo,-91.31373,38.86244,1413,25,44,19,76
63352,mo,-91.65395,39.25133,1084,22,41,19,86.4
63353,mo,-91.12199,39.44688,3148,23,42,19,82.6
63357,mo,-91.09603,38.65863,5946,26,46,20,76.9
63359,mo,-91.34907,39.15546,1718,23,42,19,82.6
63361,mo,-91.55448,38.96249,3624,26,45,19,73.1
63362,mo,-90.88013,38.93213,2930,27,47,20,74.1
63363,mo,-91.45601,38.88615,2070,27,46,19,70.4
63366,mo,-90.72027,38.85944,20541,26,47,21,80.8
63367,mo,-90.79559,38.77781,11371,25,45,20,80
63368,mo,-90.72959,38.75129,15920,25,46,21,84
63369,mo,-90.76494,38.93958,1345,27,48,21,77.8
63370,mo,-91.24062,39.09002,35,25,44,19,76
63373,mo,-90.39292,38.92998,766,27,48,21,77.8
63376,mo,-90.61738,38.79991,29102,26,47,21,80.8
63377,mo,-91.10364,39.11037,2188,24,44,20,83.3
63379,mo,-90.9888,38.99818,11325,26,45,19,73.1
63381,mo,-91.25451,38.98401,519,25,45,20,80
63382,mo,-91.49609,39.30537,2508,21,39,18,85.7
63383,mo,-91.19087,38.80635,9074,24,43,19,79.2
63384,mo,-91.56002,39.09232,1553,24,43,19,79.2
63385,mo,-90.85753,38.797,19182,25,45,20,80
63386,mo,-90.2151,38.86961,1005,24,45,21,87.5
63387,mo,-91.01674,39.1839,47,23,42,19,82.6
63388,mo,-91.74285,38.88769,942,23,42,19,82.6
63389,mo,-90.7788,39.00516,3269,26,46,20,76.9
63390,mo,-91.04079,38.80679,7757,24,43,19,79.2
63401,mo,-91.45653,39.69233,10626,19,36,17,89.5
63430,mo,-91.54048,40.38963,837,20,37,17,85
63431,mo,-92.32714,39.74416,409,22,39,17,77.3
63432,mo,-91.99893,40.50058,937,19,34,15,78.9
63433,mo,-91.13169,39.53299,85,23,42,19,82.6
63434,mo,-91.9501,39.90678,542,22,39,17,77.3
63435,mo,-91.58375,40.20542,3034,21,38,17,81
63436,mo,-91.54668,39.50659,1346,22,40,18,81.8
63437,mo,-92.23724,39.73181,883,21,38,17,81
63438,mo,-91.68647,39.96119,289,22,39,17,77.3
63439,mo,-91.86056,39.80194,211,23,41,18,78.3
63440,mo,-91.7519,39.97679,1230,22,39,17,77.3
63441,mo,-91.3096,39.47849,1233,20,38,18,90
63443,mo,-91.86801,39.6686,429,25,43,18,72
63445,mo,-91.72564,40.39882,2941,19,36,17,89.5
63446,mo,-92.0039,40.13619,1035,21,38,17,81
63447,mo,-91.90281,40.09502,1147,22,38,16,72.7
63448,mo,-91.5536,40.02693,1218,22,39,17,77.3
63450,mo,-92.14849,39.67126,201,21,38,17,81
63451,mo,-92.20452,39.90614,396,21,38,17,81
63452,mo,-91.78606,40.09122,1266,21,38,17,81
63453,mo,-91.87115,40.50433,528,19,35,16,84.2
63454,mo,-91.64757,39.92671,693,22,39,17,77.3
63456,mo,-91.72647,39.65585,3486,25,44,19,76
63457,mo,-91.70266,40.16589,396,20,37,17,85
63458,mo,-92.02155,39.99233,412,22,39,17,77.3
63459,mo,-91.37772,39.58142,2829,21,38,17,81
63460,mo,-92.2118,39.9987,864,21,37,16,76.2
63461,mo,-91.55761,39.79799,3399,20,38,18,90
63462,mo,-91.69913,39.42547,1875,23,41,18,78.3
63463,mo,-91.76015,39.84514,592,23,41,18,78.3
63464,mo,-92.08517,39.97653,67,21,38,17,81
63465,mo,-91.67531,40.51717,578,19,35,16,84.2
63467,mo,-91.27088,39.64862,52,21,39,18,85.7
63468,mo,-92.01348,39.68063,1221,22,40,18,81.8
63469,mo,-92.04303,39.83348,953,22,39,17,77.3
63471,mo,-91.50721,39.9247,576,21,39,18,85.7
63472,mo,-91.58426,40.40014,277,20,37,17,85
63473,mo,-91.78518,40.24912,652,20,37,17,85
63474,mo,-91.89948,40.35131,825,20,35,15,75
63501,mo,-92.59035,40.16727,9482,16,29,13,81.3
63530,mo,-92.45445,39.90545,1069,22,39,17,77.3
63531,mo,-92.25035,40.29941,838,19,34,15,78.9
63532,mo,-92.57342,39.76087,1039,24,41,17,70.8
63533,mo,-92.39464,40.20493,826,18,33,15,83.3
63534,mo,-92.6473,39.74493,896,24,41,17,70.8
63535,mo,-92.65853,40.56891,279,15,28,13,86.7
63536,mo,-92.35914,40.49056,1006,17,31,14,82.4
63537,mo,-92.16011,40.14854,1955,20,36,16,80
63538,mo,-92.67001,39.95442,570,22,38,16,72.7
63539,mo,-92.75526,39.9148,415,21,38,17,81
63540,mo,-92.40659,40.10398,147,18,34,16,88.9
63541,mo,-92.62972,40.50358,531,15,28,13,86.7
63543,mo,-92.00857,40.35694,541,19,35,16,84.2
63544,mo,-92.8426,40.25124,986,17,30,13,76.5
63545,mo,-92.96452,40.269,704,16,28,12,75
63546,mo,-92.51469,40.3307,1400,16,30,14,87.5
63547,mo,-92.29972,40.13756,739,19,35,16,84.2
63548,mo,-92.48526,40.53009,1203,16,29,13,81.3
63549,mo,-92.48589,40.01821,2031,19,34,15,78.9
63551,mo,-92.73559,40.50058,631,16,29,13,81.3
63552,mo,-92.44737,39.75976,4693,23,40,17,73.9
63555,mo,-92.19576,40.48106,3174,18,33,15,83.3
63556,mo,-93.12498,40.18512,1827,18,31,13,72.2
63557,mo,-92.87158,39.9762,766,19,34,15,78.9
63558,mo,-92.75305,39.74252,986,23,40,17,73.9
63559,mo,-92.74503,40.22228,1798,18,32,14,77.8
63560,mo,-93.11882,40.35815,300,15,28,13,86.7
63561,mo,-92.54225,40.41936,1122,16,29,13,81.3
63563,mo,-92.07058,40.30411,863,20,36,16,80
63565,mo,-92.94509,40.48405,7316,15,27,12,80
63566,mo,-92.92527,40.0503,285,18,33,15,83.3
63567,mo,-92.71975,40.41879,333,17,31,14,82.4
63601,mo,-90.54706,37.82415,7378,20,38,18,90
63620,mo,-90.65369,37.39458,2824,23,42,19,82.6
63621,mo,-90.60617,37.48714,1129,20,39,19,95
63622,mo,-90.89659,37.78871,757,20,37,17,85
63623,mo,-90.88897,37.67516,830,20,38,18,90
63624,mo,-90.64099,37.75232,3304,19,37,18,94.7
63625,mo,-90.97793,37.57042,596,22,40,18,81.8
63626,mo,-90.68805,38.06898,609,21,40,19,90.5
63627,mo,-90.2574,38.04462,2243,27,46,19,70.4
63628,mo,-90.52329,37.94099,12829,21,40,19,90.5
63629,mo,-91.23539,37.41513,1505,23,41,18,78.3
63630,mo,-90.72724,38.01824,2277,20,38,18,90
63631,mo,-90.78285,37.74658,690,20,38,18,90
63633,mo,-91.0185,37.42849,922,23,41,18,78.3
63636,mo,-90.5777,37.29552,660,25,44,19,76
63637,mo,-90.51408,37.71965,699,19,38,19,100
63638,mo,-91.00722,37.21664,3778,28,47,19,67.9
63640,mo,-90.36958,37.75106,11124,19,37,18,94.7
63645,mo,-90.3352,37.53673,8727,21,39,18,85.7
63648,mo,-90.69489,37.82143,1205,20,38,18,90
63650,mo,-90.6314,37.61628,5821,19,38,19,100
63653,mo,-90.59159,37.86029,579,21,40,19,90.5
63654,mo,-90.85462,37.45813,986,22,41,19,86.4
63655,mo,-90.20763,37.39356,1896,25,45,20,80
63656,mo,-90.79901,37.59294,1110,21,39,18,85.7
63660,mo,-90.69785,37.91345,1743,20,38,18,90
63662,mo,-90.05133,37.53126,1077,24,44,20,83.3
63663,mo,-90.64605,37.62504,387,19,38,19,100
63664,mo,-90.91983,37.91246,6384,19,37,18,94.7
63665,mo,-90.84563,37.30808,718,27,46,19,70.4
63666,mo,-91.05977,37.39804,72,23,41,18,78.3
63670,mo,-90.16822,37.89586,10197,27,47,20,74.1
63673,il,-89.99082,37.84214,2223,31,52,20,66.9
63674,mo,-90.65786,38.0313,103,22,41,19,86.4
63675,mo,-90.68974,37.30476,188,25,44,19,76
63701,mo,-89.5768,37.33784,15908,34,54,20,58.8
63703,mo,-89.53996,37.27382,3529,33,54,21,63.6
63730,mo,-89.91708,37.09788,2465,32,52,20,62.5
63732,mo,-89.58038,37.59161,724,31,51,20,64.5
63735,mo,-89.7798,36.98625,688,36,56,20,55.6
63736,mo,-89.50747,37.08487,2006,35,56,21,60
63738,mo,-89.95725,37.08916,55,32,52,20,62.5
63739,mo,-89.80042,37.36028,392,33,54,21,63.6
63740,mo,-89.68503,37.17594,3258,34,54,20,58.8
63742,mo,-89.44614,37.15866,148,32,53,21,65.6
63743,mo,-89.82547,37.5174,104,30,50,20,66.7
63744,mo,-89.73826,37.196,78,35,55,20,57.1
63745,mo,-89.69403,37.24194,92,35,56,21,60
63746,mo,-89.69483,37.70784,37,28,48,20,71.4
63747,mo,-89.80888,37.55971,342,29,50,21,72.4
63748,mo,-89.62223,37.67268,1147,31,51,20,64.5
63750,mo,-90.1859,37.14851,97,31,51,20,64.5
63751,mo,-90.13555,37.28125,1172,26,46,20,76.9
63755,mo,-89.63963,37.44249,12623,35,55,20,57.1
63758,mo,-89.55678,37.18641,104,32,52,20,62.5
63760,mo,-89.90157,37.24006,579,30,50,20,66.7
63763,mo,-90.17658,37.05534,279,34,54,20,58.8
63764,mo,-89.99004,37.31914,4387,27,47,20,74.1
63766,mo,-89.84408,37.43447,1091,32,52,20,62.5
63767,mo,-89.61126,37.04621,433,36,56,20,55.6
63769,mo,-89.739,37.52119,1087,32,52,20,62.5
63770,mo,-89.70302,37.59751,134,32,52,20,62.5
63771,mo,-89.70631,37.07344,2152,35,55,20,57.1
63774,mo,-89.75997,37.09608,81,35,55,20,57.1
63775,mo,-89.88131,37.71396,11906,26,46,20,76.9
63780,mo,-89.51419,37.18939,3998,32,52,20,62.5
63781,mo,-89.92908,37.53852,1183,27,47,20,74.1
63782,mo,-90.02782,37.11358,233,32,52,20,62.5
63783,mo,-89.67985,37.60727,116,32,52,20,62.5
63784,mo,-89.69155,36.98453,155,36,57,21,58.3
63785,mo,-89.81514,37.26413,978,33,53,20,60.6
63787,mo,-90.12327,37.12578,874,32,52,20,62.5
63801,mo,-89.60531,36.89806,12763,37,58,21,56.8
63820,mo,-89.32557,36.82426,194,38,59,21,55.3
63821,mo,-90.2392,36.04864,943,40,62,22,55
63822,mo,-90.00174,36.66432,1816,38,58,20,52.6
63823,mo,-89.45629,36.89568,866,38,58,20,52.6
63824,mo,-89.52669,37.00492,86,37,58,21,56.8
63825,mo,-89.94557,36.9271,2502,36,56,20,55.6
63826,mo,-89.85056,36.17481,86,38,58,20,52.6
63827,mo,-89.88761,36.26012,1113,38,59,21,55.3
63828,mo,-89.69184,36.75037,222,36,57,21,58.3
63829,mo,-90.31345,36.03854,948,41,62,21,51.2
63830,mo,-89.69066,36.13006,3835,35,56,21,60
63833,mo,-89.72895,36.64552,441,36,56,20,55.6
63834,mo,-89.27891,36.92083,4323,39,59,20,51.3
63837,mo,-89.99541,36.45874,1035,37,58,21,56.8
63839,mo,-89.81358,36.04474,296,39,60,21,53.8
63841,mo,-89.98703,36.77337,7021,39,59,20,51.3
63845,mo,-89.3234,36.70986,4143,37,58,21,56.8
63846,mo,-89.80307,36.82185,1439,38,58,20,52.6
63847,mo,-90.03893,36.43995,71,38,59,21,55.3
63848,mo,-89.89887,36.44767,1161,36,57,21,58.3
63849,mo,-89.98299,36.13283,274,39,60,21,53.8
63851,mo,-89.71724,36.25888,2962,35,56,21,60
63852,mo,-90.01537,36.37353,1147,39,60,21,53.8
63853,mo,-89.87032,36.06474,165,39,60,21,53.8
63855,mo,-90.07051,36.05438,1223,40,61,21,52.5
63857,mo,-90.04714,36.22459,7047,41,62,21,51.2
63860,mo,-89.58822,36.65344,152,37,57,20,54.1
63862,mo,-89.68325,36.57859,1429,36,56,20,55.6
63863,mo,-89.9795,36.56462,4089,37,58,21,56.8
63866,mo,-89.6042,36.53285,400,34,55,21,61.8
63867,mo,-89.54809,36.73738,1031,36,57,21,58.3
63868,mo,-89.69343,36.84917,590,36,57,21,58.3
63869,mo,-89.48601,36.5961,2637,38,58,20,52.6
63870,mo,-89.84778,36.62199,1077,37,57,20,54.1
63873,mo,-89.6706,36.42371,3705,33,53,20,60.6
63874,mo,-89.81852,36.54712,258,35,56,21,60
63876,mo,-90.16854,36.13182,1763,40,62,22,55
63877,ar,-89.85707,36.07573,3151,39,60,22,55.1
63878,mo,-89.82236,36.50302,118,35,55,20,57.1
63879,mo,-89.81699,36.35483,588,35,56,21,60
63880,mo,-90.02515,36.3275,42,40,61,21,52.5
63882,mo,-89.22181,36.91473,404,38,59,21,55.3
63901,mo,-90.46265,36.76634,19169,34,54,20,58.8
63902,mo,-90.42711,36.76762,1,34,55,21,61.8
63932,mo,-90.25075,36.68992,1312,35,56,21,60
63933,mo,-90.1104,36.52859,2719,36,57,21,58.3
63934,mo,-90.38417,37.19791,165,26,45,19,73.1
63935,mo,-90.91572,36.67175,7618,36,56,20,55.6
63936,mo,-90.13446,36.80761,750,37,57,20,54.1
63937,mo,-90.76895,36.94005,1953,30,49,19,63.3
63939,mo,-90.68208,36.66338,866,35,55,20,57.1
63940,mo,-90.22765,36.77108,1309,35,56,21,60
63941,mo,-91.17032,36.89007,614,31,50,19,61.3
63942,mo,-91.07907,36.551,792,37,57,20,54.1
63943,mo,-90.79018,36.82853,624,32,52,20,62.5
63944,mo,-90.36589,37.10637,1563,31,50,19,61.3
63945,mo,-90.54572,36.6348,741,36,57,21,58.3
63951,mo,-90.2634,37.12085,348,31,50,19,61.3
63952,mo,-90.65113,37.0093,336,31,51,20,64.5
63953,mo,-90.63152,36.58185,1175,37,58,21,56.8
63954,mo,-90.4737,36.55759,1451,37,58,21,56.8
63955,mo,-90.68088,36.60356,207,37,58,21,56.8
63956,mo,-90.51819,37.21159,947,29,48,19,65.5
63957,mo,-90.68289,37.14508,3222,30,49,19,63.3
63960,mo,-90.123,36.9611,2078,35,55,20,57.1
63961,mo,-90.27113,36.57066,1769,36,57,21,58.3
63962,mo,-90.28151,36.84403,21,34,54,20,58.8
63964,mo,-90.39994,37.25404,790,26,45,19,73.1
63965,mo,-91.01243,36.96782,2042,32,51,19,59.4
63966,mo,-90.26247,36.97807,1307,35,55,20,57.1
63967,mo,-90.47925,36.94609,1283,32,52,20,62.5
64001,mo,-93.54217,39.10532,581,25,42,17,68
64011,mo,-94.06881,38.96598,1489,25,42,17,68
64012,mo,-94.54984,38.78693,10394,25,43,18,72
64014,mo,-94.25505,39.0071,9787,24,41,17,70.8
64015,mo,-94.30633,39.01409,12681,23,41,18,78.3
64016,mo,-94.21479,39.11775,2229,24,41,17,70.8
64017,mo,-94.02396,39.19549,438,26,44,18,69.2
64018,mo,-94.72687,39.45248,611,25,42,17,68
64019,mo,-93.86393,38.77585,1614,28,46,18,64.3
64020,mo,-93.59126,38.96608,2302,26,44,18,69.2
64021,mo,-93.62757,39.10663,599,23,40,17,73.9
64022,mo,-93.67275,39.19511,209,23,40,17,73.9
64024,mo,-94.22798,39.3237,9215,21,37,16,76.2
64029,mo,-94.21513,39.00577,7789,25,42,17,68
64030,mo,-94.52269,38.88015,9342,24,42,18,75
64034,mo,-94.29943,38.85236,3712,27,45,18,66.7
64035,mo,-93.80948,39.29491,988,25,43,18,72
64036,mo,-93.9354,39.1983,452,27,45,18,66.7
64037,mo,-93.73279,39.05743,3515,23,40,17,73.9
64040,mo,-93.98637,38.7215,4410,27,45,18,66.7
64048,mo,-94.3671,39.4439,2226,19,35,16,84.2
64050,mo,-94.40758,39.11513,9416,24,41,17,70.8
64052,mo,-94.45024,39.07342,10112,23,41,18,78.3
64053,mo,-94.4647,39.10995,2856,23,41,18,78.3
64054,mo,-94.44011,39.11001,2030,23,41,18,78.3
64055,mo,-94.39856,39.05067,13969,24,42,18,75
64056,mo,-94.31639,39.11051,6114,24,41,17,70.8
64057,mo,-94.32401,39.06924,5361,24,42,18,75
64058,mo,-94.30666,39.17951,3093,23,41,18,78.3
64060,mo,-94.36464,39.36857,6557,20,36,16,80
64061,mo,-94.08874,38.78083,2141,26,44,18,69.2
64062,mo,-94.1698,39.4534,3421,20,35,15,75
64063,mo,-94.35168,38.91199,7788,24,42,18,75
64064,mo,-94.34656,38.97548,8107,24,41,17,70.8
64065,mo,-94.40577,38.95287,23,23,41,18,78.3
64066,mo,-94.12654,39.13823,45,24,42,18,75
64067,mo,-93.83555,39.15593,3576,25,42,17,68
64068,mo,-94.38878,39.2595,14172,22,39,17,77.3
64070,mo,-94.14859,38.88835,2281,25,43,18,72
64071,mo,-93.83358,39.0295,652,24,41,17,70.8
64072,mo,-94.29339,39.23953,195,23,40,17,73.9
64074,mo,-94.0743,39.08676,494,25,42,17,68
64075,mo,-94.14527,39.00029,6159,25,42,17,68
64076,mo,-93.94495,38.98052,6715,25,42,17,68
64077,mo,-94.13027,39.22359,1555,24,41,17,70.8
64078,mo,-94.45626,38.70312,4537,29,47,18,62.1
64079,mo,-94.7959,39.3578,6740,25,42,17,68
64080,mo,-94.25449,38.76704,6758,28,46,18,64.3
64081,mo,-94.40407,38.90702,9218,25,42,17,68
64082,mo,-94.40783,38.8653,6821,26,44,18,69.2
64083,mo,-94.44728,38.79972,9836,25,43,18,72
64084,mo,-94.06463,39.38342,1124,22,38,16,72.7
64085,mo,-93.94567,39.33451,5584,25,43,18,72
64086,mo,-94.28758,38.9079,10136,25,42,17,68
64088,mo,-94.18443,39.15841,939,24,41,17,70.8
64089,mo,-94.56261,39.39227,6139,21,37,16,76.2
64090,mo,-94.16358,38.75936,67,28,46,18,64.3
64092,mo,-94.80207,39.22003,79,27,44,17,63
64093,mo,-93.73173,38.79477,10833,27,45,18,66.7
64096,mo,-93.56238,39.20208,917,25,42,17,68
64097,mo,-93.98638,39.10852,964,25,43,18,72
64098,mo,-94.89396,39.45615,2196,28,45,17,60.7
64101,mo,-94.60064,39.10347,218,24,42,18,75
64102,mo,-94.60404,39.09384,84,25,42,17,68
64105,mo,-94.59091,39.10476,1317,24,42,18,75
64106,mo,-94.57204,39.10503,2025,24,42,18,75
64108,mo,-94.58486,39.08418,4301,24,41,17,70.8
64109,mo,-94.56671,39.06645,4949,24,42,18,75
64110,mo,-94.57284,39.03445,6670,25,42,17,68
64111,mo,-94.59388,39.05758,5433,24,42,18,75
64112,mo,-94.59519,39.03597,2542,24,42,18,75
64113,mo,-94.59565,39.01407,4759,25,42,17,68
64114,mo,-94.59722,38.95778,10386,25,43,18,72
64116,mo,-94.57452,39.14881,6194,25,43,18,72
64117,mo,-94.52292,39.16523,4797,25,43,18,72
64118,mo,-94.57478,39.21301,13543,23,41,18,78.3
64119,mo,-94.51937,39.20938,12250,24,42,18,75
64120,mo,-94.51527,39.13091,1055,25,43,18,72
64123,mo,-94.52323,39.11435,3786,25,43,18,72
64124,mo,-94.53921,39.10722,4375,25,43,18,72
64125,mo,-94.49386,39.1058,1181,24,41,17,70.8
64126,mo,-94.49617,39.0904,2923,24,41,17,70.8
64127,mo,-94.53854,39.08914,9695,25,42,17,68
64128,mo,-94.53458,39.06556,7382,25,43,18,72
64129,mo,-94.49609,39.04926,4103,23,41,18,78.3
64130,mo,-94.54077,39.0337,12986,25,42,17,68
64131,mo,-94.57562,38.96161,7858,25,43,18,72
64132,mo,-94.5416,38.98674,6749,24,42,18,75
64133,mo,-94.45644,39.01386,14519,24,41,17,70.8
64134,mo,-94.48674,38.92948,8447,25,42,17,68
64136,mo,-94.4007,39.01134,800,25,42,17,68
64137,mo,-94.5427,38.93523,3555,24,42,18,75
64138,mo,-94.47029,38.96878,9613,24,42,18,75
64139,mo,-94.40881,38.96675,756,23,41,18,78.3
64145,mo,-94.5931,38.87547,2552,25,42,17,68
64146,mo,-94.57334,38.88762,963,25,42,17,68
64147,mo,-94.54625,38.8528,80,24,42,18,75
64149,mo,-94.46545,38.86255,254,25,42,17,68
64150,mo,-94.63026,39.17042,1301,26,44,18,69.2
64151,mo,-94.63116,39.21484,9554,24,42,18,75
64152,mo,-94.7206,39.21295,11965,25,42,17,68
64153,mo,-94.73224,39.28051,2192,24,41,17,70.8
64154,mo,-94.63086,39.27838,3700,23,40,17,73.9
64155,mo,-94.57679,39.27697,8637,22,38,16,72.7
64156,mo,-94.52416,39.27941,4049,21,38,17,81
64157,mo,-94.47187,39.27619,8104,21,37,16,76.2
64158,mo,-94.48315,39.23532,1731,23,41,18,78.3
64161,mo,-94.44958,39.16191,701,25,42,17,68
64163,mo,-94.6909,39.33636,304,22,39,17,77.3
64164,mo,-94.63234,39.33097,261,22,39,17,77.3
64165,mo,-94.57628,39.32144,213,20,37,17,85
64166,mo,-94.52304,39.32207,194,20,36,16,80
64167,mo,-94.48301,39.31753,152,19,35,16,84.2
64192,mo,-94.52203,38.96046,7,24,42,18,75
64401,mo,-94.71722,39.63329,912,24,40,16,66.7
64402,mo,-94.32793,40.2576,2534,18,32,14,77.8
64420,mo,-94.28868,40.48534,188,16,29,13,81.3
64421,mo,-94.93354,39.91301,800,23,40,17,73.9
64422,mo,-94.49365,39.8891,353,17,32,15,88.2
64423,mo,-94.8559,40.19008,918,19,34,15,78.9
64424,mo,-94.03596,40.26242,3524,17,31,14,82.4
64426,mo,-93.86531,40.51881,635,15,28,13,86.7
64427,mo,-94.83616,40.1103,684,20,34,14,70
64428,mo,-95.09472,40.43686,1172,19,33,14,73.7
64429,mo,-94.22786,39.73476,5111,18,33,15,83.3
64430,mo,-94.5663,39.83717,672,19,34,15,78.9
64431,mo,-94.99591,40.52887,587,18,32,14,77.8
64432,mo,-94.66857,40.26359,50,18,32,14,77.8
64433,mo,-94.68057,40.24108,53,18,32,14,77.8
64434,mo,-94.7335,40.26186,526,18,32,14,77.8
64436,mo,-94.69015,39.85403,597,21,36,15,71.4
64437,mo,-95.34687,40.12856,2493,23,38,15,65.2
64438,mo,-94.41062,40.15981,517,18,32,14,77.8
64439,mo,-94.7543,39.52364,1234,24,41,17,70.8
64440,mo,-94.91894,39.57802,626,23,40,17,73.9
64441,mo,-94.26602,40.39818,662,16,30,14,87.5
64442,mo,-94.00948,40.49621,1032,14,27,13,92.9
64443,mo,-94.65232,39.74676,867,21,36,15,71.4
64444,mo,-94.63948,39.48468,1018,22,39,17,77.3
64445,mo,-95.13878,40.53533,492,18,33,15,83.3
64446,mo,-95.42102,40.32009,1556,20,36,16,80
64448,mo,-94.81897,39.59988,801,23,40,17,73.9
64449,mo,-94.9776,40.04259,522,21,36,15,71.4
64451,mo,-95.19635,39.99574,724,22,38,16,72.7
64453,mo,-94.48017,40.34502,429,18,32,14,77.8
64454,mo,-94.5964,39.60277,1507,21,37,16,76.2
64455,mo,-95.00978,40.18496,527,20,35,15,75
64456,mo,-94.38705,40.48965,2849,17,31,14,82.4
64457,mo,-94.68558,40.16096,424,18,33,15,83.3
64458,mo,-94.14314,40.5208,391,14,27,13,92.9
64459,mo,-94.64646,39.92949,480,19,34,15,78.9
64461,mo,-94.81294,40.52234,996,16,29,13,81.3
64463,mo,-94.48257,40.06282,1795,18,32,14,77.8
64465,mo,-94.29336,39.54906,3619,18,33,15,83.3
64466,mo,-95.10726,40.16543,666,21,37,16,76.2
64467,mo,-94.1609,40.40143,384,15,29,14,93.3
64468,mo,-94.88079,40.3439,6248,18,32,14,77.8
64469,mo,-94.36667,39.92672,1823,17,31,14,82.4
64470,mo,-95.22392,40.16901,1516,21,37,16,76.2
64471,mo,-94.19426,40.25605,602,17,30,13,76.5
64473,mo,-95.08302,39.97426,1662,21,37,16,76.2
64474,mo,-94.38276,39.75573,717,18,33,15,83.3
64475,mo,-94.62615,40.43886,718,17,31,14,82.4
64476,mo,-94.83745,40.45077,459,17,30,13,76.5
64477,mo,-94.45624,39.57364,2222,19,34,15,78.9
64479,mo,-94.66347,40.3503,814,18,32,14,77.8
64480,mo,-94.70838,40.05946,365,19,34,15,78.9
64481,mo,-93.88989,40.35607,1662,15,28,13,86.7
64482,mo,-95.54192,40.46296,1943,19,34,15,78.9
64483,mo,-94.83981,40.04457,624,20,35,15,75
64484,mo,-95.02038,39.55675,1594,26,43,17,65.4
64485,mo,-94.8139,39.95173,4011,21,37,16,76.2
64486,mo,-94.61859,40.52915,796,17,30,13,76.5
64487,mo,-95.10264,40.30868,1092,19,34,15,78.9
64489,mo,-94.55554,40.2331,1960,18,32,14,77.8
64490,mo,-94.51603,39.73532,1558,19,34,15,78.9
64491,mo,-95.34491,40.44832,1508,19,34,15,78.9
64492,mo,-94.53463,39.47987,1033,21,37,16,76.2
64493,mo,-94.31819,39.63505,384,18,33,15,83.3
64494,mo,-94.61179,39.99165,974,18,33,15,83.3
64496,mo,-95.63991,40.48071,314,22,37,15,68.2
64497,mo,-94.21995,39.92553,604,18,32,14,77.8
64498,mo,-95.32196,40.53959,551,18,33,15,83.3
64499,mo,-94.4398,40.39387,266,18,32,14,77.8
64501,mo,-94.84461,39.76567,5256,23,39,16,69.6
64503,mo,-94.84373,39.74899,5728,22,39,17,77.3
64504,mo,-94.91347,39.68619,5609,23,39,16,69.6
64505,mo,-94.83401,39.84434,6581,22,39,17,77.3
64506,mo,-94.80179,39.78981,7484,22,39,17,77.3
64507,mo,-94.75991,39.72866,6191,22,39,17,77.3
64601,mo,-93.5765,39.80693,7175,24,40,16,66.7
64620,mo,-94.08968,39.896,826,17,31,14,82.4
64622,mo,-93.54638,39.49524,852,24,41,17,70.8
64623,mo,-93.33376,39.47034,825,23,40,17,73.9
64624,mo,-93.77768,39.56843,1502,21,38,17,81
64625,mo,-93.80708,39.73949,957,21,37,16,76.2
64628,mo,-93.04697,39.79718,4166,21,38,17,81
64630,mo,-93.15519,40.03879,903,20,35,15,75
64631,mo,-92.87433,39.81972,1051,21,37,16,76.2
64632,mo,-93.76667,40.47072,1304,15,28,13,86.7
64633,mo,-93.48372,39.35831,4635,27,45,18,66.7
64635,mo,-93.44439,39.93781,621,23,39,16,69.6
64636,mo,-93.98126,40.11021,411,18,32,14,77.8
64637,mo,-93.91592,39.56172,833,20,35,15,75
64638,mo,-93.61337,39.61966,666,22,38,16,72.7
64639,mo,-93.22301,39.39201,536,22,39,17,77.3
64640,mo,-93.94498,39.89847,4349,19,33,14,73.7
64641,mo,-93.39899,40.17747,820,18,32,14,77.8
64642,mo,-93.83152,40.1719,1327,16,29,13,81.3
64643,mo,-93.37004,39.61359,1277,23,39,16,69.6
64644,mo,-93.97285,39.73594,2023,19,33,14,73.7
64645,mo,-93.32734,40.29744,282,17,30,13,76.5
64646,mo,-93.31379,40.09794,378,18,32,14,77.8
64647,mo,-93.97587,40.02602,678,19,33,14,73.7
64648,mo,-93.80214,39.99022,1611,19,33,14,73.7
64649,mo,-94.08764,39.77489,645,18,32,14,77.8
64650,mo,-94.05979,39.63487,713,19,34,15,78.9
64651,mo,-93.1858,39.76934,598,22,38,16,72.7
64652,mo,-93.42403,40.02449,585,21,36,15,71.4
64653,mo,-93.21048,39.90029,942,21,37,16,76.2
64654,mo,-93.77261,39.83443,93,23,39,16,69.6
64655,mo,-93.24652,40.45071,757,15,27,12,80
64656,mo,-93.6927,39.67738,322,23,40,17,73.9
64657,mo,-94.21993,40.12603,693,18,32,14,77.8
64658,mo,-92.92359,39.66686,2181,22,39,17,77.3
64659,mo,-93.29797,39.78452,831,22,38,16,72.7
64660,mo,-93.0938,39.57091,485,22,38,16,72.7
64661,mo,-93.51269,40.53058,1812,14,27,13,92.9
64664,mo,-93.66499,39.74432,561,22,39,17,77.3
64667,mo,-93.33477,40.38503,528,16,28,12,75
64668,mo,-93.70211,39.35106,1728,25,43,18,72
64670,mo,-94.14155,40.04812,1786,19,33,14,73.7
64671,mo,-94.05855,39.53652,2781,19,34,15,78.9
64672,mo,-93.24153,40.54033,717,14,25,11,78.6
64673,mo,-93.58669,40.37747,2738,15,28,13,86.7
64674,mo,-93.13956,39.96707,640,20,35,15,75
64676,mo,-93.05422,39.645,219,22,38,16,72.7
64679,mo,-93.58483,40.23549,1004,16,29,13,81.3
64681,mo,-93.22161,39.6478,276,22,39,17,77.3
64682,mo,-93.49358,39.55054,423,23,40,17,73.9
64683,mo,-93.60166,40.07741,6634,20,34,14,70
64686,mo,-93.6244,39.75022,201,24,41,17,70.8
64688,mo,-93.38265,39.81566,607,23,39,16,69.6
64689,mo,-94.14812,39.87371,602,17,31,14,82.4
64701,mo,-94.33351,38.61853,6873,29,48,19,65.5
64720,mo,-94.3431,38.40489,2386,31,49,18,58.1
64722,mo,-94.55032,38.27813,483,32,51,19,59.4
64723,mo,-94.55858,38.36338,574,31,50,19,61.3
64724,mo,-94.0112,38.15136,869,31,51,20,64.5
64725,mo,-94.36977,38.49731,1530,31,50,19,61.3
64726,mo,-93.92215,38.53187,481,29,48,19,65.5
64728,mo,-94.52366,37.70265,697,34,53,19,55.9
64730,mo,-94.29648,38.25757,4949,33,52,19,57.6
64733,mo,-93.82864,38.58477,947,27,45,18,66.7
64734,mo,-94.57271,38.65224,1334,28,47,19,67.9
64735,mo,-93.74306,38.36745,8619,30,49,19,63.3
64738,mo,-93.65927,37.9014,975,30,49,19,63.3
64739,mo,-94.09463,38.51136,848,30,48,18,60
64740,mo,-93.71439,38.22555,1772,30,49,19,63.3
64741,mo,-94.56085,37.8197,376,35,54,19,54.3
64742,mo,-94.5447,38.49885,1489,28,47,19,67.9
64743,mo,-94.23229,38.66845,164,30,48,18,60
64744,mo,-93.97885,37.85012,5439,32,51,19,59.4
64745,mo,-94.49654,38.16678,120,32,51,19,59.4
64746,mo,-94.49337,38.60936,1150,30,49,19,63.3
64747,mo,-94.17686,38.57313,2685,29,47,18,62.1
64748,mo,-94.09563,37.35693,1182,29,49,20,69
64750,mo,-94.115,37.93546,399,33,52,19,57.6
64752,mo,-94.56764,38.06543,876,33,52,19,57.6
64755,mo,-94.30937,37.33716,2026,32,52,20,62.5
64756,mo,-94.01486,37.61824,773,31,51,20,64.5
64759,mo,-94.26302,37.52495,4919,30,50,20,66.7
64761,mo,-93.68864,38.59201,1152,24,43,19,79.2
64762,mo,-94.50039,37.54781,1342,32,52,20,62.5
64763,mo,-93.70168,38.14469,765,30,50,20,66.7
64765,mo,-94.44376,37.99622,63,33,53,20,60.6
64767,mo,-94.2006,37.75002,758,32,52,20,62.5
64769,mo,-94.56883,37.48233,490,33,53,20,60.6
64770,mo,-93.98537,38.27223,1254,31,50,19,61.3
64771,mo,-94.45924,37.76057,590,33,53,20,60.6
64772,mo,-94.33174,37.82942,7243,33,53,20,60.6
64776,mo,-93.66571,38.04347,2718,30,50,20,66.7
64778,mo,-94.48262,37.92406,942,34,54,20,58.8
64779,mo,-94.40443,38.09377,2626,33,52,19,57.6
64780,mo,-94.04576,38.06167,1031,32,52,20,62.5
64781,mo,-93.81429,37.9808,18,31,51,20,64.5
64783,mo,-94.11224,38.00467,843,33,52,19,57.6
64784,mo,-94.23412,37.66687,1236,32,52,20,62.5
64788,mo,-94.02701,38.4297,1385,30,49,19,63.3
64790,mo,-94.22667,37.93013,802,33,53,20,60.6
64801,mo,-94.49632,37.11013,16764,30,50,20,66.7
64804,mo,-94.50994,37.0209,17540,30,50,20,66.7
64830,mo,-94.41037,37.23139,371,34,54,20,58.8
64831,mo,-94.45653,36.65662,3334,26,46,20,76.9
64832,mo,-94.57195,37.33986,908,34,54,20,58.8
64833,mo,-94.12984,37.19381,97,28,48,20,71.4
64834,mo,-94.56867,37.18771,4748,33,53,20,60.6
64835,mo,-94.43749,37.14844,1143,31,51,20,64.5
64836,mo,-94.28787,37.18742,11638,32,52,20,62.5
64840,mo,-94.33318,37.01816,1537,27,48,21,77.8
64841,mo,-94.41675,37.07835,197,30,50,20,66.7
64842,mo,-94.10445,36.79104,492,21,40,19,90.5
64843,mo,-94.44392,36.73389,1861,22,42,20,90.9
64844,mo,-94.23901,36.91532,2564,25,45,20,80
64847,mo,-94.441,36.59398,465,29,49,20,69
64848,mo,-93.99145,37.17521,590,25,45,20,80
64849,mo,-94.44488,37.2549,125,34,54,20,58.8
64850,mo,-94.39835,36.86086,12025,25,46,21,84
64854,mo,-94.45032,36.54354,2507,34,55,21,61.8
64855,mo,-94.48581,37.29598,2150,33,53,20,60.6
64856,mo,-94.26665,36.56462,2676,25,45,20,80
64857,mo,-94.43859,37.24585,270,34,54,20,58.8
64858,mo,-94.52991,36.90015,96,28,48,20,71.4
64859,mo,-94.14707,37.15959,937,29,48,19,65.5
64861,mo,-94.14849,36.69773,854,22,42,20,90.9
64862,mo,-94.11433,37.09737,2026,26,45,19,73.1
64863,mo,-94.58445,36.55556,873,37,58,21,56.8
64865,mo,-94.57815,36.84078,3135,30,51,20,67.2
64866,mo,-94.14221,36.86888,988,23,43,20,87
64867,mo,-94.23453,36.72964,1022,23,43,20,87
64870,mo,-94.48112,37.18523,7183,31,51,20,64.5
64873,mo,-94.05144,37.01766,758,22,42,20,90.9
64874,mo,-94.05491,36.75835,396,18,38,20,111.1
65001,mo,-92.01095,38.29076,358,22,39,17,77.3
65010,mo,-92.24033,38.79163,3453,23,41,18,78.3
65011,mo,-92.71197,38.39176,2829,27,46,19,70.4
65013,mo,-91.74976,38.27534,1801,21,39,18,85.7
65014,mo,-91.62564,38.31337,2128,22,40,18,81.8
65016,mo,-91.92076,38.56229,991,24,42,18,75
65017,mo,-92.4978,38.09078,1081,26,44,18,69.2
65018,mo,-92.56323,38.62055,4620,26,45,19,73.1
65020,mo,-92.77975,38.00439,13282,28,47,19,67.9
65023,mo,-92.39911,38.65247,1326,25,44,19,76
65024,mo,-91.75569,38.62274,1411,24,43,19,79.2
65025,mo,-92.68751,38.67034,704,25,44,19,76
65026,mo,-92.57116,38.32088,8569,26,45,19,73.1
65032,mo,-92.38235,38.34238,1383,25,44,19,76
65034,mo,-92.81971,38.55832,534,24,42,18,75
65035,mo,-91.93257,38.36225,1463,22,40,18,81.8
65037,mo,-92.85698,38.23783,9326,28,47,19,67.9
65039,mo,-92.28723,38.71069,1729,24,43,19,79.2
65040,mo,-92.31101,38.35991,937,25,44,19,76
65041,mo,-91.4766,38.64273,5765,24,43,19,79.2
65043,mo,-92.10536,38.62481,4283,24,43,19,79.2
65046,mo,-92.48088,38.77831,1179,25,43,18,72
65047,mo,-92.57226,38.16154,986,26,44,18,69.2
65048,mo,-92.04676,38.36147,156,22,40,18,81.8
65049,mo,-92.66836,38.20031,10746,27,46,19,70.4
65050,mo,-92.6855,38.54267,351,25,44,19,76
65051,mo,-91.79339,38.46845,2910,22,41,19,86.4
65052,mo,-92.65328,38.04944,2925,27,46,19,70.4
65053,mo,-92.37146,38.54134,992,25,44,19,76
65054,mo,-91.93835,38.48626,489,23,42,19,82.6
65058,mo,-92.1382,38.25325,1151,23,41,18,78.3
65059,mo,-91.87034,38.69865,653,25,43,18,72
65061,mo,-91.63668,38.60042,1043,24,42,18,75
65062,mo,-91.65148,38.49555,58,23,41,18,78.3
65063,mo,-92.0867,38.72442,1971,23,42,19,82.6
65064,mo,-92.47681,38.40778,432,26,45,19,73.1
65065,mo,-92.66884,38.13304,6597,27,45,18,66.7
65066,mo,-91.48833,38.34963,5634,21,39,18,85.7
65067,mo,-91.71316,38.76449,897,25,44,19,76
65068,mo,-92.61098,38.82169,700,24,43,19,79.2
65069,mo,-91.59185,38.75375,1060,25,44,19,76
65072,mo,-92.72312,38.2678,5390,27,46,19,70.4
65074,mo,-92.47512,38.47935,2017,25,44,19,76
65075,mo,-92.26607,38.25,805,24,43,19,79.2
65076,mo,-92.19442,38.37129,550,24,43,19,79.2
65077,mo,-91.80316,38.76607,2218,23,42,19,82.6
65078,mo,-93.00787,38.39063,7301,27,45,18,66.7
65079,mo,-92.74825,38.15233,10144,28,46,18,64.3
65080,mo,-91.97901,38.63073,805,26,45,19,73.1
65081,mo,-92.78274,38.64414,1929,24,43,19,79.2
65082,mo,-92.4265,38.22462,1050,25,44,19,76
65083,mo,-92.4397,38.14193,271,25,44,19,76
65084,mo,-92.85339,38.43574,5032,24,43,19,79.2
65085,mo,-92.07868,38.40176,837,23,42,19,82.6
65101,mo,-92.15,38.49167,13270,25,44,19,76
65109,mo,-92.27873,38.57329,16790,25,44,19,76
65201,mo,-92.24357,38.89821,11922,24,42,18,75
65202,mo,-92.29818,39.02052,19892,25,43,18,72
65203,mo,-92.397,38.8852,22896,26,44,18,69.2
65215,mo,-92.32085,38.95317,1,26,44,18,69.2
65230,mo,-92.69501,39.28715,859,22,39,17,77.3
65231,mo,-91.89788,39.01625,2065,22,41,19,86.4
65232,mo,-91.75384,39.16326,273,23,41,18,78.3
65233,mo,-92.72911,38.91429,6130,25,42,17,68
65236,mo,-93.07933,39.44201,731,21,38,17,81
65237,mo,-92.78739,38.77959,1052,24,42,18,75
65239,mo,-92.43034,39.53371,1010,22,39,17,77.3
65240,mo,-92.12571,39.22241,4569,22,40,18,81.8
65243,mo,-92.35508,39.27542,1603,22,39,17,77.3
65244,mo,-92.66175,39.48172,585,22,40,18,81.8
65246,mo,-92.99576,39.37867,301,23,40,17,73.9
65247,mo,-92.47221,39.63628,654,22,40,18,81.8
65248,mo,-92.656,39.14087,3204,23,40,17,73.9
65250,mo,-92.83649,39.03392,811,24,42,18,75
65251,mo,-91.97838,38.84709,9503,21,39,18,85.7
65254,mo,-92.85142,39.2144,1814,22,39,17,77.3
65255,mo,-92.22953,39.09609,2166,22,40,18,81.8
65256,mo,-92.45941,39.13064,1269,23,41,18,78.3
65257,mo,-92.53203,39.28663,1490,22,40,18,81.8
65258,mo,-92.13338,39.52298,602,22,40,18,81.8
65259,mo,-92.56931,39.47601,1957,23,40,17,73.9
65260,mo,-92.39624,39.58659,555,22,39,17,77.3
65261,mo,-92.92957,39.47344,456,23,40,17,73.9
65262,mo,-91.94412,38.95338,760,22,40,18,81.8
65263,mo,-92.22349,39.45685,1718,22,40,18,81.8
65264,mo,-91.69257,39.08764,709,24,42,18,75
65265,mo,-91.88458,39.20134,8404,23,41,18,78.3
65270,mo,-92.40278,39.41515,8544,22,39,17,77.3
65274,mo,-92.68016,39.01677,1188,24,42,18,75
65275,mo,-91.99251,39.46275,2577,23,41,18,78.3
65276,mo,-92.95356,38.8476,1382,23,41,18,78.3
65278,mo,-92.4107,39.3416,64,21,39,18,85.7
65279,mo,-92.51869,39.00959,1483,24,42,18,75
65280,mo,-91.73767,39.23905,231,22,41,19,86.4
65281,mo,-92.79509,39.46788,1772,23,40,17,73.9
65282,mo,-91.83066,39.38659,276,23,42,19,82.6
65283,mo,-91.835,39.5084,913,24,43,19,79.2
65284,mo,-92.29691,39.20063,1669,22,39,17,77.3
65285,mo,-92.01744,39.1997,577,22,40,18,81.8
65286,mo,-93.21899,39.50928,321,22,38,16,72.7
65287,mo,-92.5265,38.88945,465,25,43,18,72
65301,mo,-93.22615,38.69848,17765,23,41,18,78.3
65305,mo,-93.55448,38.72943,15,25,43,18,72
65320,mo,-92.94725,39.07,115,24,41,17,70.8
65321,mo,-93.45977,39.0869,458,26,44,18,69.2
65322,mo,-92.9501,38.97864,713,24,41,17,70.8
65323,mo,-93.6159,38.44723,870,27,46,19,70.4
65324,mo,-93.00097,38.11561,3425,28,47,19,67.9
65325,mo,-93.18043,38.43543,2825,25,43,18,72
65326,mo,-93.1437,38.16729,10848,28,47,19,67.9
65327,mo,-93.49531,38.97397,136,27,45,18,66.7
65329,mo,-92.95994,38.61586,402,24,42,18,75
65330,mo,-92.94792,39.21845,591,23,40,17,73.9
65332,mo,-93.41381,38.62176,1307,23,41,18,78.3
65333,mo,-93.30471,38.90712,768,25,43,18,72
65334,mo,-93.22749,38.84689,891,24,42,18,75
65335,mo,-93.34262,38.5053,217,24,43,19,79.2
65336,mo,-93.5673,38.78333,3305,26,43,17,65.4
65337,mo,-93.43051,38.79111,1302,24,42,18,75
65338,mo,-93.28142,38.36076,5381,28,47,19,67.9
65339,mo,-93.38148,39.19667,968,25,44,19,76
65340,mo,-93.17882,39.09559,8171,25,43,18,72
65344,mo,-93.19736,39.31188,744,23,41,18,78.3
65345,mo,-93.13031,38.54038,306,24,42,18,75
65347,mo,-93.04195,38.98761,914,24,41,17,70.8
65348,mo,-92.98035,38.71293,1122,25,42,17,68
65349,mo,-93.04872,39.23202,2087,24,41,17,70.8
65350,mo,-93.0953,38.64765,1282,24,42,18,75
65351,mo,-93.38843,38.98684,2092,27,45,18,66.7
65354,mo,-92.88506,38.64544,478,24,42,18,75
65355,mo,-93.36823,38.22009,15710,29,48,19,65.5
65360,mo,-93.51418,38.51957,3160,24,42,18,75
65401,mo,-91.76536,37.90466,13343,24,42,18,75
65436,mo,-91.97147,37.62356,121,22,40,18,81.8
65438,mo,-91.50255,36.92523,2752,27,45,18,66.7
65439,mo,-91.10158,37.65013,305,21,39,18,85.7
65440,mo,-91.17844,37.61181,567,22,40,18,81.8
65441,mo,-91.15617,38.08959,3828,23,42,19,82.6
65443,mo,-92.09893,38.12959,87,22,40,18,81.8
65444,mo,-92.05625,37.38089,895,23,41,18,78.3
65446,mo,-91.26924,37.78476,371,24,43,19,79.2
65449,mo,-91.48683,37.84803,507,25,43,18,72
65452,mo,-92.26774,37.96293,2004,25,43,18,72
65453,mo,-91.42885,38.09613,5934,22,40,18,81.8
65456,mo,-91.19811,37.78127,579,23,41,18,78.3
65457,mo,-92.05428,37.81157,230,25,44,19,76
65459,mo,-92.0826,38.02999,5451,24,42,18,75
65461,mo,-92.03666,37.67441,125,23,42,19,82.6
65462,mo,-91.85895,37.68637,1142,23,41,18,78.3
65463,mo,-92.77841,37.84622,908,27,46,19,70.4
65464,mo,-91.89198,37.18397,566,23,41,18,78.3
65466,mo,-91.37205,37.2059,1991,27,46,19,70.4
65468,mo,-91.79023,37.24993,103,22,40,18,81.8
65470,mo,-92.40018,37.54426,1000,24,42,18,75
65473,mo,-92.15445,37.70694,111,24,43,19,79.2
65479,mo,-91.62936,37.33026,517,24,42,18,75
65483,mo,-91.95088,37.30186,3053,23,41,18,78.3
65484,mo,-92.21528,37.35383,196,22,40,18,81.8
65486,mo,-92.31284,38.1008,2638,24,43,19,79.2
65501,mo,-91.56487,37.45368,162,25,43,18,72
65529,mo,-91.98614,37.92384,206,24,42,18,75
65534,mo,-92.28078,37.69533,609,25,43,18,72
65535,mo,-91.27775,38.07108,1225,23,41,18,78.3
65536,mo,-92.64575,37.68625,16122,26,45,19,73.1
65541,mo,-91.76622,37.64613,243,24,42,18,75
65542,mo,-91.88145,37.5041,3624,22,40,18,81.8
65543,mo,-92.30508,37.47127,438,23,41,18,78.3
65548,mo,-91.71494,37.01444,3451,24,42,18,75
65550,mo,-91.94936,37.83231,2417,24,42,18,75
65552,mo,-92.16581,37.5333,1553,23,41,18,78.3
65555,mo,-91.76671,37.3621,928,23,41,18,78.3
65556,mo,-92.40885,37.8365,4019,26,44,18,69.2
65557,mo,-92.10371,37.50619,114,23,41,18,78.3
65559,mo,-91.61263,38.02629,4897,23,41,18,78.3
65560,mo,-91.49927,37.59665,10070,26,44,18,69.2
65564,mo,-91.96831,37.23565,145,22,40,18,81.8
65565,mo,-91.24865,37.90616,4440,23,41,18,78.3
65566,mo,-91.12821,37.72224,637,22,40,18,81.8
65567,mo,-92.53838,37.87255,839,26,45,19,73.1
65570,mo,-92.10184,37.4554,370,23,41,18,78.3
65571,mo,-91.63364,37.18626,1848,24,42,18,75
65580,mo,-91.79612,38.1148,727,20,38,18,90
65582,mo,-91.92335,38.1921,1541,21,39,18,85.7
65583,mo,-92.25362,37.82154,5645,26,44,18,69.2
65584,mo,-92.13102,37.82834,4141,25,44,19,76
65586,mo,-91.43166,37.84959,53,24,43,19,79.2
65588,mo,-91.28434,36.9821,2336,27,46,19,70.4
65589,mo,-91.83824,37.24548,156,23,40,17,73.9
65590,mo,-92.94628,37.61612,1215,24,43,19,79.2
65591,mo,-92.59406,37.98116,810,26,45,19,73.1
65601,mo,-93.59082,37.5349,739,29,48,19,65.5
65603,mo,-93.8619,37.55123,181,32,51,19,59.4
65604,mo,-93.60133,37.27406,2295,25,44,19,76
65605,mo,-93.69189,36.88352,6252,19,38,19,100
65606,mo,-91.36228,36.69939,3162,30,49,19,63.3
65608,mo,-92.68159,36.89506,7261,25,44,19,76
65609,mo,-92.15779,36.52738,528,30,48,18,60
65610,mo,-93.52991,37.03629,3106,20,39,19,95
65611,mo,-93.36455,36.54182,2549,23,43,20,87
65612,mo,-93.5475,37.2179,890,23,42,19,82.6
65613,mo,-93.39414,37.63524,8461,27,46,19,70.4
65614,mo,-92.91611,36.73951,681,26,45,19,73.1
65616,mo,-93.24809,36.66901,20491,25,45,20,80
65617,mo,-93.34407,37.4357,899,24,43,19,79.2
65618,mo,-92.37584,36.74242,217,25,44,19,76
65619,mo,-93.38942,37.12118,3149,21,40,19,90.5
65620,mo,-92.95297,37.01502,195,18,36,18,100
65622,mo,-93.10313,37.63218,5770,24,43,19,79.2
65623,mo,-93.90642,36.74881,19,16,34,18,112.5
65624,mo,-93.56745,36.73106,2419,21,40,19,90.5
65625,mo,-93.81468,36.67458,4703,18,37,19,105.6
65626,mo,-92.12591,36.59883,1210,26,44,18,69.2
65627,mo,-93.00047,36.56662,1478,29,48,19,65.5
65629,mo,-93.00876,36.89419,611,22,40,18,81.8
65630,mo,-93.21669,36.83203,580,24,43,19,79.2
65631,mo,-93.4231,37.00775,2692,21,39,18,85.7
65632,mo,-92.81326,37.50031,1969,23,42,19,82.6
65633,mo,-93.53973,36.89742,2756,21,40,19,90.5
65634,mo,-93.19239,38.02342,916,28,46,18,64.3
65635,mo,-93.72094,37.5375,462,30,50,20,66.7
65637,mo,-92.20359,36.76395,986,26,44,18,69.2
65638,mo,-92.32558,36.84128,585,26,44,18,69.2
65640,mo,-93.57475,37.69917,631,28,47,19,67.9
65641,ar,-93.76437,36.54347,1849,24,44,20,79.6
65644,mo,-93.03609,37.50794,1834,23,42,19,82.6
65646,mo,-93.70203,37.33682,1378,26,46,20,76.9
65647,mo,-94.00699,36.69019,1315,16,35,19,118.8
65648,mo,-93.15633,37.40114,3289,23,42,19,82.6
65649,mo,-93.6184,37.61828,1323,29,49,20,69
65650,mo,-93.44771,37.8193,1727,28,47,19,67.9
65652,mo,-92.94617,37.14469,2203,20,39,19,95
65653,mo,-93.11436,36.77913,4293,27,46,19,70.4
65654,mo,-93.90579,37.0229,108,19,38,19,100
65655,mo,-92.4265,36.59794,2705,28,46,18,64.3
65656,mo,-93.46672,36.79505,5175,21,40,19,90.5
65657,mo,-93.01461,36.83315,101,24,43,19,79.2
65658,mo,-93.6412,36.54119,2259,23,43,20,87
65660,mo,-92.27243,37.33127,204,22,40,18,81.8
65661,mo,-93.82631,37.46178,985,31,51,20,64.5
65662,mo,-92.57739,37.44022,962,22,40,18,81.8
65663,mo,-93.24481,37.62122,1732,25,44,19,76
65664,mo,-93.61733,37.19729,92,22,42,20,90.9
65667,mo,-92.51504,37.30801,2629,22,41,19,86.4
65668,mo,-93.28781,37.93281,1639,28,47,19,67.9
65669,mo,-93.30268,36.91224,1378,21,39,18,85.7
65672,mo,-93.21579,36.56632,7226,24,43,19,79.2
65674,mo,-93.60689,37.78601,2047,29,48,19,65.5
65676,mo,-92.6099,36.57621,687,30,49,19,63.3
65679,mo,-93.10428,36.57465,1744,27,46,19,70.4
65680,mo,-93.01481,36.65751,1115,27,46,19,70.4
65681,mo,-93.46376,36.55439,3725,22,42,20,90.9
65682,mo,-93.96987,37.41614,1122,29,49,20,69
65685,mo,-93.15663,37.7542,725,24,43,19,79.2
65686,mo,-93.43873,36.62534,4961,23,42,19,82.6
65689,mo,-92.09631,37.14073,3176,22,40,18,81.8
65690,mo,-91.27242,36.58526,465,35,55,20,57.1
65692,mo,-91.63979,36.62759,1177,28,47,19,67.9
65702,mo,-92.48971,37.06737,412,24,42,18,75
65704,mo,-92.58457,37.12328,2607,24,43,19,79.2
65705,mo,-93.60893,37.02123,1987,19,38,19,100
65706,mo,-92.89563,37.3236,8004,22,41,19,86.4
65707,mo,-93.84501,37.22821,1639,22,41,19,86.4
65708,mo,-93.91017,36.90478,5671,20,39,19,95
65710,mo,-93.42287,37.4869,825,26,46,20,76.9
65711,mo,-92.27675,37.17727,6119,22,39,17,77.3
65712,mo,-93.80434,37.10791,4438,21,40,19,90.5
65713,mo,-92.7462,37.40339,1797,22,41,19,86.4
65714,mo,-93.31842,37.03861,13205,21,39,18,85.7
65715,mo,-92.57291,36.73286,124,26,45,19,73.1
65717,mo,-92.41495,37.05955,1809,23,41,18,78.3
65720,mo,-92.95278,36.94039,484,21,39,18,85.7
65721,mo,-93.21017,36.98012,12813,19,37,18,94.7
65722,mo,-92.80847,37.58162,1189,24,43,19,79.2
65723,mo,-94.04273,36.96002,2125,22,42,20,90.9
65724,mo,-93.31296,37.84326,2015,28,47,19,67.9
65725,mo,-93.27661,37.43299,1387,23,43,20,87
65727,mo,-93.29767,37.75587,189,27,46,19,70.4
65728,mo,-93.34556,36.87138,52,20,39,19,95
65729,ar,-92.58941,36.51718,449,30,49,19,63.4
65730,mo,-94.17729,36.62369,227,24,44,20,83.3
65731,mo,-93.1222,36.65456,337,27,46,19,70.4
65732,mo,-93.16163,37.94134,705,27,46,19,70.4
65733,ar,-92.84645,36.52858,1571,31,50,19,61.3
65734,mo,-93.9476,36.79586,1636,18,37,19,105.6
65735,mo,-93.47184,38.04199,181,28,47,19,67.9
65737,mo,-93.36017,36.71277,8582,23,42,19,82.6
65738,mo,-93.49911,37.13523,7869,21,40,19,90.5
65739,mo,-93.26876,36.51931,3054,22,41,19,86.4
65740,mo,-93.16393,36.71321,4999,27,46,19,70.4
65742,mo,-93.07883,37.12554,6287,19,37,18,94.7
65744,mo,-92.89755,36.62279,174,24,43,19,79.2
65745,ar,-93.96784,36.5308,1621,20,40,20,97.75
65746,mo,-92.77845,37.14712,4409,22,40,18,81.8
65747,ar,-93.57978,36.60231,9149,22,42,20,86.75
65752,mo,-93.8323,37.32578,387,29,49,20,69
65753,mo,-93.05473,36.99879,2742,17,35,18,105.9
65754,mo,-93.28965,36.84887,566,21,40,19,90.5
65755,mo,-92.62699,36.80505,477,25,44,19,76
65756,mo,-93.97093,37.10289,570,23,42,19,82.6
65757,mo,-93.09748,37.28283,3923,21,40,19,90.5
65759,mo,-93.03171,36.75518,1073,26,45,19,73.1
65760,mo,-92.28099,36.62973,673,29,48,19,65.5
65761,ar,-92.72843,36.57545,3914,31,50,19,61.35
65762,mo,-92.65338,36.68754,595,28,47,19,67.9
65764,mo,-92.95438,37.82304,1512,27,45,18,66.7
65766,mo,-92.25957,36.54036,170,31,50,19,61.3
65767,mo,-93.15451,37.84383,1989,26,45,19,73.1
65768,mo,-92.26441,36.91952,536,25,43,18,72
65769,mo,-93.79533,36.91747,1768,19,38,19,100
65770,mo,-93.54707,37.42339,2140,26,45,19,73.1
65771,mo,-93.20641,36.77246,1306,25,44,19,76
65772,mo,-94.03765,36.59502,1394,18,38,20,111.1
65773,mo,-92.50932,36.75727,655,25,44,19,76
65774,mo,-93.49221,37.92914,834,28,47,19,67.9
65775,mo,-91.85867,36.70134,12723,25,43,18,72
65777,mo,-91.99018,36.52288,223,27,45,18,66.7
65778,mo,-91.27613,36.52912,647,36,55,19,52.8
65779,mo,-93.38123,37.97555,2606,28,47,19,67.9
65781,mo,-93.41582,37.34944,4049,23,43,20,87
65783,mo,-92.93341,37.71728,262,26,45,19,73.1
65784,mo,-92.31391,36.67989,27,28,47,19,67.9
65785,mo,-93.8212,37.70612,5045,31,51,20,64.5
65786,mo,-92.96646,37.96584,1817,27,46,19,70.4
65787,mo,-92.88953,38.06898,2792,28,47,19,67.9
65788,mo,-91.69381,36.80909,249,27,45,18,66.7
65789,mo,-91.88105,36.86372,1214,24,42,18,75
65790,mo,-92.11411,36.70633,568,26,44,18,69.2
65791,mo,-91.503,36.56173,3530,31,50,19,61.3
65793,mo,-91.97214,36.99247,3981,24,41,17,70.8
65802,mo,-93.35407,37.20909,19651,21,40,19,90.5
65803,mo,-93.28909,37.28395,17740,21,40,19,90.5
65804,mo,-93.25265,37.14926,15833,21,40,19,90.5
65806,mo,-93.29911,37.20559,3182,21,40,19,90.5
65807,mo,-93.32555,37.16563,18663,21,40,19,90.5
65809,mo,-93.19327,37.1687,5242,21,40,19,90.5
65810,mo,-93.31716,37.11733,8298,21,40,19,90.5
66002,ks,-95.13884,39.54015,6987,27,44,17,63
66006,ks,-95.2383,38.79591,3968,28,46,18,64.3
66007,ks,-94.94118,39.15517,3325,26,44,18,69.2
66008,ks,-95.17243,39.71221,328,24,41,17,70.8
66010,ks,-94.98615,38.09532,742,30,49,19,63.3
66012,ks,-94.92267,39.06719,4942,27,45,18,66.7
66013,ks,-94.6887,38.72825,1558,25,43,18,72
66014,ks,-94.98357,38.2222,544,30,49,19,63.3
66015,ks,-95.4098,38.07405,967,28,47,19,67.9
66016,ks,-95.23192,39.47345,385,26,43,17,65.4
66017,ks,-95.27546,39.70788,394,25,42,17,68
66018,ks,-94.96778,38.96627,3904,29,47,18,62.1
66019,ks,-95.00273,38.94594,2,30,48,18,60
66020,ks,-95.11442,39.33759,1047,27,44,17,63
66021,ks,-95.01247,38.76546,2113,27,44,17,63
66023,ks,-95.39902,39.5138,934,26,43,17,65.4
66024,ks,-94.88262,39.74749,676,24,40,16,66.7
66025,ks,-95.08853,38.89757,3928,30,49,19,63.3
66026,ks,-94.86788,38.39634,566,31,50,19,61.3
66027,ks,-94.91575,39.36576,14,30,48,18,60
66030,ks,-94.94124,38.81498,10240,27,45,18,66.7
66031,ks,-94.89198,38.83397,147,27,45,18,66.7
66032,ks,-95.2732,38.28234,3725,31,50,19,61.3
66033,ks,-95.12202,38.36331,787,30,49,19,63.3
66035,ks,-95.25342,39.87742,1086,23,39,16,69.6
66039,ks,-95.16817,38.10419,924,29,48,19,65.5
66040,ks,-94.7436,38.3527,8724,30,49,19,63.3
66041,ks,-95.3036,39.59523,632,26,42,16,61.5
66042,ks,-95.08285,38.43468,539,28,47,19,67.9
66043,ks,-94.87833,39.25165,3111,27,45,18,66.7
66044,ks,-95.20855,39.02893,8887,33,51,18,54.5
66045,ks,-95.24987,38.95897,13,32,50,18,56.3
66046,ks,-95.21354,38.90778,6276,32,50,18,56.3
66047,ks,-95.34789,38.88002,6279,30,48,18,60
66048,ks,-94.99413,39.28288,14721,29,46,17,58.6
66049,ks,-95.34465,38.98238,10575,31,49,18,58.1
66050,ks,-95.43916,39.01537,1221,27,44,17,63
66052,ks,-95.04585,39.01101,1262,31,49,18,58.1
66053,ks,-94.66928,38.57892,3904,25,44,19,76
66054,ks,-95.1961,39.20366,1741,27,45,18,66.7
66056,ks,-94.84333,38.14989,5319,29,48,19,65.5
66058,ks,-95.51755,39.53885,431,27,44,17,63
66060,ks,-95.33214,39.41838,841,26,43,17,65.4
66061,ks,-94.87958,38.89666,27350,26,44,18,69.2
66062,ks,-94.77798,38.83454,31988,25,43,18,72
66064,ks,-94.98888,38.47803,3163,29,48,19,65.5
66066,ks,-95.33172,39.20266,1735,27,44,17,63
66067,ks,-95.27568,38.62061,7811,31,49,18,58.1
66070,ks,-95.45071,39.2054,4448,27,44,17,63
66071,ks,-94.86454,38.57328,7058,29,47,18,62.1
66072,ks,-94.97302,38.3134,921,29,48,19,65.5
66073,ks,-95.3763,39.09016,1523,29,46,17,58.6
66075,ks,-94.69189,38.20084,1932,31,50,19,61.3
66076,ks,-95.44047,38.63271,1443,28,47,19,67.9
66078,ks,-95.26226,38.48313,721,29,47,18,62.1
66079,ks,-95.11275,38.54511,649,29,47,18,62.1
66080,ks,-95.25952,38.40447,798,30,49,19,63.3
66083,ks,-94.8349,38.73374,6075,26,44,18,69.2
66085,ks,-94.64953,38.79948,5866,25,43,18,72
66086,ks,-95.07995,39.11708,4962,29,47,18,62.1
66087,ks,-95.12421,39.79814,1914,23,40,17,73.9
66088,ks,-95.46049,39.33966,1766,27,44,17,63
66090,ks,-94.97317,39.78555,2038,25,41,16,64
66091,ks,-95.32377,38.17403,478,28,47,19,67.9
66092,ks,-95.10244,38.69741,2292,27,45,18,66.7
66093,ks,-95.49837,38.21069,868,27,45,18,66.7
66094,ks,-95.34279,39.95769,886,23,39,16,69.6
66095,ks,-95.4311,38.44676,728,27,45,18,66.7
66097,ks,-95.24441,39.32882,783,26,43,17,65.4
66101,ks,-94.62598,39.11899,6731,26,44,18,69.2
66102,ks,-94.68952,39.11299,10948,25,43,18,72
66103,ks,-94.62633,39.06123,5031,25,42,17,68
66104,ks,-94.68861,39.15054,13238,25,43,18,72
66105,ks,-94.63844,39.08691,1803,25,43,18,72
66106,ks,-94.70298,39.06662,8943,25,43,18,72
66109,ks,-94.82806,39.16352,10652,25,43,18,72
66111,ks,-94.79519,39.08384,3548,26,44,18,69.2
66112,ks,-94.77359,39.11452,3980,26,44,18,69.2
66115,ks,-94.61079,39.14405,187,26,44,18,69.2
66118,ks,-94.61363,39.10409,102,25,43,18,72
66202,ks,-94.66914,39.02393,6800,25,42,17,68
66203,ks,-94.70549,39.02153,8563,25,42,17,68
66204,ks,-94.67711,38.99285,7467,25,42,17,68
66205,ks,-94.63076,39.03122,6792,24,42,18,75
66206,ks,-94.61934,38.958,4303,25,43,18,72
66207,ks,-94.6444,38.95588,5676,25,43,18,72
66208,ks,-94.62951,38.99933,9905,25,42,17,68
66209,ks,-94.63873,38.8991,7298,25,43,18,72
66210,ks,-94.70495,38.9237,6286,25,43,18,72
66211,ks,-94.63685,38.92355,2189,25,43,18,72
66212,ks,-94.68147,38.95635,11350,25,43,18,72
66213,ks,-94.70539,38.89919,8743,25,43,18,72
66214,ks,-94.71417,38.96381,3947,25,43,18,72
66215,ks,-94.74296,38.95697,9756,25,42,17,68
66216,ks,-94.74115,39.01385,10139,25,42,17,68
66217,ks,-94.78204,39.0091,2331,25,43,18,72
66218,ks,-94.81779,39.01652,3814,27,45,18,66.7
66219,ks,-94.77629,38.95222,3614,25,43,18,72
66220,ks,-94.82147,38.96107,3871,26,45,19,73.1
66221,ks,-94.71026,38.86363,5987,25,43,18,72
66223,ks,-94.6682,38.86282,7419,25,43,18,72
66224,ks,-94.62814,38.86293,5531,25,43,18,72
66226,ks,-94.86005,39.03057,5649,27,45,18,66.7
66227,ks,-94.87469,38.97274,4611,27,44,17,63
66401,ks,-96.31053,38.97017,2054,25,42,17,68
66402,ks,-95.84631,38.91899,1535,27,44,17,63
66403,ks,-96.27738,39.89663,794,22,38,16,72.7
66404,ks,-96.17712,39.87979,539,23,39,16,69.6
66406,ks,-96.41975,39.89355,510,20,35,15,75
66407,ks,-96.19407,39.23002,559,30,47,17,56.7
66408,ks,-95.97161,39.95946,477,22,38,16,72.7
66409,ks,-95.55883,38.92505,1881,27,44,17,63
66411,ks,-96.63622,39.63975,1281,23,39,16,69.6
66412,ks,-96.77908,39.91195,313,21,36,15,71.4
66413,ks,-95.88179,38.77457,1503,28,46,18,64.3
66414,ks,-95.68847,38.82938,1615,27,44,17,63
66415,ks,-96.14563,39.68725,910,23,38,15,65.2
66416,ks,-95.86139,39.52806,396,26,42,16,61.5
66417,ks,-96.04327,39.65368,368,23,39,16,69.6
66418,ks,-95.93751,39.28875,720,27,44,17,63
66419,ks,-95.59923,39.36379,343,27,44,17,63
66422,ks,-96.08528,39.33593,470,27,44,17,63
66423,ks,-96.13658,38.84866,1139,23,40,17,73.9
66424,ks,-95.39732,39.68112,642,26,43,17,65.4
66425,ks,-95.73062,39.8045,561,24,41,17,70.8
66427,ks,-96.44453,39.66516,1701,23,38,15,65.2
66428,ks,-95.93077,39.67273,709,24,40,16,66.7
66429,ks,-95.53759,39.09824,362,28,45,17,60.7
66431,ks,-96.00435,38.80471,643,26,43,17,65.4
66432,ks,-96.06653,39.48322,561,24,39,15,62.5
66434,ks,-95.54647,39.86799,3665,25,42,17,68
66436,ks,-95.69882,39.46684,3576,27,44,17,63
66438,ks,-96.49528,39.85279,162,20,36,16,80
66439,ks,-95.54496,39.65611,1959,29,46,17,58.6
66440,ks,-95.67877,39.26435,1189,26,43,17,65.4
66441,ks,-96.80309,38.9851,12386,27,44,17,63
66442,ks,-96.78981,39.0933,88,28,44,16,57.1
66449,ks,-96.86136,39.38924,731,24,40,16,66.7
66451,ks,-95.67311,38.60957,1376,26,43,17,65.4
66501,ks,-96.23743,39.05407,154,26,43,17,65.4
66502,ks,-96.53127,39.15125,14644,29,46,17,58.6
66503,ks,-96.68623,39.26361,8002,28,45,17,60.7
66506,ks,-96.58158,39.19584,13,30,46,16,53.3
66507,ks,-96.03966,39.04476,937,27,44,17,63
66508,ks,-96.63239,39.85323,3279,21,36,15,71.4
66509,ks,-95.78046,39.33308,1546,27,43,16,59.3
66510,ks,-95.61258,38.49261,698,25,43,18,72
66512,ks,-95.55023,39.19962,2114,27,44,17,63
66514,ks,-96.87843,39.12473,879,25,42,17,68
66515,ks,-95.70342,39.942,416,24,40,16,66.7
66516,ks,-95.72359,39.62406,465,26,43,17,65.4
66517,ks,-96.70692,39.11264,1144,28,45,17,60.7
66518,ks,-96.5529,39.97093,336,20,35,15,75
66520,ks,-96.61704,39.41155,1102,22,38,16,72.7
66521,ks,-96.21951,39.47983,1722,24,40,16,66.7
66522,ks,-95.94036,39.86647,67,22,38,16,72.7
66523,ks,-95.84036,38.61194,2723,27,45,18,66.7
66524,ks,-95.50516,38.79358,2104,27,44,17,63
66526,ks,-96.15573,39.06351,698,28,44,16,57.1
66527,ks,-95.67587,39.74771,385,26,43,17,65.4
66528,ks,-95.53603,38.59796,955,26,44,18,69.2
66531,ks,-96.82995,39.31201,1000,24,40,16,66.7
66532,ks,-95.37432,39.82561,884,25,42,17,68
66533,ks,-95.95176,39.15928,1107,28,45,17,60.7
66534,ks,-95.83665,39.88478,2487,23,39,16,69.6
66535,ks,-96.43751,39.26252,1470,29,46,17,58.6
66536,ks,-96.07927,39.22162,1711,29,46,17,58.6
66537,ks,-95.71913,38.75302,1036,27,45,18,66.7
66538,ks,-96.04433,39.8525,2552,24,40,16,66.7
66539,ks,-95.84825,39.14552,1445,28,44,16,57.1
66540,ks,-95.97672,39.49182,647,25,41,16,64
66541,ks,-96.36585,39.97643,403,20,34,14,74.45
66542,ks,-95.54465,39.01295,1702,26,44,18,69.2
66543,ks,-95.60047,38.64157,621,27,44,17,63
66544,ks,-96.27804,39.69457,630,22,38,16,72.7
66546,ks,-95.72403,38.89534,825,28,45,17,60.7
66547,ks,-96.30431,39.22929,4573,31,48,17,54.8
66548,ks,-96.76117,39.67869,858,23,38,15,65.2
66549,ks,-96.42491,39.43374,1627,23,39,16,69.6
66550,ks,-95.82021,39.65665,570,25,42,17,68
66552,ks,-95.6254,39.59328,461,27,44,17,63
66554,ks,-96.78555,39.49442,1569,25,41,16,64
66603,ks,-95.67584,39.05741,872,28,45,17,60.7
66604,ks,-95.72662,39.03888,9067,27,44,17,63
66605,ks,-95.63352,39.01171,7844,27,44,17,63
66606,ks,-95.72119,39.0616,4573,27,44,17,63
66607,ks,-95.63572,39.04234,4222,28,45,17,60.7
66608,ks,-95.66445,39.08034,2627,29,46,17,58.6
66609,ks,-95.66914,38.98183,2596,27,44,17,63
66610,ks,-95.83755,38.97402,5023,27,44,17,63
66611,ks,-95.69609,39.01539,3725,27,44,17,63
66612,ks,-95.68047,39.04042,1038,28,45,17,60.7
66614,ks,-95.84943,39.01152,11025,27,44,17,63
66615,ks,-95.89644,39.05486,1646,27,44,17,63
66616,ks,-95.62313,39.06843,2855,28,45,17,60.7
66617,ks,-95.62532,39.13907,3815,28,45,17,60.7
66618,ks,-95.74782,39.14266,4775,27,44,17,63
66619,ks,-95.68816,38.94779,1230,27,45,18,66.7
66621,ks,-95.70154,39.03332,1,27,44,17,63
66622,ks,-95.72227,39.0259,1,27,44,17,63
66701,ks,-94.76153,37.82352,7895,37,56,19,51.4
66710,ks,-95.633,37.55596,960,35,54,19,54.3
66711,ks,-94.69546,37.63591,945,35,54,19,54.3
66712,ks,-94.71782,37.56381,1314,35,55,20,57.1
66713,ks,-94.78593,37.03312,3393,38,59,21,55.3
66714,ks,-95.70028,37.63636,340,35,53,18,51.4
66716,ks,-95.03786,37.94084,778,32,51,19,59.4
66717,ks,-95.70322,37.69563,701,32,51,19,59.4
66720,ks,-95.45981,37.64835,6936,33,52,19,57.6
66724,ks,-94.86266,37.35101,889,34,54,20,58.8
66725,ks,-94.89052,37.16033,4240,33,54,21,63.6
66728,ks,-94.70407,37.17128,80,34,55,21,61.8
66732,ks,-95.19276,37.80032,373,32,51,19,59.4
66733,ks,-95.25355,37.59789,2098,34,54,20,58.8
66734,ks,-94.82982,37.61829,369,35,55,20,57.1
66735,ks,-94.70962,37.52195,362,35,55,20,57.1
66736,ks,-95.86047,37.54956,3891,36,55,19,52.8
66738,ks,-94.71833,38.01344,495,34,53,19,55.9
66739,ks,-94.66552,37.12023,3814,33,53,20,60.6
66740,ks,-95.36566,37.47587,465,34,53,19,55.9
66741,ks,-94.66127,37.71748,267,36,55,19,52.8
66743,ks,-94.88819,37.50757,3135,37,56,19,51.4
66746,ks,-94.95948,37.66829,378,35,54,19,54.3
66748,ks,-95.43938,37.79775,2218,33,52,19,57.6
66749,ks,-95.40779,37.93757,5522,31,50,19,61.3
66751,ks,-95.28667,37.93774,816,30,50,20,66.7
66753,ks,-95.01194,37.36096,1329,36,55,19,52.8
66754,ks,-94.88532,38.00529,1454,31,50,19,61.3
66755,ks,-95.17279,37.92244,1399,32,51,19,59.4
66756,ks,-94.64958,37.54049,1139,34,54,20,58.8
66757,ks,-95.69645,37.41691,2814,36,55,19,52.8
66758,ks,-95.59379,38.01358,551,30,49,19,63.3
66760,ks,-94.62462,37.3456,114,33,53,20,60.6
66761,ks,-95.56671,37.91762,380,30,49,19,63.3
66762,ks,-94.71048,37.39511,12128,35,55,20,57.1
66763,ks,-94.69821,37.46065,1739,35,55,20,57.1
66767,ks,-94.70851,38.07436,507,32,52,20,62.5
66769,ks,-94.89363,37.85605,549,36,55,19,52.8
66770,ks,-94.71752,37.08103,608,36,56,20,55.6
66771,ks,-95.14775,37.48937,1036,37,56,19,51.4
66772,ks,-95.21408,37.75335,338,33,52,19,57.6
66773,ks,-94.80891,37.26684,959,33,53,20,60.6
66775,ks,-95.14705,37.70181,284,34,53,19,55.9
66776,ks,-95.4874,37.46909,1207,32,52,20,62.5
66777,ks,-95.97046,37.79783,1325,28,47,19,67.9
66778,ks,-94.84086,37.0005,5,39,60,21,53.8
66779,ks,-94.98162,37.83519,728,34,54,20,58.8
66780,ks,-95.05569,37.6166,883,35,54,19,54.3
66781,ks,-94.72856,37.29125,1251,34,54,20,58.8
66782,ks,-94.9263,37.28504,232,34,54,20,58.8
66783,ks,-95.73669,37.87494,2706,29,47,18,62.1
66801,ks,-96.21802,38.41298,11460,24,41,17,70.8
66830,ks,-96.08715,38.59848,401,25,42,17,68
66833,ks,-96.18452,38.67616,917,24,41,17,70.8
66834,ks,-96.44152,38.85763,1087,21,37,16,76.2
66835,ks,-96.26076,38.53645,1055,25,42,17,68
66838,ks,-96.79295,38.55852,283,24,41,17,70.8
66839,ks,-95.75082,38.21421,3035,26,44,18,69.2
66840,ks,-96.87034,38.06791,959,25,42,17,68
66842,ks,-96.64485,38.02462,448,24,40,16,66.7
66843,ks,-96.73852,38.22308,634,27,44,17,63
66845,ks,-96.50628,38.29567,1262,26,44,18,69.2
66846,ks,-96.47345,38.65262,3152,22,39,17,77.3
66849,ks,-96.59297,38.88198,601,20,36,16,80
66850,ks,-96.72153,38.40741,685,26,44,18,69.2
66851,ks,-96.92035,38.22847,776,28,46,18,64.3
66852,ks,-95.89349,38.06671,965,26,44,18,69.2
66853,ks,-96.22163,38.00133,717,28,46,18,64.3
66854,ks,-95.97851,38.25594,1034,25,42,17,68
66856,ks,-95.81674,38.40244,1558,24,42,18,75
66857,ks,-95.63318,38.09667,1202,29,48,19,65.5
66858,ks,-96.93255,38.48,603,25,42,17,68
66859,ks,-96.96229,38.55471,377,25,42,17,68
66860,ks,-96.1607,38.12662,1654,26,44,18,69.2
66861,ks,-97.00677,38.36765,3194,26,43,17,65.4
66862,ks,-96.55432,38.15558,375,24,41,17,70.8
66863,ks,-96.08178,37.83287,78,28,46,18,64.3
66864,ks,-95.98372,38.35645,547,25,42,17,68
66865,ks,-96.2869,38.21772,1034,23,40,17,73.9
66866,ks,-97.10715,38.17281,1667,26,43,17,65.4
66868,ks,-95.98561,38.54425,931,25,43,18,72
66869,ks,-96.52747,38.45767,886,26,44,18,69.2
66870,ks,-96.01697,37.9447,579,28,47,19,67.9
66871,ks,-95.61701,38.36051,1374,24,42,18,75
66872,ks,-96.76538,38.79572,1170,22,38,16,72.7
66873,ks,-96.67448,38.6156,465,20,35,15,75
66901,ks,-97.6458,39.55446,4791,21,36,15,71.4
66930,ks,-97.48045,39.70367,473,22,37,15,68.2
66932,ks,-98.92957,39.77799,451,22,37,15,68.2
66933,ks,-96.86659,39.67377,614,24,39,15,62.5
66935,ks,-97.63122,39.84086,2359,21,36,15,71.4
66936,ks,-98.30666,39.91882,1013,17,30,13,76.5
66937,ks,-97.27266,39.58907,1270,26,42,16,61.5
66938,ks,-97.40985,39.57486,1273,25,41,16,64
66939,ks,-97.89912,39.85112,883,20,35,15,75
66940,ks,-97.44935,39.80431,614,20,35,15,75
66941,ks,-98.4478,39.8347,765,18,31,13,72.2
66942,ks,-98.00748,39.79895,768,20,34,14,70
66943,ks,-96.97155,39.67215,772,24,40,16,66.7
66944,ks,-97.30001,39.84335,628,21,36,15,71.4
66945,ks,-96.88027,39.88646,1169,22,38,16,72.7
66946,ks,-97.00686,39.96672,328,23,39,16,69.6
66948,ks,-97.85281,39.5975,937,22,37,15,68.2
66949,ks,-98.18757,39.64738,1181,22,36,14,63.6
66951,ks,-99.0251,39.85323,1197,19,33,14,73.7
66952,ks,-98.60013,39.8411,1391,20,34,14,70
66953,ks,-97.12269,39.68267,667,23,38,15,65.2
66955,ks,-97.29376,39.96517,300,18,32,14,77.8
66956,ks,-98.22584,39.7926,1706,17,31,14,82.4
66958,ks,-97.18143,39.88913,551,23,38,15,65.2
66959,ks,-97.53732,39.92803,408,19,33,14,73.7
66960,ks,-97.4265,39.93679,444,19,34,15,78.9
66962,ks,-97.12013,39.5966,400,25,41,16,64
66963,ks,-98.0043,39.63762,557,24,39,15,62.5
66964,ks,-97.80722,39.94199,516,18,32,14,77.8
66966,ks,-97.76346,39.77506,953,21,37,16,76.2
66967,ks,-98.79272,39.82413,2612,23,38,15,65.2
66968,ks,-97.06588,39.82743,1588,25,41,16,64
66970,ks,-98.03622,39.93913,254,17,30,13,76.5
67001,ks,-97.62979,37.75977,1213,25,43,18,72
67002,ks,-97.10767,37.69503,6519,27,45,18,66.7
67003,ks,-98.07256,37.10385,2570,37,55,18,48.6
67004,ks,-97.7541,37.28128,949,37,56,19,51.4
67005,ks,-96.99162,37.06511,8356,38,56,18,47.4
67008,ks,-96.7849,37.47774,778,31,49,18,58.1
67009,ks,-98.26672,37.21931,1035,35,54,19,54.3
67010,ks,-96.97278,37.66244,6270,28,46,18,64.3
67012,ks,-96.54984,37.67656,94,26,44,18,69.2
67013,ks,-97.27505,37.37787,1826,35,53,18,51.4
67016,ks,-97.51476,37.8868,433,27,44,17,63
67017,ks,-97.11164,37.82631,1487,27,45,18,66.7
67018,ks,-97.85847,37.0695,455,39,57,18,46.2
67019,ks,-96.77666,37.30587,920,34,53,19,55.9
67020,ks,-97.66872,38.00555,1569,27,44,17,63
67021,ks,-98.9153,37.7785,252,23,39,16,69.6
67022,ks,-97.63525,37.07833,2038,41,59,18,43.9
67023,ks,-96.61422,37.3349,555,33,52,19,57.6
67024,ks,-96.487,37.11332,1337,39,59,20,51.3
67025,ks,-97.78657,37.64134,2744,31,49,18,58.1
67026,ks,-97.49332,37.51123,2989,30,48,18,60
67028,ks,-98.9365,37.45985,793,26,43,17,65.4
67029,ks,-99.27487,37.17083,1861,27,45,18,66.7
67030,ks,-97.54744,37.78533,1619,26,43,17,65.4
67031,ks,-97.64046,37.40161,1608,33,52,19,57.6
67035,ks,-98.39192,37.64859,1541,28,46,18,64.3
67036,ks,-97.87667,37.29757,267,37,56,19,51.4
67037,ks,-97.21977,37.5644,12601,29,47,18,62.1
67038,ks,-96.7187,37.10522,913,37,56,19,51.4
67039,ks,-96.97668,37.52324,1858,31,50,19,61.3
67041,ks,-97.12995,38.05398,107,26,43,17,65.4
67042,ks,-96.79873,37.84883,7987,27,45,18,66.7
67045,ks,-96.34469,37.86082,3867,29,48,19,65.5
67047,ks,-96.04729,37.62481,1954,30,48,18,60
67049,ks,-97.84636,37.17745,293,37,56,19,51.4
67050,ks,-97.67832,37.67381,1445,27,45,18,66.7
67051,ks,-97.19388,37.08657,691,38,56,18,47.4
67052,ks,-97.57574,37.65817,4871,25,42,17,68
67053,ks,-97.34641,38.24674,301,26,44,18,69.2
67054,ks,-99.31558,37.57556,1671,19,34,15,78.9
67055,ks,-97.19968,37.78958,73,26,44,18,69.2
67056,ks,-97.5254,38.02198,1918,28,45,17,60.7
67057,ks,-98.77814,37.06469,692,38,57,19,50
67058,ks,-98.05662,37.31382,2255,34,53,19,55.9
67059,ks,-99.09262,37.63034,1501,22,38,16,72.7
67060,ks,-97.35951,37.54619,5968,29,48,19,65.5
67061,ks,-98.37248,37.09132,574,39,58,19,48.7
67062,ks,-97.43709,38.14519,1857,29,46,17,58.6
67063,ks,-97.22651,38.34426,2790,25,42,17,68
67065,ks,-98.52694,37.4685,460,28,45,17,60.7
67066,ks,-98.76114,37.7673,377,23,40,17,73.9
67067,ks,-97.27368,37.79344,1014,26,43,17,65.4
67068,ks,-98.10822,37.61656,3666,31,49,18,58.1
67070,ks,-98.53028,37.07351,1271,42,60,18,42.9
67071,ks,-98.88132,37.24557,529,32,50,18,56.3
67072,ks,-96.61061,37.54524,499,29,47,18,62.1
67073,ks,-97.32947,38.38422,379,25,41,16,64
67074,ks,-96.72096,37.67221,1336,28,46,18,64.3
67101,ks,-97.46345,37.78503,3102,25,43,18,72
67103,ks,-97.56058,37.26634,409,35,54,19,54.3
67104,ks,-98.65218,37.27081,2459,33,52,19,57.6
67105,ks,-97.67576,37.23337,379,37,56,19,51.4
67106,ks,-97.75728,37.46715,559,34,52,18,52.9
67107,ks,-97.53974,38.19553,2190,28,45,17,60.7
67108,ks,-97.68196,37.81401,1564,26,44,18,69.2
67109,ks,-99.48255,37.56367,870,19,34,15,78.9
67110,ks,-97.22604,37.46849,4185,32,50,18,56.3
67111,ks,-97.93374,37.61481,447,32,50,18,56.3
67112,ks,-98.41314,37.46606,427,29,47,18,62.1
67114,ks,-97.28875,38.07349,11302,29,46,17,58.6
67117,ks,-97.34733,38.07425,691,29,46,17,58.6
67118,ks,-97.85518,37.47649,754,34,53,19,55.9
67119,ks,-97.18681,37.2376,1174,36,55,19,52.8
67120,ks,-97.37752,37.46419,947,32,51,19,59.4
67122,ks,-96.42802,37.62811,630,28,46,18,64.3
67123,ks,-96.99324,37.94478,550,27,44,17,63
67124,ks,-98.77252,37.6336,5112,24,41,17,70.8
67127,ks,-99.48843,37.1675,1108,31,49,18,58.1
67131,ks,-96.95302,37.43043,254,32,51,19,59.4
67132,ks,-96.58482,37.85376,371,26,44,18,69.2
67133,ks,-97.10349,37.5765,2996,29,47,18,62.1
67134,ks,-98.68299,37.48606,534,27,44,17,63
67135,ks,-97.45832,37.91728,2331,27,45,18,66.7
67137,ks,-96.22279,37.63352,947,29,48,19,65.5
67138,ks,-98.42023,37.27319,612,34,53,19,55.9
67140,ks,-97.35648,37.07931,1075,40,58,18,45
67142,ks,-98.11742,37.45692,772,32,51,19,59.4
67143,ks,-98.94869,37.34996,171,31,49,18,58.1
67144,ks,-97.00733,37.81608,1186,28,45,17,60.7
67146,ks,-97.10311,37.38939,1298,33,51,18,54.5
67147,ks,-97.30862,37.85968,5698,26,44,18,69.2
67149,ks,-97.62587,37.5382,991,31,49,18,58.1
67150,ks,-98.2178,37.01188,97,40,59,19,47.5
67151,ks,-97.24908,38.14186,507,27,44,17,63
67152,ks,-97.41438,37.26012,5937,35,53,18,51.4
67154,ks,-97.12328,37.97277,1076,28,45,17,60.7
67155,ks,-99.13191,37.27842,758,28,45,17,60.7
67156,ks,-96.96383,37.25323,7479,34,53,19,55.9
67159,ks,-98.30719,37.41517,349,30,48,18,60
67202,ks,-97.3353,37.68681,1247,26,43,17,65.4
67203,ks,-97.36494,37.70405,11234,26,43,17,65.4
67204,ks,-97.3635,37.77247,10095,26,44,18,69.2
67205,ks,-97.42253,37.74991,8420,25,43,18,72
67206,ks,-97.22533,37.70384,6846,26,44,18,69.2
67207,ks,-97.22772,37.66641,9016,26,43,17,65.4
67208,ks,-97.27927,37.70449,7247,25,43,18,72
67209,ks,-97.43536,37.66279,5680,26,43,17,65.4
67210,ks,-97.24726,37.63126,3070,26,44,18,69.2
67211,ks,-97.31745,37.66688,9849,26,43,17,65.4
67212,ks,-97.43638,37.70201,15937,25,43,18,72
67213,ks,-97.365,37.66726,9870,26,43,17,65.4
67214,ks,-97.31787,37.70722,9980,26,43,17,65.4
67215,ks,-97.42552,37.61456,3203,26,44,18,69.2
67216,ks,-97.31391,37.60862,8297,27,45,18,66.7
67217,ks,-97.36277,37.61549,10929,27,45,18,66.7
67218,ks,-97.28042,37.66851,8387,25,43,18,72
67219,ks,-97.31743,37.77182,6591,26,43,17,65.4
67220,ks,-97.27911,37.75154,5188,26,43,17,65.4
67223,ks,-97.49791,37.7425,393,25,43,18,72
67226,ks,-97.21528,37.7733,8340,26,44,18,69.2
67227,ks,-97.49968,37.62819,246,26,44,18,69.2
67228,ks,-97.1719,37.76029,1084,27,45,18,66.7
67230,ks,-97.17129,37.68676,5765,27,45,18,66.7
67232,ks,-97.17009,37.63566,439,27,45,18,66.7
67235,ks,-97.49934,37.68909,6572,25,43,18,72
67260,ks,-97.29338,37.71932,25,25,43,18,72
67301,ks,-95.75341,37.2089,8074,38,57,19,50
67330,ks,-95.31532,37.16151,1106,36,55,19,52.8
67332,ks,-95.23445,37.04518,244,37,56,19,51.4
67333,ks,-95.88106,37.04671,1966,41,61,20,48.8
67334,ks,-96.17735,37.02371,196,39,58,19,48.7
67335,ks,-95.53667,37.2747,2630,36,55,19,52.8
67336,ks,-95.07862,37.05522,1767,39,59,20,51.3
67337,ks,-95.60148,37.05526,8179,41,61,20,48.8
67340,ks,-95.71326,37.05962,228,40,60,20,50
67341,ks,-95.43537,37.34381,292,34,53,19,55.9
67342,ks,-95.35755,37.05931,829,35,55,20,57.1
67344,ks,-95.95263,37.28807,1441,34,53,19,55.9
67345,ks,-96.2024,37.37755,357,34,53,19,55.9
67346,ks,-96.44323,37.32137,668,34,53,19,55.9
67347,ks,-95.95338,37.12734,584,39,58,19,48.7
67349,ks,-96.29881,37.48862,1434,32,51,19,59.4
67351,ks,-95.57096,37.13772,476,39,58,19,48.7
67352,ks,-96.08453,37.35616,864,34,53,19,55.9
67353,ks,-96.31242,37.31354,727,33,52,19,57.6
67354,ks,-95.4095,37.2092,753,36,56,20,55.6
67355,ks,-96.0093,37.03395,324,41,60,19,46.3
67356,ks,-95.14703,37.17777,2432,37,57,20,54.1
67357,ks,-95.26182,37.34614,8100,36,55,19,52.8
67360,ks,-96.10509,37.05099,558,39,58,19,48.7
67361,ks,-96.21817,37.13829,2351,38,58,20,52.6
67363,ks,-95.72238,37.33667,75,37,56,19,51.4
67364,ks,-95.81568,37.05264,301,37,57,20,54.1
67401,ks,-97.6458,38.83403,22156,28,45,17,60.7
67410,ks,-97.22133,38.95582,6280,32,50,18,56.3
67416,ks,-97.58052,38.6739,846,28,45,17,60.7
67417,ks,-97.55239,39.43749,486,22,37,15,68.2
67418,ks,-98.04252,39.17111,698,30,46,16,53.3
67420,ks,-98.08542,39.39875,4687,27,43,16,59.3
67422,ks,-97.58751,39.02357,1026,31,48,17,54.8
67423,ks,-97.98212,38.95119,480,30,46,16,53.3
67425,ks,-97.92781,38.77536,954,26,42,16,61.5
67427,ks,-98.39751,38.49617,537,25,42,17,68
67428,ks,-97.41871,38.3731,1344,26,43,17,65.4
67430,ks,-98.43007,39.52876,1121,21,36,15,71.4
67431,ks,-97.00941,38.95589,1642,28,45,17,60.7
67432,ks,-97.18711,39.33188,4886,30,47,17,56.7
67436,ks,-97.73257,39.27719,1132,31,47,16,51.6
67437,ks,-98.5554,39.51122,1553,23,38,15,65.2
67438,ks,-97.28227,38.49748,527,25,42,17,68
67439,ks,-98.2198,38.75448,2425,26,43,17,65.4
67441,ks,-97.10465,38.8763,711,31,48,17,54.8
67442,ks,-97.77635,38.65603,301,26,43,17,65.4
67443,ks,-97.52211,38.38072,1281,28,45,17,60.7
67444,ks,-98.12774,38.54708,1320,23,40,17,73.9
67445,ks,-97.8192,39.37644,1118,27,43,16,59.3
67446,ks,-98.30654,39.47596,1078,23,37,14,60.9
67447,ks,-96.97116,39.48345,548,27,43,16,59.3
67448,ks,-97.41276,38.65161,1732,27,45,18,66.7
67449,ks,-96.89411,38.67671,2706,26,42,16,61.5
67450,ks,-98.44685,38.61445,635,25,41,16,64
67451,ks,-97.12732,38.70253,1251,26,43,17,65.4
67452,ks,-98.37166,39.23877,768,27,43,16,59.3
67454,ks,-98.11142,38.69831,559,27,43,16,59.3
67455,ks,-98.16534,39.02266,2441,31,48,17,54.8
67456,ks,-97.67428,38.59597,2839,28,45,17,60.7
67457,ks,-97.99351,38.39201,886,25,42,17,68
67458,ks,-97.29715,39.16776,386,28,45,17,60.7
67459,ks,-98.33443,38.60578,451,25,42,17,68
67460,ks,-97.6981,38.38362,7629,29,47,18,62.1
67464,ks,-97.90125,38.56462,1214,25,41,16,64
67466,ks,-97.47999,39.33073,1169,26,42,16,61.5
67467,ks,-97.69274,39.14257,2824,34,51,17,50
67468,ks,-97.24665,39.46073,427,30,46,16,53.3
67470,ks,-97.4881,38.91302,566,29,46,17,58.6
67473,ks,-98.73595,39.37716,2241,24,40,16,66.7
67474,ks,-98.7191,39.57515,622,24,39,15,62.5
67475,ks,-97.05193,38.59104,257,25,41,16,64
67478,ks,-97.93883,39.38606,113,29,45,16,55.2
67480,ks,-97.40424,38.97168,1553,31,48,17,54.8
67481,ks,-98.38658,39.01247,1204,25,41,16,64
67482,ks,-97.25971,39.02689,68,30,47,17,56.7
67483,ks,-97.20575,38.5615,582,25,42,17,68
67484,ks,-97.83188,38.99157,1153,30,47,17,56.7
67485,ks,-98.50855,39.2904,548,26,41,15,57.7
67487,ks,-97.0717,39.17805,1068,26,43,17,65.4
67490,ks,-98.44225,38.7899,1282,24,40,16,66.7
67491,ks,-97.90397,38.38756,567,26,43,17,65.4
67492,ks,-96.96386,38.81125,275,27,43,16,59.3
67501,ks,-97.92973,37.98303,12838,26,43,17,65.4
67502,ks,-97.92912,38.12717,10807,26,43,17,65.4
67505,ks,-97.94317,38.02818,1148,26,43,17,65.4
67510,ks,-98.20667,37.99963,451,26,43,17,65.4
67511,ks,-99.04726,38.4325,483,23,40,17,73.9
67512,ks,-98.34029,38.21793,338,25,42,17,68
67513,ks,-99.54496,38.44704,303,20,36,16,80
67514,ks,-98.20703,37.86495,814,27,45,18,66.7
67515,ks,-100.06865,38.62466,191,16,31,15,93.8
67516,ks,-99.68312,38.3796,965,20,36,16,80
67518,ks,-100.16712,38.41463,505,16,30,14,87.5
67519,ks,-99.09109,37.93037,498,23,39,16,69.6
67520,ks,-99.1829,38.58581,770,24,40,16,66.7
67521,ks,-99.72285,38.62311,655,18,33,15,83.3
67522,ks,-97.7441,38.12463,1310,26,44,18,69.2
67523,ks,-99.54932,38.19747,765,20,36,16,80
67524,ks,-98.37876,38.37532,683,25,42,17,68
67525,ks,-98.57076,38.56876,1216,24,41,17,70.8
67526,ks,-98.5529,38.3348,2145,26,43,17,65.4
67529,ks,-99.25326,38.07274,679,22,38,16,72.7
67530,ks,-98.79362,38.35286,10502,26,44,18,69.2
67543,ks,-97.79477,37.87757,1521,27,44,17,63
67544,ks,-98.75738,38.58226,2711,25,42,17,68
67545,ks,-98.61996,38.16406,418,29,47,18,62.1
67546,ks,-97.81942,38.23255,1850,27,44,17,63
67547,ks,-99.45746,37.93347,2348,21,37,16,76.2
67548,ks,-99.34515,38.58311,1403,23,39,16,69.6
67550,ks,-99.12235,38.18485,4064,23,39,16,69.6
67552,ks,-99.22845,37.86619,1213,22,38,16,72.7
67553,ks,-99.30722,38.66082,155,22,38,16,72.7
67554,ks,-98.19311,38.37453,3208,25,42,17,68
67556,ks,-99.52894,38.6118,928,19,34,15,78.9
67557,ks,-98.96405,37.9278,967,23,40,17,73.9
67559,ks,-99.45504,38.39007,356,20,36,16,80
67560,ks,-99.95127,38.39492,2314,20,36,16,80
67561,ks,-98.09477,38.10633,1076,26,44,18,69.2
67563,ks,-99.55638,37.84405,596,19,35,16,84.2
67564,ks,-98.93141,38.5318,549,23,40,17,73.9
67565,ks,-99.04074,38.60394,813,23,39,16,69.6
67566,ks,-98.09774,37.93845,563,26,44,18,69.2
67567,ks,-98.97771,38.27268,776,24,41,17,70.8
67568,ks,-98.3093,38.01232,523,25,43,18,72
67570,ks,-97.96911,37.78633,1408,29,47,18,62.1
67572,ks,-99.9088,38.68662,1044,17,31,14,82.4
67573,ks,-98.41888,38.26848,442,25,43,18,72
67574,ks,-99.38504,38.22189,580,21,37,16,76.2
67575,ks,-99.26179,38.4122,1035,22,38,16,72.7
67576,ks,-98.79386,38.03367,2516,26,43,17,65.4
67578,ks,-98.58102,37.98577,1926,26,43,17,65.4
67579,ks,-98.21863,38.1833,2637,26,43,17,65.4
67581,ks,-98.41692,37.98361,717,26,43,17,65.4
67583,ks,-98.47695,37.80185,1722,26,44,18,69.2
67584,ks,-100.16372,38.68118,940,15,29,14,93.3
67601,ks,-99.34832,38.87758,11119,17,32,15,88.2
67621,ks,-99.1256,39.82467,531,19,33,14,73.7
67622,ks,-99.72994,39.89469,892,15,28,13,86.7
67623,ks,-98.95812,39.45264,864,24,39,15,62.5
67625,ks,-99.68377,39.38516,805,18,31,13,72.2
67626,ks,-98.70931,38.88531,514,21,37,16,76.2
67628,ks,-98.99409,39.62198,307,22,37,15,68.2
67629,ks,-100.18535,39.70385,449,13,25,12,92.3
67631,ks,-100.08621,39.00376,711,13,26,13,100
67632,ks,-99.58167,39.33978,373,18,31,13,72.2
67634,ks,-98.6073,38.81923,696,23,39,16,69.6
67635,ks,-100.43934,39.59489,507,12,25,13,108.3
67637,ks,-99.59842,38.9377,2523,16,30,14,87.5
67638,ks,-98.85675,39.6303,566,23,38,15,65.2
67639,ks,-99.30931,39.6372,412,22,36,14,63.6
67640,ks,-99.0467,38.90907,687,20,36,16,80
67642,ks,-99.84437,39.35815,1976,16,30,14,87.5
67643,ks,-100.30101,39.67623,705,12,25,13,108.3
67644,ks,-99.15784,39.63333,623,20,34,14,70
67645,ks,-99.87084,39.59942,1562,15,29,14,93.3
67646,ks,-99.57616,39.63451,1149,19,33,14,73.7
67647,ks,-99.53876,39.93673,522,16,29,13,81.3
67648,ks,-98.56837,39.07899,970,24,40,16,66.7
67649,ks,-98.68046,39.12292,562,23,39,16,69.6
67650,ks,-100.10611,39.37342,865,14,27,13,92.9
67651,ks,-99.05145,39.20738,1200,20,35,15,75
67653,ks,-100.21277,39.90706,955,12,23,11,91.7
67654,ks,-99.95341,39.82486,3217,14,26,12,85.7
67656,ks,-99.75603,38.98987,520,16,30,14,87.5
67657,ks,-99.61999,39.21028,750,16,30,14,87.5
67658,ks,-98.93125,39.10587,308,22,37,15,68.2
67659,ks,-100.00364,39.32488,479,14,28,14,100
67660,ks,-99.15655,38.71824,138,22,38,16,72.7
67661,ks,-99.32053,39.82821,3483,22,35,13,59.1
67663,ks,-99.34917,39.21141,2646,18,32,14,77.8
67664,ks,-99.58639,39.81429,537,17,30,13,76.5
67665,ks,-98.88161,38.85039,4321,20,36,16,80
67667,ks,-99.33249,38.71309,111,20,36,16,80
67669,ks,-99.34648,39.45331,2440,21,35,14,66.7
67671,ks,-99.13642,38.84685,1517,20,35,15,75
67672,ks,-99.91051,39.00385,2535,15,29,14,93.3
67673,ks,-98.81534,39.15832,539,22,38,16,72.7
67674,ks,-99.06872,38.86386,70,20,36,16,80
67675,ks,-99.09993,39.44085,570,23,38,15,65.2
67701,ks,-101.05956,39.39597,4567,5,15,10,200
67730,ks,-101.10586,39.80578,2378,8,19,11,137.5
67731,ks,-101.5361,39.76266,1462,5,13,8,160
67732,ks,-101.36112,39.41211,1216,5,15,10,200
67733,ks,-101.51278,39.31955,581,4,12,8,200
67734,ks,-100.89444,39.53247,497,7,18,11,157.1
67735,ks,-101.75864,39.34597,4794,2,9,7,350
67736,ks,-100.47039,38.8461,766,12,25,13,108.3
67737,ks,-100.47896,39.12284,737,10,22,12,120
67738,ks,-100.64766,38.98987,1135,10,22,12,120
67739,ks,-100.81359,39.88101,723,10,22,12,120
67740,ks,-100.35854,39.37705,2336,12,25,13,108.3
67741,ks,-101.99935,39.39497,748,2,7,5,250
67743,ks,-101.24713,39.373,405,5,14,9,180
67744,ks,-100.93522,39.85383,554,9,20,11,122.2
67745,ks,-101.34621,39.80866,993,6,16,10,166.7
67747,ks,-101.06506,39.04203,413,8,19,11,137.5
67748,ks,-100.85281,39.04069,2710,9,20,11,122.2
67749,ks,-100.56486,39.83379,2915,13,25,12,92.3
67751,ks,-100.35207,39.1214,493,10,22,12,120
67752,ks,-100.24408,38.98799,1497,11,23,12,109.1
67753,ks,-100.74614,39.42674,1045,9,21,12,133.3
67756,ks,-101.83623,39.79427,3182,4,13,9,225
67757,ks,-100.61048,39.54626,963,11,23,12,109.1
67758,ks,-101.76395,38.88406,1583,5,15,10,200
67761,ks,-101.53112,38.97087,951,6,17,11,183.3
67762,ks,-101.97248,38.90437,626,2,10,8,400
67764,ks,-101.20649,38.92281,1609,8,19,11,137.5
67801,ks,-100.05502,37.72527,11390,16,30,14,87.5
67831,ks,-99.7922,37.18663,2049,29,47,18,62.1
67834,ks,-99.63159,37.53371,1168,19,34,15,78.9
67835,ks,-100.32682,37.97116,2773,13,27,14,107.7
67836,ks,-102.00702,38.02153,440,7,19,12,171.4
67837,ks,-100.66233,37.55296,1393,12,25,13,108.3
67838,ks,-101.134,38.07792,749,11,24,13,118.2
67839,ks,-100.43139,38.47188,2819,13,26,13,100
67840,ks,-100.02607,37.08608,451,30,48,18,60
67841,ks,-100.24414,37.62236,566,13,26,13,100
67842,ks,-99.77454,37.5592,807,18,33,15,83.3
67843,ks,-99.93696,37.73027,1,16,31,15,93.8
67844,ks,-100.19474,37.38545,1289,20,36,16,80
67846,ks,-100.76701,38.03488,13028,10,22,12,120
67849,ks,-99.71484,38.14902,672,20,36,16,80
67850,ks,-100.61416,38.58678,645,12,25,13,108.3
67851,ks,-101.02606,38.06267,1389,10,22,12,120
67853,ks,-100.51503,37.88872,1534,12,25,13,108.3
67854,ks,-100.0103,38.09098,2325,18,32,14,77.8
67855,ks,-101.68844,37.55293,2858,9,22,13,144.4
67857,ks,-101.55078,37.98702,1032,8,20,12,150
67859,ks,-100.77914,37.23909,833,15,31,16,106.7
67860,ks,-101.31029,38.00295,2915,10,22,12,120
67861,ks,-101.38517,38.47219,2775,6,16,10,166.7
67862,ks,-101.9398,37.5529,1266,6,18,12,200
67863,ks,-101.21656,38.57317,643,8,19,11,137.5
67864,ks,-100.31688,37.17639,2514,22,39,17,77.3
67865,ks,-99.96545,37.43163,1317,17,32,15,88.2
67867,ks,-100.45877,37.57338,1638,11,25,14,127.3
67868,ks,-100.7088,37.82114,217,12,25,13,108.3
67869,ks,-100.57267,37.23877,1682,16,31,15,93.8
67870,ks,-101.00159,37.52237,1674,11,25,14,127.3
67871,ks,-100.90558,38.51752,5144,11,24,13,118.2
67876,ks,-99.73663,37.86158,1418,18,33,15,83.3
67877,ks,-100.84548,37.54991,2071,11,24,13,118.2
67878,ks,-101.82806,38.00548,3239,7,19,12,171.4
67879,ks,-101.80601,38.48054,3399,4,13,9,225
67880,ks,-101.31473,37.58505,5831,10,24,14,140
67882,ks,-99.88682,37.80056,527,17,31,14,82.4
67901,ks,-100.90783,37.10185,8966,18,35,16,89.3
67950,ks,-101.86805,37.04809,2062,6,16,10,175
67951,ks,-101.35253,37.16218,4519,9,22,13,144.4
67952,ks,-101.15003,37.29667,1024,11,26,15,136.4
67953,ks,-101.89435,37.25703,1687,7,18,11,157.1
67954,ks,-101.64228,37.20871,1509,8,21,13,162.5
68001,ne,-96.95893,41.3348,109,14,27,13,92.9
68002,ne,-96.33703,41.49689,1684,14,26,12,85.7
68003,ne,-96.38542,41.07767,3888,17,31,14,82.4
68004,ne,-96.63226,42.01245,1033,12,24,12,100
68005,ne,-95.89231,41.14227,8300,16,30,14,87.5
68007,ne,-96.19137,41.3698,7795,13,25,12,92.3
68008,ne,-96.16366,41.54778,7449,13,24,11,84.6
68010,ne,-96.13384,41.25583,26,13,25,12,92.3
68014,ne,-96.96194,41.28228,519,14,26,12,85.7
68015,ne,-96.64343,41.38558,1054,14,26,12,85.7
68016,ne,-96.10427,41.04331,421,17,30,13,76.5
68017,ne,-96.65489,41.05952,1268,16,29,13,81.3
68018,ne,-96.6123,41.30543,623,15,27,12,80
68019,ne,-96.3737,41.78421,820,13,25,12,92.3
68020,ne,-96.2592,41.97579,1186,15,27,12,80
68022,ne,-96.24591,41.27852,13244,13,25,12,92.3
68023,ne,-96.02011,41.44922,1763,13,25,12,92.3
68025,ne,-96.48934,41.43792,14500,15,27,12,80
68028,ne,-96.26084,41.10635,7617,15,28,13,86.7
68029,ne,-96.2827,41.66089,1113,14,26,12,85.7
68030,ne,-96.45019,42.3217,820,12,23,11,91.7
68031,ne,-96.53047,41.64279,2077,14,26,12,85.7
68033,ne,-96.51673,41.13074,440,16,29,13,81.3
68034,ne,-96.21918,41.45841,782,12,24,12,100
68036,ne,-96.95175,41.39079,691,14,26,12,85.7
68037,ne,-96.12728,40.98581,1843,16,29,13,81.3
68038,ne,-96.44588,41.95407,1510,13,24,11,84.6
68039,ne,-96.34472,42.11411,450,15,26,11,73.3
68040,ne,-96.7367,41.28447,480,15,27,12,80
68041,ne,-96.49821,41.2482,743,15,28,13,86.7
68042,ne,-96.43824,41.09663,91,17,30,13,76.5
68044,ne,-96.4441,41.54908,616,14,27,13,92.9
68045,ne,-96.49647,41.82561,1652,13,25,12,92.3
68046,ne,-96.05948,41.12492,11970,15,28,13,86.7
68047,ne,-96.74044,42.10671,1794,12,24,12,100
68048,ne,-95.93439,40.98142,8127,17,30,13,76.5
68050,ne,-96.84121,41.30706,854,14,27,13,92.9
68055,ne,-96.47221,42.05891,597,13,24,11,84.6
68057,ne,-96.71921,41.6596,2025,13,25,12,92.3
68058,ne,-96.24824,41.00874,283,17,30,13,76.5
68059,ne,-96.15785,41.06667,2105,17,30,13,76.5
68061,ne,-96.21154,41.79945,2625,17,30,13,76.5
68062,ne,-96.66908,42.19433,546,12,23,11,91.7
68063,ne,-96.49563,41.73057,232,13,25,12,92.3
68064,ne,-96.34994,41.35107,3539,14,26,12,85.7
68065,ne,-96.8399,41.07318,1286,15,28,13,86.7
68066,ne,-96.62428,41.18601,3540,16,29,13,81.3
68067,ne,-96.48395,42.15289,950,15,27,12,80
68068,ne,-96.2085,41.39789,82,13,25,12,92.3
68069,ne,-96.31621,41.24286,1984,14,27,13,92.9
68070,ne,-96.80243,41.1922,903,15,27,12,80
68071,ne,-96.47116,42.23563,1013,13,25,12,92.3
68072,ne,-96.50479,41.60918,45,14,26,12,85.7
68073,ne,-96.40781,41.25068,1412,15,27,12,80
68102,ne,-95.93338,41.26203,916,15,28,13,86.7
68104,ne,-96.00128,41.29502,12998,13,25,12,92.3
68105,ne,-95.96415,41.24054,6670,14,27,13,92.9
68106,ne,-96.00215,41.23894,7438,14,25,11,78.6
68107,ne,-95.95206,41.20846,9914,15,28,13,86.7
68108,ne,-95.93043,41.23747,5361,16,28,12,75
68110,ne,-95.91137,41.2986,4613,16,29,13,81.3
68111,ne,-95.96396,41.29561,11525,15,28,13,86.7
68112,ne,-95.95731,41.37423,4730,16,29,13,81.3
68113,ne,-95.91124,41.11757,26,17,31,14,82.4
68114,ne,-96.05211,41.26323,5150,14,26,12,85.7
68116,ne,-96.16778,41.29934,11434,13,25,12,92.3
68117,ne,-96.00038,41.20755,3733,14,26,12,85.7
68118,ne,-96.17743,41.26316,3590,13,25,12,92.3
68122,ne,-96.05108,41.36824,4968,13,24,11,84.6
68123,ne,-95.94316,41.10152,9147,16,30,14,87.5
68124,ne,-96.0516,41.2353,5277,14,27,13,92.9
68127,ne,-96.0507,41.20545,5983,15,27,12,80
68128,ne,-96.0658,41.18135,5608,15,28,13,86.7
68130,ne,-96.19589,41.23423,6954,13,26,13,100
68131,ne,-95.96447,41.26457,3141,14,26,12,85.7
68132,ne,-96.00226,41.26467,4319,13,25,12,92.3
68133,ne,-95.99944,41.11354,5174,15,28,13,86.7
68134,ne,-96.05065,41.29856,8632,13,25,12,92.3
68135,ne,-96.19553,41.20568,10156,14,26,12,85.7
68136,ne,-96.1867,41.16889,7958,14,27,13,92.9
68137,ne,-96.11888,41.20587,8349,13,25,12,92.3
68138,ne,-96.13646,41.15611,5426,14,27,13,92.9
68142,ne,-96.10461,41.3683,2336,13,24,11,84.6
68144,ne,-96.11926,41.23483,8366,13,25,12,92.3
68147,ne,-95.95674,41.17613,4324,16,28,12,75
68152,ne,-95.99786,41.36532,2782,13,25,12,92.3
68154,ne,-96.11568,41.26472,6672,13,25,12,92.3
68157,ne,-95.99695,41.17844,2261,16,29,13,81.3
68164,ne,-96.10957,41.29904,9011,13,25,12,92.3
68178,ne,-95.94766,41.2657,5,14,27,13,92.9
68301,ne,-96.52385,40.46517,1454,17,32,15,88.2
68303,ne,-97.42202,40.26605,580,18,32,14,77.8
68304,ne,-96.39241,40.87935,430,16,30,14,87.5
68305,ne,-95.85854,40.36567,3239,22,38,16,72.7
68307,ne,-96.13353,40.78985,567,17,31,14,82.4
68309,ne,-96.56873,40.05989,143,20,35,15,75
68310,ne,-96.74959,40.25097,9256,18,32,14,77.8
68313,ne,-97.27231,40.78193,966,16,30,14,87.5
68314,ne,-97.02768,41.01277,371,16,29,13,81.3
68315,ne,-97.54114,40.24944,349,17,30,13,76.5
68316,ne,-97.6181,41.01778,568,17,30,13,76.5
68317,ne,-96.50728,40.67173,1300,17,32,15,88.2
68318,ne,-96.64012,40.15392,766,19,34,15,78.9
68319,ne,-97.7615,40.93081,755,16,29,13,81.3
68320,ne,-95.95522,40.48625,849,21,36,15,71.4
68321,ne,-95.69078,40.39242,615,23,38,15,65.2
68322,ne,-97.55622,40.33883,617,15,28,13,86.7
68323,ne,-96.38206,40.14016,828,18,33,15,83.3
68324,ne,-96.29216,40.56005,299,19,34,15,78.9
68325,ks,-97.75781,40.01681,421,16,30,13,78.9
68326,ne,-97.68284,40.28605,398,15,28,13,86.7
68327,ne,-97.61813,40.02829,525,17,31,14,82.4
68328,ne,-96.83756,40.47737,504,17,30,13,76.5
68329,ne,-96.16253,40.50244,782,20,35,15,75
68331,ne,-96.71056,40.47205,828,17,31,14,82.4
68332,ne,-96.40559,40.31684,390,17,31,14,82.4
68333,ne,-96.94781,40.62331,4008,17,31,14,82.4
68335,ne,-97.80302,40.27694,774,15,27,12,80
68336,ne,-96.68796,40.96389,451,17,30,13,76.5
68337,ne,-95.83811,40.0967,774,23,40,17,73.9
68338,ne,-97.27159,40.31045,523,17,31,14,82.4
68339,ne,-96.86457,40.73373,983,17,31,14,82.4
68340,ne,-97.74722,40.13254,930,16,29,13,81.3
68341,ne,-96.91378,40.38381,1290,18,32,14,77.8
68342,ne,-96.9443,40.10068,800,19,33,14,73.7
68343,ne,-97.13426,40.61866,1268,16,30,14,87.5
68344,ne,-96.40065,40.56983,543,18,33,15,83.3
68345,ne,-96.02802,40.03994,549,24,40,16,66.7
68346,ne,-96.02894,40.66381,665,18,32,14,77.8
68347,ne,-96.42644,40.8039,1492,17,31,14,82.4
68348,ne,-96.13926,40.30611,473,21,36,15,71.4
68349,ne,-96.29745,40.82928,1085,17,30,13,76.5
68350,ne,-97.07625,40.04463,437,21,35,14,66.7
68351,ne,-97.42862,40.65709,1116,15,28,13,86.7
68352,ne,-97.22029,40.14585,5183,19,33,14,73.7
68354,ne,-97.5783,40.63782,1125,15,27,12,80
68355,ne,-95.56405,40.11508,4294,26,42,16,61.5
68357,ne,-96.55113,40.31656,536,15,28,13,86.7
68358,ne,-96.60802,40.53148,1167,17,32,15,88.2
68359,ne,-97.28531,40.62957,1889,16,29,13,81.3
68360,ne,-96.9551,40.94548,378,16,29,13,81.3
68361,ne,-97.60026,40.50995,1980,14,26,12,85.7
68362,ne,-97.44172,40.15665,111,18,31,13,72.2
68364,ne,-97.21879,40.83267,118,16,30,14,87.5
68365,ne,-97.72884,40.60962,501,14,26,12,85.7
68366,ne,-96.43816,40.97385,1139,17,30,13,76.5
68367,ne,-97.39724,41.0358,702,16,28,12,75
68368,ne,-96.82093,40.55869,530,17,31,14,82.4
68370,ne,-97.55059,40.13916,2055,18,31,13,72.2
68371,ne,-97.78922,40.77227,1404,14,26,12,85.7
68372,ne,-96.60358,40.60811,2038,17,31,14,82.4
68375,ne,-97.45676,40.03552,368,18,32,14,77.8
68376,ne,-95.94507,40.17439,2016,23,39,16,69.6
68377,ne,-97.01833,40.2142,586,18,32,14,77.8
68378,ne,-96.02535,40.38341,805,21,36,15,71.4
68379,ne,-95.86737,40.51989,85,20,35,15,75
68380,ne,-96.39326,40.24082,101,16,30,14,87.5
68381,ne,-96.48043,40.08011,562,18,33,15,83.3
68382,ne,-96.02406,40.5973,33,19,34,15,78.9
68401,ne,-97.59165,40.73787,732,16,29,13,81.3
68402,ne,-96.85716,40.90779,788,17,30,13,76.5
68403,ne,-96.168,40.92072,125,15,28,13,86.7
68404,ne,-96.7508,40.61632,807,17,31,14,82.4
68405,ne,-97.07266,40.76578,1857,17,30,13,76.5
68406,ne,-97.38542,40.49989,679,15,28,13,86.7
68407,ne,-96.26652,40.91923,836,15,28,13,86.7
68409,ne,-95.95154,40.90812,844,16,30,14,87.5
68410,ne,-95.88477,40.63753,5617,17,31,14,82.4
68413,ne,-96.01227,40.83778,787,17,31,14,82.4
68414,ne,-95.6704,40.30464,554,23,39,16,69.6
68415,ne,-96.8205,40.06377,819,20,34,14,70
68416,ne,-97.45681,40.41035,491,15,28,13,86.7
68417,ne,-96.08861,40.73642,371,19,33,14,73.7
68418,ne,-96.38856,40.6949,1158,18,32,14,77.8
68419,ne,-96.51117,40.59981,154,17,32,15,88.2
68420,ne,-96.20201,40.09416,1859,24,40,16,66.7
68421,ne,-95.74122,40.49008,831,21,37,16,76.2
68422,ne,-96.69603,40.39024,572,17,31,14,82.4
68423,ne,-96.95216,40.80265,756,17,31,14,82.4
68424,ne,-97.01682,40.29706,790,17,31,14,82.4
68428,ne,-96.79445,40.96974,1025,17,30,13,76.5
68430,ne,-96.66332,40.66862,1339,17,31,14,82.4
68431,ne,-95.43347,40.06956,976,24,41,17,70.8
68433,ne,-95.73582,40.05169,724,25,42,17,68
68434,ne,-97.12034,40.90875,4889,17,31,14,82.4
68436,ne,-97.73943,40.42384,887,14,26,12,85.7
68437,ne,-95.64579,40.2317,513,23,39,16,69.6
68438,ne,-96.74461,40.62661,87,17,31,14,82.4
68439,ne,-97.20883,41.00106,479,17,30,13,76.5
68440,ne,-97.00978,40.0569,368,21,36,15,71.4
68441,ne,-96.23815,40.22526,547,21,37,16,76.2
68442,ne,-95.77321,40.2386,513,23,39,16,69.6
68443,ne,-96.3681,40.45211,1235,19,33,14,73.7
68444,ne,-97.57708,40.41138,252,15,28,13,86.7
68445,ne,-97.07916,40.38924,282,18,32,14,77.8
68446,ne,-96.17513,40.65333,2162,20,35,15,75
68447,ne,-96.07636,40.20504,771,24,40,16,66.7
68448,ne,-96.02559,40.55163,496,20,35,15,75
68450,ne,-96.22736,40.361,2237,20,35,15,75
68452,ne,-97.85229,40.39445,245,13,26,13,100
68453,ne,-97.32778,40.416,656,16,29,13,81.3
68454,ne,-96.28848,40.69186,723,19,34,15,78.9
68455,ne,-95.90086,40.82571,1014,18,32,14,77.8
68456,ne,-97.31433,40.91116,890,16,29,13,81.3
68457,ne,-95.70731,40.15326,529,25,41,16,64
68458,ne,-96.50323,40.23005,240,15,28,13,86.7
68460,ne,-97.43023,40.89456,1066,16,30,14,87.5
68461,ne,-96.51517,40.76644,575,16,30,14,87.5
68462,ne,-96.52639,40.94911,2317,17,31,14,82.4
68463,ne,-96.1342,40.87532,1521,15,29,14,93.3
68464,ne,-97.19868,40.42861,877,17,31,14,82.4
68465,ne,-97.02073,40.49083,1971,18,32,14,77.8
68466,ne,-96.64127,40.07028,1851,19,34,15,78.9
68467,ne,-97.59541,40.86642,5308,18,31,13,72.2
68502,ne,-96.69852,40.78544,8994,17,31,14,82.4
68503,ne,-96.67402,40.82458,4338,17,31,14,82.4
68504,ne,-96.66059,40.85429,4654,17,31,14,82.4
68505,ne,-96.61926,40.82484,5357,17,31,14,82.4
68506,ne,-96.63868,40.78389,10218,17,31,14,82.4
68507,ne,-96.61485,40.85889,6779,17,31,14,82.4
68508,ne,-96.70586,40.81831,2169,18,32,14,77.8
68510,ne,-96.63603,40.80653,7749,17,31,14,82.4
68512,ne,-96.70751,40.7388,4610,17,31,14,82.4
68514,ne,-96.65157,40.92553,180,17,31,14,82.4
68516,ne,-96.64255,40.73488,17169,16,30,14,87.5
68517,ne,-96.60552,40.93396,438,17,31,14,82.4
68520,ne,-96.55153,40.79965,1956,17,31,14,82.4
68521,ne,-96.7095,40.86612,10451,18,32,14,77.8
68522,ne,-96.76205,40.78872,4449,18,32,14,77.8
68523,ne,-96.7584,40.73593,1060,17,31,14,82.4
68524,ne,-96.8053,40.8712,2198,18,32,14,77.8
68526,ne,-96.58364,40.73235,3063,16,30,14,87.5
68527,ne,-96.52422,40.84711,757,17,31,14,82.4
68528,ne,-96.81948,40.82024,3133,18,32,14,77.8
68531,ne,-96.72324,40.90148,200,18,31,13,72.2
68532,ne,-96.84265,40.79206,323,17,31,14,82.4
68601,ne,-97.40236,41.45255,14236,15,27,12,80
68620,ne,-98.06991,41.734,2948,11,22,11,100
68621,ne,-96.63636,41.48745,556,14,26,12,85.7
68622,ne,-98.58048,41.9419,574,9,18,9,100
68623,ne,-98.15036,41.44401,730,12,23,11,91.7
68624,ne,-97.23427,41.35175,1051,14,27,13,92.9
68626,ne,-96.99438,41.16708,804,14,27,13,92.9
68627,ne,-98.16233,41.55439,974,11,22,11,100
68628,ne,-97.83967,41.22076,1133,15,28,13,86.7
68629,ne,-97.12874,41.71608,1861,11,21,10,90.9
68631,ne,-97.34906,41.68976,555,11,22,11,100
68632,ne,-97.13115,41.24723,2831,14,26,12,85.7
68633,ne,-96.89691,41.70519,1428,12,23,11,91.7
68634,ne,-97.49307,41.3899,216,15,27,12,80
68635,ne,-97.01486,41.08248,619,15,28,13,86.7
68636,ne,-98.15375,42.00876,1666,8,17,9,112.5
68637,ne,-98.65844,41.80525,700,9,18,9,100
68638,ne,-97.98677,41.37422,2000,14,26,12,85.7
68640,ne,-97.77387,41.46286,1654,14,26,12,85.7
68641,ne,-97.0082,41.73518,1449,11,21,10,90.9
68642,ne,-97.51505,41.69029,1743,11,21,10,90.9
68643,ne,-97.25842,41.70457,1272,11,22,11,100
68644,ne,-97.67519,41.71032,999,11,22,11,100
68647,ne,-97.62144,41.52324,898,13,25,12,92.3
68648,ne,-96.79158,41.40459,760,14,26,12,85.7
68649,ne,-96.78774,41.50914,2068,14,26,12,85.7
68651,ne,-97.57972,41.22622,1529,16,28,12,75
68652,ne,-98.05199,41.86968,984,10,19,9,90
68653,ne,-97.48527,41.55527,886,13,24,11,84.6
68654,ne,-97.78414,41.06675,713,15,28,13,86.7
68655,ne,-98.2506,41.65522,267,11,22,11,100
68658,ne,-97.29083,41.19785,884,14,27,13,92.9
68659,ne,-96.94332,41.54492,362,13,25,12,92.3
68660,ne,-97.86971,41.57551,1393,12,23,11,91.7
68661,ne,-97.08364,41.49315,4073,14,26,12,85.7
68662,ne,-97.41403,41.21057,1263,15,27,12,80
68663,ne,-97.69462,41.31669,857,15,28,13,86.7
68664,ne,-96.78654,41.70401,240,13,25,12,92.3
68665,ne,-98.40603,41.76101,1327,10,20,10,100
68666,ne,-97.61554,41.11091,1435,16,29,13,81.3
68667,ne,-97.30805,41.11008,178,15,28,13,86.7
68669,ne,-97.23465,41.08249,626,15,28,13,86.7
68701,ne,-97.44361,42.02135,15564,11,21,10,90.9
68710,ne,-96.85469,42.43882,980,9,18,9,100
68711,ne,-99.03871,42.19267,637,6,14,8,133.3
68713,ne,-98.96909,42.538,3093,9,17,8,88.9
68714,ne,-99.4865,42.40232,2455,7,14,7,100
68715,ne,-97.60777,41.96451,1196,10,20,10,100
68716,ne,-96.82295,41.93317,1034,12,23,11,91.7
68717,ne,-97.21934,42.39465,286,10,19,9,90
68718,ne,-97.69676,42.65592,2586,10,20,10,100
68719,ne,-98.57209,42.94842,454,12,22,9,72.1
68720,ne,-98.01234,42.34587,502,11,21,10,90.9
68722,ne,-98.87403,42.9202,1012,12,21,9,75
68723,ne,-97.21194,42.28602,661,10,19,9,90
68724,ne,-97.89403,42.63801,297,13,24,11,84.6
68725,ne,-98.77707,42.20218,816,6,13,7,116.7
68726,ne,-98.20555,42.18193,954,9,19,10,111.1
68727,ne,-97.20347,42.51299,861,10,20,10,100
68728,ne,-96.95267,42.37634,325,9,18,9,100
68729,ne,-97.90425,42.47094,1879,14,24,10,71.4
68730,ne,-97.54009,42.77002,2770,9,18,9,100
68731,ne,-96.48113,42.40977,1499,12,23,11,91.7
68732,ne,-96.9795,42.49186,389,8,17,9,112.5
68733,ne,-96.72474,42.28485,1313,12,22,10,83.3
68734,ne,-98.79594,42.46906,216,9,17,8,88.9
68735,ne,-98.47552,42.14372,1615,9,18,9,100
68736,ne,-97.3678,42.73541,733,10,19,9,90
68739,ne,-97.26938,42.62571,2853,11,21,10,90.9
68740,ne,-97.30029,42.15192,744,10,20,10,100
68741,ne,-96.59044,42.34862,902,12,22,10,83.3
68742,ne,-98.51676,42.35135,363,9,18,9,100
68743,ne,-96.62613,42.46551,1101,12,22,10,83.3
68745,ne,-97.08796,42.44766,1533,9,18,9,100
68746,ne,-98.43847,42.79217,1537,12,21,9,75
68747,ne,-97.49713,42.39436,222,12,22,10,83.3
68748,ne,-97.46472,41.84007,2658,10,20,10,100
68749,ne,-97.47535,42.45309,96,10,20,10,100
68751,ne,-96.98092,42.69045,64,11,21,10,90.9
68752,ne,-97.72839,42.02714,1190,10,20,10,100
68753,ne,-99.44942,42.88464,421,9,18,9,100
68755,ne,-99.12905,42.92326,801,11,19,8,72.7
68756,ne,-97.9801,42.19064,1792,9,18,9,100
68757,ne,-96.92132,42.65011,1280,12,21,9,75
68758,ne,-97.78845,41.78656,1436,11,21,10,90.9
68759,ne,-99.31386,42.70514,925,9,18,9,100
68760,ne,-98.03093,42.76549,2435,14,24,10,71.4
68761,ne,-97.9618,42.0545,549,8,17,9,112.5
68763,ne,-98.60951,42.5087,4367,10,18,8,80
68764,ne,-98.23105,42.39996,1014,10,20,10,100
68765,ne,-97.62227,42.34267,1303,12,23,11,91.7
68766,ne,-98.40573,42.43501,782,10,19,9,90
68767,ne,-97.55185,42.19957,2457,11,21,10,90.9
68768,ne,-97.06763,41.99448,995,11,22,11,100
68769,ne,-97.81213,42.32226,1784,12,22,10,83.3
68770,ne,-96.76507,42.5642,1581,11,22,11,100
68771,ne,-97.35758,42.38322,1503,10,20,10,100
68773,ne,-98.1235,42.36475,368,11,20,9,81.8
68774,ne,-97.28006,42.81532,557,11,20,9,81.8
68776,ne,-96.4413,42.46066,5257,12,22,10,83.3
68777,ne,-98.6931,42.86573,1365,12,21,9,75
68778,ne,-99.79075,42.86752,1647,7,15,8,114.3
68779,ne,-97.20832,41.9564,2526,11,22,11,100
68780,ne,-99.13362,42.64281,1488,9,17,8,88.9
68781,ne,-97.86241,42.02383,1445,10,19,9,90
68783,ne,-98.15214,42.62072,1679,13,23,10,76.9
68784,ne,-96.89291,42.25777,1559,12,22,10,83.3
68785,ne,-96.72411,42.42655,367,11,21,10,90.9
68786,ne,-97.55667,42.50574,1145,11,21,10,90.9
68787,ne,-97.03474,42.21441,3283,10,20,10,100
68788,ne,-96.72136,41.83971,3938,12,23,11,91.7
68789,ne,-97.97267,42.54724,357,14,25,11,78.6
68790,ne,-97.17544,42.16245,749,10,20,10,100
68791,ne,-96.93645,41.99199,1844,12,22,10,83.3
68792,ne,-97.12155,42.73823,846,12,22,10,83.3
68801,ne,-98.29167,40.94786,11895,12,23,11,91.7
68803,ne,-98.4152,40.95489,10394,12,23,11,91.7
68810,ne,-98.46692,40.85845,665,11,22,11,100
68812,ne,-99.27941,40.90119,851,7,16,9,128.6
68813,ne,-99.91478,41.68515,1745,5,12,7,140
68814,ne,-99.41289,41.31654,1512,6,14,8,133.3
68815,ne,-99.14387,41.41937,1032,8,16,8,100
68816,ne,-98.13294,41.1774,298,14,26,12,85.7
68817,ne,-98.79085,41.27386,620,9,18,9,100
68818,ne,-98.00828,40.81764,4086,11,23,12,109.1
68820,ne,-98.70224,41.10855,469,10,21,11,110
68821,ne,-99.85771,42.00948,519,6,13,7,116.7
68822,ne,-99.63168,41.38303,4128,5,12,7,140
68823,ne,-99.10906,41.92656,3881,7,16,9,128.6
68824,ne,-98.60166,40.99226,1566,10,21,11,110
68825,ne,-99.96439,41.27175,1751,5,12,7,140
68826,ne,-98.0155,41.16361,2848,14,27,13,92.9
68827,ne,-98.1854,41.04497,701,12,24,12,100
68828,ne,-99.23539,41.54878,699,8,16,8,100
68831,ne,-98.5539,41.11097,900,11,22,11,100
68832,ne,-98.36574,40.76665,1729,11,22,11,100
68833,ne,-100.1541,41.82842,798,5,12,7,140
68834,ne,-99.65886,41.03165,566,6,14,8,133.3
68835,ne,-98.61996,41.33178,828,10,21,11,110
68836,ne,-99.37428,40.70651,1557,8,17,9,112.5
68837,ne,-99.07661,41.6598,178,8,17,9,112.5
68838,ne,-98.66546,41.21518,483,10,20,10,100
68840,ne,-98.88117,40.7585,2125,9,19,10,111.1
68841,ne,-98.17076,40.76,760,11,23,12,109.1
68842,ne,-98.50059,41.56757,978,9,19,10,111.1
68843,ne,-97.8853,40.90448,1006,13,25,12,92.3
68844,ne,-99.05849,41.05991,381,9,18,9,100
68845,ne,-99.16294,40.72732,7934,9,18,9,100
68846,ne,-97.88678,41.06652,381,14,27,13,92.9
68847,ne,-99.02564,40.75892,7666,9,18,9,100
68849,ne,-99.10374,40.70097,14,9,18,9,100
68850,ne,-99.73647,40.82958,5535,5,13,8,160
68852,ne,-99.12629,41.16457,735,8,16,8,100
68853,ne,-98.9883,41.2925,1683,8,17,9,112.5
68854,ne,-98.00046,41.00843,1057,13,25,12,92.3
68855,ne,-99.32388,41.16782,1124,7,15,8,114.3
68856,ne,-99.82752,41.49586,782,4,11,7,175
68858,ne,-99.37695,40.9595,474,7,15,8,114.3
68859,ne,-98.82391,41.47115,705,8,17,9,112.5
68860,ne,-99.79138,41.13307,853,5,13,8,160
68861,ne,-99.25885,40.70241,72,8,18,10,125
68862,ne,-98.93666,41.60043,2952,8,17,9,112.5
68863,ne,-99.52496,40.76973,1140,6,15,9,150
68864,ne,-98.23506,41.26306,1503,12,24,12,100
68865,ne,-98.18585,40.89646,907,11,22,11,100
68866,ne,-99.12855,40.97537,1003,8,17,9,112.5
68869,ne,-98.88122,40.99694,2098,9,19,10,111.1
68870,ne,-99.1611,40.85239,419,8,17,9,112.5
68871,ne,-98.8512,41.14059,433,9,19,10,111.1
68872,ne,-98.33397,41.09485,770,12,23,11,91.7
68873,ne,-98.45046,41.24502,2742,11,23,12,109.1
68874,ne,-99.41276,41.63757,1776,6,14,8,133.3
68875,ne,-98.66739,41.56288,993,8,18,10,125
68876,ne,-98.75,40.8173,1352,10,20,10,100
68878,ne,-99.51702,40.97612,805,6,14,8,133.3
68879,ne,-99.5446,41.90208,1049,6,14,8,133.3
68881,ne,-99.35189,41.43843,148,6,14,8,133.3
68882,ne,-98.40025,41.42785,686,10,21,11,110
68883,ne,-98.59111,40.81268,2590,10,21,11,110
68901,ne,-98.37278,40.59291,12804,11,22,11,100
68920,ne,-99.33724,40.15682,1536,14,26,12,85.7
68922,ne,-99.89662,40.3339,1654,15,27,12,80
68923,ne,-99.46832,40.35911,175,8,18,10,125
68924,ne,-99.11903,40.49562,1105,10,21,11,110
68925,ne,-98.4378,40.42541,583,11,23,12,109.1
68926,ne,-99.84769,40.09481,1233,21,35,14,66.7
68927,ne,-99.62897,40.50199,1316,7,16,9,128.6
68928,ne,-98.61362,40.27938,705,13,25,12,92.3
68929,ne,-99.05114,40.15001,482,13,25,12,92.3
68930,ne,-98.41417,40.28845,1395,13,25,12,92.3
68932,ne,-98.72515,40.30859,707,12,24,12,100
68933,ne,-98.02732,40.51676,996,10,21,11,110
68934,ne,-98.13836,40.33929,365,12,24,12,100
68935,ne,-97.95738,40.37789,1309,12,24,12,100
68936,ne,-99.77504,40.33136,556,15,28,13,86.7
68937,ne,-99.88134,40.59086,2295,5,12,7,140
68938,ne,-98.11832,40.40954,811,10,22,12,120
68939,ne,-98.96886,40.10132,1635,14,26,12,85.7
68940,ne,-99.24278,40.5513,754,10,20,10,100
68941,ne,-98.2781,40.45723,1032,10,22,12,120
68942,ne,-98.30037,40.09086,1062,17,30,13,76.5
68943,ne,-97.89869,40.0489,497,17,31,14,82.4
68944,ne,-98.09093,40.64375,1419,11,22,11,100
68945,ne,-98.77782,40.56824,314,11,22,11,100
68946,ne,-99.98579,40.11165,204,17,30,13,76.5
68947,ne,-99.04764,40.28012,682,11,22,11,100
68948,ne,-100.02193,40.32009,746,12,24,12,100
68949,ne,-99.38992,40.42911,4524,8,18,10,125
68950,ne,-98.66944,40.4618,476,11,23,12,109.1
68952,ne,-98.66777,40.0752,346,17,30,13,76.5
68954,ne,-98.23739,40.62269,130,10,22,12,120
68955,ne,-98.53925,40.59454,1749,10,21,11,110
68956,ne,-98.69255,40.6346,1220,10,21,11,110
68957,ne,-98.23722,40.26651,868,13,25,12,92.3
68958,ne,-99.5014,40.52234,808,8,17,9,112.5
68959,ne,-98.91426,40.48587,3429,11,23,12,109.1
68960,ne,-99.13727,40.10088,479,13,25,12,92.3
68961,ne,-98.0385,40.20518,1432,15,27,12,80
68964,ne,-97.91272,40.23679,321,15,28,13,86.7
68966,ne,-99.46898,40.14971,1149,16,29,13,81.3
68967,ne,-99.62432,40.25369,1757,15,28,13,86.7
68969,ne,-99.2834,40.30387,106,9,19,10,111.1
68970,ne,-98.51524,40.10887,1620,17,29,12,70.6
68971,ne,-99.24414,40.11796,1076,13,24,11,84.6
68972,ne,-98.80639,40.10798,792,16,29,13,81.3
68973,ne,-98.56398,40.45228,570,11,23,12,109.1
68974,ne,-97.87187,40.13241,372,16,28,12,75
68975,ne,-97.95379,40.62039,302,11,22,11,100
68976,ne,-99.72852,40.5832,569,6,13,7,116.7
68977,ne,-99.63086,40.06985,695,17,30,13,76.5
68978,ks,-98.09148,40.06339,2529,18,30,13,74.35
68979,ne,-97.85126,40.58519,1949,12,24,12,100
68980,ne,-98.25264,40.68126,398,11,23,12,109.1
68981,ne,-98.89663,40.28097,603,12,23,11,91.7
68982,ne,-99.18016,40.33232,825,10,20,10,100
69001,ne,-100.64167,40.24974,6495,9,19,10,111.1
69020,ne,-100.30345,40.2207,665,9,21,12,133.3
69021,ne,-101.54252,40.13765,1803,7,18,11,157.1
69022,ne,-100.18579,40.35961,2145,10,21,11,110
69023,ne,-101.9041,40.48115,906,3,10,7,233.3
69024,ne,-100.85153,40.23234,1647,9,19,10,111.1
69025,ne,-100.51306,40.62268,1300,8,18,10,125
69026,ne,-100.42967,40.04678,399,11,23,12,109.1
69027,ne,-101.53679,40.42728,241,4,11,7,175
69028,ne,-100.0563,40.63541,1055,7,15,8,114.3
69029,ne,-100.25088,40.70962,858,7,16,9,128.6
69030,ne,-101.92309,40.20562,1073,4,12,8,200
69032,ne,-101.02049,40.55802,1189,5,13,8,160
69033,ne,-101.67853,40.56055,2415,4,11,7,175
69034,ne,-100.43075,40.24865,1315,9,20,11,122.2
69036,ne,-100.27435,40.04869,347,12,23,11,91.7
69037,ne,-101.41164,40.19802,294,7,17,10,142.9
69038,ne,-100.73987,40.60863,774,7,16,9,128.6
69039,ne,-100.38837,40.69216,379,8,17,9,112.5
69040,ne,-101.12731,40.35016,1153,6,16,10,166.7
69041,ne,-101.73988,40.17093,504,5,13,8,160
69042,ne,-100.40514,40.4767,195,8,18,10,125
69043,ne,-101.23247,40.13549,1012,7,17,10,142.9
69044,ne,-101.02249,40.12829,1314,9,19,10,111.1
69045,ne,-101.37369,40.47288,1776,4,12,8,200
69046,ne,-100.08653,40.07643,791,13,25,12,92.3
69101,ne,-100.80074,41.1427,14862,5,12,7,140
69120,ne,-100.22695,41.39537,1585,5,13,8,160
69121,ne,-101.69475,41.56649,1007,2,6,4,200
69122,ne,-102.1026,41.13009,1027,2,7,5,250
69123,ne,-100.37259,41.01217,1372,6,13,7,116.7
69125,ne,-102.83345,41.61642,1071,1,5,4,400
69127,ne,-101.91077,41.12373,1495,3,9,6,200
69128,ne,-103.92136,41.22206,1060,0,1,1,NA
69129,ne,-102.41758,41.11257,1724,2,7,5,250
69130,ne,-99.95737,40.88946,3930,7,15,8,114.3
69131,ne,-102.97349,41.40733,946,0,2,2,NA
69132,ne,-100.98319,40.85692,363,4,11,7,175
69133,ne,-103.46028,41.18859,904,0,1,1,NA
69134,ne,-101.36427,40.83783,890,3,10,7,233.3
69135,ne,-100.25946,42.2403,409,5,13,8,160
69138,ne,-100.17418,40.99867,3801,7,16,9,128.6
69140,ne,-101.78045,40.85094,2223,3,10,7,233.3
69141,ne,-102.95502,41.30648,629,1,2,1,100
69142,ne,-100.31727,41.91592,347,5,12,7,140
69143,ne,-101.03918,41.21017,1468,5,12,7,140
69144,ne,-101.58235,41.29015,437,4,11,7,175
69145,ne,-103.67055,41.24633,2995,0,1,1,NA
69146,ne,-101.81756,41.34418,840,3,10,7,233.3
69147,ne,-102.101,41.50658,2288,2,8,6,300
69148,ne,-102.57941,41.58562,844,1,4,3,300
69149,ne,-102.67602,41.21539,1505,2,6,4,200
69150,ne,-101.54354,40.84766,887,4,12,8,200
69151,ne,-100.50407,41.09821,1159,5,12,7,140
69152,ne,-101.13246,42.1091,3371,3,8,5,166.7
69153,ne,-101.67641,41.09965,4115,4,11,7,175
69154,ne,-102.34766,41.43715,2176,2,5,3,150
69155,ne,-101.39563,41.19466,1359,4,11,7,175
69156,ne,-103.33208,41.3111,1211,0,2,2,NA
69157,ne,-100.16162,42.06169,62,6,14,8,133.3
69161,ne,-100.76934,42.13831,487,3,9,6,200
69162,ne,-103.0252,41.12793,5855,1,2,1,100
69163,ne,-100.57079,41.56186,1730,5,12,7,140
69165,ne,-101.22876,41.30702,1789,4,10,6,150
69166,ne,-100.56844,42.07137,2225,4,10,6,150
69167,ne,-101.00338,41.59465,1332,3,9,6,200
69168,ne,-101.98656,40.79913,789,3,9,6,200
69169,ne,-101.16911,40.81754,1338,4,10,6,150
69170,ne,-100.74145,40.79807,997,5,14,9,180
69171,ne,-100.07071,40.89004,51,7,17,10,142.9
69201,ne,-100.61125,42.71524,6108,5,12,6,130
69210,ne,-99.90854,42.37774,3616,6,14,8,133.3
69211,ne,-101.29132,42.82495,1294,3,8,5,166.7
69212,ne,-100.79254,42.93678,885,4,10,6,150
69214,ne,-100.0866,42.60807,870,5,12,7,140
69216,ne,-100.98731,42.98716,946,4,10,6,137.5
69217,ne,-99.71407,42.38758,1034,6,14,8,133.3
69218,ne,-101.66732,42.78855,1396,3,8,5,166.7
69219,ne,-101.10077,42.70609,673,3,8,5,166.7
69220,ne,-100.18995,42.90093,208,6,14,8,133.3
69221,ne,-100.31091,42.5929,1154,5,11,6,120
69301,ne,-102.88318,42.12052,7364,1,3,2,200
69331,ne,-102.98664,41.87285,424,1,2,1,100
69333,ne,-101.9726,42.05929,1004,1,3,2,200
69334,ne,-103.28836,41.8257,2796,2,5,3,150
69335,ne,-102.11393,42.08297,268,1,3,2,200
69336,ne,-103.14123,41.60969,3099,2,7,5,250
69337,ne,-103.01092,42.82658,4643,2,5,3,150
69339,ne,-103.408,42.59534,2223,1,2,1,100
69340,ne,-102.20806,42.21348,603,1,2,1,100
69341,ne,-103.67303,41.73124,5461,1,4,3,300
69343,ne,-102.01489,42.69424,3926,2,5,3,150
69345,ne,-103.74549,41.57515,1212,0,1,1,NA
69346,ne,-103.811,42.68745,2908,0,1,1,NA
69347,ne,-102.67978,42.60772,1987,1,3,2,200
69348,ne,-103.31798,42.28169,2936,1,2,1,100
69350,ne,-101.73276,41.97749,1187,1,4,3,300
69351,ne,-102.41874,42.03697,1372,1,3,2,200
69352,ne,-103.9706,41.80055,1031,1,3,2,200
69353,ne,-103.41651,41.74723,33,2,5,3,150
69354,ne,-103.4077,42.43669,447,1,2,1,100
69355,ne,-103.50794,41.78298,105,1,5,4,400
69356,ne,-103.45119,41.89495,1590,1,4,3,300
69357,ne,-103.8143,42.0755,2928,1,2,1,100
69358,ne,-103.96709,42.06781,1920,1,3,2,200
69360,ne,-102.47174,42.69948,1870,1,3,2,200
69361,ne,-103.62168,41.92459,8582,1,4,3,300
69365,ne,-102.51041,42.96867,118,2,6,4,200
69366,ne,-101.55449,42.1576,1319,2,5,3,150
69367,ne,-103.32851,42.81619,722,2,5,3,150
70001,la,-90.16724,29.98372,17692,53,84,31,58.5
70002,la,-90.1622,30.01053,8278,52,83,31,59.6
70003,la,-90.21397,29.99862,17467,50,82,32,64
70005,la,-90.13393,29.9997,14982,52,83,31,59.6
70006,la,-90.19172,30.01403,5820,50,82,32,64
70030,la,-90.43225,29.81731,2329,51,84,33,64.7
70031,la,-90.29593,29.94194,788,50,82,32,64
70032,la,-89.99779,29.95816,2820,50,82,32,64
70036,la,-90.12115,29.70903,847,45,79,34,75.6
70037,la,-90.00823,29.74826,5451,50,82,32,64
70038,la,-89.39875,29.32533,393,41,76,35,85.4
70039,la,-90.38906,29.88151,1455,52,84,32,61.5
70040,la,-89.94376,29.7474,2282,48,80,32,66.7
70041,la,-89.5346,29.37282,2758,43,78,35,81.4
70043,la,-89.96275,29.94803,9403,49,81,32,65.3
70047,la,-90.36588,29.96953,8188,50,82,32,64
70049,la,-90.57037,30.0289,1043,53,86,33,62.3
70050,la,-89.59202,29.38155,148,45,80,35,77.8
70051,la,-90.63109,30.07288,1151,56,88,32,57.1
70052,la,-90.6995,30.08276,1438,54,86,32,59.3
70053,la,-90.05337,29.91444,15,54,86,32,59.3
70056,la,-90.03029,29.88865,11825,52,83,31,59.6
70057,la,-90.46285,29.96611,2258,51,83,32,62.7
70058,la,-90.06707,29.87053,22201,53,84,31,58.5
70062,la,-90.25569,29.98926,2132,49,80,31,63.3
70065,la,-90.25405,30.02766,2958,49,80,31,63.3
70067,la,-90.10524,29.71426,1409,46,79,33,71.7
70068,la,-90.43473,30.13455,20120,54,86,32,59.3
70070,la,-90.30508,29.83447,6389,52,84,32,61.5
70071,la,-90.70639,30.05465,1595,54,86,32,59.3
70072,la,-90.11041,29.83599,24523,54,86,32,59.3
70075,la,-89.92128,29.93296,2518,47,80,33,70.2
70076,la,-90.64643,30.06503,174,56,88,32,57.1
70079,la,-90.41034,30.00401,4832,50,82,32,64
70080,la,-90.4341,29.88514,976,52,85,33,63.5
70082,la,-89.74974,29.55822,361,40,75,35,87.5
70083,la,-89.86181,29.47251,2584,42,77,35,83.3
70084,la,-90.5679,30.07523,3280,53,85,32,60.4
70085,la,-89.73976,29.83624,3562,48,80,32,66.7
70086,la,-90.87539,30.03201,910,53,84,31,58.5
70087,la,-90.31486,29.9774,5637,49,81,32,65.3
70090,la,-90.70469,29.96848,4049,51,84,33,64.7
70091,la,-89.27166,29.18805,1520,39,73,34,87.2
70092,la,-89.89271,29.89997,3546,47,80,33,70.2
70094,la,-90.20808,29.91348,12632,54,85,31,57.4
70112,la,-90.07694,29.95701,1284,52,84,32,61.5
70113,la,-90.08307,29.94302,3033,54,85,31,57.4
70114,la,-90.03269,29.93796,8707,52,83,31,59.6
70115,la,-90.10195,29.92391,11472,56,87,31,55.4
70116,la,-90.06444,29.96722,5317,52,84,32,61.5
70117,la,-90.02998,29.96849,17867,50,82,32,64
70118,la,-90.12557,29.94515,11113,54,86,32,59.3
70119,la,-90.08703,29.97574,13156,52,84,32,61.5
70121,la,-90.1624,29.96185,6913,54,85,31,57.4
70122,la,-90.06287,30.01314,14620,49,81,32,65.3
70123,la,-90.20509,29.95088,8149,51,83,32,62.7
70124,la,-90.1038,30.00748,9316,52,83,31,59.6
70125,la,-90.10331,29.95207,6174,53,85,32,60.4
70126,la,-90.02117,30.01848,12227,48,80,32,66.7
70127,la,-89.97675,30.02502,9386,49,80,31,63.3
70128,la,-89.95513,30.05107,6955,50,81,31,62
70129,la,-89.81493,30.08225,4816,50,82,32,64
70130,la,-90.06936,29.93681,4126,54,85,31,57.4
70131,la,-89.96117,29.90815,11544,50,82,32,64
70139,la,-90.071,29.95023,1,52,84,32,61.5
70163,la,-90.07544,29.95006,1,52,84,32,61.5
70301,la,-90.74088,29.81392,17598,50,82,32,64
70339,la,-91.18159,29.92372,4019,49,81,32,65.3
70340,la,-91.10429,29.66974,25,41,73,32,78
70341,la,-91.06791,30.03061,2302,53,84,31,58.5
70342,la,-91.23765,29.69485,3302,38,70,32,84.2
70343,la,-90.55716,29.54814,2225,47,80,33,70.2
70344,la,-90.62006,29.19553,4058,44,78,34,77.3
70345,la,-90.26282,29.5512,4911,36,70,34,94.4
70346,la,-91.02769,30.12219,4596,52,83,31,59.6
70352,la,-90.94385,29.68511,106,46,78,32,69.6
70353,la,-90.70531,29.37064,1415,44,77,33,75
70354,la,-90.28482,29.43741,2549,38,71,33,86.8
70355,la,-90.42924,29.69904,444,47,80,33,70.2
70356,la,-90.96074,29.64191,1404,45,77,32,71.1
70357,la,-90.22062,29.24676,1763,43,76,33,76.7
70359,la,-90.77652,29.69403,3242,47,79,32,68.1
70360,la,-90.81029,29.58819,11514,45,77,32,71.1
70363,la,-90.70665,29.51673,9856,46,78,32,69.6
70364,la,-90.68762,29.63435,10833,46,78,32,69.6
70372,la,-90.98905,29.78306,1212,49,81,32,65.3
70373,la,-90.34239,29.59712,3232,39,73,34,87.2
70374,la,-90.49873,29.60197,3083,43,76,33,76.7
70375,la,-90.53682,29.69276,78,44,77,33,75
70377,la,-90.50243,29.34691,2406,43,76,33,76.7
70380,la,-91.11664,29.72187,13765,39,72,33,84.6
70390,la,-91.02726,29.89637,3486,52,83,31,59.6
70391,la,-91.06082,29.9908,128,53,85,32,60.4
70392,la,-91.31669,29.73006,6430,36,68,32,88.9
70393,la,-91.00727,29.99136,382,54,85,31,57.4
70394,la,-90.61105,29.69451,6273,47,80,33,70.2
70395,la,-90.85121,29.693,2248,48,80,32,66.7
70397,la,-90.78594,29.40939,1137,43,76,33,76.7
70401,la,-90.45676,30.52828,9119,57,88,31,54.4
70403,la,-90.48387,30.48002,13112,57,87,30,52.6
70420,la,-89.96749,30.48719,4993,53,83,30,56.6
70422,la,-90.48253,30.73536,6769,54,84,30,55.6
70426,la,-89.85844,30.93347,3808,54,82,28,51.9
70427,la,-89.91087,30.74605,12202,55,84,29,52.7
70431,la,-89.97383,30.61318,1030,49,79,30,61.2
70433,la,-90.13838,30.46328,16488,57,87,30,52.6
70435,la,-90.10716,30.5578,6686,55,85,30,54.5
70436,la,-90.52177,30.80299,359,54,83,29,53.7
70437,la,-90.20867,30.62024,2732,55,85,30,54.5
70438,la,-90.10811,30.84675,11705,52,80,28,53.8
70442,la,-90.32822,30.68958,297,54,84,30,55.6
70443,la,-90.53604,30.62961,5552,56,86,30,53.6
70444,la,-90.48958,30.9066,6928,51,79,28,54.9
70445,la,-89.9128,30.36768,5104,63,91,28,44.4
70446,la,-90.34844,30.62885,4007,56,86,30,53.6
70447,la,-90.2015,30.42119,7217,56,87,31,55.4
70448,la,-90.03944,30.36279,10637,61,89,28,45.9
70449,la,-90.66903,30.25595,3116,54,86,32,59.3
70450,la,-90.26969,30.93702,1925,52,79,27,51.9
70451,la,-90.48088,30.54842,59,57,88,31,54.4
70452,la,-89.78738,30.43009,3414,44,75,31,70.5
70453,la,-90.76647,30.69387,41,53,83,30,56.6
70454,la,-90.37263,30.40096,16976,56,88,32,57.1
70455,la,-90.32464,30.51964,1162,58,88,30,51.7
70456,la,-90.50579,30.78992,1813,54,84,30,55.6
70458,la,-89.7944,30.25867,5715,50,82,32,64
70460,la,-89.83777,30.29571,7483,53,84,31,58.5
70461,la,-89.71582,30.23553,10631,49,81,32,65.3
70462,la,-90.58378,30.3661,4553,55,87,32,58.2
70463,la,-89.90378,30.6586,22,51,80,29,56.9
70464,la,-89.91006,30.53956,97,44,74,30,68.2
70465,la,-90.51979,30.85157,409,52,81,29,55.8
70466,la,-90.50141,30.56806,3947,57,87,30,52.6
70471,la,-90.06231,30.40717,8819,58,88,30,51.7
70501,la,-91.99044,30.23974,14306,55,85,30,54.5
70503,la,-92.06058,30.17282,11209,56,85,29,51.8
70506,la,-92.08131,30.19549,15217,56,85,29,51.8
70507,la,-92.03051,30.28174,7263,57,86,29,50.9
70508,la,-92.02863,30.15552,16729,56,85,29,51.8
70510,la,-92.19965,29.89812,13566,55,84,29,52.7
70512,la,-91.92303,30.41408,6945,61,89,28,45.9
70513,la,-91.90284,29.90359,2,52,82,30,57.7
70514,la,-91.55179,29.84593,1635,34,67,33,97.1
70515,la,-92.56949,30.45217,2186,76,102,26,34.2
70516,la,-92.3037,30.36576,1096,65,94,29,44.6
70517,la,-91.82954,30.29483,17454,55,85,30,54.5
70518,la,-91.92884,30.13341,9033,55,85,30,54.5
70519,la,-91.89733,30.08027,313,56,85,29,51.8
70520,la,-92.03579,30.33201,9587,60,89,29,48.3
70523,la,-91.50106,29.88912,1086,41,73,32,78
70524,la,-92.31129,30.55695,137,78,104,26,33.3
70525,la,-92.22125,30.41231,7772,66,94,28,42.4
70526,la,-92.37984,30.2102,9187,61,90,29,47.5
70528,la,-91.98499,29.93951,928,54,83,29,53.7
70529,la,-92.16229,30.19702,5792,57,86,29,50.9
70531,la,-92.50829,30.23273,909,62,91,29,46.8
70532,la,-92.69759,30.46656,1999,71,98,27,38
70533,la,-92.03971,29.8972,4243,52,82,30,57.7
70534,la,-92.44208,30.19491,485,61,90,29,47.5
70535,la,-92.4264,30.47823,10354,82,106,24,29.3
70537,la,-92.56671,30.25735,315,63,92,29,46
70538,la,-91.58387,29.76576,16533,34,66,32,94.1
70541,la,-92.04576,30.42558,263,66,94,28,42.4
70542,la,-92.5884,30.00521,2920,62,91,29,46.8
70543,la,-92.50081,30.33472,2505,67,96,29,43.3
70544,la,-91.66226,29.9044,7670,46,77,31,67.4
70546,la,-92.66775,30.2652,8434,61,90,29,47.5
70548,la,-92.40737,29.80155,8317,56,85,29,51.8
70549,la,-92.80308,30.07159,2397,62,92,30,48.4
70550,la,-92.18766,30.51859,138,69,96,27,39.1
70552,la,-91.69057,30.06677,1175,53,83,30,56.6
70554,la,-92.47947,30.62256,1902,79,104,25,31.6
70555,la,-92.14557,30.08124,4531,56,85,29,51.8
70556,la,-92.55973,30.19386,172,61,91,30,49.2
70558,la,-92.07576,30.10053,79,55,84,29,52.7
70559,la,-92.50457,30.1248,2282,62,91,29,46.8
70560,la,-91.87027,29.92028,18577,57,86,29,50.9
70563,la,-91.72844,30.02464,9765,56,85,29,51.8
70570,la,-92.10484,30.53274,21786,66,94,28,42.4
70575,la,-92.1581,29.94892,28,56,85,29,51.8
70576,la,-92.41825,30.78097,129,71,97,26,36.6
70577,la,-91.93386,30.5512,2645,61,90,29,47.5
70578,la,-92.26141,30.22932,9286,60,89,29,48.3
70580,la,-92.42833,30.67524,24,77,103,26,33.8
70581,la,-92.73796,30.2518,573,62,92,30,48.4
70582,la,-91.78736,30.15879,13653,54,83,29,53.7
70583,la,-92.12204,30.25965,5553,57,86,29,50.9
70584,la,-92.10135,30.38843,4312,65,93,28,43.1
70585,la,-92.40768,30.87834,95,67,93,26,38.8
70586,la,-92.33756,30.74145,8516,71,97,26,36.6
70589,la,-92.0252,30.68386,2726,63,91,28,44.4
70591,la,-92.83885,30.25534,3494,64,93,29,45.3
70592,la,-92.01238,30.08063,12328,56,85,29,51.8
70601,la,-93.21575,30.22627,28348,63,91,28,44.4
70605,la,-93.27366,30.13065,18917,62,90,28,45.2
70607,la,-93.20414,30.04234,13541,64,91,27,42.2
70611,la,-93.20155,30.34592,12750,65,92,27,41.5
70615,la,-93.12272,30.25363,9821,64,92,28,43.8
70630,la,-93.00632,30.02719,2502,66,94,28,42.4
70631,la,-93.55146,29.86566,2921,65,92,27,41.5
70632,la,-93.02242,29.83783,674,64,92,28,43.8
70633,la,-93.39726,30.42204,9351,65,92,27,41.5
70634,la,-93.23957,30.79397,13938,64,91,27,42.2
70637,la,-92.96705,30.70437,439,67,94,27,40.3
70638,la,-92.79715,30.85434,527,68,94,26,38.2
70639,la,-93.49108,30.98469,552,65,91,26,40
70640,la,-92.90715,30.37079,168,67,95,28,41.8
70643,la,-92.78988,29.78833,822,63,92,29,46
70644,la,-92.94375,30.79158,253,68,94,26,38.2
70645,la,-93.4087,29.96162,1173,68,95,27,39.7
70646,la,-92.92142,30.09882,1247,65,93,28,43.1
70647,la,-93.01872,30.25706,8610,65,93,28,43.1
70648,la,-92.87874,30.50197,4407,66,94,28,42.4
70650,la,-92.92319,30.23734,208,65,93,28,43.1
70651,la,-92.95091,30.544,343,66,94,28,42.4
70652,la,-93.26728,30.6077,1302,65,93,28,43.1
70653,la,-93.56227,30.66346,2386,68,94,26,38.2
70654,la,-92.88403,30.65509,117,65,93,28,43.1
70655,la,-92.72394,30.66447,2303,66,94,28,42.4
70656,la,-92.96961,30.96028,2808,66,92,26,39.4
70657,la,-93.1504,30.50311,3147,66,94,28,42.4
70658,la,-93.04766,30.5287,985,66,94,28,42.4
70659,la,-93.28381,30.92141,426,64,90,26,40.6
70660,la,-93.45027,30.55769,1197,65,92,27,41.5
70661,la,-93.65021,30.35983,4694,62,91,29,46.8
70662,la,-92.99771,30.79891,292,67,93,26,38.8
70663,la,-93.37946,30.28969,21468,63,91,28,44.4
70665,la,-93.45001,30.12592,11483,62,91,29,46.8
70668,la,-93.5989,30.18703,9412,60,89,29,48.3
70669,la,-93.27908,30.24338,10934,64,91,27,42.2
70706,la,-90.90149,30.61376,8673,51,81,30,58.8
70710,la,-91.25938,30.35314,1667,52,82,30,57.7
70711,la,-90.59956,30.5316,2300,55,86,31,56.4
70712,la,-91.59644,30.96941,1,51,79,28,54.9
70714,la,-91.12769,30.58647,8948,50,80,30,60
70715,la,-91.67792,30.75799,1258,52,81,29,55.8
70719,la,-91.28984,30.37695,1702,52,82,30,57.7
70721,la,-91.08692,30.2182,203,50,81,31,62
70722,la,-90.93156,30.84249,3979,47,75,28,59.6
70723,la,-90.83844,30.05946,907,53,84,31,58.5
70725,la,-90.9582,30.13056,931,52,83,31,59.6
70726,la,-90.89896,30.42799,23116,51,81,30,58.8
70729,la,-91.35054,30.58605,592,53,83,30,56.6
70730,la,-91.10125,30.81631,2304,47,75,28,59.6
70732,la,-91.60424,30.61795,779,51,81,30,58.8
70733,la,-90.79596,30.30427,978,52,83,31,59.6
70734,la,-91.00205,30.20292,3497,51,82,31,60.8
70736,la,-91.33842,30.63232,285,54,84,30,55.6
70737,la,-90.92222,30.22514,18508,51,83,32,62.7
70739,la,-90.97055,30.59834,6158,50,80,30,60
70740,la,-91.43524,30.33987,865,53,83,30,56.6
70743,la,-90.77435,30.02739,163,51,83,32,62.7
70744,la,-90.67611,30.55825,2643,54,85,31,57.4
70747,la,-91.68109,30.87462,154,53,81,28,52.8
70748,la,-91.20543,30.81405,2366,49,78,29,59.2
70749,la,-91.4026,30.63865,1090,53,83,30,56.6
70750,la,-91.76619,30.50028,1699,56,85,29,51.8
70752,la,-91.40776,30.58221,499,53,83,30,56.6
70753,la,-91.72703,30.94499,842,54,82,28,51.9
70754,la,-90.74288,30.40398,5270,52,83,31,59.6
70755,la,-91.53003,30.59332,1232,52,82,30,57.7
70756,la,-91.61416,30.54682,358,52,82,30,57.7
70757,la,-91.51875,30.48846,2170,53,83,30,56.6
70759,la,-91.5776,30.69753,1091,52,81,29,55.8
70760,la,-91.45552,30.70662,3982,53,82,29,54.7
70761,la,-91.02397,30.97611,802,48,75,27,56.3
70762,la,-91.46858,30.57673,768,53,83,30,56.6
70763,la,-90.74161,30.04387,1889,52,85,33,63.5
70764,la,-91.2883,30.2262,7968,51,82,31,60.8
70767,la,-91.32295,30.47422,6983,51,81,30,58.8
70769,la,-90.9405,30.30732,17942,50,82,32,64
70770,la,-90.9973,30.6502,1652,50,79,29,58
70772,la,-91.46865,30.43696,524,53,83,30,56.6
70773,la,-91.36328,30.60887,98,53,83,30,56.6
70774,la,-90.77374,30.20767,5099,52,84,32,61.5
70775,la,-91.36864,30.86013,5081,52,81,29,55.8
70776,la,-91.08994,30.26353,1535,49,80,31,63.3
70777,la,-91.06998,30.7383,2116,49,78,29,59.2
70778,la,-90.8607,30.15333,1394,53,85,32,60.4
70780,la,-91.1698,30.29536,564,50,80,30,60
70782,la,-91.51858,30.94372,236,51,79,28,54.9
70783,la,-91.40434,30.68344,1756,53,83,30,56.6
70785,la,-90.81817,30.55887,9171,52,82,30,57.7
70787,la,-91.44319,30.96309,92,49,78,29,59.2
70788,la,-91.1736,30.13636,1844,50,82,32,64
70789,la,-91.08262,30.93177,672,47,75,28,59.6
70791,la,-91.15565,30.65219,13529,50,80,30,60
70801,la,-91.18598,30.44965,266,50,80,30,60
70802,la,-91.17751,30.44381,16980,51,81,30,58.8
70805,la,-91.15936,30.4885,14252,50,80,30,60
70806,la,-91.12475,30.44876,12262,50,80,30,60
70807,la,-91.21105,30.54298,10508,50,80,30,60
70808,la,-91.14252,30.40565,13021,51,81,30,58.8
70809,la,-91.0711,30.39381,10426,50,81,31,62
70810,la,-91.08309,30.3454,17465,50,81,31,62
70811,la,-91.11677,30.53202,7338,50,80,30,60
70812,la,-91.11044,30.50073,4028,50,80,30,60
70814,la,-91.068,30.48517,5684,50,80,30,60
70815,la,-91.06626,30.45546,10710,50,80,30,60
70816,la,-91.02137,30.42898,13396,50,81,31,62
70817,la,-90.98091,30.37604,14443,50,81,31,62
70818,la,-91.04988,30.54253,4660,50,80,30,60
70819,la,-91.0109,30.47401,2191,50,80,30,60
70820,la,-91.18538,30.36901,6429,52,82,30,57.7
70836,la,-91.09034,30.39125,8,49,80,31,63.3
71001,la,-92.89718,32.59456,3244,59,82,23,39
71003,la,-93.02959,32.62877,1127,59,83,24,40.7
71004,la,-93.8631,32.74838,1302,62,87,25,40.3
71006,la,-93.63357,32.72758,11364,61,86,25,41
71007,la,-94.00666,32.3691,801,63,87,24,38.1
71008,la,-92.96683,32.3404,1464,63,86,23,36.5
71016,la,-93.10821,32.23253,1862,60,84,24,40
71018,la,-93.42624,32.8225,1986,63,87,24,38.1
71019,la,-93.31011,32.04803,5847,64,87,23,35.9
71021,la,-93.44615,32.96713,688,63,87,24,38.1
71023,la,-93.40682,32.47803,2984,62,87,25,40.3
71024,la,-93.20459,32.48749,1315,62,86,24,38.7
71027,la,-93.67305,32.2452,1627,61,86,25,41
71028,la,-93.07598,32.4897,2193,61,85,24,39.3
71029,la,-93.83537,32.83987,448,64,88,24,37.5
71030,la,-93.79084,32.193,748,63,87,24,38.1
71031,la,-92.90579,32.00837,683,67,90,23,34.3
71032,la,-93.79298,32.09478,2321,63,88,25,39.7
71033,la,-94.00273,32.43696,2403,62,87,25,40.3
71034,la,-93.3069,32.18368,205,60,84,24,40
71037,la,-93.52332,32.56947,13069,61,85,24,39.3
71038,la,-93.06438,32.94416,4163,63,86,23,36.5
71039,la,-93.29391,32.42689,1773,60,85,25,41.7
71040,la,-93.01985,32.78258,7008,65,88,23,35.4
71043,la,-93.88476,32.88586,725,65,89,24,36.9
71044,la,-93.8822,32.96823,1458,64,88,24,37.5
71045,la,-93.1826,32.35247,688,62,86,24,38.7
71046,la,-93.95028,32.16405,1236,63,88,25,39.7
71047,la,-93.91818,32.29784,7236,63,87,24,38.1
71048,la,-92.84559,32.83852,239,63,86,23,36.5
71049,la,-93.96558,32.01288,3179,67,91,24,35.8
71051,la,-93.49112,32.34344,3216,61,86,25,41
71052,la,-93.66506,32.00943,8588,63,87,24,38.1
71055,la,-93.29824,32.67248,12677,62,86,24,38.7
71060,la,-93.98425,32.64679,3450,62,87,25,40.3
71061,la,-93.96638,32.76707,2520,64,88,24,37.5
71063,la,-93.51125,31.9091,1035,63,86,23,36.5
71064,la,-93.68567,32.91071,7218,62,87,25,40.3
71065,la,-93.50567,31.80769,1197,61,85,24,39.3
71067,la,-93.4935,32.59682,2191,60,85,25,41.7
71068,la,-93.32182,32.28367,3165,60,85,25,41.7
71069,la,-93.9875,32.9663,1222,64,88,24,37.5
71070,la,-93.01342,32.10238,2423,63,86,23,36.5
71071,la,-93.4557,32.92379,2132,64,87,23,35.9
71072,la,-93.31261,32.93725,1778,63,87,24,38.1
71073,la,-93.30693,32.52343,1512,62,86,24,38.7
71075,la,-93.49924,32.99337,4673,63,87,24,38.1
71078,la,-93.79334,32.272,2816,62,87,25,40.3
71079,la,-92.81477,32.93909,322,63,85,22,34.9
71082,la,-93.98027,32.83647,4394,64,88,24,37.5
71101,la,-93.74682,32.50611,5755,59,84,25,42.4
71103,la,-93.77209,32.49194,5714,60,85,25,41.7
71104,la,-93.73255,32.48492,6363,60,85,25,41.7
71105,la,-93.70977,32.45675,8154,61,86,25,41
71106,la,-93.73635,32.38572,18671,62,86,24,38.7
71107,la,-93.85886,32.59662,19905,60,86,26,43.3
71108,la,-93.7885,32.44262,9087,62,86,24,38.7
71109,la,-93.81378,32.46869,11597,61,86,25,41
71110,la,-93.59974,32.50011,70,60,85,25,41.7
71111,la,-93.70314,32.58156,20090,59,84,25,42.4
71112,la,-93.63618,32.44251,14180,61,86,25,41
71115,la,-93.56901,32.26849,6320,62,86,24,38.7
71118,la,-93.80533,32.39271,8672,62,86,24,38.7
71119,la,-93.9298,32.48452,6306,61,86,25,41
71129,la,-93.92384,32.38799,5688,62,87,25,40.3
71201,la,-92.10524,32.53297,12037,63,86,23,36.5
71202,la,-92.05622,32.39602,14140,63,85,22,34.9
71203,la,-92.01768,32.5828,16237,62,85,23,37.1
71209,la,-92.07003,32.52913,6,63,85,22,34.9
71219,la,-91.68425,32.32305,766,57,80,23,40.4
71220,la,-91.91139,32.86487,15511,61,84,23,37.7
71222,la,-92.65794,32.82676,2708,63,86,23,36.5
71223,la,-91.66024,32.89244,720,57,80,23,40.4
71225,la,-92.34423,32.51038,4905,64,86,22,34.4
71226,la,-92.44543,32.25255,2130,65,87,22,33.8
71227,la,-92.4804,32.53466,3147,63,85,22,34.9
71229,la,-91.89322,32.63902,1103,61,83,22,36.1
71232,la,-91.47355,32.3953,4134,55,78,23,41.8
71234,la,-92.34164,32.64414,2862,63,85,22,34.9
71235,la,-92.67431,32.69053,4083,64,87,23,35.9
71237,la,-91.49196,32.59249,871,58,81,23,39.7
71238,la,-92.37884,32.36779,2318,64,86,22,34.4
71241,la,-92.36294,32.77185,4576,63,85,22,34.9
71243,la,-91.81107,31.95723,221,59,82,23,39
71245,la,-92.72199,32.52971,1412,60,84,24,40
71247,la,-92.72174,32.27238,812,64,87,23,35.9
71250,la,-91.57614,32.95895,536,57,80,23,40.4
71251,la,-92.67172,32.21631,5698,63,86,23,36.5
71253,la,-91.30945,32.9912,112,56,79,23,41.1
71254,la,-91.25569,32.79697,4287,56,79,23,41.1
71256,la,-92.7229,32.95108,402,63,85,22,34.9
71259,la,-91.84624,32.27256,1475,58,81,23,39.7
71260,la,-92.2388,32.90791,2836,59,82,23,39
71261,la,-91.69885,32.77218,1704,58,81,23,39.7
71263,la,-91.42562,32.86899,4549,57,80,23,40.4
71264,la,-91.77469,32.60213,1180,55,78,23,41.8
71266,la,-91.49626,32.69813,1228,58,81,23,39.7
71268,la,-92.74097,32.3471,2146,63,86,23,36.5
71269,la,-91.78693,32.4457,8142,52,76,24,46.2
71270,la,-92.63933,32.49459,14990,61,84,23,37.7
71272,la,-92.64934,32.52687,14,60,83,23,38.3
71275,la,-92.82081,32.51341,2083,61,84,23,37.7
71276,la,-91.14942,32.57553,276,53,77,24,45.3
71277,la,-92.55721,32.94944,1462,62,84,22,35.5
71279,la,-91.85712,32.48736,16,53,77,24,45.3
71280,la,-92.09702,32.72601,2631,63,85,22,34.9
71282,la,-91.18107,32.3649,1,52,76,24,46.2
71286,la,-91.19644,32.66446,722,55,78,23,41.8
71291,la,-92.18198,32.57004,16427,64,86,22,34.4
71292,la,-92.21429,32.40101,13060,64,86,22,34.4
71295,la,-91.70694,32.14741,8442,61,84,23,37.7
71301,la,-92.46877,31.27428,11012,68,93,25,36.8
71302,la,-92.3775,31.20427,8498,68,93,25,36.8
71303,la,-92.54372,31.27807,9011,67,91,24,35.8
71316,la,-91.75987,31.26252,224,57,84,27,47.4
71322,la,-92.14658,30.86409,4569,64,90,26,40.6
71323,la,-92.20838,31.265,731,66,90,24,36.4
71325,la,-92.32197,31.00132,1302,66,91,25,37.9
71326,la,-91.60945,31.77055,1090,51,77,26,51
71327,la,-92.03353,30.98263,2596,63,89,26,41.3
71328,la,-92.1755,31.36087,5630,67,91,24,35.8
71331,la,-92.08171,31.26464,1010,64,89,25,39.1
71333,la,-92.07389,30.90603,638,63,89,26,41.3
71334,la,-91.56304,31.65641,5219,50,76,26,52
71336,la,-91.59336,32.02121,1396,59,82,23,39
71339,la,-91.93229,31.01383,116,60,87,27,45
71340,la,-91.8107,31.76918,832,57,82,25,43.9
71341,la,-92.16498,31.06165,1876,64,90,26,40.6
71342,la,-92.138,31.60486,5489,61,85,24,39.3
71343,la,-91.90443,31.51699,5983,59,84,25,42.4
71345,la,-91.97546,30.72922,9,60,88,28,46.7
71346,la,-92.37613,31.11305,2595,68,93,25,36.8
71350,la,-92.06899,31.06814,2897,63,88,25,39.7
71351,la,-91.96283,31.17739,7904,63,88,25,39.7
71353,la,-91.8187,30.75051,1555,52,82,30,57.7
71354,la,-91.76946,31.40668,1442,57,83,26,45.6
71355,la,-91.85007,31.07852,2669,59,86,27,45.8
71356,la,-92.04829,30.82063,533,63,90,27,42.9
71357,la,-91.29867,32.11113,2318,55,79,24,43.6
71358,la,-91.86611,30.69304,1224,56,85,29,51.8
71360,la,-92.35299,31.32038,17214,67,92,25,37.3
71362,la,-91.96621,30.89645,1898,61,88,27,44.3
71366,la,-91.33851,31.93956,2279,57,81,24,42.1
71367,la,-92.29376,30.88324,722,66,92,26,39.4
71368,la,-91.68798,31.86469,1153,55,79,24,43.6
71369,la,-91.86746,30.92283,1634,58,85,27,46.6
71371,la,-92.25658,31.67912,2210,61,85,24,39.3
71373,la,-91.60792,31.30965,5010,47,74,27,57.4
71375,la,-91.47555,31.84919,1337,51,76,25,49
71377,la,-91.78651,31.61107,57,57,82,25,43.9
71378,la,-91.70933,31.95538,1653,58,81,23,39.7
71401,la,-91.94593,31.79747,83,57,82,25,43.9
71403,la,-93.43254,31.21495,2686,60,86,26,43.3
71404,la,-92.74909,31.74823,132,65,89,24,36.9
71405,la,-92.40098,31.40947,2716,66,91,25,37.9
71406,la,-93.50458,31.7331,165,60,84,24,40
71407,la,-92.48598,31.51594,477,63,87,24,38.1
71409,la,-92.7074,31.31964,5051,63,88,25,39.7
71411,la,-93.08993,31.9049,2190,69,92,23,33.3
71414,la,-93.02468,31.82639,81,70,93,23,32.9
71416,la,-92.91219,31.5379,574,65,90,25,38.5
71417,la,-92.6541,31.51539,2927,64,89,25,39.1
71418,la,-92.0555,32.14303,5040,61,84,23,37.7
71419,la,-93.70938,31.80197,2605,63,87,24,38.1
71423,la,-92.56737,31.6081,2019,63,88,25,39.7
71424,la,-92.67218,31.18521,932,67,91,24,35.8
71425,la,-91.8988,31.88611,267,59,82,23,39
71426,la,-93.4599,31.49894,134,59,84,25,42.4
71427,la,-92.89248,31.396,293,61,86,25,41
71429,la,-93.42731,31.40622,3832,61,86,25,41
71430,la,-92.50057,31.04033,1966,67,92,25,37.3
71433,la,-92.64661,31.00163,4184,67,93,26,38.8
71435,la,-92.1637,32.03091,2743,60,83,23,38.3
71438,la,-92.82484,31.11376,1245,64,89,25,39.1
71439,la,-93.3963,31.33691,1052,58,84,26,44.8
71441,la,-92.14072,31.94402,774,60,83,23,38.3
71446,la,-93.18772,31.16717,10554,60,86,26,43.3
71447,la,-92.81208,31.43689,1386,63,88,25,39.7
71449,la,-93.51997,31.54279,9070,62,86,24,38.7
71450,la,-93.41056,31.77816,1084,63,87,24,38.1
71452,la,-92.94179,31.5787,92,66,90,24,36.4
71454,la,-92.8612,31.69264,1305,65,90,25,38.5
71455,la,-92.97938,31.40506,258,61,86,25,41
71456,la,-92.97666,31.63654,1143,68,92,24,35.3
71457,la,-93.09296,31.74636,12754,69,92,23,33.3
71459,la,-93.21789,31.07667,14,57,83,26,45.6
71461,la,-93.29019,31.11835,825,60,86,26,43.3
71462,la,-93.71398,31.66308,976,63,87,24,38.1
71463,la,-92.61257,30.80781,5557,70,96,26,37.1
71465,la,-92.18813,31.8677,2753,60,84,24,40
71466,la,-92.74863,31.21515,379,64,89,25,39.1
71467,la,-92.39541,31.55787,2638,65,90,25,38.5
71468,la,-93.14767,31.481,958,64,89,25,39.1
71469,la,-93.26634,31.69021,2709,65,89,24,36.9
71472,la,-92.79374,31.19838,310,64,89,25,39.1
71474,la,-93.01388,31.27411,363,61,86,25,41
71479,la,-92.36354,31.85467,945,62,86,24,38.7
71480,la,-92.2918,31.86294,562,62,85,23,37.1
71485,la,-92.54527,31.15499,1336,68,93,25,36.8
71486,la,-93.61821,31.64931,3892,63,87,24,38.1
71601,ar,-91.90318,34.17716,11783,47,69,22,46.8
71602,ar,-92.14304,34.26709,12868,48,69,21,43.8
71603,ar,-92.08628,34.12637,19676,47,68,21,44.7
71630,ar,-91.20854,33.62321,638,52,74,22,42.3
71631,ar,-92.26493,33.58005,1488,52,74,22,42.3
71635,ar,-92.00058,33.13019,8388,51,74,23,45.1
71638,ar,-91.48057,33.51928,3999,55,77,22,40
71639,ar,-91.52668,33.89813,3849,51,74,23,45.1
71640,ar,-91.2836,33.10571,3474,57,80,23,40.4
71642,ar,-91.89069,33.38758,741,51,74,23,45.1
71643,ar,-91.57343,34.01746,1319,50,72,22,44
71644,ar,-91.70397,34.09406,886,47,69,22,46.8
71646,ar,-91.7838,33.23112,6125,52,75,23,44.2
71647,ar,-92.11937,33.36486,3430,54,77,23,42.6
71651,ar,-92.28225,33.31759,540,57,79,22,38.6
71652,ar,-92.33568,33.93065,1538,49,71,22,44.9
71653,ar,-91.25683,33.34045,4225,55,77,22,40
71654,ar,-91.36946,33.62056,2328,55,77,22,40
71655,ar,-91.7465,33.63091,7266,46,69,23,50
71658,ar,-91.57216,33.31535,1256,55,78,23,41.8
71659,ar,-91.77588,34.14357,121,46,68,22,47.8
71660,ar,-92.18748,33.76075,1446,49,72,23,46.9
71661,ar,-91.54705,33.14896,817,57,80,23,40.4
71662,ar,-91.50225,33.84199,44,52,75,23,44.2
71663,ar,-91.43142,33.22984,799,56,80,24,42.9
71665,ar,-92.11528,33.93397,3596,48,70,22,45.8
71666,ar,-91.28223,33.76109,27,48,70,22,45.8
71667,ar,-91.8307,33.92542,4685,46,69,23,50
71670,ar,-91.40689,33.7369,1801,50,73,23,46
71671,ar,-92.10148,33.60432,6933,48,71,23,47.9
71674,ar,-91.19064,33.8413,1223,47,70,23,48.9
71675,ar,-91.93909,33.58848,1680,49,72,23,46.9
71676,ar,-91.56856,33.05413,1150,57,80,23,40.4
71677,ar,-91.48065,33.76356,222,51,74,23,45.1
71701,ar,-92.81988,33.58636,8926,55,77,22,40
71711,ar,-92.72026,33.63758,26,54,76,22,40.7
71720,ar,-92.64824,33.78103,2344,50,72,22,44
71722,ar,-93.15367,33.71536,279,54,76,22,40.7
71724,ar,-92.53586,33.32741,319,56,78,22,39.3
71725,ar,-92.55295,34.04519,1445,47,69,22,46.8
71726,ar,-92.99642,33.67896,2777,54,75,21,38.9
71730,ar,-92.62908,33.20064,18654,58,80,22,37.9
71740,ar,-93.16371,33.08114,2091,61,83,22,36.1
71742,ar,-92.45283,33.84887,5722,48,70,22,45.8
71743,ar,-93.11778,33.88688,4540,54,75,21,38.9
71744,ar,-92.47804,33.49275,6487,54,76,22,40.7
71745,ar,-92.3961,33.50082,296,52,75,23,44.2
71747,ar,-92.21504,33.05957,1915,59,82,23,39
71749,ar,-92.82033,33.07174,2952,61,83,22,36.1
71751,ar,-92.76688,33.40706,1437,57,79,22,38.6
71752,ar,-93.19552,33.4009,529,56,79,23,41.1
71753,ar,-93.18405,33.23018,6268,58,80,22,37.9
71758,ar,-92.91425,33.30757,984,58,80,22,37.9
71759,ar,-92.64417,33.32098,279,57,79,22,38.6
71762,ar,-92.77121,33.33794,1724,57,79,22,38.6
71763,ar,-92.79794,33.91828,3114,52,73,21,40.4
71764,ar,-93.04685,33.43171,3150,57,78,21,36.8
71765,ar,-92.33117,33.13198,2809,59,81,22,37.3
71766,ar,-92.50979,33.72221,1321,48,70,22,45.8
71770,ar,-93.31799,33.38942,2195,58,80,22,37.9
71772,ar,-93.12617,33.83275,62,55,76,21,38.2
71801,ar,-93.59442,33.64422,9563,54,77,23,42.6
71820,ar,-94.26811,33.7944,254,58,81,23,39.7
71822,ar,-94.15645,33.66112,8879,58,80,22,37.9
71823,ar,-94.12547,33.8235,178,58,81,23,39.7
71825,ar,-93.55981,33.87815,579,53,75,22,41.5
71826,ar,-93.72342,33.09208,1325,63,87,24,38.1
71827,ar,-93.41149,33.42485,1105,59,81,22,37.3
71832,ar,-94.35095,34.03779,5940,62,83,21,33.9
71833,ar,-94.04119,34.14471,1847,51,73,22,43.1
71834,ar,-93.95383,33.11633,2807,63,87,24,38.1
71835,ar,-93.44502,33.66469,1581,57,79,22,38.6
71836,ar,-94.39697,33.71557,3118,60,83,23,38.3
71837,ar,-93.85445,33.25781,3628,61,84,23,37.7
71838,ar,-93.80623,33.65163,1218,58,80,22,37.9
71839,ar,-93.73556,33.31305,508,59,82,23,39
71841,ar,-94.3392,34.16034,1094,55,77,22,40
71842,ar,-94.28709,33.90169,1630,60,82,22,36.7
71845,ar,-93.62751,33.32423,2998,58,81,23,39.7
71846,ar,-94.12418,33.94124,3082,57,79,22,38.6
71847,ar,-93.63494,33.92683,808,52,74,22,42.3
71851,ar,-93.94246,33.85657,1906,57,79,22,38.6
71852,ar,-93.85538,33.99921,6989,50,73,23,46
71853,ar,-93.94653,33.59097,561,57,80,23,40.4
71854,ar,-93.90121,33.44702,19310,58,81,23,39.7
71855,ar,-93.74623,33.86184,935,53,75,22,41.5
71857,ar,-93.34538,33.80575,6006,57,79,22,38.6
71858,ar,-93.26614,33.58906,3578,55,77,22,40
71859,ar,-93.90825,33.74897,503,56,79,23,41.1
71860,ar,-93.48877,33.30174,2566,58,81,23,39.7
71861,ar,-93.49285,33.10318,2288,62,86,23,36.8
71862,ar,-93.73418,33.76965,821,54,77,23,42.6
71865,ar,-94.14993,33.74116,215,57,80,23,40.4
71866,ar,-94.40399,33.88049,817,60,82,22,36.7
71901,ar,-92.9716,34.52699,17208,51,71,20,39.2
71909,ar,-92.9994,34.64091,35247,48,68,20,41.7
71913,ar,-93.09525,34.44814,27875,48,69,21,43.8
71921,ar,-93.39343,34.24923,3962,47,68,21,44.7
71922,ar,-93.41947,34.02443,117,54,75,21,38.9
71923,ar,-93.04605,34.08195,11099,52,73,21,40.4
71929,ar,-93.16263,34.30583,3253,48,69,21,43.8
71933,ar,-93.42233,34.41033,1476,44,65,21,47.7
71935,ar,-93.76369,34.39132,1240,44,65,21,47.7
71937,ar,-94.38947,34.39985,1933,42,64,22,52.4
71940,ar,-93.50975,34.02056,1937,52,74,22,42.3
71941,ar,-92.95189,34.24828,1620,49,70,21,42.9
71943,ar,-93.59481,34.33945,3195,46,67,21,45.7
71944,ar,-94.33419,34.24348,848,50,71,21,42
71945,ar,-94.33954,34.48403,1497,42,63,21,50
71949,ar,-93.21898,34.69503,2324,44,64,20,45.5
71950,ar,-93.71029,34.24822,992,45,66,21,46.7
71952,ar,-93.8536,34.3039,219,45,66,21,46.7
71953,ar,-94.19484,34.61428,13003,40,61,21,52.5
71956,ar,-93.15386,34.59765,1168,45,65,20,44.4
71957,ar,-93.58001,34.56372,3222,44,65,21,47.7
71958,ar,-93.66606,34.11258,2806,44,66,22,50
71959,ar,-93.93293,34.24728,714,44,65,21,47.7
71960,ar,-93.70888,34.47901,1932,44,64,20,45.5
71961,ar,-93.84062,34.59808,1083,47,68,21,44.7
71962,ar,-93.32633,34.03346,1909,53,74,21,39.6
71964,ar,-93.24348,34.42299,2091,45,65,20,44.4
71965,ar,-93.74268,34.66557,352,48,68,20,41.7
71968,ar,-93.29728,34.52731,3668,43,64,21,48.8
71969,ar,-93.63223,34.6661,556,47,67,20,42.6
71970,ar,-93.49163,34.66454,1167,47,67,20,42.6
71971,ar,-94.03721,34.30391,598,44,65,21,47.7
71972,ar,-94.27147,34.38666,481,42,63,21,50
71973,ar,-94.3173,34.29961,1343,46,68,22,47.8
71998,ar,-93.05368,34.12585,5,53,74,21,39.6
71999,ar,-93.05907,34.12746,17,53,74,21,39.6
72001,ar,-92.87931,35.06641,474,50,70,20,40
72002,ar,-92.52899,34.66297,9346,46,67,21,45.7
72003,ar,-91.39772,34.38597,865,43,64,21,48.8
72004,ar,-91.77965,34.2822,2025,46,68,22,47.8
72005,ar,-91.07152,35.53999,368,42,62,20,47.6
72006,ar,-91.3512,35.24536,3417,42,64,22,52.4
72007,ar,-91.98198,35.00249,3880,40,61,21,52.5
72010,ar,-91.53611,35.32025,4445,41,63,22,53.7
72011,ar,-92.47154,34.51183,2490,48,69,21,43.8
72012,ar,-91.91747,35.09827,6389,42,64,22,52.4
72013,ar,-92.36833,35.45671,2229,36,55,19,52.8
72014,ar,-91.1113,35.4326,91,42,63,21,50
72015,ar,-92.58957,34.49334,14020,48,69,21,43.8
72016,ar,-92.63171,34.97077,2758,50,70,20,40
72017,ar,-91.41027,34.89738,935,41,62,21,51.2
72019,ar,-92.68946,34.63537,13591,47,68,21,44.7
72020,ar,-91.47505,35.47233,3645,37,59,22,59.5
72021,ar,-91.22426,34.84678,4132,38,60,22,57.9
72022,ar,-92.48826,34.60435,6014,46,67,21,45.7
72023,ar,-92.0565,34.95755,15461,40,61,21,52.5
72024,ar,-91.75095,34.76848,2984,42,63,21,50
72025,ar,-92.99817,35.05527,925,48,68,20,41.7
72026,ar,-91.30633,34.50989,537,42,64,22,52.4
72027,ar,-92.57657,35.37107,1389,42,62,20,47.6
72029,ar,-91.23379,34.70695,1482,39,61,22,56.4
72030,ar,-92.6812,35.43579,842,43,64,21,48.8
72031,ar,-92.52566,35.61347,8468,32,51,19,59.4
72032,ar,-92.36152,35.07329,16366,49,70,21,42.9
72034,ar,-92.48673,35.05035,16613,50,71,21,42
72035,ar,-92.4574,35.07878,1,50,71,21,42
72036,ar,-91.27137,35.00633,2309,42,63,21,50
72037,ar,-91.87349,34.53888,25,42,63,21,50
72038,ar,-91.24349,34.44619,196,44,66,22,50
72039,ar,-92.40284,35.35542,2053,40,60,20,50
72040,ar,-91.5404,34.97643,2739,43,64,21,48.8
72041,ar,-91.47395,34.72608,1881,40,61,21,52.5
72042,ar,-91.31613,34.26766,4288,45,67,22,48.9
72044,ar,-92.17144,35.67217,2082,34,53,19,55.9
72045,ar,-92.04844,35.12897,1123,42,63,21,50
72046,ar,-91.9561,34.55647,3995,41,62,21,51.2
72047,ar,-92.21069,35.2238,1057,44,65,21,47.7
72048,ar,-91.12362,34.23177,414,46,68,22,47.8
72051,ar,-92.30833,35.78843,757,25,42,17,68
72055,ar,-91.36253,34.10242,1065,44,66,22,50
72057,ar,-92.31455,34.14421,1150,47,69,22,46.8
72058,ar,-92.37061,35.24214,10523,44,65,21,47.7
72059,ar,-91.315,35.1396,211,43,64,21,48.8
72060,ar,-91.60112,35.08405,724,44,65,21,47.7
72061,ar,-92.29908,35.32187,154,37,57,20,54.1
72063,ar,-92.77242,35.323,1695,48,69,21,43.8
72064,ar,-91.61097,34.79207,2462,41,63,22,53.7
72065,ar,-92.28891,34.52076,3481,48,69,21,43.8
72067,ar,-92.15824,35.56461,5219,36,56,20,55.6
72068,ar,-91.71076,35.1903,277,46,68,22,47.8
72069,ar,-91.13089,34.53483,2701,43,64,21,48.8
72070,ar,-92.70854,35.00986,1601,50,70,20,40
72072,ar,-91.73981,34.52492,686,44,65,21,47.7
72073,ar,-91.66963,34.37218,1451,45,66,21,46.7
72074,ar,-91.09059,35.08195,506,42,63,21,50
72076,ar,-92.14355,34.91143,15928,44,65,21,47.7
72079,ar,-92.17615,34.39059,693,46,67,21,45.7
72080,ar,-92.80507,35.52426,1103,31,50,19,61.3
72081,ar,-91.6698,35.37933,4761,43,64,21,48.8
72082,ar,-91.67365,35.23286,1135,46,68,22,47.8
72083,ar,-92.01355,34.59396,238,38,60,22,57.9
72084,ar,-92.6637,34.14418,1468,46,68,22,47.8
72085,ar,-91.82912,35.36391,163,46,68,22,47.8
72086,ar,-91.90937,34.80896,6261,41,63,22,53.7
72087,ar,-92.83114,34.59481,2888,47,68,21,44.7
72088,ar,-92.267,35.59795,14329,37,57,20,54.1
72101,ar,-91.15673,35.24001,4307,42,63,21,50
72102,ar,-91.83543,35.14594,1895,44,65,21,47.7
72103,ar,-92.38374,34.5898,7092,47,68,21,44.7
72104,ar,-92.82353,34.3435,12041,48,69,21,43.8
72106,ar,-92.48264,34.96675,3208,48,69,21,43.8
72107,ar,-92.5417,35.14341,427,51,71,20,39.2
72108,ar,-91.1031,34.70575,109,41,62,21,51.2
72110,ar,-92.77583,35.15483,8518,52,72,20,38.5
72111,ar,-92.13191,35.23589,1309,41,62,21,51.2
72112,ar,-91.22614,35.57974,7732,42,63,21,50
72113,ar,-92.39893,34.85943,9208,47,68,21,44.7
72114,ar,-92.25846,34.76444,6546,47,69,22,46.8
72116,ar,-92.24495,34.80044,8229,48,69,21,43.8
72117,ar,-92.14387,34.77744,8478,46,68,22,47.8
72118,ar,-92.32981,34.8414,10744,48,69,21,43.8
72120,ar,-92.24108,34.89894,15354,47,68,21,44.7
72121,ar,-91.78609,35.45536,2233,42,63,21,50
72122,ar,-92.7774,34.7824,1197,45,66,21,46.7
72123,ar,-91.2354,35.25873,290,42,63,21,50
72125,ar,-92.78676,35.06788,724,52,72,20,38.5
72126,ar,-92.91477,34.93769,3180,49,69,20,40.8
72127,ar,-92.60253,35.16655,2042,51,72,21,41.2
72128,ar,-92.63303,34.31946,105,49,70,21,42.9
72129,ar,-92.54197,34.32777,296,48,69,21,43.8
72130,ar,-92.07053,35.66415,531,28,46,18,64.3
72131,ar,-92.19206,35.41012,4348,34,54,20,58.8
72132,ar,-92.20561,34.44936,2014,45,67,22,48.9
72134,ar,-91.3687,34.62873,480,40,61,21,52.5
72135,ar,-92.55277,34.87579,2444,48,69,21,43.8
72136,ar,-92.0163,35.23579,1656,39,60,21,53.8
72137,ar,-92.03001,35.33693,1698,34,53,19,55.9
72139,ar,-91.50776,35.36101,134,41,63,22,53.7
72140,ar,-91.16068,34.36787,443,46,68,22,47.8
72141,ar,-92.67971,35.51824,848,37,56,19,51.4
72142,ar,-92.05828,34.69515,2623,41,63,22,53.7
72143,ar,-91.73566,35.2289,18075,46,68,22,47.8
72149,ar,-91.72621,35.24909,21,47,69,22,46.8
72150,ar,-92.39328,34.31864,3049,48,69,21,43.8
72152,ar,-91.97733,34.35524,943,48,69,21,43.8
72153,ar,-92.3261,35.6453,4231,33,52,19,57.6
72156,ar,-92.68489,35.27909,641,49,69,20,40.8
72157,ar,-92.55827,35.27421,1593,47,68,21,44.7
72160,ar,-91.53307,34.42232,7110,43,65,22,51.2
72165,ar,-91.45796,35.57545,75,40,62,22,55
72166,ar,-91.23825,34.05265,757,46,68,22,47.8
72167,ar,-92.65421,34.42147,1179,49,70,21,42.9
72168,ar,-91.97078,34.43844,460,46,67,21,45.7
72169,ar,-91.2266,35.3965,249,42,63,21,50
72170,ar,-91.41975,34.58049,265,41,63,22,53.7
72173,ar,-92.20559,35.09986,5989,45,66,21,46.7
72175,ar,-91.76267,34.34327,742,45,67,22,48.9
72176,ar,-91.83214,35.00258,4434,40,62,22,55
72179,ar,-91.85547,35.50362,365,39,60,21,53.8
72181,ar,-92.44516,35.1624,38,49,70,21,42.9
72201,ar,-92.27981,34.74728,923,47,68,21,44.7
72202,ar,-92.2649,34.74691,4616,47,68,21,44.7
72204,ar,-92.35884,34.7177,15187,46,67,21,45.7
72205,ar,-92.35023,34.7503,9029,46,67,21,45.7
72206,ar,-92.23829,34.62844,17063,46,67,21,45.7
72207,ar,-92.34571,34.77361,4511,46,67,21,45.7
72209,ar,-92.34405,34.67701,10601,45,67,22,48.9
72210,ar,-92.50445,34.71394,6658,46,67,21,45.7
72211,ar,-92.41709,34.75064,6995,46,67,21,45.7
72212,ar,-92.41527,34.786,4882,47,68,21,44.7
72223,ar,-92.51091,34.78833,10307,47,68,21,44.7
72227,ar,-92.37511,34.77779,3664,47,68,21,44.7
72301,ar,-90.18808,35.14482,7993,44,66,22,50
72311,ar,-90.89148,34.72383,107,43,64,21,48.8
72315,ar,-89.90098,35.90476,14257,41,62,21,51.2
72320,ar,-90.51812,34.82099,333,43,65,22,51.2
72321,ar,-89.94465,35.81595,128,41,62,21,51.2
72322,ar,-90.82207,35.0649,69,41,62,21,51.2
72324,ar,-90.782,35.38814,1602,42,63,21,50
72325,ar,-90.24604,35.32237,41,43,65,22,51.2
72326,ar,-90.90047,35.11191,944,42,63,21,50
72327,ar,-90.3331,35.23156,1613,43,64,21,48.8
72328,ar,-91.02181,34.05503,217,47,69,22,46.8
72329,ar,-89.98807,35.61457,273,42,63,21,50
72330,ar,-90.2103,35.5878,886,43,64,21,48.8
72331,ar,-90.46449,35.28356,1503,42,64,22,52.4
72333,ar,-90.86449,34.29958,798,47,68,21,44.7
72335,ar,-90.7567,34.99131,7233,41,62,21,51.2
72338,ar,-90.1277,35.43011,108,44,66,22,48.3
72339,ar,-90.26808,35.42197,57,43,65,22,51.2
72340,ar,-91.02823,34.94085,152,42,63,21,50
72341,ar,-90.76114,34.88698,182,43,64,21,48.8
72342,ar,-90.68581,34.45823,3703,47,69,22,46.8
72346,ar,-90.4824,35.0833,370,43,65,22,51.2
72347,ar,-90.99972,35.38533,907,42,63,21,50
72348,ar,-90.42344,34.94155,2259,44,66,22,50
72350,ar,-90.12537,35.50109,1285,44,65,21,47.7
72351,ar,-90.0964,35.67372,471,42,63,21,50
72353,ar,-91.00694,34.30141,303,46,68,22,47.8
72354,ar,-90.31658,35.61567,1907,44,65,21,47.7
72355,ar,-90.76412,34.55031,2279,44,66,22,50
72358,ar,-89.88152,35.79149,1195,41,62,21,51.2
72359,ar,-90.72165,35.02285,115,42,64,22,52.4
72360,ar,-90.7714,34.75471,4206,43,64,22,50
72364,ar,-90.18944,35.2168,7001,44,65,21,47.7
72365,ar,-90.43716,35.51763,2107,45,66,21,46.7
72366,ar,-90.95781,34.51978,2931,45,66,21,46.7
72367,ar,-90.94567,34.19172,423,47,69,22,46.8
72368,ar,-91.02052,34.80994,1826,42,63,21,50
72370,ar,-90.1013,35.68545,4550,40,62,22,55
72372,ar,-90.94663,34.96979,1185,42,63,21,50
72373,ar,-90.59001,35.29642,1278,43,64,21,48.8
72374,ar,-90.83444,34.56527,875,45,66,21,46.7
72376,ar,-90.30054,35.08673,1840,45,66,21,46.7
72377,ar,-90.33854,35.68765,35,43,64,21,48.8
72379,ar,-91.05428,34.0512,254,47,69,22,46.8
72383,ar,-91.03961,34.49104,74,45,66,21,46.7
72384,ar,-90.22111,35.37435,1033,43,64,21,48.8
72386,ar,-90.36344,35.4522,1890,43,65,22,51.2
72389,ar,-90.90585,34.37703,466,47,68,21,44.7
72390,ar,-90.67834,34.55012,4494,45,67,22,48.9
72392,ar,-91.09855,34.95702,402,41,62,21,51.2
72394,ar,-90.61746,35.05613,241,43,64,21,48.8
72395,ar,-90.08243,35.59544,712,43,65,22,51.2
72396,ar,-90.82296,35.23113,8315,42,63,21,50
72401,ar,-90.6606,35.87894,24628,39,60,21,53.8
72404,ar,-90.78173,35.77595,11666,40,61,21,52.5
72410,ar,-91.09777,35.93354,653,42,63,21,50
72411,ar,-90.57435,35.74408,1405,42,63,21,50
72412,ar,-90.69434,36.12416,910,38,59,21,55.3
72413,ar,-90.82188,36.30002,787,37,58,21,56.8
72414,ar,-90.37035,35.82443,358,42,64,22,52.4
72415,ar,-91.17387,36.12821,369,39,59,20,51.3
72416,ar,-90.79509,35.96186,3422,39,60,21,53.8
72417,ar,-90.55003,35.921,2559,40,62,22,55
72419,ar,-90.35122,35.74773,1325,42,64,22,52.4
72421,ar,-90.9716,35.78762,695,41,62,21,51.2
72422,ar,-90.54199,36.41929,4511,38,59,21,55.3
72424,ar,-90.73634,36.39052,99,38,59,21,55.3
72425,ar,-90.7312,36.21946,874,39,60,21,53.8
72426,ar,-90.04193,35.86971,148,41,62,21,51.2
72427,ar,-90.93565,35.86705,192,40,61,21,52.5
72428,ar,-90.2243,35.73926,119,41,62,21,51.2
72429,ar,-90.92985,35.49203,817,42,63,21,50
72430,ar,-90.17127,36.33452,586,40,61,21,52.5
72431,ar,-91.08203,35.63339,335,42,63,21,50
72432,ar,-90.71999,35.55642,4842,42,63,21,50
72433,ar,-91.04882,36.02248,676,41,61,20,48.8
72434,ar,-91.16265,36.21681,1304,38,58,20,52.6
72435,ar,-90.57624,36.31873,915,38,59,21,55.3
72436,ar,-90.48109,36.23588,825,37,58,21,56.8
72437,ar,-90.45283,35.8371,2718,42,63,21,50
72438,ar,-90.22107,35.94662,1995,41,62,21,51.2
72440,ar,-91.25148,35.9951,45,43,63,20,46.5
72441,ar,-90.38531,36.43695,92,36,57,21,58.3
72442,ar,-90.19358,35.81976,3715,41,62,21,51.2
72443,ar,-90.41419,36.18042,2212,39,61,22,56.4
72444,ar,-90.86049,36.42784,1905,37,58,21,56.8
72445,ar,-91.02661,35.97651,3,41,61,20,48.8
72447,ar,-90.3307,35.9138,1683,41,63,22,53.7
72449,ar,-90.81964,36.17749,129,38,59,21,55.3
72450,ar,-90.51879,36.07938,21313,38,60,22,57.9
72453,ar,-90.70821,36.2945,493,38,59,21,55.3
72454,ar,-90.20791,36.40124,4043,38,59,21,55.3
72455,ar,-91.03604,36.31835,9532,37,57,20,54.1
72456,ar,-90.32124,36.45722,863,36,57,21,58.3
72457,ar,-91.06818,36.08895,2,40,60,20,50
72458,ar,-91.15848,36.07257,253,41,61,20,48.8
72459,ar,-91.29825,36.28895,1327,37,57,20,54.1
72460,ar,-91.17079,36.35182,1195,38,57,19,50
72461,ar,-90.28518,36.26527,4098,39,60,21,53.8
72462,ar,-90.77021,36.3727,319,38,59,21,55.3
72464,ar,-90.14404,36.45784,63,37,58,21,56.8
72466,ar,-91.32903,36.05571,1430,41,61,20,48.8
72469,ar,-91.29164,35.95441,514,42,62,20,47.6
72470,ar,-90.70624,36.46738,524,38,59,21,55.3
72471,ar,-91.11793,35.82516,1146,42,63,21,50
72472,ar,-90.53584,35.59604,5991,44,66,22,50
72473,ar,-91.17539,35.73906,1916,43,64,21,48.8
72476,ar,-90.91953,36.05183,2263,39,59,20,51.3
72478,ar,-91.05577,36.46331,743,38,58,20,52.6
72479,ar,-90.90302,35.63344,2359,42,63,21,50
72482,ar,-91.36556,36.27496,7106,38,58,20,52.6
72501,ar,-91.65349,35.79158,10069,35,55,20,57.1
72512,ar,-91.74645,36.22046,13455,34,53,19,55.9
72513,ar,-91.65153,36.22597,3034,35,53,18,51.4
72515,ar,-92.05647,36.27635,60,29,48,19,65.5
72517,ar,-91.97325,36.13231,825,33,51,18,54.5
72519,ar,-92.18671,36.12016,3227,32,51,19,59.4
72520,ar,-91.72019,36.3909,223,33,52,19,57.6
72521,ar,-91.54268,35.95131,3758,35,54,19,54.3
72522,ar,-91.47042,35.81089,176,36,56,20,55.6
72523,ar,-91.83212,35.64368,911,26,44,18,69.2
72524,ar,-91.30432,35.83538,615,42,63,21,50
72526,ar,-91.77894,35.8836,73,35,55,20,57.1
72527,ar,-91.68498,35.73986,131,35,55,20,57.1
72528,ar,-92.13833,36.22746,113,30,48,18,60
72529,ar,-91.5655,36.29572,15130,33,52,19,57.6
72530,ar,-91.95341,35.61822,2830,31,50,19,61.3
72531,ar,-92.14889,36.31936,1295,32,50,18,56.3
72532,ar,-91.59686,36.09854,2432,40,59,19,47.5
72533,ar,-92.25039,35.97341,672,33,51,18,54.5
72534,ar,-91.72589,35.60015,1318,29,49,20,69
72536,ar,-91.7672,36.1471,559,36,54,18,50
72537,ar,-92.23371,36.45016,1040,33,51,18,54.5
72538,ar,-92.10297,36.44007,441,30,48,18,60
72539,ar,-91.71112,36.33214,177,32,50,18,56.3
72540,ar,-91.90054,35.92721,455,37,56,19,51.4
72542,ar,-91.47156,36.30393,13921,35,54,19,54.3
72543,ar,-91.98886,35.45357,10015,36,56,20,55.6
72544,ar,-92.19052,36.40615,2541,31,50,19,61.3
72546,ar,-91.94104,35.57893,137,27,45,18,66.7
72550,ar,-91.78292,35.70967,630,30,49,19,63.3
72553,ar,-91.48085,35.70027,5,40,61,21,52.5
72554,ar,-91.56234,36.4402,1418,32,50,18,56.3
72555,ar,-91.88224,35.77488,294,37,57,20,54.1
72556,ar,-91.9591,36.02359,4486,35,54,19,54.3
72560,ar,-92.09181,35.85173,10136,31,49,18,58.1
72561,ar,-91.80287,35.95108,1244,36,56,20,55.6
72562,ar,-91.39827,35.73263,1084,41,62,21,51.2
72564,ar,-91.45698,35.59936,357,40,61,21,52.5
72565,ar,-91.90978,36.21627,1163,31,49,18,58.1
72566,ar,-92.07808,36.21666,902,31,49,18,58.1
72567,ar,-91.92595,35.81457,262,37,57,20,54.1
72568,ar,-91.62495,35.56937,1367,30,50,20,66.7
72569,ar,-91.44523,36.10291,698,40,59,19,47.5
72571,ar,-91.5347,35.6421,227,38,59,21,55.3
72572,ar,-91.29106,35.89914,113,43,63,20,46.5
72573,ar,-91.7962,36.07314,389,35,53,18,51.4
72576,ar,-91.84661,36.35157,1455,30,49,19,63.3
72577,ar,-91.71393,36.02715,921,35,54,19,54.3
72578,ar,-91.88636,36.45323,157,30,49,19,63.3
72579,ar,-91.4451,35.83713,639,37,57,20,54.1
72581,ar,-91.97485,35.54504,1035,36,56,20,55.6
72583,ar,-91.99152,36.40242,816,28,46,18,64.3
72584,ar,-91.84371,36.141,779,33,51,18,54.5
72585,ar,-92.00813,36.18323,402,32,50,18,56.3
72587,ar,-91.81673,36.22537,202,33,52,19,57.6
72601,ar,-93.09182,36.23725,15822,21,40,19,90.5
72611,ar,-93.33038,36.25025,1372,17,35,18,105.9
72616,ar,-93.55641,36.34302,6077,23,43,20,87
72617,ar,-92.36466,36.02206,345,27,45,18,66.7
72619,ar,-92.58514,36.37882,617,31,50,19,61.3
72623,ar,-92.31663,36.4632,650,31,49,18,58.1
72624,ar,-93.37476,36.06163,334,13,29,16,123.1
72626,ar,-92.53951,36.30418,1188,32,50,18,56.3
72628,ar,-93.28746,35.83461,995,13,28,15,115.4
72629,ar,-92.55841,35.73926,789,22,40,18,81.8
72630,ar,-92.91033,36.4742,867,30,49,19,63.3
72631,ar,-93.79106,36.45373,7283,25,45,20,80
72632,ar,-93.74481,36.37355,5155,25,45,20,80
72633,ar,-92.87191,36.1354,1479,26,45,19,73.1
72634,ar,-92.52832,36.20351,1743,31,49,18,58.1
72635,ar,-92.48772,36.31795,2243,29,48,19,65.5
72638,ar,-93.40737,36.31998,4284,20,40,20,100
72639,ar,-92.48824,36.01278,742,28,47,19,67.9
72640,ar,-93.05314,36.0111,83,27,46,19,70.4
72641,ar,-93.23044,35.98243,1694,17,35,18,105.9
72642,ar,-92.54411,36.371,1755,29,48,19,65.5
72644,ar,-92.97075,36.42475,4817,30,49,19,63.4
72645,ar,-92.56266,35.80605,2386,21,39,18,85.7
72648,ar,-93.15597,36.0805,419,25,44,19,76
72650,ar,-92.70618,35.88004,3488,23,41,18,78.3
72651,ar,-92.48149,36.38676,809,27,45,18,66.7
72653,ar,-92.3862,36.34239,22727,29,48,19,65.5
72655,ar,-93.02132,35.90113,520,21,39,18,85.7
72658,ar,-92.32052,36.16637,2044,31,49,18,58.1
72660,ar,-93.3751,36.48077,597,21,41,20,95.2
72661,ar,-92.58576,36.44908,705,29,48,19,65.5
72662,ar,-93.18091,36.4319,2667,22,42,20,90.9
72663,ar,-92.32777,35.93776,407,31,49,18,58.1
72666,ar,-93.26856,35.93896,213,16,33,17,106.3
72668,ar,-92.77191,36.42448,806,28,47,19,67.9
72669,ar,-92.87616,36.06472,10,26,44,18,69.2
72670,ar,-93.38538,35.97281,53,13,29,16,123.1
72672,ar,-92.83778,36.28136,86,26,45,19,73.1
72675,ar,-92.78989,36.00348,1706,32,50,18,56.3
72677,ar,-92.68703,36.25137,4,33,52,19,57.6
72679,ar,-92.82794,35.73421,101,14,31,17,121.4
72680,ar,-92.32699,35.88639,980,29,47,18,62.1
72682,ar,-92.7374,36.14004,182,26,45,19,73.1
72683,ar,-93.10069,35.93461,16,24,42,18,75
72685,ar,-92.97531,36.05574,349,26,45,19,73.1
72686,ar,-92.84401,35.77806,328,15,32,17,113.3
72687,ar,-92.71363,36.26762,4385,28,47,19,67.9
72701,ar,-94.08081,35.98467,17554,25,44,19,76
72703,ar,-94.04883,36.11506,11959,24,44,20,83.3
72704,ar,-94.29666,36.10359,12196,26,46,20,76.9
72712,ar,-94.25422,36.35041,24581,23,43,20,87
72714,ar,-94.21665,36.46757,16850,24,44,20,83.3
72715,ar,-94.30641,36.4654,23654,27,47,20,74.1
72717,ar,-94.42668,35.84004,1031,24,43,19,79.2
72718,ar,-94.22273,36.26966,2694,24,44,20,83.3
72719,ar,-94.29579,36.36759,5915,24,44,20,83.3
72721,ar,-93.78939,35.82751,662,15,33,18,120
72722,ar,-94.46277,36.34182,1947,27,47,20,74.1
72727,ar,-93.92866,35.92287,5111,22,41,19,86.4
72729,ar,-94.46378,35.78234,307,22,42,20,90.9
72730,ar,-94.26597,36.03055,4612,25,44,19,76
72732,ar,-93.95884,36.43285,5864,22,42,20,90.9
72734,ar,-94.45336,36.27284,5062,26,46,20,76.9
72736,ar,-94.46411,36.41218,4449,33,53,20,60.6
72738,ar,-93.88658,36.1605,2294,23,43,20,87
72739,ar,-94.33002,36.42606,425,25,45,20,80
72740,ar,-93.68695,36.10252,8312,21,40,19,90.5
72742,ar,-93.49781,35.97149,1111,15,33,18,120
72744,ar,-94.43804,35.96356,3932,23,42,19,82.6
72745,ar,-94.10067,36.24756,6772,22,42,20,90.9
72747,ar,-94.58286,36.36873,132,36,57,21,58.3
72749,ar,-94.43684,35.86743,53,26,46,20,76.9
72751,ar,-94.1203,36.46106,4243,20,41,21,105
72752,ar,-93.57706,35.80415,899,16,34,18,112.5
72753,ar,-94.32683,35.93133,6072,25,44,19,76
72756,ar,-93.98339,36.32117,21774,21,41,20,95.2
72758,ar,-94.13832,36.29971,15511,22,42,20,90.9
72760,ar,-93.70993,35.8309,486,14,31,17,121.4
72761,ar,-94.45815,36.17015,11169,28,47,19,67.9
72762,ar,-94.22925,36.18775,16432,25,44,19,76
72764,ar,-94.05256,36.17839,18195,24,43,19,79.2
72768,ar,-94.5019,36.47693,1308,36,56,20,55.6
72769,ar,-94.49867,36.03342,987,26,46,20,76.9
72773,ar,-93.84892,36.01648,922,21,41,20,95.2
72774,ar,-94.21516,35.87857,4761,20,39,19,95
72776,ar,-93.64583,35.92139,983,16,34,18,112.5
72801,ar,-93.14086,35.27912,6474,54,74,20,37
72802,ar,-93.06678,35.31304,10158,52,72,20,38.5
72821,ar,-93.72355,35.44219,1620,50,71,21,42
72823,ar,-92.90654,35.25153,4200,53,73,20,37.7
72824,ar,-93.41369,35.13525,859,51,71,20,39.2
72826,ar,-93.70931,35.12281,64,55,74,19,34.5
72827,ar,-93.61684,34.87658,346,51,71,20,39.2
72828,ar,-93.54776,34.9287,149,52,72,20,38.5
72830,ar,-93.51167,35.51341,7498,47,68,21,44.7
72832,ar,-93.66735,35.41246,586,53,73,20,37.7
72833,ar,-93.47495,35.02223,1419,50,70,20,40
72834,ar,-93.1821,35.16889,1805,52,72,20,38.5
72835,ar,-93.34831,35.27786,1274,49,70,21,42.9
72837,ar,-93.10986,35.50541,4579,47,67,20,42.6
72838,ar,-93.67657,34.90529,171,53,72,19,35.8
72839,ar,-93.26418,35.65412,598,33,52,19,57.6
72840,ar,-93.61585,35.46136,1464,50,70,20,40
72841,ar,-93.77223,34.84203,324,51,71,20,39.2
72842,ar,-93.60294,35.08475,708,51,71,20,39.2
72843,ar,-92.93454,35.57631,1875,39,59,20,51.3
72845,ar,-93.37603,35.36419,823,50,71,21,42
72846,ar,-93.32559,35.48469,2623,47,68,21,44.7
72847,ar,-93.27213,35.37389,1959,51,71,20,39.2
72851,ar,-93.46203,35.25629,743,49,70,21,42.9
72852,ar,-93.55372,35.68365,546,20,38,18,90
72853,ar,-93.213,35.01934,670,48,67,19,39.6
72854,ar,-93.42431,35.70634,1310,20,38,18,90
72855,ar,-93.67872,35.25292,5455,50,70,20,40
72856,ar,-93.07496,35.77708,535,15,31,16,106.7
72857,ar,-93.31535,34.85775,1457,47,67,20,42.6
72858,ar,-93.0423,35.23088,1537,53,73,20,37.7
72860,ar,-93.42842,34.95278,285,50,70,20,40
72863,ar,-93.50948,35.36496,1820,52,72,20,38.5
72865,ar,-93.56626,35.30969,1022,49,69,20,40.8
72901,ar,-94.41577,35.36636,9685,50,71,21,42
72903,ar,-94.36069,35.35106,9019,51,72,21,41.2
72904,ar,-94.38268,35.41346,8334,52,73,21,40.4
72908,ar,-94.40918,35.30651,5479,49,70,21,42.9
72916,ar,-94.37663,35.26792,4795,50,71,20,40.6
72921,ar,-94.19432,35.4757,7470,51,71,20,39.2
72923,ar,-94.30787,35.31595,2135,51,72,21,41.2
72926,ar,-94.04734,34.73296,681,44,64,20,45.5
72927,ar,-93.93653,35.07483,6469,59,78,19,32.2
72928,ar,-93.93364,35.28957,667,57,77,20,35.1
72930,ar,-93.9723,35.43316,590,47,68,21,44.7
72932,ar,-94.37726,35.60418,1024,40,61,21,52.5
72933,ar,-94.02176,35.33007,3518,54,74,20,37
72934,ar,-94.27207,35.6886,1335,31,52,21,67.7
72935,ar,-94.12644,35.49134,362,53,73,20,37.7
72936,ar,-94.22557,35.18957,7546,51,71,20,39.2
72937,ar,-94.39671,35.1327,2869,50,70,20,40
72938,ar,-94.37583,35.00593,1266,48,68,20,41.7
72940,ar,-94.26013,35.11502,1739,52,72,20,38.5
72941,ar,-94.15359,35.36585,2947,52,72,20,38.5
72943,ar,-93.78655,35.17944,2254,55,75,20,36.4
72944,ar,-94.23614,35.02862,2104,49,69,20,40.8
72945,ar,-94.34903,35.08837,245,52,72,20,38.5
72946,ar,-94.14176,35.66629,3118,36,57,21,58.3
72947,ar,-94.02798,35.57206,3620,50,70,20,40
72948,ar,-94.41309,35.70472,701,37,57,20,54.1
72949,ar,-93.80772,35.57723,8183,46,66,20,43.5
72950,ar,-93.88748,34.78364,712,51,70,19,37.3
72951,ar,-93.87515,35.32073,771,55,75,20,36.4
72952,ar,-94.30041,35.56879,1947,45,66,21,46.7
72955,ar,-94.44391,35.61223,343,42,63,21,50
72956,ar,-94.3494,35.468,16982,51,72,21,41.2
72958,ar,-94.12447,34.90486,5969,51,71,20,39.2
72959,ar,-94.06809,35.78274,3403,20,39,19,95
73002,ok,-97.73099,34.94934,877,45,65,20,44.4
73003,ok,-97.49717,35.66898,8461,40,60,20,50
73004,ok,-97.84624,35.148,714,45,65,20,44.4
73005,ok,-98.23818,35.05783,4816,39,60,21,53.8
73006,ok,-98.40269,34.90893,3544,43,64,21,48.8
73007,ok,-97.31857,35.68863,2011,43,63,20,46.5
73008,ok,-97.64617,35.5141,7585,34,54,20,58.8
73009,ok,-98.36362,35.28608,1275,40,61,21,52.5
73010,ok,-97.67845,35.10624,10562,40,61,21,52.5
73011,ok,-97.74981,34.84438,552,44,65,21,47.7
73012,ok,-97.59363,35.66751,15426,40,60,20,50
73013,ok,-97.48118,35.61947,21782,39,59,20,51.3
73014,ok,-98.14626,35.58107,1745,38,58,20,52.6
73015,ok,-98.59538,35.08054,2633,42,62,20,47.6
73016,ok,-97.68712,35.79894,1391,43,63,20,46.5
73017,ok,-98.09378,34.92621,1676,41,62,21,51.2
73018,ok,-97.94096,35.05123,10957,48,69,21,43.8
73019,ok,-97.44358,35.20606,2,40,61,21,52.5
73020,ok,-97.26219,35.45867,10944,39,60,21,53.8
73021,ok,-98.66217,35.34251,518,40,60,20,50
73024,ok,-98.7981,35.35865,601,40,60,20,50
73025,ok,-97.57278,35.73235,6053,42,62,20,47.6
73026,ok,-97.27915,35.2343,6137,43,64,21,48.8
73027,ok,-97.24019,35.97278,1742,44,64,20,45.5
73028,ok,-97.62715,35.97494,2916,45,64,19,42.2
73029,ok,-98.20637,34.90561,1252,41,62,21,51.2
73030,ok,-97.17404,34.47364,3988,44,66,22,50
73032,ok,-97.04676,34.3986,177,47,69,22,46.8
73033,ok,-98.54663,35.31438,225,41,61,20,48.8
73034,ok,-97.4255,35.70189,18786,42,62,20,47.6
73036,ok,-97.95959,35.50998,9805,37,57,20,54.1
73038,ok,-98.44596,35.12207,2282,42,62,20,47.6
73040,ok,-98.37558,35.6416,2559,35,55,20,57.1
73041,ok,-98.87662,35.04284,1042,43,63,20,46.5
73042,ok,-98.25067,35.22811,1101,39,60,21,53.8
73043,ok,-98.39716,35.73425,255,37,57,20,54.1
73044,ok,-97.42483,35.86325,13466,45,65,20,44.4
73045,ok,-97.14366,35.51215,5426,41,62,21,51.2
73047,ok,-98.31644,35.45869,3444,37,57,20,54.1
73048,ok,-98.55685,35.48769,2311,38,58,20,52.6
73049,ok,-97.30166,35.58638,3838,40,61,21,52.5
73050,ok,-97.26381,35.9387,215,44,64,20,45.5
73051,ok,-97.24586,35.03323,4254,43,65,22,51.2
73052,ok,-97.59584,34.83158,4799,44,65,21,47.7
73053,ok,-98.4142,35.36203,1090,39,59,20,51.3
73054,ok,-97.19167,35.67306,3293,44,64,20,45.5
73055,ok,-97.91351,34.64568,6147,40,60,20,50
73056,ok,-97.62408,36.17071,1068,46,65,19,41.3
73057,ok,-97.43161,34.83305,1917,45,67,22,48.9
73058,ok,-97.2183,35.82062,820,45,65,20,44.4
73059,ok,-98.04737,35.31891,2242,39,59,20,51.3
73061,ok,-97.00648,36.34879,1578,44,63,19,43.2
73062,ok,-98.7439,35.04527,2251,42,62,20,47.6
73063,ok,-97.42387,36.0535,903,45,64,19,42.2
73064,ok,-97.74555,35.37518,10336,33,53,20,60.6
73065,ok,-97.61208,35.25212,4029,38,58,20,52.6
73066,ok,-97.32738,35.50017,181,39,59,20,51.3
73067,ok,-97.90818,34.9031,1808,44,65,21,47.7
73068,ok,-97.28289,35.13905,5905,42,63,21,50
73069,ok,-97.46292,35.2496,11025,40,61,21,52.5
73071,ok,-97.4114,35.23899,13681,40,61,21,52.5
73072,ok,-97.50311,35.20828,14825,40,61,21,52.5
73073,ok,-97.40782,36.1559,847,45,64,19,42.2
73074,ok,-97.27982,34.83028,748,46,68,22,47.8
73075,ok,-97.23349,34.75158,5872,47,68,21,44.7
73077,ok,-97.26677,36.30485,5287,48,67,19,39.6
73078,ok,-97.75349,35.6703,5425,39,59,20,51.3
73079,ok,-98.01557,35.20623,686,44,65,21,47.7
73080,ok,-97.46233,35.00656,5554,43,64,21,48.8
73082,ok,-97.90324,34.77587,2552,38,59,21,55.3
73084,ok,-97.34436,35.52585,5946,38,58,20,52.6
73086,ok,-96.9662,34.48378,8628,42,64,22,52.4
73089,ok,-97.79433,35.26443,6551,37,57,20,54.1
73090,ok,-97.94648,35.39707,919,38,58,20,52.6
73092,ok,-98.095,35.12692,769,45,65,20,44.4
73093,ok,-97.49228,35.10354,1991,42,62,20,47.6
73095,ok,-97.29912,34.90714,1316,43,64,21,48.8
73096,ok,-98.73747,35.51537,5944,37,57,20,54.1
73097,ok,-97.64479,35.40049,164,34,54,20,58.8
73098,ok,-97.16102,34.62856,3499,45,67,22,48.9
73099,ok,-97.76239,35.52827,33937,34,54,20,58.8
73102,ok,-97.519,35.47075,621,36,57,21,58.3
73103,ok,-97.51891,35.48907,1772,37,57,20,54.1
73104,ok,-97.50392,35.47523,1400,37,57,20,54.1
73105,ok,-97.50305,35.51898,2963,38,58,20,52.6
73106,ok,-97.53681,35.48197,5341,36,57,21,58.3
73107,ok,-97.5756,35.4816,11181,36,56,20,55.6
73108,ok,-97.56769,35.45002,5893,36,56,20,55.6
73109,ok,-97.52455,35.43306,7885,35,56,21,60
73110,ok,-97.39765,35.4612,12302,35,56,21,60
73111,ok,-97.47717,35.51883,6402,38,58,20,52.6
73112,ok,-97.5749,35.51842,11483,36,56,20,55.6
73114,ok,-97.51767,35.57895,7947,38,58,20,52.6
73115,ok,-97.44153,35.44234,8683,35,56,21,60
73116,ok,-97.56416,35.54633,4599,37,58,21,56.8
73117,ok,-97.45974,35.47468,3727,37,57,20,54.1
73118,ok,-97.52953,35.51831,6434,37,57,20,54.1
73119,ok,-97.56613,35.42201,10323,35,55,20,57.1
73120,ok,-97.57223,35.58042,12615,37,58,21,56.8
73121,ok,-97.44094,35.52109,2258,38,59,21,55.3
73122,ok,-97.61433,35.51987,4618,34,54,20,58.8
73127,ok,-97.65392,35.47756,6050,34,54,20,58.8
73128,ok,-97.64344,35.45034,1972,34,54,20,58.8
73129,ok,-97.48428,35.43148,8700,35,55,20,57.1
73130,ok,-97.34559,35.45865,8967,36,56,20,55.6
73131,ok,-97.46429,35.57671,1812,39,60,21,53.8
73132,ok,-97.63994,35.55092,8215,33,53,20,60.6
73134,ok,-97.56831,35.61422,785,38,59,21,55.3
73135,ok,-97.42883,35.39482,7429,35,56,21,60
73139,ok,-97.52559,35.38473,5015,34,55,21,61.8
73141,ok,-97.39776,35.51695,1702,37,58,21,56.8
73142,ok,-97.64245,35.61374,5967,37,57,20,54.1
73145,ok,-97.39404,35.41909,41,34,55,21,61.8
73149,ok,-97.48933,35.3894,2234,34,54,20,58.8
73150,ok,-97.33272,35.40091,2264,38,58,20,52.6
73151,ok,-97.41109,35.56758,688,39,60,21,53.8
73159,ok,-97.57679,35.3901,10703,34,55,21,61.8
73160,ok,-97.4754,35.33206,22841,38,58,20,52.6
73162,ok,-97.64144,35.58111,10438,36,56,20,55.6
73165,ok,-97.35728,35.3438,3322,40,61,21,52.5
73169,ok,-97.64251,35.38132,694,34,54,20,58.8
73170,ok,-97.55059,35.32738,15260,37,57,20,54.1
73173,ok,-97.62227,35.34526,1931,36,56,20,55.6
73179,ok,-97.64449,35.42444,3349,33,53,20,60.6
73401,ok,-97.11481,34.20307,20550,57,79,22,38.6
73425,ok,-97.55504,34.45348,97,45,67,22,48.9
73430,ok,-97.36691,33.90518,4525,51,73,22,43.1
73432,ok,-96.41945,34.25701,1021,55,78,23,41.8
73433,ok,-97.40676,34.62412,2793,45,67,22,48.9
73434,ok,-97.58561,34.62388,892,43,65,22,51.2
73437,ok,-97.41556,34.36191,168,50,72,22,44
73438,ok,-97.49945,34.28646,2966,49,71,22,44.9
73439,ok,-96.7569,33.94558,10471,50,73,23,46
73440,ok,-96.8999,33.98068,373,52,75,23,44.2
73441,ok,-97.43058,33.90446,164,50,72,22,44
73442,ok,-97.6718,34.3265,794,48,70,22,45.8
73443,ok,-97.2962,34.16433,1987,55,77,22,40
73444,ok,-97.35854,34.45676,276,42,64,22,52.4
73446,ok,-96.778,34.08958,5289,53,76,23,43.4
73447,ok,-96.85807,34.24607,1140,54,76,22,40.7
73448,ok,-97.10761,33.94682,4142,50,73,23,46
73449,ok,-96.53773,34.00003,3005,54,77,23,42.6
73450,ok,-96.53518,34.26244,1283,55,77,22,40
73453,ok,-97.26461,34.03427,695,54,76,22,40.7
73455,ok,-96.76248,34.23162,482,55,77,22,40
73456,ok,-97.63459,34.13071,2525,51,72,21,41.2
73458,ok,-97.25328,34.35203,1053,52,74,22,42.3
73459,ok,-97.13313,33.77435,850,48,71,23,47.9
73460,ok,-96.6614,34.28712,3487,55,77,22,40
73461,ok,-96.44362,34.35955,1085,54,77,23,42.6
73463,ok,-97.43372,34.11233,3324,51,73,22,43.1
73481,ok,-97.52179,34.43639,1194,46,68,22,47.8
73487,ok,-97.44574,34.4788,370,45,67,22,48.9
73491,ok,-97.65182,34.47654,524,45,67,22,48.9
73501,ok,-98.28814,34.5607,9325,52,72,20,38.5
73503,ok,-98.49715,34.67862,114,44,64,20,45.5
73505,ok,-98.47857,34.57887,19772,50,70,20,40
73507,ok,-98.54677,34.76079,10911,47,67,20,42.6
73520,ok,-97.98124,34.25287,207,55,75,20,36.4
73521,ok,-99.31553,34.64011,11876,51,71,20,39.2
73526,ok,-99.26923,34.79411,1895,44,65,21,47.7
73527,ok,-98.62197,34.57105,2775,51,70,19,37.3
73528,ok,-98.63495,34.40432,875,58,77,19,32.8
73529,ok,-97.94627,34.35645,3953,51,72,21,41.2
73530,ok,-99.02049,34.24724,1013,55,75,20,36.4
73531,ok,-98.5336,34.19654,903,55,75,20,36.4
73532,ok,-99.58945,34.64263,1152,52,72,20,38.5
73533,ok,-97.85432,34.49774,16547,46,67,21,45.7
73537,ok,-99.66083,34.47925,1699,52,73,21,40.4
73538,ok,-98.29787,34.73294,3437,44,64,20,45.5
73539,ok,-99.27993,34.4576,658,51,72,21,41.2
73540,ok,-98.56045,34.47006,647,58,78,20,34.5
73541,ok,-98.17914,34.78956,2172,42,62,20,47.6
73542,ok,-98.94178,34.4037,4944,53,72,19,35.8
73543,ok,-98.37801,34.46585,1498,55,75,20,36.4
73544,ok,-99.76503,34.695,936,51,71,20,39.2
73546,ok,-98.72441,34.22029,1779,55,75,20,36.4
73547,ok,-99.40794,34.98708,1525,42,63,21,50
73548,ok,-98.14646,34.2086,829,56,76,20,35.7
73549,ok,-99.15533,34.65092,690,48,68,20,41.7
73550,ok,-99.90223,34.69156,2890,50,71,21,42
73551,ok,-98.87199,34.35174,170,56,76,20,35.7
73552,ok,-98.75668,34.63296,1236,47,67,20,42.6
73553,ok,-98.72944,34.3262,305,56,76,20,35.7
73554,ok,-99.62002,34.89061,4328,46,67,21,45.7
73555,ok,-98.96301,34.50174,333,52,71,19,36.5
73556,ok,-99.38405,34.73008,177,49,69,20,40.8
73557,ok,-98.4893,34.72968,879,42,62,20,47.6
73559,ok,-98.96377,34.72771,1019,44,64,20,45.5
73560,ok,-99.45028,34.53728,1331,53,73,20,37.7
73562,ok,-98.41304,34.18344,1198,56,76,20,35.7
73564,ok,-98.98819,34.84193,1774,42,62,20,47.6
73565,ok,-97.87867,34.02494,1412,55,76,21,38.2
73566,ok,-98.94466,34.62435,1901,46,66,20,43.5
73567,ok,-98.15515,34.74323,574,43,63,20,46.5
73568,ok,-98.21204,34.24895,1712,56,76,20,35.7
73569,ok,-97.80527,33.93793,739,54,75,21,38.9
73570,ok,-99.10762,34.51006,1483,48,69,21,43.8
73571,ok,-99.8957,34.91822,662,40,61,21,52.5
73572,ok,-98.34469,34.36052,3607,56,76,20,35.7
73573,ok,-97.94315,34.16882,2563,56,77,21,37.5
73601,ok,-98.96586,35.48712,5709,42,62,20,47.6
73620,ok,-99.01511,35.6136,1279,39,59,20,51.3
73622,ok,-98.99579,35.38945,574,41,60,19,46.3
73624,ok,-99.17916,35.3411,1093,30,49,19,63.3
73625,ok,-99.19053,35.67701,1257,34,53,19,55.9
73626,ok,-99.27904,35.42136,1346,29,49,20,69
73627,ok,-99.45347,35.20291,1025,35,56,21,60
73628,ok,-99.68449,35.6247,2423,25,43,18,72
73632,ok,-98.9274,35.27186,3530,40,60,20,50
73638,ok,-99.78449,35.8404,520,21,38,17,81
73639,ok,-98.95611,35.73186,1282,33,53,20,60.6
73641,ok,-99.17218,35.27333,789,32,52,20,62.5
73642,ok,-99.91097,35.8211,467,20,36,16,80
73644,ok,-99.43893,35.41852,8680,27,46,19,70.4
73645,ok,-99.89631,35.20227,2412,30,49,19,63.3
73646,ok,-98.61416,35.82977,780,34,53,19,55.9
73647,ok,-99.1591,35.4278,931,33,52,19,57.6
73650,ok,-99.40729,35.64185,1543,28,47,19,67.9
73651,ok,-99.07317,35.01468,3948,42,62,20,47.6
73654,ok,-99.37033,35.85939,2009,27,45,18,66.7
73655,ok,-99.25965,34.9801,1802,41,62,21,51.2
73658,ok,-98.73347,35.94782,584,31,49,18,58.1
73659,ok,-98.92296,35.86952,673,31,50,19,61.3
73660,ok,-99.91542,35.62476,741,19,36,17,89.5
73661,ok,-99.01614,35.16077,764,38,58,20,52.6
73662,ok,-99.67524,35.29862,4658,34,54,20,58.8
73663,ok,-98.90284,36.1075,1399,34,53,19,55.9
73664,ok,-99.24867,35.18594,1435,37,58,21,56.8
73666,ok,-99.91469,35.4743,347,23,41,18,78.3
73667,ok,-99.02415,36.00238,1023,34,53,19,55.9
73669,ok,-98.7404,35.72892,1683,34,53,19,55.9
73673,ok,-99.56728,35.05296,852,40,61,21,52.5
73701,ok,-97.78618,36.42778,13715,42,61,19,45.2
73703,ok,-97.96223,36.42763,12529,40,59,19,47.5
73705,ok,-97.90263,36.33824,3,39,58,19,48.7
73716,ok,-98.51718,36.4998,987,42,61,19,45.2
73717,ok,-98.77292,36.84326,6645,42,61,19,45.2
73718,ok,-98.17033,36.22231,488,46,65,19,41.3
73719,ok,-98.28844,36.95678,315,44,62,18,40.9
73720,ok,-97.87317,36.2008,423,44,63,19,43.2
73722,ok,-98.3385,36.89873,1064,44,63,19,43.2
73724,ok,-98.66738,36.04882,1569,35,53,18,51.4
73726,ok,-98.49725,36.58014,1019,41,60,19,46.3
73727,ok,-98.03714,36.50567,366,41,60,19,46.3
73728,ok,-98.37799,36.74218,2588,47,65,18,38.3
73729,ok,-98.47216,36.41929,499,46,65,19,41.3
73730,ok,-97.54429,36.3194,816,44,63,19,43.2
73731,ok,-98.5979,36.64335,532,44,63,19,43.2
73733,ok,-97.69071,36.2536,424,45,64,19,42.2
73734,ok,-97.86013,35.98576,1110,46,65,19,41.3
73735,ok,-98.05835,36.28066,553,42,61,19,45.2
73736,ok,-97.68844,36.34493,502,43,62,19,44.2
73737,ok,-98.62321,36.29655,3305,45,64,19,42.2
73738,ok,-97.55177,36.45196,1167,42,60,18,42.9
73739,ok,-98.14038,36.51629,558,40,58,18,45
73741,ok,-98.26017,36.55964,929,38,57,19,50
73742,ok,-97.93305,36.09845,3050,45,64,19,42.2
73743,ok,-98.01407,36.57434,159,43,61,18,41.9
73744,ok,-98.30384,35.94352,636,44,64,20,45.5
73746,ok,-98.65771,36.68512,32,43,62,19,44.2
73747,ok,-98.33228,36.22763,285,49,68,19,38.8
73749,ok,-98.15967,36.71275,925,43,62,19,44.2
73750,ok,-97.9523,35.85547,4985,45,64,19,42.2
73753,ok,-97.85718,36.5517,543,44,63,19,43.2
73754,ok,-98.09097,36.39686,689,42,62,20,47.6
73755,ok,-98.57168,36.13495,1100,36,55,19,52.8
73756,ok,-98.13028,35.9817,576,46,66,20,43.5
73757,ok,-97.4564,36.2874,306,45,64,19,42.2
73758,ok,-98.0797,36.94521,562,41,60,19,46.3
73759,ok,-97.71491,36.8589,2780,46,64,18,39.1
73760,ok,-98.16081,36.37359,399,42,61,19,45.2
73761,ok,-98.03852,36.6839,768,45,63,18,40
73762,ok,-97.968,35.71323,2166,41,61,20,48.8
73763,ok,-98.32462,36.0997,2157,49,68,19,38.8
73764,ok,-98.205,35.85043,397,44,63,19,43.2
73766,ok,-97.82811,36.65192,1310,47,66,19,40.4
73768,ok,-98.29584,36.35703,1319,44,63,19,43.2
73771,ok,-97.9662,36.87045,948,44,63,19,43.2
73772,ok,-98.4268,35.86019,3890,37,57,20,54.1
73773,ok,-97.92447,36.26053,1424,41,60,19,46.3
73801,ok,-99.43638,36.47874,10393,26,43,17,65.4
73832,ok,-99.67436,36.03793,2295,18,35,17,94.4
73834,ok,-99.55376,36.85226,2812,41,59,18,43.9
73835,ok,-99.21106,35.97588,726,29,47,18,62.1
73838,ok,-98.89635,36.24589,718,35,53,18,51.4
73840,ok,-99.61841,36.35371,1115,22,39,17,77.3
73841,ok,-99.62413,36.55888,517,24,41,17,70.8
73842,ok,-99.19632,36.81201,1823,35,53,18,51.4
73843,ok,-99.8153,36.40142,1837,22,39,17,77.3
73844,ok,-100.14301,36.88699,1022,26,44,18,69.2
73848,ok,-100.00729,36.65403,3504,25,42,17,68
73851,ok,-99.80655,36.59139,396,26,44,18,69.2
73852,ok,-99.11655,36.48159,3028,32,51,19,59.4
73853,ok,-99.14685,36.23955,985,32,50,18,56.3
73855,ok,-99.86538,36.91681,700,31,49,18,58.1
73857,ok,-99.32996,36.27054,638,26,44,18,69.2
73858,ok,-99.92276,36.183,2342,20,37,17,85
73859,ok,-99.2984,36.12366,1600,26,43,17,65.4
73860,ok,-98.83379,36.53021,2425,41,60,19,46.3
73901,ok,-101.02068,36.73544,239,15,31,16,106.7
73931,ok,-100.79273,36.60446,1097,12,26,14,127.7
73932,ok,-100.50251,36.7161,2780,19,36,17,89.5
73933,ok,-102.57366,36.74599,4053,2,9,7,350
73937,ok,-102.7912,36.55422,543,1,4,3,300
73938,ok,-100.58308,36.93498,1027,20,37,17,85
73939,ok,-101.79127,36.77795,1899,8,21,13,162.5
73942,ok,-101.51134,36.74518,6860,11,25,14,127.3
73944,ok,-101.10778,36.59053,1094,14,31,17,121.4
73945,ok,-101.23306,36.83333,2838,14,30,16,114.3
73946,ok,-102.81267,36.93138,527,1,7,6,600
73947,ok,-102.15783,36.81288,1494,3,12,9,300
73949,ok,-101.92068,36.57946,2304,6,16,11,201.65
73950,ok,-100.88376,36.85718,1382,16,33,17,106.3
73951,ok,-101.05745,36.94471,928,16,32,16,100
74001,ok,-96.07971,36.49723,414,48,68,20,41.7
74002,ok,-96.14402,36.55612,2048,48,68,20,41.7
74003,ok,-96.06583,36.72746,9069,52,72,20,38.5
74006,ok,-95.89222,36.71431,11918,49,69,20,40.8
74008,ok,-95.87253,35.9246,13965,48,69,21,43.8
74010,ok,-96.36494,35.81445,7740,51,71,20,39.2
74011,ok,-95.80943,35.98164,12822,48,69,21,43.8
74012,ok,-95.80494,36.05361,23954,47,68,21,44.7
74014,ok,-95.67526,36.05979,18603,47,68,21,44.7
74015,ok,-95.70715,36.18222,3871,47,68,21,44.7
74016,ok,-95.44981,36.54513,4006,45,66,21,46.7
74017,ok,-95.58349,36.39318,13858,45,66,21,46.7
74019,ok,-95.60383,36.28057,9190,46,67,21,45.7
74020,ok,-96.41914,36.24512,5544,45,65,20,44.4
74021,ok,-95.8479,36.38241,10319,45,66,21,46.7
74022,ok,-95.97946,36.9319,1388,45,65,20,44.4
74023,ok,-96.74971,35.95802,6887,45,64,19,42.2
74026,ok,-96.76238,35.71297,731,50,70,20,40
74027,ok,-95.58709,36.79882,1023,46,66,20,43.5
74028,ok,-96.52371,35.78656,1710,50,70,20,40
74029,ok,-95.88749,36.82677,2601,51,71,20,39.2
74030,ok,-96.56447,35.98766,3053,46,66,20,43.5
74032,ok,-96.90427,36.20922,1402,43,62,19,44.2
74033,ok,-96.00752,35.9459,4863,47,67,20,42.6
74034,ok,-96.57898,36.22641,558,45,66,21,46.7
74035,ok,-96.38873,36.42347,3395,46,66,20,43.5
74036,ok,-95.50718,36.15909,3901,48,69,21,43.8
74037,ok,-95.97832,36.00191,8418,48,68,20,41.7
74038,ok,-96.56363,36.15817,1920,46,66,20,43.5
74039,ok,-96.22923,35.89628,2135,48,69,21,43.8
74041,ok,-96.05454,35.94166,1335,47,68,21,44.7
74042,ok,-95.57557,36.86883,603,44,65,21,47.7
74044,ok,-96.38256,36.09467,4815,44,65,21,47.7
74045,ok,-96.70738,36.22345,510,44,64,20,45.5
74046,ok,-96.56311,35.74992,91,49,70,21,42.9
74047,ok,-96.0141,35.85507,4392,48,69,21,43.8
74048,ok,-95.65211,36.69186,4897,47,67,20,42.6
74050,ok,-96.06458,36.07282,342,46,67,21,45.7
74051,ok,-95.96606,36.60995,1051,48,69,21,43.8
74052,ok,-96.57992,36.08463,949,46,66,20,43.5
74053,ok,-95.73268,36.43263,2393,44,65,21,47.7
74054,ok,-96.34749,36.2753,2076,45,66,21,46.7
74055,ok,-95.81883,36.27845,18115,46,67,21,45.7
74056,ok,-96.33635,36.80031,6623,44,64,20,45.5
74058,ok,-96.75988,36.35684,4227,44,64,20,45.5
74059,ok,-97.0522,35.95899,3202,43,63,20,46.5
74060,ok,-96.24784,36.26749,841,43,64,21,48.8
74061,ok,-95.90054,36.53894,1411,47,68,21,44.7
74062,ok,-96.89318,36.04058,686,43,62,19,44.2
74063,ok,-96.19611,36.15044,16168,44,65,21,47.7
74066,ok,-96.16466,35.99283,16808,47,68,21,44.7
74068,ok,-96.57508,35.90829,215,47,67,20,42.6
74070,ok,-96.07442,36.38839,9047,46,67,21,45.7
74071,ok,-96.28054,35.78206,266,51,71,20,39.2
74072,ok,-95.53756,36.94697,1310,42,62,20,47.6
74073,ok,-96.01697,36.30146,3505,46,67,21,45.7
74074,ok,-97.07626,36.08104,11945,42,61,19,45.2
74075,ok,-97.07906,36.17191,7343,42,61,19,45.2
74079,ok,-96.65587,35.74672,3811,49,69,20,40.8
74080,ok,-95.7412,36.52745,1881,45,65,20,44.4
74081,ok,-96.45565,36.17585,1383,46,67,21,45.7
74082,ok,-95.88148,36.45044,59,46,67,21,45.7
74083,ok,-95.76942,36.91547,965,41,61,20,48.8
74084,ok,-96.34613,36.53813,927,45,64,19,42.2
74085,ok,-96.71516,36.11041,1862,44,64,20,45.5
74103,ok,-95.99456,36.1556,362,45,66,21,46.7
74104,ok,-95.954,36.14647,5753,45,66,21,46.7
74105,ok,-95.96409,36.09743,10403,47,68,21,44.7
74106,ok,-95.98426,36.19199,9851,45,66,21,46.7
74107,ok,-96.04147,36.10694,10139,47,68,21,44.7
74108,ok,-95.79392,36.14762,3114,46,67,21,45.7
74110,ok,-95.9539,36.18861,8003,45,66,21,46.7
74112,ok,-95.90435,36.14715,9768,46,67,21,45.7
74114,ok,-95.94674,36.12698,7659,46,67,21,45.7
74115,ok,-95.90941,36.19238,10541,45,66,21,46.7
74116,ok,-95.83618,36.18804,2325,46,67,21,45.7
74117,ok,-95.89624,36.24163,337,46,67,21,45.7
74119,ok,-95.98918,36.14208,1147,47,68,21,44.7
74120,ok,-95.97687,36.15049,3171,46,67,21,45.7
74126,ok,-96.02966,36.24066,6184,46,67,21,45.7
74127,ok,-96.04532,36.17901,9217,46,67,21,45.7
74128,ok,-95.85148,36.14746,4449,46,67,21,45.7
74129,ok,-95.86972,36.12678,5920,46,67,21,45.7
74130,ok,-95.95511,36.24154,1156,46,67,21,45.7
74131,ok,-96.07095,36.05235,1682,48,68,20,41.7
74132,ok,-96.01323,36.04862,4043,48,69,21,43.8
74133,ok,-95.8794,36.04148,13676,48,68,20,41.7
74134,ok,-95.80388,36.11165,5182,46,67,21,45.7
74135,ok,-95.92332,36.09731,7158,46,67,21,45.7
74136,ok,-95.94235,36.06142,6628,47,68,21,44.7
74137,ok,-95.92938,36.02055,9234,48,69,21,43.8
74145,ok,-95.88737,36.09737,6383,46,67,21,45.7
74146,ok,-95.85325,36.09781,3915,46,67,21,45.7
74301,ok,-95.22874,36.67735,5404,45,66,21,46.7
74330,ok,-95.27256,36.43703,2224,46,67,21,45.7
74331,ok,-94.94232,36.6394,12901,45,66,21,46.7
74332,ok,-95.23333,36.52078,1324,46,68,22,47.8
74333,ok,-95.08622,36.79147,801,43,64,21,48.8
74337,ok,-95.34137,36.13397,4772,49,70,21,42.9
74338,ok,-94.72951,36.26275,3705,33,54,21,63.6
74339,ok,-94.87971,36.93395,1199,42,63,21,50
74340,ok,-95.02401,36.47587,403,45,66,21,46.7
74342,ok,-94.93771,36.42104,9394,43,64,21,48.8
74343,ok,-94.82579,36.74203,2046,43,64,21,48.8
74344,ok,-94.73849,36.59728,13001,45,67,22,48.9
74346,ok,-94.75043,36.43792,7710,41,63,22,53.7
74347,ok,-94.78535,36.1772,3591,37,58,21,56.8
74349,ok,-95.03399,36.51758,114,46,67,21,45.7
74350,ok,-95.05118,36.46625,808,45,67,22,48.9
74352,ok,-95.18096,36.14183,5194,44,65,21,47.7
74354,ok,-94.8827,36.88589,10623,43,64,21,48.8
74358,ok,-94.88065,36.91786,175,42,63,21,50
74359,ok,-94.82631,36.17705,384,37,57,20,54.1
74360,ok,-94.83288,36.97151,572,40,61,21,52.5
74361,ok,-95.30656,36.30297,9034,48,69,21,43.8
74363,ok,-94.71435,36.9531,2012,37,58,21,56.8
74364,ok,-94.95727,36.2021,1420,36,56,20,55.6
74365,ok,-95.0675,36.29625,2913,44,65,21,47.7
74366,ok,-95.04639,36.39033,1499,42,63,21,50
74367,ok,-95.11207,36.41972,502,45,67,22,48.9
74368,ok,-94.84854,36.20755,50,34,55,21,61.8
74369,ok,-95.19813,36.91927,1510,40,61,21,52.5
74370,ok,-94.67979,36.76581,2808,39,60,21,53.8
74401,ok,-95.46531,35.72181,3407,52,73,21,40.4
74403,ok,-95.30674,35.67163,4106,53,74,21,39.6
74421,ok,-96.0437,35.76008,3185,49,71,22,44.9
74422,ok,-95.70861,35.63654,662,51,72,21,41.2
74423,ok,-95.19169,35.67309,590,52,73,21,40.4
74425,ok,-95.6419,35.17233,2015,53,74,21,39.6
74426,ok,-95.52891,35.44992,9081,51,72,21,41.2
74427,ok,-94.90699,35.68398,2130,39,59,20,51.3
74428,ok,-95.63753,35.5678,615,51,72,21,41.2
74429,ok,-95.62801,35.95448,7878,48,69,21,43.8
74430,ok,-95.66095,35.12421,1058,52,73,21,40.4
74431,ok,-95.94544,35.46683,596,50,72,22,44
74432,ok,-95.65655,35.28442,14095,51,72,21,41.2
74434,ok,-95.21266,35.8085,3197,48,70,22,45.8
74435,ok,-95.09356,35.57733,3513,48,70,22,45.8
74436,ok,-95.6968,35.79666,2268,50,71,21,42
74437,ok,-95.92802,35.45454,7802,50,72,22,44
74438,ok,-95.75541,35.53762,72,51,72,21,41.2
74441,ok,-95.15073,35.97558,4527,46,67,21,45.7
74442,ok,-95.81584,35.13137,1466,52,73,21,40.4
74445,ok,-95.82588,35.62808,1826,51,72,21,41.2
74446,ok,-95.31622,35.84856,647,53,74,21,39.6
74447,ok,-96.00319,35.65123,10728,50,72,22,44
74450,ok,-95.48131,35.59646,1034,52,73,21,40.4
74451,ok,-94.97552,35.74316,5525,46,67,21,45.7
74452,ok,-95.06808,36.12018,487,40,61,21,52.5
74454,ok,-95.51522,35.85545,4064,51,72,21,41.2
74455,ok,-95.26374,35.3619,3582,50,71,21,42
74456,ok,-95.99699,35.71124,209,50,72,22,44
74457,ok,-94.81928,36.03115,967,37,58,21,56.8
74458,ok,-95.59175,35.88359,1789,49,70,21,42.9
74459,ok,-95.49219,35.53446,319,51,72,21,41.2
74460,ok,-95.95652,35.50786,207,51,72,21,41.2
74462,ok,-95.15535,35.28317,10420,49,70,21,42.9
74463,ok,-95.55047,35.75979,29,51,72,21,41.2
74464,ok,-94.98502,35.92728,11801,45,67,22,48.9
74467,ok,-95.39265,35.9663,10510,50,71,21,42
74468,ok,-95.56809,35.61217,68,51,72,21,41.2
74469,ok,-95.30812,35.4952,801,53,74,21,39.6
74470,ok,-95.17268,35.48062,1429,52,73,21,40.4
74471,ok,-94.86477,35.83005,1230,42,63,21,50
74472,ok,-95.26677,35.24793,450,52,73,21,40.4
74501,ok,-95.79553,34.98235,19453,51,72,21,41.2
74521,ok,-95.0937,34.65768,292,55,75,20,36.4
74522,ok,-95.69296,34.90359,309,51,72,21,41.2
74523,ok,-95.6104,34.22748,4749,58,81,23,39.7
74525,ok,-96.06885,34.33509,7813,59,81,22,37.3
74528,ok,-95.72555,34.72501,302,49,71,22,44.9
74530,ok,-96.50119,34.4259,420,53,76,23,43.4
74531,ok,-96.25218,34.88725,1493,51,73,22,43.1
74533,ok,-96.18858,34.20706,656,57,80,23,40.4
74534,ok,-96.36845,34.61217,438,51,74,23,45.1
74535,ok,-96.43966,34.4829,246,53,76,23,43.4
74536,ok,-95.45184,34.56179,2876,52,73,21,40.4
74538,ok,-96.25758,34.57978,5182,55,77,22,40
74540,ok,-95.70265,34.55688,390,49,70,21,42.9
74543,ok,-95.4318,34.36424,664,55,77,22,40
74546,ok,-95.57867,34.85837,658,51,72,21,41.2
74547,ok,-95.59307,34.81484,2910,50,71,21,42
74549,ok,-94.93271,34.55837,234,42,64,22,52.4
74552,ok,-95.24293,35.12113,1415,52,73,21,40.4
74553,ok,-95.91384,34.71207,1312,51,72,21,41.2
74554,ok,-95.71067,34.92331,1073,51,72,21,41.2
74555,ok,-95.95488,34.25963,799,59,81,22,37.3
74556,ok,-96.18203,34.46699,833,59,81,22,37.3
74557,ok,-95.69245,34.40177,2378,53,75,22,41.5
74558,ok,-95.15184,34.4938,587,47,68,21,44.7
74560,ok,-95.74546,34.64691,1574,49,70,21,42.9
74561,ok,-95.42927,35.12565,2173,48,69,21,43.8
74562,ok,-95.2851,34.29464,1449,54,76,22,40.7
74563,ok,-95.06673,34.97374,2725,55,75,20,36.4
74565,ok,-95.84542,34.80331,515,51,72,21,41.2
74567,ok,-95.39559,34.4248,357,51,72,21,41.2
74569,ok,-95.90907,34.46562,1455,55,77,22,40
74570,ok,-96.10641,34.85269,1499,51,72,21,41.2
74571,ok,-94.98832,34.71846,3902,53,73,20,37.7
74572,ok,-96.42489,34.64064,876,52,74,22,42.3
74574,ok,-95.2833,34.68416,1964,51,72,21,41.2
74576,ok,-96.03759,34.66018,373,53,75,22,41.5
74577,ok,-94.8438,34.6825,205,52,72,20,38.5
74578,ok,-95.34058,34.90554,5392,51,71,20,39.2
74601,ok,-97.14622,36.70064,11155,43,62,19,44.2
74604,ok,-96.98172,36.69829,6878,43,62,19,44.2
74630,ok,-97.42651,36.51156,932,42,61,19,45.2
74631,ok,-97.30869,36.79405,5204,45,64,19,42.2
74632,ok,-97.33694,36.93705,965,43,62,19,44.2
74633,ok,-96.79227,36.70323,942,43,62,19,44.2
74636,ok,-97.52228,36.81782,416,44,63,19,43.2
74637,ok,-96.67472,36.57167,2082,44,64,20,45.5
74640,ok,-97.65395,36.55126,561,43,62,19,44.2
74641,ok,-96.87903,36.78924,897,42,61,19,45.2
74643,ok,-97.5556,36.67088,1049,44,63,19,43.2
74644,ok,-97.10982,36.556,761,44,63,19,43.2
74646,ok,-97.44105,36.82623,454,44,63,19,43.2
74647,ok,-96.98533,36.91232,3722,40,59,19,47.5
74650,ok,-96.74749,36.47746,1299,45,64,19,42.2
74651,ok,-97.17475,36.46925,1331,45,64,19,42.2
74652,ok,-96.65035,36.85874,2270,41,61,20,48.8
74653,ok,-97.3517,36.65116,2814,45,64,19,42.2
74701,ok,-96.37812,34.00731,12802,58,80,22,37.9
74720,ok,-96.37534,33.82587,528,53,77,24,45.3
74722,ok,-94.9167,34.38785,223,47,68,21,44.7
74723,ok,-96.01514,33.99063,2094,55,79,24,43.6
74724,ok,-94.85597,34.34709,364,46,67,21,45.7
74726,ok,-96.17825,33.95264,2339,57,80,23,40.4
74727,ok,-95.85236,34.01581,2353,55,79,24,43.6
74728,ok,-94.8017,34.15339,9708,59,81,22,37.3
74729,ok,-96.25429,34.14711,2470,56,79,23,41.1
74730,ok,-96.43335,33.90486,2910,56,79,23,41.1
74731,ok,-96.56036,33.878,1505,49,73,24,49
74733,ok,-96.48261,33.83108,1947,51,75,24,47.1
74734,ok,-94.54627,34.10218,1360,60,81,21,35
74735,ok,-95.24952,34.08559,2136,59,82,23,39
74736,ok,-94.9863,33.92512,1068,59,82,23,39
74738,ok,-95.44264,33.90364,645,59,83,24,40.7
74740,ok,-94.59987,33.79041,2998,61,84,23,37.7
74741,ok,-96.29677,33.77914,1040,54,78,24,44.4
74743,ok,-95.49415,34.00824,6751,59,83,24,40.7
74745,ok,-94.81157,33.86503,7462,59,82,23,39
74747,ok,-96.35613,33.77375,127,53,77,24,45.3
74748,ok,-96.44037,34.1588,1325,55,78,23,41.8
74750,ok,-95.02071,33.96847,331,59,82,23,39
74753,ok,-96.53657,33.90792,32,52,75,23,44.2
74754,ok,-95.12593,34.20372,693,59,81,22,37.3
74755,ok,-95.1173,34.12939,135,61,83,22,36.1
74756,ok,-95.36582,34.07074,825,59,82,23,39
74759,ok,-95.70974,34.04825,1597,57,81,24,42.1
74760,ok,-95.36331,34.15786,207,58,81,23,39.7
74761,ok,-95.20161,34.00966,58,59,82,23,39
74764,ok,-95.09159,34.04512,2683,60,82,22,36.7
74766,ok,-94.97465,34.1501,1302,60,82,22,36.7
74801,ok,-96.96868,35.3163,11044,46,67,21,45.7
74804,ok,-96.92029,35.39285,8544,46,66,20,43.5
74820,ok,-96.7108,34.78902,17733,45,67,22,48.9
74824,ok,-96.87419,35.88649,890,46,66,20,43.5
74825,ok,-96.40798,34.80788,2285,50,72,22,44
74826,ok,-96.90122,35.01933,1622,46,68,22,47.8
74827,ok,-96.34218,34.94199,520,51,73,22,43.1
74829,ok,-96.47046,35.51736,1545,49,69,20,40.8
74830,ok,-96.66497,35.14388,153,50,72,22,44
74831,ok,-97.06024,34.8986,1073,44,65,21,47.7
74832,ok,-97.01138,35.82625,771,46,66,20,43.5
74833,ok,-96.41103,35.57664,717,49,70,21,42.9
74834,ok,-96.88247,35.70139,5191,49,69,20,40.8
74836,ok,-96.67941,34.45388,308,50,72,22,44
74837,ok,-96.45105,35.35859,251,49,70,21,42.9
74839,ok,-96.03009,35.23979,1069,50,72,22,44
74840,ok,-96.76991,35.30843,1386,49,70,21,42.9
74842,ok,-96.61253,34.62511,118,50,72,22,44
74843,ok,-96.72251,34.65641,348,42,64,22,52.4
74844,ok,-96.57788,34.86904,334,47,69,22,46.8
74845,ok,-95.88722,35.25753,955,51,73,22,43.1
74848,ok,-96.36395,35.08207,5539,51,73,22,43.1
74849,ok,-96.73769,34.98447,2569,47,68,21,44.7
74850,ok,-96.09219,35.11312,581,51,72,21,41.2
74851,ok,-97.07905,35.42615,4864,43,63,20,46.5
74852,ok,-97.00988,35.12578,1252,47,68,21,44.7
74854,ok,-96.74673,35.10615,1825,49,71,22,44.9
74855,ok,-96.90013,35.51677,2848,44,65,21,47.7
74856,ok,-96.81977,34.4125,980,48,70,22,45.8
74857,ok,-97.19641,35.34016,5446,42,63,21,50
74859,ok,-96.3176,35.46298,4692,50,71,21,42
74860,ok,-96.56774,35.52884,1442,48,69,21,43.8
74864,ok,-96.70258,35.48952,3407,48,69,21,43.8
74865,ok,-96.79571,34.60484,1839,42,64,22,52.4
74867,ok,-96.55664,34.96441,1317,49,70,21,42.9
74868,ok,-96.6462,35.2672,8623,52,73,21,40.4
74869,ok,-96.75472,35.602,840,48,69,21,43.8
74871,ok,-96.54582,34.60391,2209,50,72,22,44
74872,ok,-96.98193,34.7809,2983,42,64,22,52.4
74873,ok,-96.97339,35.21879,7209,47,68,21,44.7
74875,ok,-96.97383,35.87711,815,46,66,20,43.5
74878,ok,-97.07005,35.00907,1703,45,67,22,48.9
74880,ok,-96.11954,35.37784,2437,51,72,21,41.2
74881,ok,-97.08273,35.71851,3849,45,65,20,44.4
74883,ok,-96.22614,35.22787,2729,51,72,21,41.2
74884,ok,-96.51601,35.19212,5364,50,72,22,44
74901,ok,-94.45823,35.34832,1330,51,72,21,41.2
74902,ok,-94.48043,35.24454,2475,52,72,20,38.5
74930,ok,-94.77975,35.18554,1742,56,77,21,37.5
74931,ok,-94.75745,35.69477,1190,34,55,21,61.8
74932,ok,-94.53072,35.14641,1934,56,76,20,35.7
74935,ok,-94.89683,34.94843,201,59,79,20,33.9
74936,ok,-94.71701,35.37797,734,48,69,21,43.8
74937,ok,-94.57619,34.82533,3822,55,75,20,36.4
74939,ok,-94.61527,34.70454,1112,44,65,21,47.7
74940,ok,-94.62578,34.9542,1715,58,78,20,34.5
74941,ok,-94.87576,35.28547,2332,52,73,21,40.4
74942,ok,-94.97703,34.89911,133,55,75,20,36.4
74943,ok,-95.0758,35.08203,203,45,65,20,44.4
74944,ok,-94.99736,35.13026,1571,53,73,20,37.7
74945,ok,-94.80935,35.59722,425,38,59,21,55.3
74946,ok,-94.45259,35.39154,160,52,73,21,40.4
74948,ok,-94.56098,35.46559,7910,49,70,21,42.9
74949,ok,-94.76832,34.66107,357,49,70,21,42.9
74951,ok,-94.65581,35.1704,939,59,79,20,33.9
74953,ok,-94.60708,35.04467,7223,61,81,20,32.8
74954,ok,-94.49712,35.42669,2372,52,73,21,40.4
74955,ok,-94.75662,35.4939,9370,42,63,21,50
74956,ok,-94.76287,35.1096,1255,54,74,20,37
74957,ok,-94.65679,34.52613,1992,46,66,20,43.5
74959,ok,-94.61839,35.26246,4666,55,75,20,36.4
74960,ok,-94.64971,35.81041,6704,31,51,20,64.5
74962,ok,-94.95252,35.53333,5966,42,63,21,50
74963,ok,-94.57587,34.39817,898,45,66,21,46.7
74964,ok,-94.66435,36.11707,1702,32,52,20,62.5
74965,ok,-94.62554,35.99871,2610,30,50,20,66.7
74966,ok,-94.86888,34.91123,3846,57,77,20,35.1
75001,tx,-96.83851,32.95997,2315,58,82,24,41.4
75002,tx,-96.60757,33.08966,23242,59,84,25,42.4
75006,tx,-96.89703,32.96184,12477,59,82,23,39
75007,tx,-96.89712,33.00462,16489,58,82,24,41.4
75009,tx,-96.75036,33.34029,8793,56,80,24,42.9
75010,tx,-96.89675,33.03427,8694,58,82,24,41.4
75013,tx,-96.69409,33.11463,15332,60,84,24,40
75019,tx,-96.9854,32.96348,13326,59,82,23,39
75020,tx,-96.60414,33.77168,12911,45,70,25,55.6
75021,tx,-96.47329,33.72616,5263,48,73,25,52.1
75022,tx,-97.12022,33.02776,9197,58,81,23,39.7
75023,tx,-96.73244,33.05701,14586,58,82,24,41.4
75024,tx,-96.80701,33.07736,10242,58,82,24,41.4
75025,tx,-96.74122,33.09093,14915,58,83,25,43.1
75028,tx,-97.06083,33.03278,16747,58,81,23,39.7
75032,tx,-96.42772,32.85506,14613,59,84,25,42.4
75034,tx,-96.8603,33.15194,39815,58,82,24,41.4
75035,tx,-96.77271,33.15537,26518,58,82,24,41.4
75038,tx,-96.99752,32.87456,3440,59,82,23,39
75039,tx,-96.94225,32.8875,2774,59,82,23,39
75040,tx,-96.6201,32.92769,19549,59,84,25,42.4
75041,tx,-96.65142,32.88092,8636,60,84,24,40
75042,tx,-96.67494,32.9139,9691,58,83,25,43.1
75043,tx,-96.57937,32.85707,17246,62,86,24,38.7
75044,tx,-96.6532,32.96266,13382,58,83,25,43.1
75048,tx,-96.58089,32.97202,9079,57,82,25,43.9
75050,tx,-97.00535,32.7741,10751,58,82,24,41.4
75051,tx,-96.99441,32.72754,10111,60,84,24,40
75052,tx,-97.02649,32.66589,28425,62,86,24,38.7
75054,tx,-97.04053,32.59078,4849,64,88,24,37.5
75056,tx,-96.91459,33.07394,20210,58,82,24,41.4
75057,tx,-96.98368,33.04973,3299,58,81,23,39.7
75058,tx,-96.74226,33.45008,2426,52,76,24,46.2
75060,tx,-96.95448,32.79595,12318,59,83,24,40.7
75061,tx,-96.96547,32.82604,10352,59,82,23,39
75062,tx,-96.95692,32.84704,10459,59,82,23,39
75063,tx,-96.98552,32.92053,9303,59,83,24,40.7
75065,tx,-97.01168,33.11082,5291,57,81,24,42.1
75067,tx,-97.00017,33.0137,13396,58,81,23,39.7
75068,tx,-96.95054,33.17646,24852,58,81,23,39.7
75069,tx,-96.5947,33.16546,12737,62,85,23,37.1
75070,tx,-96.69774,33.17307,34986,60,84,24,40
75071,tx,-96.629,33.24665,25366,60,84,24,40
75074,tx,-96.67429,33.0319,13655,58,82,24,41.4
75075,tx,-96.74109,33.02134,11406,58,82,24,41.4
75076,tx,-96.72167,33.79475,6582,44,69,25,56.8
75077,tx,-97.06272,33.07886,12920,57,81,24,42.1
75078,tx,-96.80855,33.24672,16521,57,80,23,40.4
75080,tx,-96.74202,32.97395,12854,58,82,24,41.4
75081,tx,-96.71018,32.94881,10578,58,82,24,41.4
75082,tx,-96.66248,32.99157,7143,57,82,25,43.9
75087,tx,-96.44999,32.94184,15430,57,83,26,45.6
75088,tx,-96.54907,32.89231,9858,61,86,25,41
75089,tx,-96.54984,32.92958,11255,60,85,25,41.7
75090,tx,-96.54561,33.6045,11319,47,72,25,53.2
75092,tx,-96.70007,33.64892,11342,45,70,25,55.6
75093,tx,-96.81003,33.03549,14073,57,82,25,43.9
75094,tx,-96.61505,33.01907,7289,57,82,25,43.9
75098,tx,-96.53479,33.01176,22397,57,83,26,45.6
75101,tx,-96.70249,32.27003,273,58,84,26,44.8
75102,tx,-96.64223,32.06633,1339,59,86,27,45.8
75103,tx,-95.88234,32.51193,9144,59,86,27,45.8
75104,tx,-96.96613,32.58041,18096,62,86,24,38.7
75105,tx,-96.37521,32.26653,452,61,88,27,44.3
75109,tx,-96.35403,32.04521,5744,60,88,28,46.7
75110,tx,-96.52878,32.08693,15204,57,85,28,49.1
75114,tx,-96.44552,32.61018,3810,61,86,25,41
75115,tx,-96.86373,32.59884,18099,62,86,24,38.7
75116,tx,-96.91396,32.66015,5835,60,84,24,40
75117,tx,-95.8508,32.71183,2725,60,85,25,41.7
75119,tx,-96.59335,32.32975,12838,59,85,26,44.1
75124,tx,-95.97243,32.32678,5592,62,89,27,43.5
75125,tx,-96.6248,32.53137,3885,63,88,25,39.7
75126,tx,-96.45184,32.74207,21088,61,86,25,41
75127,tx,-95.79335,32.6912,1207,59,85,26,44.1
75132,tx,-96.37372,32.94538,1614,59,84,25,42.4
75134,tx,-96.78294,32.62003,7355,63,87,24,38.1
75135,tx,-96.22292,33.06522,4650,63,87,24,38.1
75137,tx,-96.91175,32.63399,7057,62,86,24,38.7
75140,tx,-95.69143,32.6469,4529,60,86,26,43.3
75141,tx,-96.69459,32.63998,1566,65,88,23,35.4
75142,tx,-96.24715,32.57359,10491,60,86,26,43.3
75143,tx,-96.24819,32.36358,15972,61,88,27,44.3
75144,tx,-96.20884,32.11311,4237,62,89,27,43.5
75146,tx,-96.75068,32.57461,8184,64,88,24,37.5
75147,tx,-96.07743,32.433,4833,61,87,26,42.6
75148,tx,-96.01214,32.12465,10355,64,91,27,42.2
75149,tx,-96.61487,32.77,17709,64,88,24,37.5
75150,tx,-96.63037,32.81577,14908,61,86,25,41
75152,tx,-96.68035,32.43644,2488,61,86,25,41
75153,tx,-96.32861,32.15027,573,60,87,27,45
75154,tx,-96.81005,32.52276,17381,62,86,24,38.7
75155,tx,-96.47319,32.22568,2525,60,86,26,43.3
75156,tx,-96.09979,32.28688,27360,62,89,27,43.5
75157,tx,-96.44685,32.46227,333,61,87,26,42.6
75158,tx,-96.39665,32.46221,2871,60,86,26,43.3
75159,tx,-96.54087,32.60745,8226,63,88,25,39.7
75160,tx,-96.30018,32.76169,12546,59,85,26,44.1
75161,tx,-96.17115,32.7374,4536,58,84,26,44.8
75163,tx,-96.1103,32.16758,5196,63,90,27,42.9
75164,tx,-96.30791,33.0659,943,61,86,25,41
75165,tx,-96.79745,32.36911,18390,61,86,25,41
75166,tx,-96.45007,33.01257,2390,58,83,25,43.1
75167,tx,-96.91516,32.35887,5276,60,85,25,41.7
75169,tx,-95.99656,32.70456,14852,59,85,26,44.1
75172,tx,-96.67516,32.60482,1402,65,89,24,36.9
75173,tx,-96.39103,33.05924,3971,58,83,25,43.1
75180,tx,-96.61843,32.7189,7138,63,87,24,38.1
75181,tx,-96.55518,32.72694,8692,64,89,25,39.1
75182,tx,-96.55404,32.80014,3393,65,88,23,35.4
75189,tx,-96.31193,32.95183,15302,59,84,25,42.4
75201,tx,-96.79943,32.78776,1150,60,84,24,40
75202,tx,-96.80477,32.77926,333,60,84,24,40
75203,tx,-96.80303,32.74622,5984,60,84,24,40
75204,tx,-96.78885,32.80213,4036,60,84,24,40
75205,tx,-96.79624,32.83655,6392,59,83,24,40.7
75206,tx,-96.77029,32.83155,6946,59,84,25,42.4
75207,tx,-96.82129,32.7867,1635,60,84,24,40
75208,tx,-96.83988,32.75372,9698,58,82,24,41.4
75209,tx,-96.82588,32.84884,5606,59,83,24,40.7
75210,tx,-96.74597,32.77135,3353,61,85,24,39.3
75211,tx,-96.90298,32.73494,15445,57,81,24,42.1
75212,tx,-96.8791,32.78144,10485,59,83,24,40.7
75214,tx,-96.74545,32.82862,11017,60,84,24,40
75215,tx,-96.758,32.75072,8922,61,85,24,39.3
75216,tx,-96.78366,32.71162,19039,60,84,24,40
75217,tx,-96.68118,32.71215,22958,62,86,24,38.7
75218,tx,-96.70235,32.84149,8749,59,83,24,40.7
75219,tx,-96.8129,32.81182,3109,60,84,24,40
75220,tx,-96.87618,32.86668,6869,58,82,24,41.4
75223,tx,-96.744,32.79224,4973,61,85,24,39.3
75224,tx,-96.83991,32.71103,7835,59,83,24,40.7
75225,tx,-96.79099,32.86516,6790,58,83,25,43.1
75226,tx,-96.77644,32.78283,1217,60,84,24,40
75227,tx,-96.68728,32.77001,14794,61,85,24,39.3
75228,tx,-96.67992,32.82444,15771,60,84,24,40
75229,tx,-96.86438,32.89376,10809,58,82,24,41.4
75230,tx,-96.79205,32.90232,7935,59,83,24,40.7
75231,tx,-96.74978,32.87763,3257,59,83,24,40.7
75232,tx,-96.84013,32.66094,9177,60,84,24,40
75233,tx,-96.87299,32.70433,3514,57,82,25,43.9
75234,tx,-96.89039,32.92366,9452,59,82,23,39
75235,tx,-96.8485,32.83253,3430,59,83,24,40.7
75236,tx,-96.93575,32.68557,3543,59,83,24,40.7
75237,tx,-96.87306,32.66562,2068,59,83,24,40.7
75238,tx,-96.70782,32.8785,7416,58,83,25,43.1
75240,tx,-96.7886,32.93176,2865,59,83,24,40.7
75241,tx,-96.75905,32.66569,11641,62,86,24,38.7
75243,tx,-96.73564,32.91214,7843,58,83,25,43.1
75244,tx,-96.83662,32.92541,3627,59,83,24,40.7
75246,tx,-96.77333,32.79296,621,60,84,24,40
75247,tx,-96.87748,32.8136,1289,59,83,24,40.7
75248,tx,-96.79529,32.96953,9389,58,82,24,41.4
75249,tx,-96.95879,32.64441,5025,61,85,24,39.3
75251,tx,-96.77188,32.91902,49,59,83,24,40.7
75252,tx,-96.79083,32.99722,6545,57,82,25,43.9
75253,tx,-96.61286,32.67499,4863,63,88,25,39.7
75254,tx,-96.80138,32.94562,1787,59,83,24,40.7
75270,tx,-96.80223,32.7812,5,60,84,24,40
75287,tx,-96.84109,33.00026,6509,58,82,24,41.4
75401,tx,-96.1195,33.18425,10202,61,86,25,41
75402,tx,-96.08537,33.06875,9170,61,86,25,41
75407,tx,-96.48797,33.15087,11611,60,84,24,40
75409,tx,-96.52734,33.35196,10226,57,81,24,42.1
75410,tx,-95.63453,32.791,4102,63,88,25,39.7
75411,tx,-95.64861,33.86203,1156,58,82,24,41.4
75412,tx,-95.15242,33.79983,1006,54,78,24,44.4
75413,tx,-96.17916,33.44144,171,55,79,24,43.6
75414,tx,-96.43182,33.62338,2129,51,75,24,47.1
75415,tx,-95.75127,33.45984,246,56,81,25,44.6
75416,tx,-95.35439,33.67816,2337,52,77,25,48.1
75417,tx,-95.13136,33.43888,2198,57,83,26,45.6
75418,tx,-96.17765,33.5727,7840,53,77,24,45.3
75420,tx,-95.72611,33.05296,844,56,82,26,46.4
75421,tx,-95.71723,33.64662,997,58,82,24,41.4
75422,tx,-95.93202,33.13937,2560,58,84,26,44.8
75423,tx,-96.19999,33.28613,2678,57,82,25,43.9
75424,tx,-96.38588,33.3066,3059,58,82,24,41.4
75426,tx,-95.00499,33.65529,5456,54,79,25,46.3
75428,tx,-95.91605,33.26849,4815,58,83,25,43.1
75431,tx,-95.46367,33.01158,1564,58,84,26,44.8
75432,tx,-95.67441,33.39603,3367,56,81,25,44.6
75433,tx,-95.80427,33.10765,2131,56,82,26,46.4
75435,tx,-95.31355,33.48221,1334,55,80,25,45.5
75436,tx,-95.25158,33.71281,1590,53,78,25,47.2
75437,tx,-95.46898,33.2584,1032,55,82,27,49.1
75438,tx,-96.06542,33.60829,1119,53,78,25,47.2
75439,tx,-96.27709,33.55205,581,52,77,25,48.1
75440,tx,-95.75557,32.87824,6392,57,83,26,45.6
75441,tx,-95.6534,33.43222,223,56,81,25,44.6
75442,tx,-96.35309,33.17365,6812,58,82,24,41.4
75446,tx,-95.89417,33.61203,3598,55,80,25,45.5
75447,tx,-96.11766,33.76504,909,54,78,24,44.4
75448,tx,-95.79329,33.31494,802,57,82,25,43.9
75449,tx,-95.94603,33.42067,1766,56,81,25,44.6
75450,tx,-95.47842,33.40509,641,56,81,25,44.6
75451,tx,-95.12121,32.96633,1424,61,86,25,41
75452,tx,-96.24334,33.39323,3007,55,80,25,45.5
75453,tx,-95.93274,32.99673,4541,59,85,26,44.1
75454,tx,-96.56321,33.28334,7253,59,83,24,40.7
75455,tx,-94.97819,33.217,15194,65,89,24,36.9
75457,tx,-95.21223,33.1728,6632,58,83,25,43.1
75459,tx,-96.67755,33.53104,2667,49,73,24,49
75460,tx,-95.60421,33.65814,13521,56,80,24,42.9
75462,tx,-95.4838,33.62385,7560,53,78,25,47.2
75468,tx,-95.40654,33.5132,905,54,79,25,46.3
75469,tx,-95.81456,33.42162,555,56,82,26,46.4
75470,tx,-95.80819,33.58228,336,57,81,24,42.1
75471,tx,-95.38925,33.03947,1056,56,82,26,46.4
75472,tx,-95.87795,32.88593,3678,59,84,25,42.4
75473,tx,-95.49,33.81429,2554,58,81,23,39.7
75474,tx,-96.10898,32.91952,12784,59,85,26,44.1
75475,tx,-96.23825,33.47489,142,54,79,25,46.3
75476,tx,-96.24351,33.70592,1126,53,77,24,45.3
75477,tx,-95.7347,33.53285,1299,58,82,24,41.4
75478,tx,-95.35752,33.17445,832,55,81,26,47.3
75479,tx,-96.33923,33.62144,1535,52,76,24,46.2
75480,tx,-95.19412,33.02473,4686,60,85,25,41.7
75481,tx,-95.37373,33.31523,641,56,81,25,44.6
75482,tx,-95.6068,33.16816,14229,55,81,26,47.3
75486,tx,-95.74861,33.75823,2057,58,82,24,41.4
75487,tx,-95.16156,33.33606,1799,59,85,26,44.1
75488,tx,-95.98747,33.77724,1342,56,80,24,42.9
75489,tx,-96.48432,33.51925,497,52,76,24,46.2
75490,tx,-96.31336,33.43429,1702,54,79,25,46.3
75491,tx,-96.3975,33.49637,3811,53,77,24,45.3
75492,tx,-95.99552,33.58768,922,54,79,25,46.3
75493,tx,-95.10852,33.13881,344,61,85,24,39.3
75494,tx,-95.26235,32.90935,9321,58,84,26,44.8
75495,tx,-96.55162,33.43312,5222,54,78,24,44.4
75496,tx,-96.06299,33.35986,2994,56,82,26,46.4
75497,tx,-95.572,32.92199,5128,62,87,25,40.3
75501,tx,-94.13145,33.37359,20053,63,86,23,36.5
75503,tx,-94.13037,33.51344,11232,59,81,22,37.3
75550,tx,-94.88242,33.49407,913,60,84,24,40
75551,tx,-94.20199,33.11557,9028,64,88,24,37.5
75554,tx,-94.7795,33.55471,1653,61,85,24,39.3
75555,tx,-94.13835,32.94694,2443,64,88,24,37.5
75556,ar,-94.0613,33.16111,1064,64,88,24,36.7
75558,tx,-94.85807,33.24192,1401,64,88,24,37.5
75559,tx,-94.62738,33.50989,5801,63,86,23,36.5
75560,tx,-94.36877,33.18694,1634,63,87,24,38.1
75561,tx,-94.27785,33.51336,3583,61,83,22,36.1
75562,tx,-94.24845,32.92541,336,63,88,25,39.7
75563,tx,-94.38963,33.00609,5070,63,88,25,39.7
75565,tx,-94.07228,32.93729,370,64,88,24,37.5
75566,tx,-94.49174,33.14818,1234,64,88,24,37.5
75567,tx,-94.31878,33.31404,2772,63,86,23,36.5
75568,tx,-94.59618,33.20101,3463,64,88,24,37.5
75569,tx,-94.12653,33.44147,1293,61,84,23,37.7
75570,tx,-94.43753,33.46195,6224,63,86,23,36.5
75571,tx,-94.76401,33.20622,2294,65,89,24,36.9
75572,tx,-94.13216,33.23154,3277,64,87,23,35.9
75573,tx,-94.23729,33.34231,150,63,86,23,36.5
75574,tx,-94.55349,33.33097,1854,64,87,23,35.9
75601,tx,-94.72384,32.50859,7753,63,89,26,41.3
75602,tx,-94.65992,32.459,10367,63,89,26,41.3
75603,tx,-94.70909,32.39854,3353,59,86,27,45.8
75604,tx,-94.82775,32.50967,11965,64,90,26,40.6
75605,tx,-94.72063,32.58259,13134,64,90,26,40.6
75630,tx,-94.5527,32.87433,5072,66,90,24,36.4
75631,tx,-94.45454,32.24924,2015,63,88,25,39.7
75633,tx,-94.27709,32.12893,8900,65,90,25,38.5
75638,tx,-94.73185,33.02096,4375,67,91,24,35.8
75639,tx,-94.16948,32.29031,2608,63,88,25,39.7
75640,tx,-94.68412,32.71556,3171,65,90,25,38.5
75641,tx,-94.57578,32.37841,265,61,87,26,42.6
75642,tx,-94.1766,32.37154,176,62,87,25,40.3
75643,tx,-94.36087,32.01618,1599,65,90,25,38.5
75644,tx,-94.99552,32.7951,7927,65,90,25,38.5
75645,tx,-94.87403,32.68749,6793,64,90,26,40.6
75647,tx,-94.95131,32.51892,7928,62,88,26,41.9
75650,tx,-94.55473,32.51394,5426,61,87,26,42.6
75651,tx,-94.53604,32.67159,2686,63,89,26,41.3
75652,tx,-94.73272,32.2299,8168,59,85,26,44.1
75654,tx,-94.82648,32.08097,7283,59,85,26,44.1
75656,tx,-94.5907,33.00551,4332,66,90,24,36.4
75657,tx,-94.30605,32.79221,12067,63,88,25,39.7
75661,tx,-94.16155,32.63753,3518,64,88,24,37.5
75662,tx,-94.87015,32.38399,12992,59,86,27,45.8
75667,tx,-94.84003,31.98547,1217,60,87,27,45
75668,tx,-94.68359,32.90449,1699,68,92,24,35.3
75669,tx,-94.56396,32.03375,999,63,88,25,39.7
75670,tx,-94.42298,32.57299,11877,59,84,25,42.4
75672,tx,-94.29489,32.46883,11447,60,85,25,41.7
75681,tx,-94.6919,31.92838,2914,62,88,26,41.9
75682,tx,-94.93654,32.25034,230,57,84,27,47.4
75683,tx,-94.737,32.82299,3700,67,92,25,37.3
75684,tx,-94.93896,32.27335,4388,57,84,27,47.4
75686,tx,-94.95018,32.96954,12407,65,89,24,36.9
75691,tx,-94.55063,32.31325,2761,60,86,26,43.3
75692,tx,-94.11628,32.48037,3473,62,87,25,40.3
75693,tx,-94.85992,32.53381,2915,63,89,26,41.3
75701,tx,-95.30095,32.32329,14170,56,84,28,50
75702,tx,-95.31531,32.36286,11500,55,84,29,52.7
75703,tx,-95.32062,32.23855,15561,56,85,29,51.8
75704,tx,-95.44132,32.40752,5178,53,82,29,54.7
75705,tx,-95.10274,32.36602,1850,57,85,28,49.1
75706,tx,-95.30765,32.46602,5216,56,84,28,50
75707,tx,-95.17689,32.30358,7633,57,85,28,49.1
75708,tx,-95.20959,32.41636,4166,57,85,28,49.1
75709,tx,-95.39293,32.3107,3006,54,82,28,51.9
75750,tx,-95.07493,32.27444,2792,58,85,27,46.6
75751,tx,-95.9083,32.09642,11412,63,90,27,42.9
75752,tx,-95.80865,32.24456,8155,64,91,27,42.2
75754,tx,-95.6652,32.42578,4432,58,85,27,46.6
75755,tx,-95.08594,32.63316,3984,62,88,26,41.9
75756,tx,-95.60004,32.30404,3479,59,87,28,47.5
75757,tx,-95.349,32.11465,11983,59,87,28,47.5
75758,tx,-95.50736,32.2754,11017,58,86,28,48.3
75759,tx,-95.4188,32.03594,420,61,88,27,44.3
75760,tx,-94.85562,31.8041,2832,62,89,27,43.5
75762,tx,-95.41381,32.21685,14292,57,85,28,49.1
75763,tx,-95.52213,32.04188,7646,61,89,28,45.9
75764,tx,-95.14372,31.89543,172,55,83,28,50.9
75765,tx,-95.23514,32.64158,8976,60,86,26,43.3
75766,tx,-95.25701,31.94618,19140,58,86,28,48.3
75770,tx,-95.64876,32.13857,3996,62,90,28,45.2
75771,tx,-95.43457,32.53611,12078,57,84,27,47.4
75773,tx,-95.44589,32.67875,10207,62,88,26,41.9
75778,tx,-95.71184,32.30229,4440,62,89,27,43.5
75779,tx,-95.48585,31.86522,182,61,89,28,45.9
75780,tx,-95.09185,31.99102,102,58,85,27,46.6
75783,tx,-95.42365,32.82155,7957,63,88,25,39.7
75784,tx,-94.97328,31.87369,788,61,88,27,44.3
75785,tx,-95.17383,31.77993,8396,55,84,29,52.7
75788,tx,-94.92587,31.82594,313,61,88,27,44.3
75789,tx,-95.09696,32.10911,6864,59,86,27,45.8
75790,tx,-95.64261,32.5323,2508,59,85,26,44.1
75791,tx,-95.22054,32.22163,6279,58,86,28,48.3
75792,tx,-95.10196,32.4767,3245,59,86,27,45.8
75801,tx,-95.53315,31.73456,10603,63,91,28,44.4
75803,tx,-95.66912,31.87443,10459,61,89,28,45.9
75831,tx,-96.01471,31.4623,1517,66,93,27,40.9
75832,tx,-95.99462,31.91907,87,67,93,26,38.8
75835,tx,-95.49194,31.29349,9169,66,93,27,40.9
75838,tx,-96.22825,31.47742,1280,63,91,28,44.4
75839,tx,-95.57789,31.60598,3803,65,92,27,41.5
75840,tx,-96.089,31.78237,7070,64,92,28,43.8
75844,tx,-95.43843,31.51375,6468,65,92,27,41.5
75845,tx,-95.0896,31.10079,3281,73,98,25,34.2
75846,tx,-96.16543,31.33863,871,64,91,27,42.2
75847,tx,-95.14601,31.35383,2688,67,93,26,38.8
75848,tx,-96.32993,31.76524,98,61,89,28,45.9
75849,tx,-95.48165,31.41741,55,66,93,27,40.9
75851,tx,-95.49714,31.09325,3479,69,94,25,36.2
75852,tx,-95.71167,30.96684,2155,73,98,25,34.2
75853,tx,-95.81321,31.93695,1009,63,90,27,42.9
75855,tx,-95.85024,31.5622,2064,68,94,26,38.2
75856,tx,-95.25574,31.1889,298,71,97,26,36.6
75858,tx,-95.12665,31.39077,46,65,91,26,40
75859,tx,-96.24022,31.8816,4336,64,91,27,42.2
75860,tx,-96.2486,31.6209,5817,63,90,27,42.9
75861,tx,-95.8924,31.85322,1493,66,93,27,40.9
75862,tx,-95.32385,30.95983,21714,71,96,25,35.2
75901,tx,-94.65551,31.30136,16234,68,94,26,38.2
75904,tx,-94.82173,31.33967,17327,66,92,26,39.4
75925,tx,-95.06598,31.61116,4630,60,87,27,45
75926,tx,-94.96269,31.25138,1274,68,94,26,38.2
75928,tx,-93.71173,30.67146,1403,72,98,26,36.1
75929,tx,-94.19465,31.24551,2900,69,94,25,36.2
75930,tx,-94.03262,31.32202,2055,67,91,24,35.8
75931,tx,-94.00383,31.1108,7101,67,91,24,35.8
75932,tx,-93.60979,31.05419,2980,64,89,25,39.1
75933,tx,-93.81156,30.55808,1306,80,105,25,31.3
75934,tx,-94.75073,30.89591,207,71,96,25,35.2
75935,tx,-94.20157,31.73268,8852,68,92,24,35.3
75936,tx,-94.57959,30.9521,1277,70,95,25,35.7
75937,tx,-94.37647,31.45873,871,67,92,25,37.3
75938,tx,-94.35343,30.93263,3024,70,95,25,35.7
75939,tx,-94.79411,31.01823,4483,71,96,25,35.2
75941,tx,-94.76367,31.17992,4303,69,95,26,37.7
75942,tx,-94.43151,30.8163,118,70,95,25,35.7
75943,tx,-94.88782,31.65354,1018,63,89,26,41.3
75944,tx,-94.3886,31.33733,1773,68,93,25,36.8
75946,tx,-94.52539,31.81358,2953,65,90,25,38.5
75948,tx,-93.77902,31.30805,10749,63,88,25,39.7
75949,tx,-94.51943,31.23143,8146,69,94,25,36.2
75951,tx,-94.05382,30.94152,11666,69,95,26,37.7
75954,tx,-94.05442,31.92344,2811,67,91,24,35.8
75956,tx,-93.97821,30.67771,6303,76,102,26,34.2
75959,tx,-93.84931,31.51447,1745,64,88,24,37.5
75960,tx,-94.86709,30.91444,1089,70,96,26,37.1
75961,tx,-94.50001,31.56112,8633,66,91,25,37.9
75962,tx,-94.64708,31.61987,12,67,93,26,38.8
75964,tx,-94.74496,31.62169,9461,65,91,26,40
75965,tx,-94.62608,31.72378,6582,67,92,25,37.3
75966,tx,-93.7284,30.83521,4819,69,95,26,37.7
75968,tx,-93.95041,31.2526,1320,67,91,24,35.8
75969,tx,-94.89895,31.44688,2912,58,86,28,48.3
75972,tx,-94.12709,31.495,6017,66,90,24,36.4
75973,tx,-93.93303,31.71645,2860,66,90,24,36.4
75974,tx,-94.2387,31.95669,2268,67,91,24,35.8
75975,tx,-94.41302,31.89736,3149,65,90,25,38.5
75976,tx,-94.92749,31.5206,622,56,84,28,50
75977,tx,-93.78206,31.06121,1823,64,89,25,39.1
75978,tx,-94.52726,31.50906,84,67,91,24,35.8
75979,tx,-94.40152,30.77631,11419,72,97,25,34.7
75980,tx,-94.35256,31.12667,4725,69,94,25,36.2
76001,tx,-97.15277,32.63043,10995,60,83,23,38.3
76002,tx,-97.09225,32.62262,10840,62,86,24,38.7
76006,tx,-97.10022,32.78492,2842,57,81,24,42.1
76008,tx,-97.6237,32.69282,9384,53,77,24,45.3
76009,tx,-97.2017,32.41578,10431,61,85,24,39.3
76010,tx,-97.08032,32.72283,10346,58,81,23,39.7
76011,tx,-97.08255,32.75424,3639,57,80,23,40.4
76012,tx,-97.13905,32.7546,9023,57,80,23,40.4
76013,tx,-97.15645,32.7203,9508,57,81,24,42.1
76014,tx,-97.0879,32.69201,7984,58,82,24,41.4
76015,tx,-97.13343,32.69218,4926,58,82,24,41.4
76016,tx,-97.18875,32.68902,11775,58,82,24,41.4
76017,tx,-97.16246,32.66207,14747,59,82,23,39
76018,tx,-97.09002,32.66078,8612,61,84,23,37.7
76020,tx,-97.56548,32.89998,15287,59,82,23,39
76021,tx,-97.13125,32.85231,10562,57,81,24,42.1
76022,tx,-97.14516,32.83066,3928,58,81,23,39.7
76023,tx,-97.60577,33.04848,3472,58,80,22,37.9
76028,tx,-97.30318,32.52603,28531,58,82,24,41.4
76031,tx,-97.33112,32.3485,9052,63,87,24,38.1
76033,tx,-97.51144,32.28511,13809,65,88,23,35.4
76034,tx,-97.14882,32.89123,10727,57,81,24,42.1
76035,tx,-97.63362,32.56289,1679,52,76,24,46.2
76036,tx,-97.41284,32.57704,12414,57,81,24,42.1
76039,tx,-97.08387,32.85936,8933,57,81,24,42.1
76040,tx,-97.09675,32.81468,10445,57,81,24,42.1
76041,tx,-96.84633,32.24001,302,60,85,25,41.7
76043,tx,-97.79713,32.2053,4535,59,83,24,40.7
76044,tx,-97.54355,32.42762,3597,60,83,23,38.3
76048,tx,-97.80877,32.4232,23357,57,81,24,42.1
76049,tx,-97.70807,32.46394,19654,59,82,23,39
76050,tx,-97.16606,32.27534,4494,61,85,24,39.3
76051,tx,-97.07161,32.92517,14179,58,81,23,39.7
76052,tx,-97.37655,32.98624,11396,59,82,23,39
76053,tx,-97.17949,32.81709,8556,58,81,23,39.7
76054,tx,-97.17783,32.8591,4898,57,81,24,42.1
76055,tx,-97.15512,32.16217,2472,58,83,25,43.1
76058,tx,-97.42395,32.46693,8563,59,83,24,40.7
76059,tx,-97.32688,32.39251,1531,62,86,24,38.7
76060,tx,-97.21582,32.64084,3746,58,82,24,41.4
76061,tx,-97.18839,32.50399,193,60,84,24,40
76063,tx,-97.14274,32.56977,25234,61,85,24,39.3
76064,tx,-97.03566,32.30149,1026,61,86,25,41
76065,tx,-96.98899,32.4705,16887,60,85,25,41.7
76066,tx,-97.99505,32.70727,2633,60,82,22,36.7
76067,tx,-98.12755,32.80005,11333,63,84,21,33.3
76070,tx,-97.65439,32.26239,659,62,85,23,37.1
76071,tx,-97.47929,33.00546,1685,59,82,23,39
76073,tx,-97.72735,33.10347,3398,59,81,22,37.3
76077,tx,-97.70543,32.28214,336,63,85,22,34.9
76078,tx,-97.46659,33.08918,4838,57,79,22,38.6
76082,tx,-97.71844,32.97049,10120,54,77,23,42.6
76084,tx,-97.08946,32.43218,4307,61,85,24,39.3
76085,tx,-97.70075,32.85031,4911,53,76,23,43.4
76086,tx,-97.78993,32.75481,8605,49,72,23,46.9
76087,tx,-97.78318,32.67077,18196,53,77,24,45.3
76088,tx,-97.90144,32.84578,7045,51,74,23,45.1
76092,tx,-97.14866,32.95993,11389,57,81,24,42.1
76093,tx,-97.39489,32.21724,1650,64,87,23,35.9
76102,tx,-97.32976,32.75924,2211,58,82,24,41.4
76103,tx,-97.26546,32.75207,5041,58,81,23,39.7
76104,tx,-97.31782,32.72869,9760,58,82,24,41.4
76105,tx,-97.26943,32.72405,9278,58,82,24,41.4
76106,tx,-97.35251,32.8145,10990,59,82,23,39
76107,tx,-97.38198,32.74171,12174,57,81,24,42.1
76108,tx,-97.52195,32.77594,17262,55,79,24,43.6
76109,tx,-97.38396,32.70101,7137,57,80,23,40.4
76110,tx,-97.33889,32.70695,10640,58,81,23,39.7
76111,tx,-97.29986,32.77811,8233,58,82,24,41.4
76112,tx,-97.21846,32.74809,12026,58,82,24,41.4
76114,tx,-97.40268,32.77439,9187,58,81,23,39.7
76115,tx,-97.33075,32.67879,5635,57,81,24,42.1
76116,tx,-97.44639,32.72173,12387,56,80,24,42.9
76117,tx,-97.26756,32.80367,10354,58,82,24,41.4
76118,tx,-97.20777,32.79964,5840,58,81,23,39.7
76119,tx,-97.26213,32.69064,13464,58,82,24,41.4
76120,tx,-97.17819,32.77221,4586,57,81,24,42.1
76123,tx,-97.39315,32.61898,12461,56,80,24,42.9
76126,tx,-97.51234,32.63383,12270,56,80,24,42.9
76127,tx,-97.4301,32.77712,39,57,81,24,42.1
76129,tx,-97.36349,32.70864,1,57,80,23,40.4
76131,tx,-97.34688,32.88334,16626,59,82,23,39
76132,tx,-97.41797,32.66758,5232,56,80,24,42.9
76133,tx,-97.37724,32.65394,15690,56,80,24,42.9
76134,tx,-97.3335,32.64276,8748,57,81,24,42.1
76135,tx,-97.46488,32.83434,8204,58,82,24,41.4
76137,tx,-97.29129,32.85878,16364,58,81,23,39.7
76140,tx,-97.2701,32.62058,11313,58,82,24,41.4
76148,tx,-97.25197,32.86819,8776,57,80,23,40.4
76155,tx,-97.04874,32.82402,206,58,81,23,39.7
76164,tx,-97.35459,32.78111,5532,59,82,23,39
76177,tx,-97.31118,32.97524,5331,59,82,23,39
76179,tx,-97.43783,32.91442,25788,59,82,23,39
76180,tx,-97.22507,32.83998,9838,57,81,24,42.1
76182,tx,-97.20984,32.8828,11906,57,80,23,40.4
76201,tx,-97.14725,33.22113,5531,56,80,24,42.9
76205,tx,-97.12812,33.19028,4874,56,80,24,42.9
76207,tx,-97.18132,33.22853,7899,57,80,23,40.4
76208,tx,-97.05736,33.20883,8123,57,80,23,40.4
76209,tx,-97.10987,33.23155,7742,56,80,24,42.9
76210,tx,-97.09597,33.15037,15036,57,80,23,40.4
76225,tx,-97.67313,33.36444,2393,53,76,23,43.4
76226,tx,-97.16945,33.11036,14703,57,80,23,40.4
76227,tx,-96.99051,33.27391,21229,57,81,24,42.1
76228,tx,-98.06025,33.62103,1644,52,74,22,42.3
76230,tx,-97.95469,33.51994,8433,50,72,22,44
76233,tx,-96.90829,33.53625,2637,53,76,23,43.4
76234,tx,-97.51417,33.272,10589,52,75,23,44.2
76238,tx,-97.35068,33.48819,443,51,74,23,45.1
76239,tx,-97.54516,33.51983,1354,50,73,23,46
76240,tx,-97.17454,33.65615,17645,50,73,23,46
76244,tx,-97.28436,32.93099,23134,58,81,23,39.7
76245,tx,-96.84915,33.828,3874,48,72,24,50
76247,tx,-97.32496,33.09842,8330,59,82,23,39
76248,tx,-97.22904,32.92573,13663,57,80,23,40.4
76249,tx,-97.30406,33.28278,4296,57,80,23,40.4
76250,tx,-97.23575,33.63016,582,47,70,23,48.9
76251,tx,-97.68979,33.62078,719,49,72,23,46.9
76252,tx,-97.38539,33.68575,3061,47,70,23,48.9
76253,tx,-97.31083,33.61586,184,47,70,23,48.9
76255,tx,-97.72916,33.81995,6741,51,73,22,43.1
76258,tx,-96.91964,33.37191,4879,59,82,23,39
76259,tx,-97.30708,33.20018,3023,58,80,22,37.9
76261,tx,-97.96329,33.80064,512,54,75,21,38.9
76262,tx,-97.2258,33.00948,18330,58,81,23,39.7
76263,tx,-97.45337,33.46745,90,52,75,23,44.2
76264,tx,-96.83527,33.73974,1175,47,71,24,51.1
76265,tx,-97.54501,33.74817,2141,47,70,23,48.9
76266,tx,-97.21411,33.36726,8601,58,80,22,37.9
76268,tx,-96.7674,33.62762,180,47,71,24,51.1
76270,tx,-97.75202,33.45611,1865,53,75,22,41.5
76271,tx,-96.90776,33.467,1378,56,80,24,42.9
76272,tx,-97.12887,33.46627,4842,56,79,23,41.1
76273,tx,-96.93353,33.74558,7080,49,72,23,46.9
76301,tx,-98.47977,33.9056,9773,57,77,20,35.1
76302,tx,-98.49111,33.8646,4871,57,77,20,35.1
76305,tx,-98.39389,33.99941,3702,57,77,20,35.1
76306,tx,-98.52391,33.94501,6481,57,77,20,35.1
76308,tx,-98.54059,33.85238,7224,57,77,20,35.1
76309,tx,-98.54428,33.89524,5794,57,77,20,35.1
76310,tx,-98.51087,33.79856,8527,57,77,20,35.1
76311,tx,-98.50894,33.96897,3,57,77,20,35.1
76351,tx,-98.67456,33.56895,1863,59,79,20,33.9
76354,tx,-98.62125,34.09739,5599,57,76,19,33.3
76357,tx,-98.18467,34.0818,655,56,76,20,35.7
76360,tx,-98.96629,33.96898,3620,57,76,19,33.3
76363,tx,-99.54201,33.48307,683,58,78,20,34.5
76364,tx,-99.01681,34.11368,366,56,76,20,35.7
76365,tx,-98.20163,33.75811,5506,56,76,20,35.7
76366,tx,-98.78211,33.72701,1612,57,77,20,35.1
76367,tx,-98.72276,33.97433,6250,57,77,20,35.1
76370,tx,-98.88817,33.53165,617,58,78,20,34.5
76371,tx,-99.64035,33.48661,1787,57,78,21,36.8
76372,tx,-98.91903,33.25291,1538,57,78,21,36.8
76373,tx,-99.11395,34.13071,135,54,74,20,37
76374,tx,-98.73827,33.35975,3302,60,81,21,35
76377,tx,-98.23964,34.01484,785,56,76,20,35.7
76379,tx,-98.47543,33.67013,339,58,78,20,34.5
76380,tx,-99.24238,33.61863,6553,56,76,20,35.7
76384,tx,-99.32556,34.16766,7862,54,74,20,37
76388,tx,-99.63095,33.32169,694,54,75,21,38.9
76389,tx,-98.45822,33.51578,970,57,78,21,36.8
76401,tx,-98.19882,32.28259,13253,36,60,24,66.7
76402,tx,-98.21717,32.21633,4,35,59,24,68.6
76424,tx,-98.8986,32.80508,6336,53,75,22,41.5
76426,tx,-97.84272,33.16682,9412,64,85,21,32.8
76427,tx,-98.37771,33.15543,913,54,76,22,40.7
76429,tx,-98.67424,32.74096,2033,45,68,23,51.1
76430,tx,-99.24738,32.78502,3114,48,71,23,47.9
76431,tx,-97.85662,33.31748,3446,60,82,22,36.7
76432,tx,-98.79693,31.8422,1322,41,66,25,61
76433,tx,-98.0197,32.31515,2560,50,74,24,48
76435,tx,-98.85664,32.25175,887,39,64,25,64.1
76436,tx,-98.22142,31.86715,372,43,68,25,58.1
76437,tx,-99.02366,32.39592,5449,40,64,24,60
76442,tx,-98.61492,31.89185,8530,43,68,25,58.1
76443,tx,-99.21057,32.13343,1344,34,59,25,73.5
76444,tx,-98.56578,32.1147,3277,43,68,25,58.1
76445,tx,-98.55077,32.29952,659,41,65,24,58.5
76446,tx,-98.34948,32.07524,6831,39,63,24,61.5
76448,tx,-98.8008,32.40014,4747,41,65,24,58.5
76449,tx,-98.3228,32.91562,6805,54,76,22,40.7
76450,tx,-98.62581,33.06256,9509,56,77,21,37.5
76452,tx,-98.35406,31.75513,66,38,63,25,65.8
76453,tx,-98.34165,32.58559,2004,53,77,24,45.3
76454,tx,-98.72897,32.20813,2009,42,66,24,57.1
76455,tx,-98.38357,31.80575,1110,43,68,25,58.1
76457,tx,-98.02942,31.95199,3733,47,72,25,53.2
76458,tx,-98.18773,33.21793,6278,54,76,22,40.7
76459,tx,-98.38767,33.27405,164,54,76,22,40.7
76460,tx,-98.49836,33.30967,695,56,77,21,37.5
76462,tx,-98.02748,32.52347,2919,53,76,23,43.4
76463,tx,-98.41489,32.45662,964,50,73,23,46
76464,tx,-99.16499,32.55591,1322,48,71,23,47.9
76466,tx,-98.73742,32.43331,277,39,63,24,61.5
76469,tx,-99.19387,32.34529,293,44,68,24,54.5
76470,tx,-98.66152,32.50228,3449,40,64,24,60
76471,tx,-98.98479,32.11607,2194,35,59,24,68.6
76472,tx,-98.17054,32.60119,1495,57,80,23,40.4
76474,tx,-98.79293,31.97302,378,40,64,24,60
76475,tx,-98.49888,32.65906,2011,51,75,24,47.1
76476,tx,-97.91948,32.36652,2617,51,75,24,47.1
76481,tx,-98.74313,32.99563,394,55,77,22,40
76483,tx,-99.27223,33.18878,2483,53,74,21,39.6
76484,tx,-98.28241,32.75832,1171,57,80,23,40.4
76486,tx,-98.06216,33.02292,1674,56,79,23,41.1
76487,tx,-97.88219,32.9795,2040,53,76,23,43.4
76490,tx,-98.0189,32.94547,66,56,78,22,39.3
76491,tx,-99.05052,33.03483,748,55,76,21,38.2
76501,tx,-97.25434,31.07501,9131,59,85,26,44.1
76502,tx,-97.41035,31.09624,20272,58,83,25,43.1
76504,tx,-97.37258,31.13807,8924,58,83,25,43.1
76508,tx,-97.36406,31.07757,1,58,83,25,43.1
76511,tx,-97.42492,30.80164,2053,55,81,26,47.3
76513,tx,-97.49964,31.05136,22598,56,82,26,46.4
76518,tx,-97.1542,30.84973,1457,62,89,27,43.5
76519,tx,-97.04728,30.99424,772,64,91,27,42.2
76520,tx,-96.90751,30.87608,5975,66,93,27,40.9
76522,tx,-97.97338,31.21604,15149,44,70,26,59.1
76523,tx,-97.29116,30.78949,24,56,83,27,48.2
76524,tx,-97.20313,31.26696,1977,57,83,26,45.6
76525,tx,-98.14597,31.48558,1468,37,64,27,73
76527,tx,-97.80604,30.84416,3273,49,74,25,51
76528,tx,-97.76156,31.42046,11693,54,79,25,46.3
76530,tx,-97.42175,30.71583,2356,56,82,26,46.4
76531,tx,-98.18814,31.68581,4540,40,65,25,62.5
76534,tx,-97.3736,30.88264,2059,58,84,26,44.8
76537,tx,-97.60545,30.81749,5398,52,77,25,48.1
76538,tx,-97.89018,31.64148,1095,47,73,26,55.3
76539,tx,-98.00992,31.08864,4779,47,72,25,53.2
76541,tx,-97.72886,31.11414,6699,50,76,26,52
76542,tx,-97.74605,31.01058,18385,50,76,26,52
76543,tx,-97.64313,31.1389,9804,50,76,26,52
76544,tx,-97.76164,31.14313,240,50,75,25,50
76548,tx,-97.64586,31.0508,11343,52,78,26,50
76549,tx,-97.82997,31.01317,18217,48,74,26,54.2
76550,tx,-98.22872,31.08755,10283,42,67,25,59.5
76554,tx,-97.3678,30.97574,941,61,87,26,42.6
76556,tx,-96.82587,30.70298,1459,64,91,27,42.2
76557,tx,-97.39493,31.29554,3948,54,80,26,48.1
76559,tx,-97.60489,31.07641,2589,53,79,26,49.1
76561,tx,-97.53715,31.41288,782,54,79,25,46.3
76565,tx,-98.351,31.64372,168,34,59,25,73.5
76566,tx,-97.99615,31.51053,413,45,71,26,57.8
76567,tx,-97.00758,30.65002,6297,62,89,27,43.5
76569,tx,-97.22879,30.94375,1951,61,87,26,42.6
76570,tx,-96.93866,31.08167,2786,65,92,27,41.5
76571,tx,-97.58907,30.93382,5390,53,79,26,49.1
76573,tx,-97.50248,30.81863,37,55,81,26,47.3
76574,tx,-97.38741,30.58423,9907,61,87,26,42.6
76577,tx,-97.16967,30.62971,2482,61,87,26,42.6
76578,tx,-97.23787,30.53617,1620,62,88,26,41.9
76579,tx,-97.26368,31.19699,2796,57,83,26,45.6
76596,tx,-97.72956,31.4775,1,55,81,26,47.3
76597,tx,-97.70741,31.4857,3,52,78,26,50
76621,tx,-97.08596,31.883,1367,59,84,25,42.4
76622,tx,-97.24401,31.82202,1156,62,86,24,38.7
76623,tx,-96.75656,32.2104,110,59,85,26,44.1
76624,tx,-96.95962,31.65653,1638,60,86,26,43.3
76626,tx,-96.71539,32.10625,1267,58,85,27,46.6
76627,tx,-97.39449,32.10743,1623,61,85,24,39.3
76628,tx,-96.95226,32.03144,208,60,85,25,41.7
76629,tx,-96.65539,31.15492,2267,64,91,27,42.2
76630,tx,-97.22091,31.34054,1054,57,83,26,45.6
76631,tx,-96.96749,31.97452,647,59,85,26,44.1
76632,tx,-97.06003,31.29865,1569,61,88,27,44.3
76633,tx,-97.31734,31.67812,2930,61,86,25,41
76634,tx,-97.56146,31.80782,6175,59,83,24,40.7
76635,tx,-96.66383,31.72841,1383,62,88,26,41.9
76636,tx,-97.28592,32.17161,1333,59,84,25,42.4
76637,tx,-97.81681,31.76615,651,49,74,25,51
76638,tx,-97.4446,31.54981,2038,56,82,26,46.4
76639,tx,-96.65573,31.87245,2379,60,86,26,43.3
76640,tx,-97.07075,31.68989,2206,62,88,26,41.9
76641,tx,-96.79491,32.03449,2007,59,85,26,44.1
76642,tx,-96.51758,31.50128,5287,62,90,28,45.2
76643,tx,-97.19363,31.45384,5348,58,84,26,44.8
76645,tx,-97.13363,32.02171,7371,57,83,26,45.6
76648,tx,-96.80272,31.8472,2750,58,85,27,46.6
76649,tx,-97.87751,32.00079,1195,50,75,25,50
76650,tx,-96.86046,31.98358,216,59,85,26,44.1
76651,tx,-96.86701,32.1807,2143,60,85,25,41.7
76652,tx,-97.57045,32.11576,995,61,84,23,37.7
76653,tx,-96.60821,31.29811,2039,61,89,28,45.9
76654,tx,-97.0142,31.73048,128,60,86,26,43.3
76655,tx,-97.17736,31.39607,4875,58,84,26,44.8
76656,tx,-97.05858,31.18463,2531,60,87,27,45
76657,tx,-97.39451,31.44583,5689,57,82,25,43.9
76660,tx,-96.90237,31.9243,695,59,85,26,44.1
76661,tx,-96.84934,31.31863,6574,60,88,28,46.7
76664,tx,-96.79574,31.55796,2966,59,87,28,47.5
76665,tx,-97.7163,31.9135,2188,53,78,25,47.2
76666,tx,-96.91739,32.04405,381,59,85,26,44.1
76667,tx,-96.46851,31.65531,6809,65,91,26,40
76670,tx,-96.9894,32.13145,1242,59,84,25,42.4
76671,tx,-97.53198,31.99489,2233,59,83,24,40.7
76673,tx,-96.89141,31.74943,1494,58,85,27,46.6
76676,tx,-96.95104,31.86554,502,58,85,27,46.6
76678,tx,-96.75876,31.65549,292,58,86,28,48.3
76679,tx,-96.58567,31.92432,1704,61,87,26,42.6
76680,tx,-96.81786,31.19333,665,65,93,28,43.1
76681,tx,-96.43504,31.89327,1467,62,89,27,43.5
76682,tx,-96.90588,31.45361,2414,59,87,28,47.5
76685,tx,-97.01114,31.35325,156,62,89,27,43.5
76686,tx,-96.55802,31.76593,259,64,91,27,42.2
76687,tx,-96.49938,31.37172,2622,63,90,27,42.9
76689,tx,-97.50415,31.66662,3483,56,81,25,44.6
76690,tx,-97.73327,32.08225,1058,53,78,25,47.2
76691,tx,-97.09625,31.77817,4436,60,86,26,43.3
76692,tx,-97.32889,31.95808,15275,60,85,25,41.7
76693,tx,-96.40643,31.78595,1835,63,91,28,44.4
76701,tx,-97.1386,31.55195,1016,61,87,26,42.6
76704,tx,-97.12699,31.57674,4248,62,88,26,41.9
76705,tx,-97.09606,31.62654,13849,62,88,26,41.9
76706,tx,-97.0912,31.46652,11516,61,87,26,42.6
76707,tx,-97.15824,31.55374,5898,61,86,25,41
76708,tx,-97.21138,31.62689,11095,61,87,26,42.6
76710,tx,-97.19524,31.53877,8048,59,85,26,44.1
76711,tx,-97.15331,31.51441,3335,60,86,26,43.3
76712,tx,-97.25565,31.52403,11031,58,84,26,44.8
76798,tx,-97.1196,31.54794,13,62,88,26,41.9
76801,tx,-99.03991,31.7425,19386,53,77,24,45.3
76802,tx,-98.90283,31.75327,3072,54,77,23,42.6
76820,tx,-99.04863,30.76719,448,42,67,25,59.5
76821,tx,-99.93626,31.73867,3806,42,67,25,59.5
76823,tx,-99.15991,31.7012,2237,47,72,25,53.2
76824,tx,-98.47066,31.00365,99,43,68,25,58.1
76825,tx,-99.39545,31.10467,6199,37,62,25,67.6
76827,tx,-99.12818,31.52634,593,47,71,24,51.1
76831,tx,-98.9196,30.63979,238,43,69,26,60.5
76832,tx,-98.73039,30.98539,1152,38,64,26,68.4
76836,tx,-99.55598,31.42604,145,41,66,25,61
76837,tx,-99.89593,31.2207,2897,32,58,26,81.3
76841,tx,-100.09662,30.89333,442,23,47,24,104.3
76842,tx,-99.07298,30.95435,579,35,60,25,71.4
76844,tx,-98.50904,31.43787,5189,31,57,26,83.9
76848,tx,-99.57004,30.84312,315,30,54,24,80
76849,tx,-99.79704,30.48901,6722,26,51,25,96.2
76852,tx,-99.45093,31.35935,659,40,65,25,62.5
76853,tx,-98.38717,31.24581,2368,37,62,25,67.6
76854,tx,-99.57562,30.68568,1006,29,54,25,86.2
76856,tx,-99.2662,30.70613,5162,31,56,25,80.6
76857,tx,-98.93513,31.9319,5051,45,69,24,53.3
76858,tx,-99.62054,31.19747,730,36,61,25,69.4
76859,tx,-99.8326,30.90805,4081,28,53,25,89.3
76861,tx,-100.19536,31.59102,1727,39,64,25,64.1
76862,tx,-99.68745,31.41519,1057,44,69,25,56.8
76864,tx,-98.73379,31.55411,1787,37,63,26,70.3
76865,tx,-100.16633,31.85814,141,38,63,25,65.8
76866,tx,-99.92782,31.46084,2238,46,70,24,52.2
76869,tx,-98.99789,30.91282,398,39,64,25,64.1
76870,tx,-98.52979,31.63822,360,34,59,25,73.5
76871,tx,-98.9871,31.2905,1754,40,65,25,62.5
76872,tx,-99.16706,31.32327,1809,40,65,25,62.5
76874,tx,-100.06916,30.4587,350,22,47,25,113.6
76875,tx,-100.00578,31.60271,770,45,69,24,53.3
76877,tx,-98.75693,31.17242,5281,44,69,25,56.8
76882,tx,-99.7024,31.81964,198,27,52,25,92.6
76885,tx,-98.86329,30.87708,709,45,70,25,55.6
76887,tx,-99.16061,31.01268,317,38,63,25,65.8
76888,tx,-99.63991,31.60826,15,35,60,25,71.4
76890,tx,-98.77559,31.69146,887,42,67,25,59.5
76901,tx,-100.62877,31.54095,14189,29,54,25,86.2
76903,tx,-100.43723,31.4848,15538,30,55,25,83.3
76904,tx,-100.39452,31.28361,14672,28,53,25,89.3
76905,tx,-100.32214,31.5098,6151,31,56,25,80.6
76908,tx,-100.40219,31.43208,3,29,54,25,86.2
76930,tx,-101.17274,31.27271,725,21,44,23,109.5
76932,tx,-101.54094,31.26947,3450,18,40,22,122.2
76933,tx,-100.28784,31.86341,2221,39,64,25,64.1
76934,tx,-100.66899,31.60306,1012,26,51,25,96.2
76935,tx,-100.41657,31.08047,2024,22,46,24,109.1
76936,tx,-100.58768,30.88559,3947,16,38,22,137.5
76937,tx,-100.15145,31.38855,66,37,62,25,67.6
76939,tx,-100.55744,31.27776,151,24,48,24,100
76940,tx,-100.14294,31.43904,166,40,65,25,62.5
76941,tx,-100.91168,31.26803,2552,26,50,24,92.3
76943,tx,-101.3007,30.53096,6423,24,48,24,100
76945,tx,-100.61153,31.88095,4241,36,60,24,66.7
76949,tx,-100.69272,32.04181,48,31,56,25,80.6
76950,tx,-100.56036,30.43727,6202,25,50,25,100
76951,tx,-101.0464,31.8149,2049,22,45,23,104.5
76953,tx,-100.32768,31.72302,218,32,56,24,75
76955,tx,-100.15267,31.28954,221,32,57,25,78.1
76957,tx,-100.30516,31.37215,32,32,57,25,78.1
76958,tx,-100.79933,31.5951,458,23,47,24,104.3
77002,tx,-95.36536,29.7565,1345,64,93,29,45.3
77003,tx,-95.34583,29.74933,5435,67,96,29,43.3
77004,tx,-95.36307,29.72467,11015,64,94,30,46.9
77005,tx,-95.4242,29.71819,8272,64,93,29,45.3
77006,tx,-95.3913,29.74097,6793,63,92,29,46
77007,tx,-95.41153,29.77131,16277,62,92,30,48.4
77008,tx,-95.41761,29.79859,15841,62,92,30,48.4
77009,tx,-95.36745,29.79504,14558,62,92,30,48.4
77010,tx,-95.35981,29.75362,24,64,93,29,45.3
77011,tx,-95.30844,29.74331,6040,70,99,29,41.4
77012,tx,-95.27432,29.71894,5187,69,98,29,42
77013,tx,-95.23817,29.79549,3993,72,101,29,40.3
77014,tx,-95.4636,29.98049,7128,73,100,27,37
77015,tx,-95.17343,29.76437,14157,68,98,30,44.1
77016,tx,-95.29998,29.86161,12720,68,97,29,42.6
77017,tx,-95.25226,29.68993,7740,66,97,31,47
77018,tx,-95.42592,29.82693,12132,63,92,29,46
77019,tx,-95.4102,29.75322,6517,62,92,30,48.4
77020,tx,-95.31384,29.77301,11396,69,98,29,42
77021,tx,-95.35746,29.6971,10140,65,94,29,44.6
77022,tx,-95.37699,29.83056,9500,62,91,29,46.8
77023,tx,-95.31847,29.72164,7630,67,97,30,44.8
77024,tx,-95.51163,29.77081,10599,67,97,30,44.8
77025,tx,-95.43499,29.68654,7226,66,95,29,43.9
77026,tx,-95.32943,29.80013,10724,67,96,29,43.3
77027,tx,-95.44591,29.74019,3313,62,92,30,48.4
77028,tx,-95.28677,29.82464,10821,71,99,28,39.4
77029,tx,-95.26241,29.76283,8022,71,100,29,40.8
77030,tx,-95.40259,29.70627,2290,62,92,30,48.4
77031,tx,-95.54642,29.65447,3456,73,101,28,38.4
77032,tx,-95.3416,29.96495,4401,73,101,28,38.4
77033,tx,-95.337,29.66721,10701,64,94,30,46.9
77034,tx,-95.19247,29.61755,8155,65,95,30,46.2
77035,tx,-95.47687,29.65256,7446,70,99,29,41.4
77036,tx,-95.53592,29.70169,5904,71,100,29,40.8
77037,tx,-95.3944,29.89114,5240,65,94,29,44.6
77038,tx,-95.44166,29.91859,7378,71,99,28,39.4
77039,tx,-95.34118,29.90927,7753,69,98,29,42
77040,tx,-95.52783,29.87442,13574,68,97,29,42.6
77041,tx,-95.58075,29.86047,12908,69,98,29,42
77042,tx,-95.56056,29.74114,4714,70,99,29,41.4
77043,tx,-95.58127,29.81186,7942,69,98,29,42
77044,tx,-95.17696,29.89791,19006,76,103,27,35.5
77045,tx,-95.433,29.63574,11224,68,97,29,42.6
77046,tx,-95.43335,29.73378,45,63,92,29,46
77047,tx,-95.38662,29.60844,11346,65,95,30,46.2
77048,tx,-95.33029,29.62043,7670,62,92,30,48.4
77049,tx,-95.14733,29.83414,11162,69,99,30,43.5
77050,tx,-95.27004,29.90307,1478,71,100,29,40.8
77051,tx,-95.3801,29.6562,7658,64,94,30,46.9
77053,tx,-95.46034,29.58306,9855,71,100,29,40.8
77054,tx,-95.40496,29.68088,2035,65,94,29,44.6
77055,tx,-95.49174,29.79768,11242,65,95,30,46.2
77056,tx,-95.46803,29.74827,4015,63,93,30,47.6
77057,tx,-95.48864,29.74534,5602,66,95,29,43.9
77058,tx,-95.09284,29.56286,3412,56,88,32,57.1
77059,tx,-95.12489,29.60766,7051,53,85,32,60.4
77060,tx,-95.39693,29.93517,4963,71,99,28,39.4
77061,tx,-95.28426,29.65384,4511,65,95,30,46.2
77062,tx,-95.13146,29.57486,8657,51,84,33,64.7
77063,tx,-95.52163,29.73551,4630,69,98,29,42
77064,tx,-95.54707,29.92215,14114,71,99,28,39.4
77065,tx,-95.60374,29.92694,8915,71,99,28,39.4
77066,tx,-95.50207,29.95666,10129,71,100,29,40.8
77067,tx,-95.4469,29.9527,6179,73,101,28,38.4
77068,tx,-95.48692,30.00598,3666,72,100,28,38.9
77069,tx,-95.5244,29.98572,5509,72,99,27,37.5
77070,tx,-95.57317,29.97776,13579,72,99,27,37.5
77071,tx,-95.52029,29.65296,6856,72,101,29,40.3
77072,tx,-95.585,29.69963,12513,71,100,29,40.8
77073,tx,-95.39954,29.99988,12275,75,102,27,36
77074,tx,-95.51627,29.68802,6229,70,99,29,41.4
77075,tx,-95.26714,29.62086,10442,63,94,31,49.2
77076,tx,-95.38353,29.8596,7651,63,92,29,46
77077,tx,-95.6154,29.7501,11511,71,100,29,40.8
77078,tx,-95.25161,29.85302,5595,73,101,28,38.4
77079,tx,-95.60461,29.77628,8643,71,100,29,40.8
77080,tx,-95.524,29.81594,10322,67,96,29,43.3
77081,tx,-95.48121,29.7119,1869,67,96,29,43.3
77082,tx,-95.64177,29.72357,11141,71,100,29,40.8
77083,tx,-95.6489,29.69323,20297,72,100,28,38.9
77084,tx,-95.66214,29.82645,29213,72,100,28,38.9
77085,tx,-95.48435,29.62439,5440,72,100,28,38.9
77086,tx,-95.49111,29.9183,7075,70,99,29,41.4
77087,tx,-95.30348,29.68623,10228,66,96,30,45.5
77088,tx,-95.45356,29.88181,18297,66,95,29,43.9
77089,tx,-95.22521,29.5867,16036,61,92,31,50.8
77090,tx,-95.44388,30.00863,5802,73,101,28,38.4
77091,tx,-95.44066,29.85378,9509,64,93,29,45.3
77092,tx,-95.47384,29.8297,7705,65,94,29,44.6
77093,tx,-95.34101,29.86229,15070,64,94,30,46.9
77094,tx,-95.6782,29.76209,3391,73,102,29,39.7
77095,tx,-95.65322,29.90817,21505,71,100,29,40.8
77096,tx,-95.47946,29.67477,8439,70,99,29,41.4
77098,tx,-95.41528,29.7349,3571,62,92,30,48.4
77099,tx,-95.58514,29.67077,8910,72,101,29,40.3
77201,tx,-95.36436,29.766,7,64,93,29,45.3
77301,tx,-95.43431,30.30795,11164,77,102,25,32.5
77302,tx,-95.35899,30.22236,9888,76,102,26,34.2
77303,tx,-95.38144,30.37666,9221,73,99,26,35.6
77304,tx,-95.51412,30.32951,13641,77,102,25,32.5
77306,tx,-95.31254,30.27974,6124,74,100,26,35.1
77316,tx,-95.67994,30.31023,16677,76,101,25,32.9
77318,tx,-95.54319,30.44571,11118,73,99,26,35.6
77320,tx,-95.5509,30.804,19954,66,93,27,40.9
77326,tx,-94.81702,30.50488,168,75,100,25,33.3
77327,tx,-94.9264,30.32157,38090,76,101,25,32.9
77328,tx,-95.19404,30.39634,9252,69,96,27,39.1
77331,tx,-95.16596,30.61651,11325,70,95,25,35.7
77334,tx,-95.36464,30.77995,211,66,93,27,40.9
77335,tx,-94.92471,30.58762,2629,73,98,25,34.2
77336,tx,-95.09884,30.06431,8144,78,104,26,33.3
77338,tx,-95.29019,30.0068,15498,75,102,27,36
77339,tx,-95.22129,30.04931,14603,74,102,28,37.8
77340,tx,-95.53985,30.64369,11616,65,93,28,43.1
77345,tx,-95.15897,30.05415,9556,75,102,27,36
77346,tx,-95.17717,29.99497,24334,76,104,28,36.8
77350,tx,-94.84798,30.82866,95,71,96,25,35.2
77351,tx,-94.82191,30.7127,40974,72,97,25,34.7
77354,tx,-95.64791,30.21107,17903,76,102,26,34.2
77355,tx,-95.74805,30.15769,13451,75,101,26,34.7
77356,tx,-95.70183,30.45056,19358,73,99,26,35.6
77357,tx,-95.19113,30.15845,17693,75,102,27,36
77358,tx,-95.43501,30.55778,3921,69,95,26,37.7
77359,tx,-95.29991,30.75381,3058,67,94,27,40.3
77360,tx,-95.11401,30.84701,8432,71,96,25,35.2
77362,tx,-95.66834,30.15826,2322,74,101,27,36.5
77363,tx,-95.85387,30.32932,5543,73,99,26,35.6
77364,tx,-95.22088,30.76591,5740,70,96,26,37.1
77365,tx,-95.26749,30.11109,15696,75,102,27,36
77367,tx,-95.39824,30.85573,174,68,95,27,39.7
77368,tx,-94.82627,30.45853,269,75,101,26,34.7
77369,tx,-94.7452,30.42357,3606,77,101,24,31.2
77371,tx,-94.99093,30.49361,8660,71,98,27,38
77372,tx,-95.16108,30.2408,8394,73,100,27,37
77373,tx,-95.38418,30.06148,22280,75,103,28,37.3
77374,tx,-94.62253,30.39589,491,78,102,24,30.8
77375,tx,-95.58944,30.09544,23114,72,99,27,37.5
77376,tx,-94.67375,30.44806,848,77,102,25,32.5
77377,tx,-95.68201,30.06135,15216,72,99,27,37.5
77378,tx,-95.36869,30.45742,9355,73,98,25,34.2
77379,tx,-95.53382,30.03913,28165,72,100,28,38.9
77380,tx,-95.46867,30.13645,8471,74,101,27,36.5
77381,tx,-95.50142,30.17818,13476,76,102,26,34.2
77382,tx,-95.54607,30.19805,12799,77,102,25,32.5
77384,tx,-95.49525,30.23491,8011,78,103,25,32.1
77385,tx,-95.42225,30.1889,11894,76,102,26,34.2
77386,tx,-95.35582,30.10124,23052,75,102,27,36
77388,tx,-95.46852,30.05985,17014,74,101,27,36.5
77389,tx,-95.5075,30.11517,14613,73,100,27,37
77396,tx,-95.25989,29.94822,19252,74,102,28,37.8
77401,tx,-95.46177,29.7045,6691,66,95,29,43.9
77406,tx,-95.79797,29.64358,25077,73,102,29,39.7
77407,tx,-95.7125,29.67649,25124,72,101,29,40.3
77412,tx,-96.42812,29.55498,147,82,108,26,31.7
77414,tx,-95.87998,28.89913,20508,86,109,23,26.7
77415,tx,-95.73591,28.93227,65,89,112,23,25.8
77417,tx,-95.96703,29.46458,3060,73,102,29,39.7
77418,tx,-96.25056,29.97879,6311,75,102,27,36
77419,tx,-96.25609,28.85073,1957,68,98,30,44.1
77420,tx,-95.93006,29.2581,1684,72,100,28,38.9
77422,tx,-95.561,28.96079,11301,92,113,21,22.8
77423,tx,-95.98253,29.83891,7569,77,105,28,36.4
77426,tx,-96.24903,30.11818,1893,74,101,27,36.5
77428,tx,-96.18975,28.62312,721,69,100,31,44.9
77429,tx,-95.65884,29.99103,32860,72,100,28,38.9
77430,tx,-95.65369,29.26718,4922,72,101,29,40.3
77432,tx,-96.19387,29.06993,223,69,99,30,43.5
77433,tx,-95.73921,29.94913,36483,73,101,28,38.4
77434,tx,-96.30215,29.52566,3950,81,108,27,33.3
77435,tx,-96.11116,29.51734,3827,76,104,28,36.8
77436,tx,-96.23224,29.42395,130,76,105,29,38.2
77437,tx,-96.28033,29.21304,10149,73,103,30,41.1
77440,tx,-96.15081,28.89493,68,66,96,30,45.5
77441,tx,-95.92278,29.66822,8890,76,104,28,36.8
77442,tx,-96.50677,29.42429,2959,77,105,28,36.4
77443,tx,-96.19267,29.34828,149,75,104,29,38.7
77444,tx,-95.7772,29.28814,1220,72,101,29,40.3
77445,tx,-96.06495,30.09974,10484,73,100,27,37
77446,tx,-95.9905,30.08683,1366,75,101,26,34.7
77447,tx,-95.83045,30.05123,9637,74,101,27,36.5
77448,tx,-96.08657,29.41538,384,73,102,29,39.7
77449,tx,-95.73814,29.83556,40708,73,102,29,39.7
77450,tx,-95.73832,29.7463,22961,73,101,28,38.4
77451,tx,-96.00165,29.43791,150,73,102,29,39.7
77453,tx,-95.99947,29.21204,213,72,100,28,38.9
77454,tx,-96.21863,29.52034,234,80,107,27,33.8
77455,tx,-96.4303,29.13952,2341,72,102,30,41.7
77456,tx,-96.09035,29.00036,1674,68,97,29,42.6
77457,tx,-95.92221,28.70919,1912,91,114,23,25.3
77458,tx,-96.24034,28.95288,491,68,97,29,42.6
77459,tx,-95.53298,29.52566,33463,75,104,29,38.7
77460,tx,-96.38451,29.39743,63,76,104,28,36.8
77461,tx,-95.80671,29.38014,8803,73,102,29,39.7
77464,tx,-95.96169,29.59338,242,74,103,29,39.2
77465,tx,-96.22971,28.76249,10115,63,95,32,50.8
77466,tx,-96.01284,29.80565,404,79,106,27,34.2
77467,tx,-96.12323,29.21065,65,74,103,29,39.2
77468,tx,-95.93105,29.14257,197,72,101,29,40.3
77469,tx,-95.6831,29.48,25991,75,104,29,38.7
77470,tx,-96.55136,29.53217,497,79,105,26,32.9
77471,tx,-95.86814,29.54597,16820,74,103,29,39.2
77473,tx,-96.10771,29.79515,56,79,106,27,34.2
77474,tx,-96.17927,29.77378,8045,80,107,27,33.8
77475,tx,-96.65876,29.49297,1223,77,104,27,35.1
77476,tx,-95.98313,29.67251,313,77,105,28,36.4
77477,tx,-95.56674,29.62569,9665,73,102,29,39.7
77478,tx,-95.60704,29.61967,10483,74,102,28,37.8
77479,tx,-95.63555,29.56645,34432,76,104,28,36.8
77480,tx,-95.76602,29.09235,5318,73,101,28,38.4
77481,tx,-95.55998,29.47037,83,77,106,29,37.7
77482,tx,-95.8802,29.10206,1586,66,96,30,45.5
77483,tx,-95.83655,28.78763,392,93,115,22,23.7
77484,tx,-95.9309,30.07521,6931,75,101,26,34.7
77485,tx,-96.05613,29.6342,3446,78,106,28,35.9
77486,tx,-95.68089,29.15808,5701,72,100,28,38.9
77488,tx,-96.09123,29.30679,9621,73,102,29,39.7
77489,tx,-95.51635,29.60061,14668,74,102,28,37.8
77493,tx,-95.83094,29.85209,18726,75,103,28,37.3
77494,tx,-95.8286,29.74328,46909,74,102,28,37.8
77498,tx,-95.65238,29.64334,17375,72,101,29,40.3
77502,tx,-95.19978,29.67952,9498,66,96,30,45.5
77503,tx,-95.15943,29.7022,6773,64,95,31,48.4
77504,tx,-95.19002,29.64801,4765,65,95,30,46.2
77505,tx,-95.13826,29.64609,7357,60,91,31,51.7
77506,tx,-95.20019,29.7149,8291,66,97,31,47
77507,tx,-95.06449,29.626,478,58,90,32,55.2
77510,tx,-95.08546,29.36127,8797,77,104,27,35.1
77511,tx,-95.24205,29.38145,21811,60,92,32,53.3
77514,tx,-94.60147,29.67987,5630,80,105,25,31.3
77515,tx,-95.44987,29.17432,20912,76,104,28,36.8
77517,tx,-95.13218,29.36942,2898,69,98,29,42
77518,tx,-94.98705,29.50705,4102,75,101,26,34.7
77519,tx,-94.60226,30.23432,1211,77,102,25,32.5
77520,tx,-94.99419,29.73298,14103,70,98,28,40
77521,tx,-94.96589,29.79849,18875,74,101,27,36.5
77523,tx,-94.86719,29.78727,11811,77,104,27,35.1
77530,tx,-95.11151,29.78836,10216,65,95,30,46.2
77531,tx,-95.39243,29.04934,6355,102,121,19,18.6
77532,tx,-95.05656,29.93018,16057,75,102,27,36
77533,tx,-94.59616,30.09165,971,82,106,24,29.3
77534,tx,-95.3089,29.22632,2556,93,116,23,24.7
77535,tx,-94.91787,30.05703,20912,82,107,25,30.5
77536,tx,-95.12129,29.69838,11072,61,92,31,50.8
77538,tx,-94.53125,29.9915,1213,81,106,25,30.9
77539,tx,-95.03179,29.45598,20526,66,95,29,43.9
77541,tx,-95.30995,29.02668,19473,97,115,18,18.6
77545,tx,-95.4746,29.53638,11166,73,102,29,39.7
77546,tx,-95.19218,29.51492,19088,51,84,33,64.7
77547,tx,-95.23785,29.736,3015,70,100,30,42.9
77550,tx,-94.77647,29.30999,10264,53,83,30,56.6
77551,tx,-94.833,29.27842,6351,53,84,31,58.5
77554,tx,-94.92816,29.24368,13896,54,84,30,55.6
77560,tx,-94.59323,29.87665,839,73,100,27,37
77561,tx,-94.73545,30.16651,39,82,106,24,29.3
77562,tx,-95.05352,29.83106,4918,68,97,29,42.6
77563,tx,-95.03035,29.29424,8055,72,99,27,37.5
77564,tx,-94.66745,30.20361,1782,79,104,25,31.6
77565,tx,-95.03002,29.53647,3661,67,97,30,44.8
77566,tx,-95.47544,29.05025,11759,97,118,21,21.6
77568,tx,-94.97975,29.36383,8911,76,102,26,34.2
77571,tx,-95.05287,29.69048,15973,59,90,31,52.5
77573,tx,-95.0865,29.50208,33122,59,91,32,54.2
77575,tx,-94.73397,30.07536,12900,84,108,24,28.6
77577,tx,-95.2787,29.27972,1527,88,112,24,27.3
77578,tx,-95.36558,29.48133,11211,64,95,31,48.4
77580,tx,-94.86924,29.86751,521,76,102,26,34.2
77581,tx,-95.27757,29.56051,19462,59,90,31,52.5
77583,tx,-95.46219,29.38137,22417,68,98,30,44.1
77584,tx,-95.3508,29.54599,30647,65,95,30,46.2
77585,tx,-94.52241,30.29552,2122,75,101,26,34.7
77586,tx,-95.0362,29.58434,8443,60,91,31,51.7
77587,tx,-95.22954,29.66108,5017,66,96,30,45.5
77590,tx,-94.91986,29.39083,12947,66,94,28,42.4
77591,tx,-94.99751,29.39941,6051,80,105,25,31.3
77597,tx,-94.70222,29.83707,867,78,105,27,34.6
77598,tx,-95.13686,29.53787,3866,49,83,34,69.4
77611,tx,-93.82256,30.0132,4488,63,93,30,47.6
77612,tx,-93.92575,30.40615,6556,78,103,25,32.1
77613,tx,-94.35558,30.04725,1021,73,100,27,37
77614,tx,-93.76054,30.30488,710,60,89,29,48.3
77615,tx,-94.05966,30.32406,569,75,101,26,34.7
77616,tx,-94.17996,30.56778,820,76,102,26,34.2
77617,tx,-94.51919,29.50659,2945,61,88,27,44.3
77619,tx,-93.91848,29.94725,7136,67,96,29,43.3
77622,tx,-94.29898,29.86001,1114,71,98,27,38
77623,tx,-94.41674,29.55919,807,71,96,25,35.2
77624,tx,-94.29168,30.68375,759,73,99,26,35.6
77625,tx,-94.37897,30.37574,7046,76,102,26,34.2
77627,tx,-94.00913,29.98744,9591,66,95,29,43.9
77629,tx,-94.4024,29.97784,908,74,100,26,35.1
77630,tx,-93.86458,30.07111,15928,60,89,29,48.3
77632,tx,-93.80515,30.20326,12491,58,88,30,51.7
77640,tx,-93.94104,29.88112,14332,67,96,29,43.3
77642,tx,-93.91598,29.93919,13426,67,96,29,43.3
77650,tx,-94.68608,29.42665,11179,54,84,30,55.6
77651,tx,-93.95605,29.98507,5949,67,95,28,41.8
77655,tx,-93.94992,29.71103,1522,67,94,27,40.3
77656,tx,-94.17206,30.41588,9451,76,102,26,34.2
77657,tx,-94.19611,30.22558,9364,74,100,26,35.1
77659,tx,-94.4353,30.15811,4514,74,101,27,36.5
77660,tx,-94.14546,30.64629,954,75,101,26,34.7
77661,tx,-94.41378,29.73465,823,71,98,27,38
77662,tx,-94.01841,30.17843,14671,65,93,28,43.1
77663,tx,-94.39544,30.5124,3287,78,102,24,30.8
77664,tx,-94.41635,30.59998,2238,76,101,25,32.9
77665,tx,-94.41656,29.81688,4360,72,99,27,37.5
77701,tx,-94.10597,30.07315,9189,66,94,28,42.4
77702,tx,-94.1283,30.08627,1430,67,95,28,41.8
77703,tx,-94.1174,30.12828,7989,68,95,27,39.7
77705,tx,-94.16147,29.90459,16712,66,95,29,43.9
77706,tx,-94.17075,30.09975,9499,69,96,27,39.1
77707,tx,-94.17655,30.05296,7586,69,97,28,40.6
77708,tx,-94.16483,30.14477,4809,70,97,27,38.6
77713,tx,-94.25395,30.06084,7933,72,99,27,37.5
77801,tx,-96.36338,30.63889,2962,66,94,28,42.4
77802,tx,-96.32261,30.66125,8252,68,95,27,39.7
77803,tx,-96.38544,30.68076,10029,67,94,27,40.3
77807,tx,-96.48006,30.67877,5224,67,95,28,41.8
77808,tx,-96.31434,30.78934,7932,68,96,28,41.2
77830,tx,-96.01183,30.52414,2887,69,96,27,39.1
77831,tx,-95.90474,30.72842,3499,70,96,26,37.1
77833,tx,-96.40706,30.21068,14881,75,101,26,34.7
77835,tx,-96.595,30.19172,2559,71,97,26,36.6
77836,tx,-96.68002,30.5375,11613,66,93,27,40.9
77837,tx,-96.68718,31.00731,2076,66,93,27,40.9
77840,tx,-96.326,30.60907,6437,68,95,27,39.7
77845,tx,-96.27563,30.56254,25101,69,96,27,39.1
77853,tx,-96.84281,30.36445,1049,64,91,27,42.2
77856,tx,-96.42384,31.07335,4886,65,92,27,41.5
77857,tx,-96.70857,30.7844,966,68,94,26,38.2
77859,tx,-96.51741,30.86934,4896,68,95,27,39.7
77861,tx,-96.09599,30.72741,2627,70,97,27,38.6
77864,tx,-95.90561,30.95409,5350,75,101,26,34.7
77867,tx,-96.54442,30.74133,74,69,96,27,39.1
77868,tx,-96.06159,30.3686,11332,72,98,26,36.1
77871,tx,-96.11752,31.05102,929,71,97,26,36.6
77872,tx,-96.11027,30.88686,1557,71,98,27,38
77873,tx,-95.81291,30.57428,1432,68,95,27,39.7
77876,tx,-95.87443,30.59728,276,67,95,28,41.8
77878,tx,-96.43603,30.47155,434,68,95,27,39.7
77879,tx,-96.49697,30.39925,7907,69,95,26,37.7
77880,tx,-96.184,30.28141,1761,72,98,26,36.1
77901,tx,-96.98471,28.80496,16117,83,109,26,31.3
77904,tx,-97.01818,28.92333,11247,81,108,27,33.3
77905,tx,-97.04244,28.73132,11556,83,109,26,31.3
77950,tx,-96.87385,28.3012,497,82,106,24,29.3
77951,tx,-96.91084,28.63413,1281,83,109,26,31.3
77954,tx,-97.28269,29.09673,8603,84,109,25,29.8
77957,tx,-96.70046,29.03761,6256,77,104,27,35.1
77960,tx,-97.20836,28.66913,208,84,111,27,32.1
77961,tx,-96.36153,28.85745,3103,70,100,30,42.9
77962,tx,-96.48947,29.02261,2489,75,103,28,37.3
77963,tx,-97.41551,28.65701,6761,84,110,26,31
77964,tx,-96.84371,29.37694,8872,75,102,27,36
77968,tx,-96.84712,28.90924,2607,79,106,27,34.2
77969,tx,-96.65118,28.77244,311,80,107,27,33.8
77970,tx,-96.43447,28.8447,4467,74,102,28,37.8
77971,tx,-96.52193,28.83224,648,75,103,28,37.3
77973,tx,-96.96373,28.54328,139,85,111,26,30.6
77974,tx,-97.29483,28.8916,479,83,109,26,31.3
77975,tx,-97.08483,29.56785,1870,66,93,27,40.9
77976,tx,-97.12272,28.9545,172,84,109,25,29.8
77977,tx,-96.79415,28.69556,434,81,108,27,33.3
77978,tx,-96.57246,28.66662,928,71,101,30,42.3
77979,tx,-96.60784,28.6023,13213,70,100,30,42.9
77982,tx,-96.46008,28.44604,2801,76,104,28,36.8
77983,tx,-96.57474,28.42873,4148,75,104,29,38.7
77984,tx,-97.18785,29.45351,3964,69,96,27,39.1
77987,tx,-97.07565,29.34257,225,75,101,26,34.7
77988,tx,-96.88962,28.83905,405,83,109,26,31.3
77990,tx,-96.90361,28.46317,1063,73,102,29,39.7
77991,tx,-96.61312,28.79624,255,76,104,28,36.8
77993,tx,-97.42856,28.85773,169,80,106,26,32.5
77994,tx,-97.46028,29.17823,758,75,100,25,33.3
77995,tx,-97.0835,29.21182,8173,76,103,27,35.5
78001,tx,-99.21952,28.29492,87,97,118,21,21.6
78002,tx,-98.73826,29.28296,3770,72,98,26,36.1
78003,tx,-99.09411,29.70968,14285,42,69,27,64.3
78004,tx,-98.55579,29.90067,1208,45,72,27,60
78005,tx,-98.85242,28.94843,1225,79,104,25,31.6
78006,tx,-98.72262,29.85534,20464,34,60,26,76.5
78007,tx,-98.37833,28.49508,257,96,118,22,22.9
78008,tx,-98.27929,28.72411,997,86,110,24,27.9
78009,tx,-98.88668,29.35729,4348,64,91,27,42.2
78010,tx,-99.04481,29.9124,2705,24,48,24,100
78011,tx,-98.72128,28.79245,1990,84,108,24,28.6
78012,tx,-98.47915,28.75992,1835,93,115,22,23.7
78013,tx,-98.9052,29.9706,5003,26,50,24,92.3
78014,tx,-99.14487,28.36123,7181,94,115,21,22.3
78015,tx,-98.65548,29.74695,7235,40,67,27,67.5
78016,tx,-98.966,29.18357,6317,73,99,26,35.6
78017,tx,-99.19391,28.70692,2424,87,109,22,25.3
78019,tx,-99.39662,28.04207,2957,97,118,21,21.6
78021,tx,-98.82636,28.50106,4164,94,116,22,23.4
78022,tx,-98.14446,28.25928,5642,93,116,23,24.7
78023,tx,-98.74532,29.61084,12516,51,78,27,52.9
78024,tx,-99.4809,30.00114,2739,14,35,21,150
78025,tx,-99.28318,30.08365,3116,17,39,22,129.4
78026,tx,-98.59732,28.8375,4389,88,111,23,26.1
78027,tx,-98.54273,29.97552,1035,41,67,26,63.4
78028,tx,-99.15819,30.03424,22155,19,42,23,121.1
78029,tx,-99.34501,30.15914,2,15,36,21,140
78039,tx,-98.82965,29.31367,1119,67,94,27,40.3
78040,tx,-99.50231,27.51344,10714,97,118,21,21.6
78041,tx,-99.46339,27.55416,11981,95,116,21,22.1
78043,tx,-99.26173,27.54915,13359,94,115,21,22.3
78044,tx,-99.13108,27.75007,2029,92,113,21,22.8
78045,tx,-99.66888,27.85007,21569,94,115,21,22.3
78046,tx,-99.34944,27.37488,21440,95,115,20,21.1
78050,tx,-98.48181,29.07055,463,83,106,23,27.7
78052,tx,-98.77535,29.2045,3688,70,96,26,37.1
78055,tx,-99.31946,29.82095,2817,25,50,25,100
78056,tx,-98.93488,29.53764,3021,47,75,28,59.6
78057,tx,-98.99948,29.03927,1315,79,103,24,30.4
78058,tx,-99.63954,30.09573,3188,14,35,21,150
78059,tx,-98.84177,29.19187,3638,69,95,26,37.7
78060,tx,-98.10705,28.4468,57,97,120,23,23.7
78061,tx,-99.14691,28.90172,4739,84,107,23,27.4
78063,tx,-98.91419,29.68786,11861,42,69,27,64.3
78064,tx,-98.42571,28.93614,8417,90,112,22,24.4
78065,tx,-98.6398,29.0776,6553,78,102,24,30.8
78066,tx,-98.8956,29.47944,646,60,87,27,45
78067,tx,-99.33642,27.13266,1438,104,125,21,20.2
78069,tx,-98.68111,29.18605,2527,70,96,26,37.1
78070,tx,-98.4063,29.89823,15358,48,74,26,54.2
78071,tx,-98.22428,28.46952,3409,96,119,23,24
78072,tx,-98.5851,28.30179,2107,94,117,23,24.5
78073,tx,-98.61955,29.24488,4307,71,96,25,35.2
78075,tx,-98.35309,28.60116,516,92,115,23,25
78076,tx,-99.1551,26.93098,9483,110,131,21,19.1
78101,tx,-98.23886,29.34405,4487,68,94,26,38.2
78102,tx,-97.71086,28.40248,10782,79,105,26,32.9
78104,tx,-97.76461,28.51877,140,73,99,26,35.6
78107,tx,-97.57402,28.54929,756,78,104,26,33.3
78108,tx,-98.21881,29.57433,16604,60,86,26,43.3
78109,tx,-98.29149,29.48786,16013,64,90,26,40.6
78112,tx,-98.37165,29.2128,4514,74,99,25,33.8
78113,tx,-98.1269,28.95336,2777,79,103,24,30.4
78114,tx,-98.20179,29.11825,11198,76,100,24,31.6
78116,tx,-97.75696,29.11265,755,71,97,26,36.6
78117,tx,-97.95445,28.94399,623,77,102,25,32.5
78118,tx,-97.95036,28.88644,3381,76,101,25,32.9
78119,tx,-97.89598,28.73026,4449,79,103,24,30.4
78121,tx,-98.10727,29.35152,6784,69,94,25,36.2
78122,tx,-97.73588,29.4366,588,65,92,27,41.5
78123,tx,-98.04411,29.60238,1512,63,89,26,41.3
78124,tx,-98.14734,29.55517,3975,63,89,26,41.3
78125,tx,-97.9632,28.53827,176,80,104,24,30
78130,tx,-98.0702,29.69773,34018,61,87,26,42.6
78132,tx,-98.19109,29.76314,20112,55,81,26,47.3
78133,tx,-98.24215,29.88675,21834,48,74,26,54.2
78140,tx,-97.76912,29.30693,2828,67,93,26,38.8
78141,tx,-97.62701,28.91742,1021,75,100,25,33.3
78142,tx,-97.81051,28.53663,95,74,100,26,35.1
78143,tx,-97.86049,29.26241,67,68,93,25,36.8
78144,tx,-97.88798,28.95501,27,79,103,24,30.4
78145,tx,-97.99412,28.64518,42,80,104,24,30
78146,tx,-97.83853,28.60315,666,76,101,25,32.9
78147,tx,-98.08021,29.07379,1051,78,101,23,29.5
78148,tx,-98.29562,29.54345,6311,62,88,26,41.9
78151,tx,-97.70391,28.86506,1491,78,103,25,32.1
78152,tx,-98.2065,29.43416,1961,69,94,25,36.2
78154,tx,-98.26631,29.54624,15893,62,88,26,41.9
78155,tx,-97.93885,29.53343,25384,63,89,26,41.3
78159,tx,-97.58728,29.23638,1487,71,97,26,36.6
78160,tx,-97.92959,29.24311,3259,68,94,26,38.2
78161,tx,-98.05757,29.28697,1022,71,96,25,35.2
78162,tx,-97.77349,28.58996,334,74,100,26,35.1
78163,tx,-98.45474,29.76676,9552,47,73,26,55.3
78164,tx,-97.52255,28.98216,4964,76,101,25,32.9
78201,tx,-98.52822,29.46879,13383,66,91,25,37.9
78202,tx,-98.46088,29.42817,4895,67,92,25,37.3
78203,tx,-98.45912,29.4151,2641,67,92,25,37.3
78204,tx,-98.50374,29.40317,4317,68,94,26,38.2
78205,tx,-98.48588,29.42349,875,67,93,26,38.8
78207,tx,-98.52545,29.42219,15583,68,94,26,38.2
78208,tx,-98.45855,29.43982,1509,67,92,25,37.3
78209,tx,-98.45672,29.48905,12027,64,90,26,40.6
78210,tx,-98.46447,29.39603,13228,68,93,25,36.8
78211,tx,-98.56312,29.34646,10568,70,95,25,35.7
78212,tx,-98.49263,29.46456,9470,66,91,25,37.9
78213,tx,-98.52364,29.51698,10907,62,88,26,41.9
78214,tx,-98.46937,29.32649,8013,70,95,25,35.7
78215,tx,-98.4805,29.44126,793,67,92,25,37.3
78216,tx,-98.48929,29.53646,9185,61,87,26,42.6
78217,tx,-98.42011,29.54044,8771,61,87,26,42.6
78218,tx,-98.40112,29.49151,10023,63,89,26,41.3
78219,tx,-98.38754,29.44206,5180,66,91,25,37.9
78220,tx,-98.39329,29.41674,7131,67,92,25,37.3
78221,tx,-98.47822,29.28014,13437,71,96,25,35.2
78222,tx,-98.37784,29.36619,8003,69,95,26,37.7
78223,tx,-98.39089,29.3122,16542,70,95,25,35.7
78224,tx,-98.53944,29.29429,5189,71,96,25,35.2
78225,tx,-98.52603,29.38799,4572,68,94,26,38.2
78226,tx,-98.5691,29.38374,1708,69,94,25,36.2
78227,tx,-98.6294,29.40624,12435,68,94,26,38.2
78228,tx,-98.57203,29.46097,18095,66,92,26,39.4
78229,tx,-98.57223,29.50555,2715,58,85,27,46.6
78230,tx,-98.55551,29.54612,11040,57,83,26,45.6
78231,tx,-98.54276,29.57815,3258,56,83,27,48.2
78232,tx,-98.47483,29.58814,11839,60,87,27,45
78233,tx,-98.36177,29.55553,15805,59,85,26,44.1
78234,tx,-98.43924,29.46039,47,66,91,25,37.9
78235,tx,-98.44355,29.34592,40,72,97,25,34.7
78236,tx,-98.64429,29.37814,27,68,94,26,38.2
78237,tx,-98.56932,29.42112,13185,68,94,26,38.2
78238,tx,-98.61824,29.4714,6878,62,88,26,41.9
78239,tx,-98.363,29.5168,11015,61,87,26,42.6
78240,tx,-98.60749,29.52463,12452,57,84,27,47.4
78242,tx,-98.60743,29.35065,8865,71,96,25,35.2
78244,tx,-98.35008,29.47382,12939,65,90,25,38.5
78245,tx,-98.73079,29.40396,28562,67,93,26,38.8
78247,tx,-98.40708,29.58547,18211,57,84,27,47.4
78248,tx,-98.52526,29.59048,5064,56,83,27,48.2
78249,tx,-98.61347,29.56795,15998,55,82,27,49.1
78250,tx,-98.66622,29.50317,18940,62,89,27,43.5
78251,tx,-98.67601,29.46219,14503,65,91,26,40
78252,tx,-98.70528,29.34096,4487,72,97,25,34.7
78253,tx,-98.79063,29.46742,21595,61,88,27,44.3
78254,tx,-98.73772,29.53688,24263,58,85,27,46.6
78255,tx,-98.66556,29.65428,7164,43,71,28,65.1
78256,tx,-98.62636,29.62305,2739,47,74,27,57.4
78257,tx,-98.58354,29.66125,3401,47,75,28,59.6
78258,tx,-98.49606,29.63372,14012,51,79,28,54.9
78259,tx,-98.4278,29.6263,9043,54,81,27,50
78260,tx,-98.48741,29.69664,14324,46,73,27,58.7
78261,tx,-98.40189,29.69179,9326,51,77,26,51
78263,tx,-98.3093,29.35947,2844,70,95,25,35.7
78264,tx,-98.50119,29.18831,6289,73,98,25,34.2
78266,tx,-98.33055,29.65387,3639,57,84,27,47.4
78330,tx,-97.9156,27.74272,596,91,116,25,27.5
78332,tx,-98.14282,27.71843,15686,94,117,23,24.5
78335,tx,-97.0922,27.87303,35,68,97,29,42.6
78336,tx,-97.17736,27.92768,8741,64,96,32,50
78338,tx,-97.76254,26.89253,25,99,125,26,26.3
78339,tx,-97.79223,27.80506,313,87,112,25,28.7
78340,tx,-97.20027,28.12017,1362,73,102,29,39.7
78341,tx,-98.48909,27.62993,1772,92,115,23,25
78342,tx,-98.07572,27.65992,352,94,118,24,25.5
78343,tx,-97.74484,27.61951,3252,87,114,27,31
78344,tx,-98.86471,27.48002,836,88,111,23,26.1
78349,tx,-98.29991,27.37539,696,98,122,24,24.5
78351,tx,-97.7597,27.67315,356,85,111,26,30.6
78352,tx,-97.67903,27.96292,151,82,108,26,31.7
78353,tx,-98.22373,26.88251,624,101,125,24,23.8
78355,tx,-98.20252,27.19013,5330,105,128,23,21.9
78357,tx,-98.62171,27.84386,2675,89,112,23,25.8
78358,tx,-97.04411,28.06827,451,80,106,26,32.5
78359,tx,-97.28707,27.92354,957,64,97,33,51.6
78361,tx,-98.78677,27.1043,4481,95,119,24,25.3
78362,tx,-97.20118,27.86635,4565,63,95,32,50.8
78363,tx,-97.86248,27.44943,12182,91,117,26,28.6
78368,tx,-97.81031,28.10544,6790,79,106,27,34.2
78369,tx,-98.99744,27.36791,881,85,107,22,25.9
78370,tx,-97.60071,27.94841,2754,83,109,26,31.3
78371,tx,-98.95941,27.62828,1011,86,108,22,25.6
78372,tx,-98.05592,27.98726,4473,82,108,26,31.7
78373,tx,-97.12271,27.77133,6365,60,92,32,53.3
78374,tx,-97.37814,27.89768,6884,59,92,33,55.9
78375,tx,-98.14464,27.39447,2619,100,124,24,24
78376,tx,-98.51403,27.41845,872,95,119,24,25.3
78377,tx,-97.15627,28.35104,2821,76,104,28,36.8
78379,tx,-97.78507,27.30335,2120,89,115,26,29.2
78380,tx,-97.74623,27.78905,13023,86,112,26,30.2
78382,tx,-97.05321,28.13521,19443,79,105,26,32.9
78383,tx,-97.9638,28.09165,5727,81,107,26,32.1
78384,tx,-98.37029,27.8531,4632,90,114,24,26.7
78385,tx,-97.82543,27.17658,368,96,121,25,26
78387,tx,-97.5447,28.09168,5669,78,105,27,34.6
78389,tx,-97.66073,28.24899,1574,82,109,27,32.9
78390,tx,-97.32698,27.99988,3592,72,102,30,41.7
78391,tx,-97.73277,28.18201,201,81,108,27,33.3
78393,tx,-97.36806,28.19993,1919,75,103,28,37.3
78401,tx,-97.39936,27.79782,1995,64,95,31,48.4
78402,tx,-97.39633,27.82257,580,57,91,34,59.6
78404,tx,-97.39914,27.76802,5797,66,97,31,47
78405,tx,-97.43877,27.77425,6313,66,97,31,47
78406,tx,-97.51879,27.77124,686,77,106,29,37.7
78407,tx,-97.43898,27.81087,1646,67,97,30,44.8
78408,tx,-97.44686,27.795,4194,67,98,31,46.3
78409,tx,-97.52286,27.80943,1546,77,106,29,37.7
78410,tx,-97.59656,27.8385,9588,83,110,27,32.5
78411,tx,-97.38569,27.72954,9077,66,97,31,47
78412,tx,-97.34297,27.70383,9325,68,99,31,45.6
78413,tx,-97.40538,27.68352,10478,72,102,30,41.7
78414,tx,-97.36893,27.6603,15145,72,102,30,41.7
78415,tx,-97.48181,27.65656,12938,70,100,30,42.9
78416,tx,-97.43651,27.75202,5164,68,99,31,45.6
78417,tx,-97.46681,27.73963,1708,73,102,29,39.7
78418,tx,-97.26048,27.62164,18627,77,104,27,35.1
78501,tx,-98.23917,26.21581,18453,99,123,24,24.2
78503,tx,-98.24771,26.16532,7699,100,125,25,25
78504,tx,-98.23657,26.27197,17902,99,124,25,25.3
78516,tx,-98.11937,26.14577,11693,101,125,24,23.8
78520,tx,-97.55031,25.96357,21233,101,126,25,24.8
78521,tx,-97.31974,25.95143,27585,95,121,26,27.4
78526,tx,-97.43937,25.99103,17417,97,122,25,25.8
78535,tx,-97.74273,26.2543,342,97,122,25,25.8
78536,tx,-98.45112,26.64929,412,102,126,24,23.5
78537,tx,-98.05671,26.16187,16252,101,126,25,24.8
78538,tx,-97.9782,26.37274,5912,100,125,25,25
78539,tx,-98.18323,26.27919,12312,101,125,24,23.8
78541,tx,-98.28425,26.44809,16778,103,127,24,23.3
78542,tx,-98.08433,26.45197,26119,102,126,24,23.5
78543,tx,-97.99997,26.29738,3140,100,125,25,25
78545,tx,-99.11811,26.59039,434,113,134,21,18.6
78548,tx,-98.65454,26.27078,495,107,130,23,21.5
78549,tx,-98.03372,26.46089,817,103,127,24,23.3
78550,tx,-97.66668,26.25666,19729,96,122,26,27.1
78552,tx,-97.75025,26.19513,16065,97,122,25,25.8
78557,tx,-98.2434,26.1069,4790,100,124,24,24
78558,tx,-98.03526,26.29963,332,101,126,25,24.8
78559,tx,-97.83138,26.14829,6114,97,123,26,26.8
78560,tx,-98.49436,26.24619,2149,107,130,23,21.5
78561,tx,-97.91811,26.47801,358,101,126,25,24.8
78562,tx,-97.89885,26.29359,1202,98,124,26,26.5
78563,tx,-98.25681,26.65733,556,104,128,24,23.1
78564,tx,-99.10307,26.67344,491,112,133,21,18.8
78565,tx,-98.55198,26.24349,282,107,130,23,21.5
78566,tx,-97.37069,26.14855,8713,93,120,27,29
78567,tx,-97.73937,26.052,333,95,121,26,27.4
78569,tx,-97.74317,26.3718,3423,99,124,25,25.3
78570,tx,-97.91094,26.17481,12837,98,124,26,26.5
78572,tx,-98.37667,26.22807,29591,103,127,24,23.3
78573,tx,-98.30077,26.29367,12878,102,126,24,23.5
78574,tx,-98.37005,26.31892,20032,104,127,23,22.1
78575,tx,-97.52772,26.02477,4611,98,125,27,27.6
78576,tx,-98.47608,26.30717,3912,106,130,24,22.6
78577,tx,-98.19103,26.15061,23473,100,124,24,24
78578,tx,-97.31243,26.05395,6576,72,102,30,41.7
78579,tx,-97.95963,26.08659,1684,97,122,25,25.8
78580,tx,-97.7379,26.48666,6828,98,124,26,26.5
78582,tx,-98.73563,26.5555,20959,109,131,22,20.2
78583,tx,-97.48614,26.26417,4466,93,119,26,28
78584,tx,-98.98754,26.57858,7863,111,132,21,18.9
78585,tx,-99.12143,26.52608,204,115,135,20,17.4
78586,tx,-97.6311,26.10506,25325,96,122,26,27.1
78588,tx,-98.3972,26.73786,184,102,126,24,23.5
78589,tx,-98.15483,26.16786,13253,100,125,25,25
78590,tx,-97.65218,26.50603,1247,89,115,26,29.2
78591,tx,-98.51376,26.58083,394,100,124,24,24
78592,tx,-97.8461,26.06526,416,96,122,26,27.1
78593,tx,-97.82226,26.27385,3222,98,124,26,26.5
78594,tx,-97.79491,26.34521,944,99,125,26,26.3
78595,tx,-98.54548,26.29141,2612,105,129,24,22.9
78596,tx,-97.98925,26.15816,23325,100,125,25,25
78597,tx,-97.23698,26.26949,4756,52,87,35,67.3
78598,tx,-97.43658,26.55757,827,43,78,35,81.4
78602,tx,-97.32843,30.1238,20798,71,96,25,35.2
78605,tx,-98.04564,30.78219,4014,44,70,26,59.1
78606,tx,-98.46683,30.09259,6126,42,68,26,61.9
78607,tx,-98.47555,30.8244,341,52,77,25,48.1
78608,tx,-97.93383,30.93526,440,48,73,25,52.1
78609,tx,-98.44875,30.76315,2352,51,76,25,49
78610,tx,-97.83739,30.07722,16177,61,86,25,41
78611,tx,-98.26016,30.79177,13113,40,66,26,65
78612,tx,-97.48685,30.09419,6223,65,91,26,40
78613,tx,-97.82461,30.50397,27057,55,81,26,47.3
78614,tx,-97.59346,29.41743,667,67,93,26,38.8
78615,tx,-97.38367,30.46866,1354,64,90,26,40.6
78616,tx,-97.56199,29.94017,4553,63,89,26,41.3
78617,tx,-97.59615,30.14719,9000,64,90,26,40.6
78618,tx,-99.16514,30.47772,1163,21,44,23,109.5
78619,tx,-98.03327,30.11222,2764,54,79,25,46.3
78620,tx,-98.12893,30.21896,11538,50,76,26,52
78621,tx,-97.36147,30.33856,11649,67,93,26,38.8
78622,tx,-97.7761,29.75401,163,66,91,25,37.9
78623,tx,-98.23307,29.973,1334,47,73,26,55.3
78624,tx,-98.87707,30.2816,22081,24,48,24,100
78626,tx,-97.59734,30.66535,15840,58,83,25,43.1
78628,tx,-97.7511,30.64106,20378,53,78,25,47.2
78629,tx,-97.45169,29.47721,8950,66,92,26,39.4
78631,tx,-99.30528,30.33772,4062,16,38,22,137.5
78632,tx,-97.47046,29.69632,1341,63,89,26,41.3
78633,tx,-97.75427,30.74198,15594,51,76,25,49
78634,tx,-97.5447,30.55911,16385,61,86,25,41
78635,tx,-98.55959,30.21089,161,33,59,26,78.8
78636,tx,-98.41885,30.30501,3612,44,70,26,59.1
78638,tx,-97.79495,29.6569,2197,64,89,25,39.1
78639,tx,-98.44045,30.66283,10309,58,82,24,41.4
78640,tx,-97.82814,29.99495,22333,61,86,25,41
78641,tx,-97.91516,30.56174,31906,53,78,25,47.2
78642,tx,-97.94694,30.69726,8125,50,75,25,50
78643,tx,-98.69475,30.6903,9755,56,80,24,42.9
78644,tx,-97.67526,29.87048,8621,64,90,26,40.6
78645,tx,-97.97001,30.44898,17085,57,82,25,43.9
78648,tx,-97.63449,29.69106,5153,68,93,25,36.8
78650,tx,-97.21843,30.29935,1339,65,92,27,41.5
78652,tx,-97.87469,30.13281,2554,61,87,26,42.6
78653,tx,-97.52368,30.33941,13657,64,91,27,42.2
78654,tx,-98.2073,30.57232,17698,56,80,24,42.9
78655,tx,-97.8402,29.81448,1671,63,89,26,41.3
78656,tx,-97.80868,29.90046,909,61,87,26,42.6
78657,tx,-98.37775,30.53098,14819,51,76,25,49
78659,tx,-97.1236,30.20886,3264,67,93,26,38.8
78660,tx,-97.5955,30.44308,31623,61,87,26,42.6
78661,tx,-97.7537,29.72558,155,67,92,25,37.3
78662,tx,-97.43419,29.93522,2174,63,90,27,42.9
78663,tx,-98.33535,30.42069,993,45,71,26,57.8
78664,tx,-97.64575,30.5048,17617,59,85,26,44.1
78665,tx,-97.64375,30.54486,16322,60,86,26,43.3
78666,tx,-97.96641,29.87959,20606,61,87,26,42.6
78669,tx,-98.12244,30.42264,13793,55,81,26,47.3
78670,tx,-97.82005,29.77132,118,64,90,26,40.6
78671,tx,-98.62377,30.21628,944,32,58,26,81.3
78672,tx,-98.47111,30.85968,1806,51,76,25,49
78675,tx,-98.68504,30.44581,637,29,54,25,86.2
78676,tx,-98.14589,30.03286,12269,51,77,26,51
78677,tx,-97.5802,29.34995,153,70,96,26,37.1
78681,tx,-97.72469,30.53329,18976,58,83,25,43.1
78701,tx,-97.74237,30.27048,1301,64,90,26,40.6
78702,tx,-97.71431,30.26324,7647,64,89,25,39.1
78703,tx,-97.76568,30.29408,6229,64,90,26,40.6
78704,tx,-97.76537,30.24316,9992,64,89,25,39.1
78705,tx,-97.73852,30.29433,2406,64,89,25,39.1
78712,tx,-97.73473,30.28502,14,64,89,25,39.1
78717,tx,-97.75399,30.48992,9945,57,82,25,43.9
78719,tx,-97.67084,30.14489,859,64,90,26,40.6
78721,tx,-97.68363,30.2701,3854,63,89,26,41.3
78722,tx,-97.7147,30.28996,2401,63,88,25,39.7
78723,tx,-97.68571,30.30427,9303,63,88,25,39.7
78724,tx,-97.61415,30.29439,6345,64,90,26,40.6
78725,tx,-97.60835,30.23579,3681,65,91,26,40
78726,tx,-97.84207,30.42951,2446,56,81,25,44.6
78727,tx,-97.71741,30.4295,7274,59,85,26,44.1
78728,tx,-97.6899,30.45657,5076,58,84,26,44.8
78729,tx,-97.75596,30.45843,7533,56,82,26,46.4
78730,tx,-97.83735,30.36491,2646,60,86,26,43.3
78731,tx,-97.7685,30.34741,7785,62,87,25,40.3
78732,tx,-97.89311,30.37911,5638,59,84,25,42.4
78733,tx,-97.87607,30.32324,3593,59,85,26,44.1
78734,tx,-97.94963,30.37853,11182,58,84,26,44.8
78735,tx,-97.86659,30.26591,4229,60,86,26,43.3
78736,tx,-97.95944,30.26108,3491,55,81,26,47.3
78737,tx,-97.95963,30.18781,9127,56,81,25,44.6
78738,tx,-97.95835,30.3194,5792,56,81,25,44.6
78739,tx,-97.88869,30.17847,7241,60,86,26,43.3
78741,tx,-97.71402,30.23049,4332,65,91,26,40
78742,tx,-97.65829,30.24415,310,65,91,26,40
78744,tx,-97.7292,30.18277,11946,66,91,25,37.9
78745,tx,-97.79738,30.20685,16035,63,88,25,39.7
78746,tx,-97.81054,30.29727,9118,63,88,25,39.7
78747,tx,-97.74014,30.12653,6778,64,89,25,39.1
78748,tx,-97.82345,30.16536,14269,63,88,25,39.7
78749,tx,-97.85818,30.21377,10726,60,86,26,43.3
78750,tx,-97.80246,30.41825,8666,57,82,25,43.9
78751,tx,-97.72275,30.31079,3938,62,88,26,41.9
78752,tx,-97.70428,30.33182,3255,60,85,25,41.7
78753,tx,-97.67363,30.38203,8986,61,86,25,41
78754,tx,-97.64482,30.35576,5594,61,87,26,42.6
78756,tx,-97.74017,30.32222,2657,61,87,26,42.6
78757,tx,-97.73257,30.35154,7635,60,86,26,43.3
78758,tx,-97.70685,30.38799,7958,60,85,25,41.7
78759,tx,-97.76104,30.40267,10273,59,84,25,42.4
78801,tx,-99.87149,29.35664,13642,70,94,24,34.3
78802,tx,-99.88165,29.15512,260,78,100,22,28.2
78827,tx,-99.73538,28.42467,1682,100,120,20,20
78828,tx,-100.01734,29.86441,1036,22,46,24,109.1
78829,tx,-99.55915,28.88992,1793,84,106,22,26.2
78830,tx,-99.50852,28.52534,4563,98,119,21,21.4
78832,tx,-100.41622,29.39068,10219,61,87,26,42.6
78833,tx,-100.05886,29.69363,2174,28,54,26,92.9
78834,tx,-99.92138,28.46428,8099,94,115,21,22.3
78836,tx,-99.70455,28.29632,1061,105,126,21,20
78837,tx,-101.21496,29.83395,1965,55,79,24,43.6
78838,tx,-99.74384,29.52912,1259,45,72,27,60
78839,tx,-99.81653,28.71396,5369,90,112,22,24.4
78840,tx,-100.88271,29.74203,28203,64,88,24,37.5
78843,tx,-100.77859,29.35687,15,65,89,24,36.9
78850,tx,-99.32764,29.28024,1866,62,89,27,43.5
78851,tx,-101.93071,30.00452,1543,40,66,26,65
78852,tx,-100.31078,28.75203,22900,91,111,20,22
78860,tx,-100.29501,28.48238,663,93,113,20,21.5
78861,tx,-99.15449,29.4267,8515,61,87,26,42.6
78870,tx,-99.62905,29.29916,1007,70,95,25,35.7
78871,tx,-101.64941,29.99919,1018,51,76,25,49
78872,tx,-99.88007,28.92589,1978,84,106,22,26.2
78873,tx,-99.73609,29.76656,3297,24,48,24,100
78877,tx,-100.59233,28.94736,1164,86,107,21,24.4
78879,tx,-99.67588,29.64777,606,32,59,27,84.4
78880,tx,-100.28854,29.97977,6797,21,44,23,109.5
78881,tx,-99.52967,29.38699,2815,60,86,26,43.3
78883,tx,-99.3161,29.68094,988,27,52,25,92.6
78884,tx,-99.49587,29.61302,2470,33,60,27,81.8
78885,tx,-99.54772,29.82234,683,17,40,23,135.3
78886,tx,-99.16071,29.13461,887,78,102,24,30.8
78931,tx,-96.4448,30.02923,325,73,100,27,37
78932,tx,-96.70637,30.16566,1043,70,96,26,37.1
78933,tx,-96.35763,29.79538,1626,78,105,27,34.6
78934,tx,-96.56014,29.69373,4646,82,108,26,31.7
78935,tx,-96.43038,29.69036,1035,82,108,26,31.7
78938,tx,-96.69061,29.80211,499,73,99,26,35.6
78940,tx,-96.66019,29.93149,2577,72,98,26,36.1
78941,tx,-97.15231,29.74271,2814,63,91,28,44.4
78942,tx,-96.92221,30.16903,6133,67,93,26,38.8
78943,tx,-96.61188,29.7106,266,83,108,25,30.1
78944,tx,-96.49801,30.00044,552,73,99,26,35.6
78945,tx,-96.88949,29.91568,7565,71,97,26,36.6
78946,tx,-96.77091,30.19122,1405,69,95,26,37.7
78947,tx,-97.03764,30.42088,3945,60,88,28,46.7
78948,tx,-96.96198,30.30301,1034,63,90,27,42.9
78949,tx,-97.08597,29.84136,772,68,94,26,38.2
78950,tx,-96.48193,29.90255,2431,74,100,26,35.1
78951,tx,-96.82437,29.58728,62,73,100,27,37
78953,tx,-97.34829,29.85219,1148,64,91,27,42.2
78954,tx,-96.69957,30.04587,1423,71,97,26,36.6
78956,tx,-96.93416,29.68793,4305,69,96,27,39.1
78957,tx,-97.17579,30.01286,8401,71,97,26,36.6
78959,tx,-97.30285,29.69773,2396,65,92,27,41.5
78962,tx,-96.73557,29.65418,4526,72,99,27,37.5
78963,tx,-97.02794,29.92619,827,70,96,26,37.1
79001,tx,-102.78511,35.32999,1042,2,7,5,250
79003,tx,-100.09467,35.58004,278,15,31,16,106.7
79005,tx,-100.50399,36.38548,1488,14,29,15,107.1
79007,tx,-101.3979,35.69976,8791,7,18,11,157.1
79009,tx,-102.88569,34.53319,1193,1,6,5,500
79010,tx,-102.12364,35.44482,1172,5,16,11,220
79011,tx,-100.22943,35.63469,378,15,31,16,106.7
79012,tx,-102.10916,35.26653,1260,2,8,6,300
79013,tx,-102.00343,36.03845,1065,5,15,10,200
79014,tx,-100.29809,35.91222,1310,17,33,16,94.1
79015,tx,-101.91641,34.94033,10098,5,14,9,180
79016,tx,-101.91868,34.98342,2,5,15,10,200
79018,tx,-102.38627,35.69548,1378,3,10,7,233.3
79019,tx,-101.3971,35.00728,5253,4,13,9,225
79021,tx,-102.02769,33.98488,117,3,11,8,266.7
79022,tx,-102.61111,36.10662,8307,1,6,5,500
79024,tx,-100.34713,36.43872,530,14,29,15,107.1
79025,tx,-102.20589,34.94099,93,2,8,6,300
79027,tx,-102.33088,34.48689,3038,2,7,5,250
79029,tx,-102.02429,35.89517,7307,4,13,9,225
79031,tx,-102.45285,34.26915,1230,2,8,6,300
79032,tx,-101.94142,34.28288,148,3,11,8,266.7
79033,tx,-100.984,36.33005,121,10,24,14,140
79034,tx,-100.165,36.37353,1176,15,30,15,100
79035,tx,-102.78733,34.68451,3454,1,5,4,400
79036,tx,-101.54858,35.61316,6921,6,17,11,183.3
79039,tx,-101.0953,35.26033,1088,6,17,11,183.3
79040,tx,-101.55702,36.29871,1660,9,22,13,144.4
79041,tx,-101.93134,34.04763,2521,4,13,9,225
79042,tx,-101.90318,34.74685,1756,3,10,7,233.3
79043,tx,-102.13484,34.37049,1124,2,7,5,250
79044,tx,-102.36703,35.87298,999,1,7,6,600
79045,tx,-102.559,34.91239,9786,2,8,6,300
79046,tx,-100.12168,36.16349,1397,16,32,16,100
79051,tx,-102.2601,36.4774,301,2,9,7,350
79052,tx,-101.74246,34.36103,1272,4,12,8,200
79053,tx,-102.58606,34.40741,74,2,7,5,250
79054,tx,-100.78748,35.42586,685,10,25,15,150
79056,tx,-100.22118,36.21714,575,22,39,17,77.3
79057,tx,-100.64261,35.24303,2059,12,26,14,116.7
79058,tx,-101.90755,35.61636,234,5,16,11,220
79059,tx,-100.7679,35.83018,1062,11,25,14,127.3
79061,tx,-100.44185,35.52043,1061,15,31,16,106.7
79062,tx,-101.52535,36.03138,440,9,22,13,144.4
79063,tx,-102.10041,34.52587,574,2,8,6,300
79064,tx,-102.12114,34.19815,2626,2,7,5,250
79065,tx,-100.89979,35.54205,13453,6,16,10,166.7
79068,tx,-101.43641,35.34375,2676,5,15,10,200
79070,tx,-100.79876,36.27682,5822,10,23,13,130
79072,tx,-101.73873,34.17158,12344,5,15,10,200
79078,tx,-101.55827,35.70049,1281,8,21,13,162.5
79079,tx,-100.24311,35.20903,3983,22,41,19,86.4
79080,tx,-101.21077,35.73479,987,8,21,13,162.5
79081,tx,-101.21807,36.23016,3155,14,30,16,114.3
79082,tx,-102.28775,34.22428,561,2,7,5,250
79083,tx,-101.52806,35.88432,2431,7,19,12,171.4
79084,tx,-102.00053,36.28002,3143,3,11,8,266.7
79085,tx,-102.51443,34.74072,10,1,7,6,600
79086,tx,-101.77412,36.03849,1305,7,19,12,171.4
79087,nm,-102.93582,36.30888,850,0,2,2,NA
79088,tx,-101.69538,34.57854,4326,4,12,8,200
79091,tx,-102.11252,34.90641,151,2,9,7,350
79092,tx,-102.4687,35.28151,1444,1,5,4,400
79093,tx,-101.03395,36.28992,157,12,27,15,125
79094,tx,-101.52674,34.85075,211,8,20,12,150
79095,tx,-100.20608,34.89615,3208,39,61,22,56.4
79096,tx,-100.19604,35.4381,2020,18,35,17,94.4
79097,tx,-101.17852,35.4358,1338,6,17,11,183.3
79098,tx,-102.22841,35.15532,948,1,6,5,500
79101,tx,-101.83955,35.20606,1577,2,9,7,350
79102,tx,-101.84669,35.19952,3840,2,9,7,350
79103,tx,-101.7944,35.17735,4148,2,10,8,400
79104,tx,-101.7886,35.20276,2958,2,9,7,350
79105,tx,-101.81166,35.68833,144,7,19,12,171.4
79106,tx,-101.89514,35.20321,10950,2,9,7,350
79107,tx,-101.80227,35.22941,13905,2,9,7,350
79108,tx,-101.80579,35.35064,7379,3,10,7,233.3
79109,tx,-101.88645,35.16635,15029,3,10,7,233.3
79110,tx,-101.87116,35.14899,7833,3,10,7,233.3
79111,tx,-101.68932,35.21966,450,3,10,7,233.3
79118,tx,-101.73884,35.09862,13619,3,11,8,266.7
79119,tx,-102.01661,35.11029,8704,3,11,8,266.7
79121,tx,-101.92972,35.1747,2513,2,10,8,400
79124,tx,-101.9691,35.26272,4649,2,10,8,400
79201,tx,-100.2809,34.43715,6517,39,60,21,53.8
79220,tx,-100.78641,33.75778,337,19,39,20,105.3
79225,tx,-99.51496,34.25638,1368,52,73,21,40.4
79226,tx,-100.99532,34.9032,5822,17,34,17,100
79227,tx,-99.77067,33.89957,5594,56,75,19,33.9
79229,tx,-100.67826,33.66677,384,26,47,21,80.8
79230,tx,-100.05157,34.727,962,46,67,21,45.7
79231,tx,-101.07004,33.90638,525,8,21,13,162.5
79233,tx,-100.5286,34.52344,543,38,60,22,57.9
79234,tx,-100.92951,34.2268,343,24,44,20,83.3
79235,tx,-101.25216,33.96352,6601,7,20,13,185.7
79236,tx,-100.22817,33.64183,1629,45,67,22,48.9
79237,tx,-100.63778,34.9133,579,22,41,19,86.4
79239,tx,-100.75778,34.65104,884,35,57,22,62.9
79240,tx,-100.77108,34.88121,40,20,38,18,90
79241,tx,-101.38684,34.1848,4973,6,17,11,183.3
79243,tx,-100.99103,33.75948,119,10,26,16,160
79244,tx,-100.84614,34.03173,557,21,41,20,95.2
79245,tx,-100.50844,34.84546,2528,37,58,21,56.8
79247,tx,-99.40907,34.32981,48,50,70,20,40
79248,tx,-100.29275,34.00044,1474,43,64,21,48.8
79250,tx,-101.59394,33.87871,1702,5,17,12,240
79251,tx,-100.43891,34.92887,148,29,49,20,69
79252,tx,-99.81701,34.30508,4597,49,69,20,40.8
79255,tx,-101.05842,34.34611,184,16,34,18,112.5
79256,tx,-100.74645,33.89498,422,22,43,21,95.5
79257,tx,-101.28703,34.46106,18,4,14,10,250
79258,tx,-101.28847,34.22729,589,6,17,11,183.3
79259,tx,-100.46304,34.40295,325,36,58,22,61.1
79261,tx,-100.81109,34.45013,1358,29,51,22,75.9
79311,tx,-101.88306,33.86073,2283,5,14,9,180
79312,tx,-102.36318,34.05165,1190,3,9,6,200
79313,tx,-102.16228,33.80495,1430,4,13,9,225
79314,tx,-103.01451,33.5849,1532,2,8,6,300
79316,tx,-102.31615,33.14435,7386,5,16,11,220
79322,tx,-101.18731,33.65765,2220,9,24,15,166.7
79323,tx,-102.87227,32.94697,3907,4,13,9,225
79324,tx,-102.68249,33.89789,317,3,11,8,266.7
79325,tx,-102.94,34.41501,1524,2,7,5,250
79326,tx,-102.21612,34.07794,185,2,9,7,350
79329,tx,-101.68203,33.7248,1829,6,19,13,216.7
79330,tx,-101.20987,33.03674,1072,21,43,22,104.8
79331,tx,-102.01054,32.69328,1672,11,29,18,163.6
79336,tx,-102.40273,33.60536,9357,4,14,10,250
79339,tx,-102.33546,33.88987,5467,3,11,8,266.7
79342,tx,-102.3366,32.9082,452,7,21,14,200
79343,tx,-101.53012,33.65564,1796,6,19,13,216.7
79344,tx,-102.93041,33.84496,139,3,9,6,200
79345,tx,-102.32966,33.33421,1009,5,15,10,200
79346,tx,-102.82489,33.64822,3128,3,9,6,200
79347,tx,-102.78213,34.17746,2979,2,9,7,350
79350,tx,-101.83122,33.73173,211,5,16,11,220
79351,tx,-101.76919,32.92343,1552,9,25,16,177.8
79353,tx,-102.58385,33.78411,47,3,10,7,233.3
79355,tx,-102.87668,33.18172,2301,4,12,8,200
79356,tx,-101.33041,33.25907,4024,15,34,19,126.7
79357,tx,-101.40248,33.61648,2559,7,21,14,200
79358,tx,-102.19134,33.43884,1079,5,15,10,200
79359,tx,-102.5893,32.96702,2206,6,19,13,216.7
79360,tx,-102.74143,32.68906,9635,9,25,16,177.8
79363,tx,-102.04111,33.70896,2751,5,16,11,220
79364,tx,-101.64304,33.45204,5189,7,20,13,185.7
79366,tx,-101.68366,33.53014,739,7,21,14,200
79367,tx,-102.1908,33.62146,393,5,15,10,200
79369,tx,-102.14517,33.95575,120,3,11,8,266.7
79370,tx,-100.90346,33.50302,1077,24,45,21,87.5
79371,tx,-102.7541,33.97455,1874,2,9,7,350
79372,tx,-102.4884,33.43425,915,4,13,9,225
79373,tx,-101.83548,33.17078,3477,7,20,13,185.7
79376,tx,-102.67314,33.23389,322,4,13,9,225
79377,tx,-102.13167,32.93211,97,8,22,14,175
79378,tx,-102.48609,33.05329,237,6,17,11,183.3
79379,tx,-102.6464,33.51057,630,3,11,8,266.7
79380,tx,-102.35928,33.74713,148,4,12,8,200
79381,tx,-101.76522,33.32287,1233,6,18,12,200
79382,tx,-102.02108,33.45862,3830,5,16,11,220
79401,tx,-101.85142,33.58788,2632,6,19,13,216.7
79403,tx,-101.76829,33.6446,9625,6,19,13,216.7
79404,tx,-101.79631,33.52536,5967,6,19,13,216.7
79406,tx,-101.88128,33.58345,1,6,18,12,200
79407,tx,-102.07928,33.56318,6834,5,16,11,220
79410,tx,-101.8913,33.56968,3946,6,18,12,200
79411,tx,-101.85773,33.57003,3042,6,18,12,200
79412,tx,-101.85741,33.54545,4890,6,18,12,200
79413,tx,-101.88728,33.54622,7880,6,17,11,183.3
79414,tx,-101.91945,33.54871,4921,5,17,12,240
79415,tx,-101.90484,33.69755,5786,6,18,12,200
79416,tx,-101.97647,33.6043,11208,5,17,12,240
79423,tx,-101.85078,33.44039,15823,5,17,12,240
79424,tx,-101.94095,33.46996,19387,5,16,11,220
79501,tx,-99.90507,32.74482,3288,42,66,24,57.1
79502,tx,-100.24902,33.17849,2576,44,67,23,52.3
79503,tx,-99.69601,32.87114,442,51,73,22,43.1
79504,tx,-99.35234,32.32057,2371,34,58,24,70.6
79505,tx,-99.81602,33.57582,919,55,75,20,36.4
79506,tx,-100.32338,32.11801,1055,29,53,24,82.8
79508,tx,-99.82604,32.27408,1121,25,49,24,96
79510,tx,-99.529,32.27507,3499,25,49,24,96
79511,tx,-101.25957,32.41452,1943,21,43,22,104.8
79512,tx,-100.91776,32.3155,5947,27,50,23,85.2
79517,tx,-101.24272,32.87678,670,17,37,20,117.6
79518,tx,-100.72204,33.33063,547,29,52,23,79.3
79519,tx,-99.69698,32.04877,44,27,51,24,88.9
79520,tx,-100.13231,32.86489,3946,45,68,23,51.1
79521,tx,-99.65415,33.12233,4150,50,73,23,46
79525,tx,-99.83182,32.63114,2233,40,64,24,60
79526,tx,-100.7202,32.63733,1479,23,46,23,100
79527,tx,-101.15093,32.64365,522,24,48,24,100
79528,tx,-100.79076,33.26205,1427,31,53,22,71
79529,tx,-99.84731,33.43853,1219,52,74,22,42.3
79530,tx,-99.75925,32.11901,560,30,55,25,83.3
79532,tx,-100.71227,32.405,1147,22,45,23,104.5
79533,tx,-99.55486,32.85548,1176,46,70,24,52.2
79534,tx,-100.21828,32.75676,524,40,64,24,60
79535,tx,-100.47634,32.22571,450,19,42,23,121.1
79536,tx,-100.03348,32.47378,4880,33,57,24,72.7
79537,tx,-100.21074,32.29188,351,19,41,22,115.8
79538,tx,-99.68086,31.97814,97,24,48,24,100
79539,tx,-99.88221,33.36843,506,51,73,22,43.1
79540,tx,-100.03756,33.16877,265,48,71,23,47.9
79541,tx,-99.81502,32.15306,1420,28,52,24,85.7
79543,tx,-100.40077,32.7218,1680,37,61,24,64.9
79544,tx,-99.85289,33.30151,902,49,71,22,44.9
79545,tx,-100.5801,32.41142,2133,18,39,21,116.7
79546,tx,-100.49802,32.89238,2475,38,62,24,63.2
79547,tx,-99.91176,33.19922,1096,47,70,23,48.9
79548,tx,-99.92293,33.05569,566,50,72,22,44
79549,tx,-100.84504,32.91367,11753,24,47,23,95.8
79553,tx,-99.84264,32.93884,4063,54,76,22,40.7
79556,tx,-100.36403,32.45432,9276,25,49,24,96
79560,tx,-100.20895,32.67887,550,39,64,25,64.1
79561,tx,-100.2004,32.52133,1109,33,57,24,72.7
79562,tx,-99.866,32.2444,3445,25,49,24,96
79563,tx,-99.90773,32.42314,992,32,57,25,78.1
79565,tx,-101.09316,32.39462,643,24,48,24,100
79566,tx,-100.12205,32.11339,686,26,50,24,92.3
79567,tx,-99.95306,31.97765,2682,35,60,25,71.4
79601,tx,-99.66351,32.57964,11410,31,56,25,80.6
79602,tx,-99.66981,32.33945,12371,27,51,24,88.9
79603,tx,-99.88473,32.40159,10317,30,55,25,83.3
79605,tx,-99.78197,32.43397,11339,29,53,24,82.8
79606,tx,-99.82696,32.36095,9781,27,52,25,92.6
79607,tx,-99.82548,32.42848,13,30,55,25,83.3
79699,tx,-99.71589,32.46224,5,29,54,25,86.2
79701,tx,-102.08146,31.99239,13520,18,41,23,127.8
79703,tx,-102.13236,31.97943,7386,16,37,21,131.3
79705,tx,-102.05953,32.05116,14914,18,40,22,122.2
79706,tx,-102.00236,31.84553,13906,17,39,22,129.4
79707,tx,-102.21159,32.03344,12615,15,35,20,133.3
79713,tx,-101.75562,32.49638,678,14,34,20,142.9
79714,tx,-102.69924,32.32939,10033,13,33,20,153.8
79718,tx,-103.76176,31.00532,1297,12,28,16,133.3
79719,tx,-103.40556,31.46014,1534,38,62,24,63.2
79720,tx,-101.47295,32.25361,18721,16,37,21,131.3
79730,tx,-103.08512,31.16956,474,30,53,23,76.7
79731,tx,-102.48349,31.41804,3140,24,49,25,104.2
79733,tx,-101.36543,32.10291,365,14,35,21,150
79734,tx,-103.95563,30.68398,3638,0,2,2,NA
79735,tx,-102.78313,30.74292,10745,13,31,18,138.5
79738,tx,-101.47557,32.75712,1129,18,39,21,116.7
79739,tx,-101.51602,31.76368,1308,15,35,20,133.3
79741,tx,-102.62755,31.97001,1004,13,32,19,146.2
79742,tx,-102.86847,31.34204,1111,41,64,23,56.1
79743,tx,-102.5944,31.17767,1302,36,60,24,66.7
79744,tx,-101.97035,30.92202,1384,29,54,25,86.2
79745,tx,-103.05181,31.82636,4904,24,46,22,91.7
79748,tx,-101.65047,32.41118,301,15,36,21,140
79749,tx,-101.87179,32.28906,229,14,34,20,142.9
79752,tx,-102.15314,31.21544,2346,30,55,25,83.3
79754,tx,-103.59999,31.80169,1448,31,54,23,74.2
79755,tx,-101.93778,31.50465,628,16,38,22,137.5
79756,tx,-102.85812,31.54583,5871,38,62,24,63.2
79758,tx,-102.33426,32.00823,2220,12,31,19,158.3
79759,tx,-102.70159,31.79653,1025,18,38,20,111.1
79761,tx,-102.34959,31.85575,13084,14,34,20,142.9
79762,tx,-102.35443,31.92648,13284,13,32,19,146.2
79763,tx,-102.4679,31.79915,15100,16,37,21,131.3
79764,tx,-102.47105,31.89051,12694,15,35,20,133.3
79765,tx,-102.29245,31.92344,6937,12,31,19,158.3
79766,tx,-102.41214,31.70332,5522,17,39,22,129.4
79770,tx,-103.92974,31.86399,817,37,60,23,62.2
79772,tx,-103.62299,31.42542,11964,37,60,23,62.2
79777,tx,-103.12975,31.49785,1443,34,58,24,70.6
79778,tx,-101.92383,31.17627,1059,21,44,23,109.5
79780,tx,-103.59213,31.06198,455,25,47,22,88
79781,tx,-101.77778,30.59596,1304,28,54,26,92.9
79782,tx,-101.84326,32.15846,3677,16,37,21,131.3
79783,tx,-102.04228,32.32169,255,14,34,20,142.9
79785,tx,-103.90689,31.3275,1062,24,45,21,87.5
79788,tx,-102.98351,31.57294,554,37,61,24,64.9
79789,tx,-103.1854,31.76008,1342,28,51,23,82.1
79821,tx,-106.5978,31.97693,2454,9,28,19,211.1
79830,tx,-103.22462,29.80004,13026,13,26,13,100
79831,tx,-103.32554,30.42954,111,2,7,5,250
79834,tx,-103.26522,29.29106,29,14,32,18,128.6
79835,tx,-106.58689,31.93521,5156,8,26,18,225
79836,tx,-106.20189,31.57126,2995,10,29,19,190
79837,nm,-105.26711,32.19021,699,13,30,17,149.15
79838,tx,-106.17353,31.49186,3561,8,25,17,212.5
79839,tx,-105.6077,31.21316,1290,5,15,10,200
79842,tx,-103.11656,30.09107,911,2,7,5,250
79843,tx,-104.22333,30.12703,4756,3,8,5,166.7
79845,tx,-104.5197,29.88856,6224,79,101,22,27.8
79846,tx,-103.99015,29.45218,631,20,32,12,60
79847,tx,-104.97261,31.80662,2700,7,19,12,171.4
79848,tx,-102.30542,30.24901,3387,16,36,20,125
79849,tx,-106.2504,31.56105,4397,11,32,21,190.9
79851,tx,-105.31978,31.28847,1942,2,10,8,400
79852,tx,-103.62408,29.4032,5920,31,52,21,67.7
79853,tx,-106.06371,31.42986,2225,7,24,17,242.9
79854,tx,-104.65912,30.57935,2449,5,13,8,160
79855,tx,-104.63687,31.09241,8214,5,15,10,200
79901,tx,-106.4798,31.75998,2438,13,35,22,169.2
79902,tx,-106.49793,31.78413,6318,11,32,21,190.9
79903,tx,-106.44189,31.7862,6175,12,33,21,175
79904,tx,-106.44651,31.85289,7973,9,28,19,211.1
79905,tx,-106.42488,31.76661,7101,14,37,23,164.3
79906,tx,-106.41644,31.80924,148,10,30,20,200
79907,tx,-106.3268,31.70752,14969,20,45,25,125
79908,tx,-106.38038,31.8572,47,9,28,19,211.1
79911,tx,-106.54256,31.89246,1941,5,20,15,300
79912,tx,-106.53264,31.84822,22422,6,21,15,250
79915,tx,-106.37237,31.74585,10729,18,42,24,133.3
79916,tx,-106.41813,31.81397,2,10,30,20,200
79922,tx,-106.5611,31.81511,3658,11,32,21,190.9
79924,tx,-106.41324,31.90244,18181,9,28,19,211.1
79925,tx,-106.3633,31.79772,10990,12,33,21,175
79927,tx,-106.27372,31.64457,15337,15,38,23,153.3
79928,tx,-106.15596,31.62863,73662,9,28,19,211.1
79930,tx,-106.46993,31.82025,8115,12,32,20,166.7
79932,tx,-106.60642,31.87824,10116,11,32,21,190.9
79934,tx,-106.43394,31.95194,8605,9,28,19,211.1
79935,tx,-106.33018,31.76795,4946,14,37,23,164.3
79936,tx,-106.29784,31.77618,33581,13,35,22,169.2
79938,tx,-105.97011,31.83092,84184,8,24,16,200
79942,tx,-101.34274,30.57794,52,19,43,24,126.3
80002,co,-105.10576,39.79501,7584,0,1,1,NA
80003,co,-105.06328,39.82646,12280,0,1,1,NA
80004,co,-105.12349,39.8147,13700,0,0,0,NA
80005,co,-105.13031,39.85091,11567,0,0,0,NA
80007,co,-105.19938,39.86604,8029,0,0,0,NA
80010,co,-104.86246,39.73877,9477,0,0,0,NA
80011,co,-104.78313,39.73892,13052,0,0,0,NA
80012,co,-104.83763,39.69973,13687,0,0,0,NA
80013,co,-104.76566,39.6614,24896,0,0,0,NA
80014,co,-104.83818,39.6635,15026,0,0,0,NA
80015,co,-104.78053,39.62602,24773,0,0,0,NA
80016,co,-104.70683,39.59961,21808,0,0,0,NA
80017,co,-104.7859,39.69762,11464,0,0,0,NA
80018,co,-104.69553,39.69286,6915,0,0,0,NA
80019,co,-104.70205,39.78523,2481,0,0,0,NA
80020,co,-105.07453,39.93181,17923,0,1,1,NA
80021,co,-105.1145,39.89096,11319,0,0,0,NA
80022,co,-104.79783,39.87954,21901,0,1,1,NA
80023,co,-105.01094,39.97241,9888,0,1,1,NA
80024,co,-104.91792,39.84388,87,0,1,1,NA
80025,co,-105.29061,39.94513,227,0,0,0,NA
80026,co,-105.09803,40.01321,11780,0,1,1,NA
80027,co,-105.1639,39.95069,12155,0,0,0,NA
80030,co,-105.03695,39.83018,4573,0,1,1,NA
80031,co,-105.04068,39.87584,13551,0,1,1,NA
80033,co,-105.10219,39.77308,11126,0,1,1,NA
80045,co,-104.83863,39.7475,69,0,0,0,NA
80101,co,-104.02853,39.39267,508,0,0,0,NA
80102,co,-104.44394,39.74091,3717,0,0,0,NA
80103,co,-104.13662,39.78114,2133,0,1,1,NA
80104,co,-104.81811,39.30194,16297,0,0,0,NA
80105,co,-103.96169,39.66096,1755,0,1,1,NA
80106,co,-104.529,39.17265,3716,0,0,0,NA
80107,co,-104.57249,39.40945,5823,0,0,0,NA
80108,co,-104.85302,39.44552,14707,0,0,0,NA
80109,co,-104.90137,39.36428,10595,0,0,0,NA
80110,co,-105.00924,39.6463,7930,0,0,0,NA
80111,co,-104.87983,39.61228,10781,0,0,0,NA
80112,co,-104.85739,39.57257,13235,0,0,0,NA
80113,co,-104.96254,39.64219,7670,0,0,0,NA
80116,co,-104.71758,39.30726,2600,0,0,0,NA
80117,co,-104.36152,39.36472,1409,0,0,0,NA
80118,co,-104.89196,39.1924,5011,0,0,0,NA
80120,co,-105.00955,39.59333,10285,0,0,0,NA
80121,co,-104.95316,39.61112,7359,0,0,0,NA
80122,co,-104.95601,39.58058,12641,0,0,0,NA
80123,co,-105.06885,39.61583,15578,0,0,0,NA
80124,co,-104.89207,39.53185,7045,0,0,0,NA
80125,co,-105.05021,39.48595,8596,0,0,0,NA
80126,co,-104.96085,39.54075,14910,0,0,0,NA
80127,co,-105.15135,39.54044,17643,0,0,0,NA
80128,co,-105.07868,39.56405,13731,0,0,0,NA
80129,co,-105.01084,39.54457,10031,0,0,0,NA
80130,co,-104.92324,39.53062,9017,0,0,0,NA
80131,co,-105.00754,39.47644,127,0,0,0,NA
80132,co,-104.8472,39.09813,10066,0,0,0,NA
80133,co,-104.96952,39.09975,1158,0,0,0,NA
80134,co,-104.77882,39.48221,29220,0,0,0,NA
80135,co,-105.11816,39.27929,3334,0,0,0,NA
80136,co,-104.29733,39.7909,3085,0,1,1,NA
80137,co,-104.59284,39.75778,1623,0,0,0,NA
80138,co,-104.67097,39.51754,14477,0,0,0,NA
80202,co,-104.99763,39.75191,785,0,1,1,NA
80203,co,-104.98265,39.73169,1970,0,1,1,NA
80204,co,-105.0204,39.73484,9443,0,1,1,NA
80205,co,-104.9633,39.75869,9840,0,0,0,NA
80206,co,-104.9526,39.73028,6387,0,0,0,NA
80207,co,-104.91658,39.7623,8591,0,0,0,NA
80209,co,-104.96591,39.70602,7990,0,0,0,NA
80210,co,-104.96258,39.67806,13067,0,0,0,NA
80211,co,-105.02009,39.76712,13018,0,1,1,NA
80212,co,-105.04828,39.77159,8135,0,1,1,NA
80214,co,-105.07118,39.7421,9098,0,1,1,NA
80215,co,-105.11594,39.74406,7924,0,0,0,NA
80216,co,-104.95669,39.78839,4969,0,1,1,NA
80218,co,-104.97067,39.73106,3382,0,0,0,NA
80219,co,-105.03431,39.69531,17602,0,0,0,NA
80220,co,-104.91657,39.73382,11899,0,0,0,NA
80221,co,-105.00954,39.81544,13248,0,1,1,NA
80222,co,-104.9279,39.67102,6458,0,0,0,NA
80223,co,-105.00184,39.6961,6995,0,0,0,NA
80224,co,-104.91134,39.68777,4311,0,0,0,NA
80226,co,-105.09137,39.71104,10836,0,0,0,NA
80227,co,-105.08949,39.66719,11043,0,0,0,NA
80228,co,-105.15679,39.69001,11564,0,0,0,NA
80229,co,-104.95736,39.85552,15214,0,1,1,NA
80230,co,-104.89023,39.71946,2556,0,0,0,NA
80231,co,-104.88783,39.67148,7275,0,0,0,NA
80232,co,-105.09043,39.68853,8941,0,0,0,NA
80233,co,-104.94698,39.89975,13733,0,1,1,NA
80234,co,-105.00552,39.91228,8215,0,1,1,NA
80235,co,-105.08997,39.6461,1777,0,0,0,NA
80236,co,-105.03958,39.65165,4133,0,0,0,NA
80237,co,-104.90118,39.64008,3718,0,0,0,NA
80238,co,-104.8824,39.77159,7264,0,0,0,NA
80239,co,-104.83802,39.7868,12630,0,0,0,NA
80241,co,-104.95505,39.92871,11019,0,1,1,NA
80246,co,-104.93094,39.70433,2109,0,0,0,NA
80247,co,-104.88183,39.69714,4181,0,0,0,NA
80249,co,-104.69613,39.84992,11119,0,0,0,NA
80260,co,-105.00609,39.8668,5931,0,1,1,NA
80264,co,-104.98548,39.74248,5,0,1,1,NA
80290,co,-104.98675,39.74409,4,0,1,1,NA
80293,co,-104.98993,39.74625,9,0,1,1,NA
80294,co,-104.98927,39.74945,1,0,1,1,NA
80301,co,-105.20014,40.04857,7170,0,1,1,NA
80302,co,-105.36912,40.03889,8070,0,0,0,NA
80303,co,-105.21274,39.97411,6012,0,0,0,NA
80304,co,-105.29049,40.04546,8421,0,0,0,NA
80305,co,-105.24923,39.97463,5641,0,0,0,NA
80310,co,-105.26143,40.00376,7,0,0,0,NA
80401,co,-105.2351,39.7164,18005,0,0,0,NA
80403,co,-105.31505,39.83088,12185,0,0,0,NA
80419,co,-105.20281,39.7284,14,0,0,0,NA
80420,co,-106.10381,39.31679,2177,0,0,0,NA
80421,co,-105.52621,39.47859,5445,0,0,0,NA
80422,co,-105.53238,39.86909,6294,0,0,0,NA
80423,co,-106.59511,39.89447,307,0,0,0,NA
80424,co,-106.01692,39.47098,9119,0,0,0,NA
80425,co,-105.22335,39.3448,398,0,0,0,NA
80426,co,-106.99145,39.90842,99,0,0,0,NA
80427,co,-105.49499,39.78029,2008,0,0,0,NA
80428,co,-106.96085,40.86099,1710,0,0,0,NA
80432,co,-105.81905,39.22873,2782,0,0,0,NA
80433,co,-105.27376,39.48948,5930,0,0,0,NA
80435,co,-105.92428,39.60145,3560,0,0,0,NA
80436,co,-105.64734,39.78748,737,0,0,0,NA
80438,co,-105.78337,39.7603,729,0,0,0,NA
80439,co,-105.43309,39.63753,15302,0,0,0,NA
80440,co,-105.97814,39.22627,5463,0,0,0,NA
80442,co,-105.88143,39.93482,2720,0,0,0,NA
80443,co,-106.16295,39.50537,2600,0,0,0,NA
80444,co,-105.73751,39.63087,1580,0,0,0,NA
80446,co,-105.95254,40.17423,5353,0,0,0,NA
80447,co,-105.79684,40.27252,4708,0,0,0,NA
80448,co,-105.63004,39.40796,238,0,0,0,NA
80449,co,-105.85576,38.98134,13603,0,0,0,NA
80451,co,-106.07315,40.09846,943,0,0,0,NA
80452,co,-105.61388,39.70713,7511,0,0,0,NA
80453,co,-105.24257,39.66269,273,0,0,0,NA
80454,co,-105.25137,39.62952,989,0,0,0,NA
80455,co,-105.39222,40.1134,729,0,0,0,NA
80456,co,-105.64456,39.28406,3381,0,0,0,NA
80457,co,-105.29096,39.64829,385,0,0,0,NA
80459,co,-106.43493,40.17601,2331,0,0,0,NA
80461,co,-106.31469,39.23392,7622,0,0,0,NA
80463,co,-106.73028,39.97326,217,0,0,0,NA
80465,co,-105.20888,39.60851,8896,0,0,0,NA
80466,co,-105.53852,39.97599,3066,0,0,0,NA
80467,co,-106.86995,40.25317,3838,0,0,0,NA
80468,co,-106.11892,39.94765,607,0,0,0,NA
80469,co,-106.96459,40.20499,300,0,0,0,NA
80470,co,-105.34359,39.36774,3260,0,0,0,NA
80471,co,-105.42091,39.93521,24,0,0,0,NA
80475,co,-105.56007,39.45202,48,0,0,0,NA
80476,co,-105.81124,39.68543,1641,0,0,0,NA
80477,co,-106.82935,40.48639,67,0,0,0,NA
80478,co,-105.84698,40.0279,2052,0,0,0,NA
80479,co,-106.83313,40.03183,112,0,0,0,NA
80481,co,-105.54576,40.08963,976,0,0,0,NA
80482,co,-105.78446,39.89394,2544,0,0,0,NA
80483,co,-106.91774,40.11978,439,0,0,0,NA
80487,co,-106.86713,40.54802,11138,0,0,0,NA
80488,co,-106.81818,40.4487,10,0,0,0,NA
80497,co,-106.00005,39.67076,94,0,0,0,NA
80498,co,-106.22718,39.77488,5190,0,0,0,NA
80501,co,-105.10294,40.16474,13073,0,1,1,NA
80503,co,-105.20364,40.17002,12819,0,1,1,NA
80504,co,-105.0289,40.16392,22840,0,1,1,NA
80510,co,-105.57861,40.20875,999,0,0,0,NA
80511,co,-105.57222,40.34011,1,0,0,0,NA
80512,co,-105.57322,40.63403,2928,0,0,0,NA
80513,co,-105.10366,40.29803,8544,0,1,1,NA
80514,co,-104.95825,40.06595,2539,0,1,1,NA
80515,co,-105.37529,40.44444,1511,0,0,0,NA
80516,co,-105.01834,40.05124,17116,0,1,1,NA
80517,co,-105.61166,40.4003,9142,0,0,0,NA
80520,co,-104.93143,40.1131,590,0,1,1,NA
80521,co,-105.12779,40.59326,9180,0,0,0,NA
80524,co,-105.02623,40.6529,17387,0,0,0,NA
80525,co,-105.0371,40.52917,20033,0,0,0,NA
80526,co,-105.14004,40.52427,16266,0,0,0,NA
80528,co,-105.00021,40.49613,10469,0,1,1,NA
80530,co,-104.92926,40.09779,2195,0,1,1,NA
80532,co,-105.46868,40.49322,313,0,0,0,NA
80534,co,-104.93541,40.33199,7947,0,1,1,NA
80535,co,-105.18354,40.73339,1274,0,0,0,NA
80536,co,-105.37664,40.87006,2639,0,0,0,NA
80537,co,-105.18297,40.37543,19066,0,0,0,NA
80538,co,-105.17399,40.47884,21271,0,0,0,NA
80540,co,-105.38335,40.24189,3385,0,0,0,NA
80542,co,-104.9994,40.23474,2428,0,1,1,NA
80543,co,-104.85143,40.34565,3880,0,2,2,NA
80544,co,-105.17106,40.10342,79,0,1,1,NA
80545,co,-105.68929,40.86594,4428,0,0,0,NA
80546,co,-104.8497,40.52524,80,0,2,2,NA
80547,co,-104.96358,40.52493,1720,0,1,1,NA
80549,co,-105.04553,40.85319,6635,0,0,0,NA
80550,co,-104.90022,40.48094,19441,0,1,1,NA
80601,co,-104.80879,39.96253,14421,0,1,1,NA
80602,co,-104.90722,39.9636,18117,0,1,1,NA
80603,co,-104.73724,39.98261,9867,0,1,1,NA
80610,co,-104.59543,40.6674,2203,0,1,1,NA
80611,co,-104.28169,40.62304,1316,0,1,1,NA
80612,co,-104.86668,40.87981,689,0,0,0,NA
80615,co,-104.64409,40.54558,4966,0,2,2,NA
80620,co,-104.71702,40.37453,5967,1,3,2,200
80621,co,-104.80123,40.10798,6602,0,1,1,NA
80622,co,-104.45847,40.5378,187,0,2,2,NA
80623,co,-104.78254,40.28538,384,0,2,2,NA
80624,co,-104.49929,40.48538,584,1,2,1,100
80631,co,-104.67638,40.44145,13348,1,3,2,200
80634,co,-104.79255,40.4028,23960,1,2,1,100
80640,co,-104.88223,39.8854,4422,0,1,1,NA
80642,co,-104.61524,40.04687,1975,0,1,1,NA
80643,co,-104.47715,40.11396,2660,0,1,1,NA
80644,co,-104.43853,40.3775,2274,1,3,2,200
80645,co,-104.58074,40.28359,2516,0,2,2,NA
80648,co,-104.73958,40.75504,1222,0,1,1,NA
80649,co,-104.17678,40.37922,786,1,3,2,200
80650,co,-104.7798,40.6465,1004,0,1,1,NA
80651,co,-104.81554,40.23688,2401,0,1,1,NA
80652,co,-104.28012,40.11125,795,1,2,1,100
80653,co,-103.97814,40.38844,985,1,3,2,200
80654,co,-104.07483,40.13618,2151,1,3,2,200
80701,co,-103.82647,40.16992,7414,1,3,2,200
80705,co,-103.82949,40.27033,373,1,3,2,200
80721,co,-102.1539,40.68962,333,2,7,5,250
80722,co,-103.27494,40.50822,257,1,4,3,300
80723,co,-103.5708,40.15,3287,1,3,2,200
80726,co,-102.79095,40.90621,498,2,6,4,200
80727,co,-102.50377,40.06028,922,2,7,5,250
80728,co,-102.87383,40.64498,1162,1,3,2,200
80729,co,-104.265,40.87934,1972,0,1,1,NA
80731,co,-102.60411,40.59618,1964,1,5,4,400
80733,co,-103.45188,40.37072,258,1,3,2,200
80734,co,-102.29359,40.51935,2654,2,6,4,200
80735,co,-102.27247,39.7156,1169,1,6,5,500
80736,co,-103.03552,40.81136,635,1,5,4,400
80737,co,-102.18505,40.87973,1639,3,8,5,166.7
80741,co,-103.47185,40.57072,968,1,3,2,200
80742,co,-103.82828,40.74906,1451,0,1,1,NA
80744,co,-102.39,40.87805,691,3,8,5,166.7
80745,co,-103.39714,40.90155,341,1,2,1,100
80746,co,-102.46605,40.60956,42,1,5,4,400
80747,co,-103.09136,40.94169,610,1,2,1,100
80749,co,-102.55731,40.87491,638,3,8,5,166.7
80750,co,-103.6041,40.41083,655,1,3,2,200
80751,co,-103.23146,40.63713,7353,1,5,4,400
80754,co,-103.66395,40.72068,687,0,2,2,NA
80755,co,-102.35411,39.90926,491,2,7,5,250
80758,co,-102.20076,40.11399,4092,4,11,8,216.65
80759,co,-102.68379,40.13528,3873,2,6,4,200
80802,co,-102.17359,38.84218,983,1,7,6,600
80804,co,-103.26134,39.35199,552,0,0,0,NA
80805,co,-102.4417,39.31188,661,1,4,3,300
80807,co,-102.22595,39.31889,4163,1,5,4,400
80808,co,-104.30272,38.99192,3229,0,0,0,NA
80809,co,-104.99688,38.86856,1078,0,0,0,NA
80810,co,-102.45986,38.82311,1866,1,5,4,400
80813,co,-105.09939,38.7678,6722,0,0,0,NA
80814,co,-105.18039,38.95728,3699,0,0,0,NA
80815,co,-103.07838,39.39203,1575,0,1,1,NA
80816,co,-105.3121,38.8548,7487,0,0,0,NA
80817,co,-104.68173,38.63274,11031,0,0,0,NA
80818,co,-103.47465,39.39617,461,0,0,0,NA
80819,co,-105.01376,38.96083,903,0,0,0,NA
80820,co,-105.57789,38.78822,3184,0,0,0,NA
80821,co,-103.40966,38.96196,968,0,1,1,NA
80822,co,-102.67268,39.70963,701,1,3,2,200
80823,co,-103.41515,38.65559,494,0,2,2,NA
80824,co,-102.51716,39.64662,437,1,4,3,300
80825,co,-102.84909,38.80036,1419,1,4,3,300
80827,co,-105.4682,39.06016,1837,0,0,0,NA
80828,co,-103.72902,39.34796,803,0,0,0,NA
80829,co,-104.93533,38.82841,3081,0,0,0,NA
80830,co,-103.89063,39.12084,386,0,0,0,NA
80831,co,-104.50596,38.99673,11390,0,0,0,NA
80832,co,-104.00734,39.01346,774,0,0,0,NA
80833,co,-103.93413,38.74029,942,0,0,0,NA
80834,co,-102.88036,39.28399,996,0,1,1,NA
80835,co,-104.08,39.20797,670,0,0,0,NA
80836,co,-102.5824,39.29659,1534,1,4,3,300
80840,co,-104.85708,38.99468,7,0,0,0,NA
80860,co,-105.08656,38.69133,3500,0,0,0,NA
80861,co,-102.74068,39.34258,749,0,2,2,NA
80862,co,-103.06089,38.88626,257,0,2,2,NA
80863,co,-105.10805,39.02826,7103,0,0,0,NA
80864,co,-104.18677,38.69783,1259,0,0,0,NA
80903,co,-104.81519,38.8313,6090,0,0,0,NA
80904,co,-104.87193,38.86059,9375,0,0,0,NA
80905,co,-104.83676,38.81791,6643,0,0,0,NA
80906,co,-104.87161,38.76568,13545,0,0,0,NA
80907,co,-104.82744,38.8783,10422,0,0,0,NA
80908,co,-104.68949,39.0477,9312,0,0,0,NA
80909,co,-104.77575,38.8527,11714,0,0,0,NA
80910,co,-104.77429,38.81251,8579,0,0,0,NA
80911,co,-104.72205,38.75327,12009,0,0,0,NA
80913,co,-104.77236,38.7028,1,0,0,0,NA
80914,co,-104.70434,38.82405,1,0,0,0,NA
80915,co,-104.71585,38.85235,7278,0,0,0,NA
80916,co,-104.7131,38.80519,9464,0,0,0,NA
80917,co,-104.74551,38.88596,10184,0,0,0,NA
80918,co,-104.78025,38.91152,15221,0,0,0,NA
80919,co,-104.85422,38.92712,11069,0,0,0,NA
80920,co,-104.77079,38.95761,13450,0,0,0,NA
80921,co,-104.91021,39.00561,10590,0,0,0,NA
80922,co,-104.7006,38.89065,10262,0,0,0,NA
80923,co,-104.71481,38.92689,11182,0,0,0,NA
80924,co,-104.72111,38.96752,4667,0,0,0,NA
80925,co,-104.65039,38.7507,5437,0,0,0,NA
80926,co,-104.91875,38.6458,697,0,0,0,NA
80927,co,-104.65801,38.9286,2535,0,0,0,NA
80928,co,-104.45201,38.64909,1034,0,0,0,NA
80929,co,-104.62697,38.82471,236,0,0,0,NA
80930,co,-104.50248,38.81424,472,0,0,0,NA
80938,co,-104.66331,38.90476,222,0,0,0,NA
80939,co,-104.67737,38.87796,43,0,0,0,NA
80951,co,-104.65549,38.88807,1602,0,0,0,NA
81001,co,-104.53373,38.29451,12108,1,4,3,300
81003,co,-104.63148,38.27926,7475,1,4,3,300
81004,co,-104.71645,38.04116,12463,0,2,2,NA
81005,co,-104.84166,38.19775,13882,0,2,2,NA
81006,co,-104.50445,38.23048,5996,1,4,3,300
81007,co,-104.77796,38.35514,19147,0,3,3,NA
81008,co,-104.61748,38.43686,6321,0,3,3,NA
81019,co,-104.84122,37.94406,10931,0,0,0,NA
81020,co,-104.52318,37.53094,1476,0,0,0,NA
81022,co,-104.43229,38.04428,1687,1,4,3,300
81023,co,-104.95102,38.06297,1528,0,0,0,NA
81024,co,-104.73471,37.24935,329,0,0,0,NA
81025,co,-104.26803,38.35828,1800,1,5,4,400
81027,co,-103.79992,37.18946,426,0,0,0,NA
81029,co,-102.48253,37.08498,285,1,7,6,600
81030,co,-103.51916,38.10254,142,2,11,9,450
81039,co,-104.08165,37.94067,1986,1,7,6,600
81040,co,-105.23077,37.78546,1841,0,0,0,NA
81041,co,-102.38295,37.87496,1039,4,14,10,250
81043,co,-102.22091,38.13095,80,5,15,10,200
81047,co,-102.19578,38.01781,2661,5,16,11,220
81049,co,-103.37719,37.33993,925,0,1,1,NA
81050,co,-103.50556,37.94023,5735,3,13,10,333.3
81052,co,-102.65979,37.92615,5103,4,15,11,275
81055,co,-105.07237,37.488,2940,0,0,0,NA
81058,co,-103.87966,38.09876,666,1,7,6,600
81059,co,-104.01643,37.51074,1343,0,2,2,NA
81063,co,-103.78278,38.44561,139,0,2,2,NA
81064,co,-102.98888,37.23911,243,0,1,1,NA
81067,co,-103.78397,37.93793,3394,2,9,7,350
81069,co,-104.897,37.89714,8445,0,0,0,NA
81073,co,-102.70957,37.42388,119,1,5,4,400
81077,co,-103.6307,38.01794,264,3,12,9,300
81081,co,-104.1948,37.06735,60,0,0,0,NA
81082,co,-104.51612,37.17862,7882,0,0,0,NA
81084,co,-102.4171,37.57723,80,2,9,7,350
81087,co,-102.40899,37.36591,1,1,7,6,600
81089,co,-104.73155,37.65597,8000,0,0,0,NA
81090,co,-102.22137,37.35664,26,2,9,7,350
81091,co,-104.97101,37.15009,1773,0,0,0,NA
81092,co,-102.74771,38.19797,473,4,14,10,250
81101,co,-105.82995,37.48369,11872,0,0,0,NA
81120,co,-106.27834,37.16422,3571,0,0,0,NA
81121,co,-107.43908,37.10981,526,0,0,0,NA
81122,co,-107.47853,37.33999,6729,0,0,0,NA
81123,co,-105.56976,37.39857,10862,0,0,0,NA
81124,co,-106.1606,37.30625,392,0,0,0,NA
81125,co,-106.06907,37.81703,2712,0,0,0,NA
81126,co,-105.33458,37.15559,385,0,0,0,NA
81128,co,-106.67234,37.06809,364,0,0,0,NA
81129,co,-106.02905,37.10336,120,0,0,0,NA
81130,co,-107.0154,37.70736,2311,0,0,0,NA
81131,co,-105.63761,37.87297,4632,0,0,0,NA
81132,co,-106.42884,37.70743,3312,0,0,0,NA
81133,co,-105.31027,37.42918,13595,0,0,0,NA
81136,co,-105.82789,37.72499,391,0,0,0,NA
81137,co,-107.61338,37.05905,2855,0,0,0,NA
81138,co,-105.6228,37.02653,470,0,0,0,NA
81140,co,-106.12884,37.30576,1828,0,0,0,NA
81141,co,-105.8636,37.15686,851,0,0,0,NA
81143,co,-105.85145,38.04875,3872,0,0,0,NA
81144,co,-106.15116,37.54987,4082,0,0,0,NA
81146,co,-105.68684,37.65747,2005,0,0,0,NA
81147,co,-107.09647,37.31907,16942,0,0,0,NA
81148,co,-105.98541,37.17182,205,0,0,0,NA
81149,co,-106.3401,38.08397,1285,0,0,0,NA
81151,co,-105.70858,37.23319,6152,0,0,0,NA
81152,co,-105.39906,37.11506,15864,0,0,0,NA
81154,co,-106.64859,37.595,5437,0,0,0,NA
81155,co,-106.03195,38.29741,1289,0,0,0,NA
81201,co,-106.06481,38.56048,7658,0,0,0,NA
81210,co,-106.63112,38.82131,1061,0,0,0,NA
81211,co,-106.23909,38.90703,6082,0,0,0,NA
81212,co,-105.38592,38.53862,13971,0,0,0,NA
81220,co,-107.48983,38.30909,1401,0,0,0,NA
81221,co,-105.14443,38.36237,340,0,0,0,NA
81222,co,-105.81843,38.35568,276,0,0,0,NA
81223,co,-105.60644,38.40534,5377,0,0,0,NA
81224,co,-106.93721,38.87338,3867,0,0,0,NA
81225,co,-106.95466,38.95885,1476,0,0,0,NA
81226,co,-105.12435,38.33378,4232,0,1,1,NA
81227,co,-106.29012,38.5493,140,0,0,0,NA
81230,co,-106.9564,38.42485,6355,0,0,0,NA
81231,co,-106.91967,38.55002,3,0,0,0,NA
81232,co,-105.61047,38.28513,15,0,0,0,NA
81233,co,-105.82737,38.42523,876,0,0,0,NA
81236,co,-106.2436,38.70612,2123,0,0,0,NA
81237,co,-106.61405,38.60307,189,0,0,0,NA
81239,co,-106.66363,38.50882,124,0,0,0,NA
81240,co,-105.03219,38.50409,2696,0,1,1,NA
81241,co,-106.51465,38.61791,743,0,0,0,NA
81242,co,-106.07551,38.50814,583,0,0,0,NA
81243,co,-107.1896,38.26343,1010,0,0,0,NA
81244,co,-105.17773,38.36294,356,0,0,0,NA
81248,co,-106.39655,38.45214,408,0,0,0,NA
81251,co,-106.44163,39.10111,890,0,0,0,NA
81252,co,-105.4202,38.10882,7904,0,0,0,NA
81253,co,-105.0686,38.21922,483,0,0,0,NA
81301,co,-107.85156,37.44496,19080,0,0,0,NA
81303,co,-107.8911,37.11629,4279,0,0,0,NA
81320,co,-108.73334,37.7218,495,0,0,0,NA
81321,co,-108.76214,37.3184,7698,0,0,0,NA
81323,co,-108.28465,37.63986,3436,0,0,0,NA
81324,co,-109.03341,37.66414,1867,0,0,0,NA
81325,co,-108.72827,37.91698,446,0,0,0,NA
81326,co,-108.1683,37.16207,1841,0,0,0,NA
81327,co,-108.6546,37.5177,414,0,0,0,NA
81328,co,-108.25858,37.36328,3199,0,0,0,NA
81331,co,-108.87142,37.51646,699,0,0,0,NA
81332,co,-107.95771,37.72685,746,0,0,0,NA
81334,co,-108.54661,37.11242,11,0,0,0,NA
81335,co,-108.75704,37.49642,150,0,0,0,NA
81401,co,-107.75848,38.48717,12549,0,0,0,NA
81403,co,-107.96918,38.33439,7788,0,0,0,NA
81410,co,-107.96771,38.80139,925,0,2,2,NA
81411,co,-108.98017,38.25077,75,0,1,1,NA
81413,co,-107.95493,38.95722,3978,0,0,0,NA
81415,co,-107.63675,38.64049,1589,0,0,0,NA
81416,co,-108.13762,38.75098,6863,0,1,1,NA
81418,co,-107.98717,38.84872,870,0,1,1,NA
81419,co,-107.75853,38.86944,2657,0,1,1,NA
81422,co,-108.71157,38.34672,739,0,1,1,NA
81423,co,-108.36913,38.02467,1492,0,0,0,NA
81424,co,-108.45796,38.3344,926,0,1,1,NA
81425,co,-108.22149,38.53577,2993,0,1,1,NA
81426,co,-107.8913,37.8682,242,0,0,0,NA
81427,co,-107.63167,38.02015,1384,0,0,0,NA
81428,co,-107.59524,38.95808,2555,0,0,0,NA
81429,co,-108.87798,38.31738,298,1,2,1,100
81430,co,-108.05371,38.01872,1340,0,0,0,NA
81431,co,-108.58304,38.10425,468,0,0,0,NA
81432,co,-107.75691,38.12815,3413,0,0,0,NA
81433,co,-107.63082,37.78203,2085,0,0,0,NA
81434,co,-107.35451,38.95024,739,0,0,0,NA
81435,co,-107.8695,37.90381,4127,0,0,0,NA
81501,co,-108.54757,39.07211,9632,1,3,2,200
81503,co,-108.43604,39.03071,7069,1,2,1,100
81504,co,-108.49158,39.07913,13293,1,2,1,100
81505,co,-108.57774,39.18188,7092,1,3,2,200
81506,co,-108.53243,39.11587,5633,1,3,2,200
81507,co,-108.62607,39.00931,7925,1,3,2,200
81520,co,-108.43378,39.10988,5221,1,2,1,100
81521,co,-108.81649,39.14588,7620,1,4,3,300
81522,co,-108.91452,38.65093,259,0,0,0,NA
81523,co,-108.88258,38.95269,1044,0,0,0,NA
81524,co,-108.78118,39.26886,1418,1,4,3,300
81525,co,-108.95157,39.28857,696,1,4,3,300
81526,co,-108.3369,39.09624,2720,0,1,1,NA
81527,co,-108.5513,38.74878,1645,0,1,1,NA
81601,co,-107.3136,39.5839,7115,0,0,0,NA
81610,co,-108.76944,40.30276,719,0,1,1,NA
81611,co,-106.77139,39.15157,9626,0,0,0,NA
81612,co,-106.83737,39.13419,37,0,0,0,NA
81615,co,-106.93197,39.22114,3679,0,0,0,NA
81620,co,-106.51435,39.59656,3466,0,0,0,NA
81621,co,-106.88557,39.38609,2911,0,0,0,NA
81623,co,-107.20443,39.25108,8605,0,0,0,NA
81624,co,-107.77749,39.2481,1874,0,0,0,NA
81625,co,-107.6871,40.7338,8007,0,0,0,NA
81630,co,-108.54202,39.46252,1403,0,1,1,NA
81631,co,-106.76546,39.63855,4308,0,0,0,NA
81632,co,-106.60466,39.63334,4636,0,0,0,NA
81633,co,-108.42922,40.33836,80,0,0,0,NA
81635,co,-108.04807,39.51984,2942,0,0,0,NA
81637,co,-107.10153,39.77665,4048,0,0,0,NA
81638,co,-107.55455,40.32106,225,0,0,0,NA
81639,co,-107.25305,40.50561,2322,0,0,0,NA
81640,co,-108.51904,40.65843,927,0,0,0,NA
81641,co,-107.76291,40.08039,2975,0,0,0,NA
81642,co,-106.6596,39.31985,166,0,0,0,NA
81643,co,-108.15791,39.07826,1250,0,0,0,NA
81645,co,-106.41704,39.45073,652,0,0,0,NA
81646,co,-107.99625,39.10255,214,0,0,0,NA
81647,co,-107.55421,39.621,3337,0,0,0,NA
81648,co,-108.73358,39.97208,1642,0,1,1,NA
81649,co,-106.31038,39.51831,251,0,0,0,NA
81650,co,-108.11824,39.73874,5542,0,0,0,NA
81652,co,-107.65625,39.48542,2685,0,0,0,NA
81653,co,-107.27054,40.96558,79,0,0,0,NA
81654,co,-107.03027,39.22583,757,0,0,0,NA
81655,co,-106.53375,39.75114,91,0,0,0,NA
81656,co,-106.89726,39.28385,166,0,0,0,NA
81657,co,-106.32342,39.65119,3064,0,0,0,NA
82001,wy,-104.93442,41.09144,14430,0,0,0,NA
82007,wy,-104.74935,41.06478,7818,0,0,0,NA
82009,wy,-104.84867,41.37799,17054,0,0,0,NA
82050,wy,-104.18977,41.45317,381,0,0,0,NA
82051,wy,-105.61117,41.57354,272,0,0,0,NA
82052,wy,-105.30862,41.11856,36,0,0,0,NA
82053,wy,-104.35077,41.25087,1129,0,0,0,NA
82054,wy,-104.36066,41.06376,791,0,0,0,NA
82055,wy,-106.16837,41.3376,702,0,0,0,NA
82058,wy,-105.59802,42.09054,282,0,0,0,NA
82059,wy,-105.17728,41.05734,215,0,0,0,NA
82060,wy,-104.50146,41.23549,229,0,0,0,NA
82061,wy,-105.14916,41.44495,62,0,0,0,NA
82063,co,-105.98452,40.88767,598,0,0,0,NA
82070,wy,-105.83217,41.20538,9340,0,0,0,NA
82072,wy,-105.47817,41.42475,5063,0,0,0,NA
82081,wy,-104.41704,41.52219,33,0,0,0,NA
82082,ne,-104.12186,41.2333,1366,0,0,0,NA
82083,wy,-106.08573,41.65936,1009,0,0,0,NA
82084,wy,-105.54657,41.0361,117,0,0,0,NA
82190,wy,-110.51814,44.57437,2,0,0,0,NA
82201,wy,-105.14687,42.01851,4996,0,1,1,NA
82210,wy,-104.83083,41.74638,885,0,0,0,NA
82212,wy,-104.52488,42.28855,749,0,2,2,NA
82213,wy,-104.99095,42.4912,899,0,1,1,NA
82214,wy,-104.75952,42.26075,829,1,2,1,100
82215,wy,-104.76062,42.38176,437,0,1,1,NA
82217,wy,-104.17018,41.76564,179,1,2,1,100
82219,wy,-104.51339,42.49874,111,0,1,1,NA
82221,wy,-104.3429,41.63841,469,0,1,1,NA
82222,wy,-104.67087,43.20147,187,1,2,1,100
82223,wy,-104.39511,42.12844,672,1,3,2,200
82224,wy,-104.79731,43.04213,111,0,1,1,NA
82225,wy,-104.31654,42.98524,2023,0,1,1,NA
82227,wy,-104.72256,42.76171,380,0,0,0,NA
82229,wy,-104.96783,42.8767,263,0,0,0,NA
82240,wy,-104.17916,42.24069,5290,1,3,2,200
82242,wy,-104.10934,42.69459,102,0,1,1,NA
82243,wy,-104.42752,41.9945,191,1,3,2,200
82244,wy,-104.43973,41.88118,645,1,3,2,200
82301,wy,-107.49509,41.88844,6144,0,0,0,NA
82321,wy,-107.76313,41.17807,845,0,0,0,NA
82322,wy,-107.56103,42.23774,221,0,0,0,NA
82323,wy,-107.49897,41.0445,144,0,0,0,NA
82324,wy,-106.41038,41.66702,472,0,0,0,NA
82325,wy,-107.0732,41.16525,1349,0,0,0,NA
82327,wy,-106.68554,42.1654,1081,0,0,0,NA
82329,wy,-106.07534,42.08883,1120,0,0,0,NA
82331,wy,-106.80054,41.3839,2305,0,0,0,NA
82332,wy,-107.29438,41.05674,162,0,0,0,NA
82334,wy,-106.99555,41.88119,383,0,0,0,NA
82335,wy,-106.85236,41.80999,76,0,0,0,NA
82336,wy,-108.19014,41.73136,2455,0,0,0,NA
82401,wy,-108.14615,43.98603,4126,0,2,2,NA
82410,wy,-108.12365,44.36573,1128,1,2,1,100
82411,wy,-108.45811,44.41452,465,0,0,0,NA
82412,wy,-108.55223,44.79597,402,0,1,1,NA
82414,wy,-109.58733,44.47308,9463,0,0,0,NA
82420,wy,-108.45492,44.92285,546,0,1,1,NA
82421,wy,-108.5983,44.90755,420,0,1,1,NA
82422,wy,-108.38228,44.49766,64,0,0,0,NA
82423,wy,-108.584,44.9701,231,0,1,1,NA
82426,wy,-107.76173,44.52248,1837,0,1,1,NA
82428,wy,-107.52619,44.30832,272,0,1,1,NA
82430,wy,-108.18853,43.82019,128,0,1,1,NA
82431,wy,-108.16578,44.84241,2260,0,1,1,NA
82432,wy,-107.89136,44.22677,296,0,2,2,NA
82433,wy,-109.10145,44.06316,907,0,0,0,NA
82434,wy,-108.30867,44.38714,143,0,1,1,NA
82435,wy,-108.9383,44.82011,6642,0,0,0,NA
82440,wy,-108.86417,44.71975,91,0,0,0,NA
82441,wy,-107.77167,44.64349,213,0,1,1,NA
82442,wy,-107.31481,43.87939,879,0,0,0,NA
82443,wy,-108.47151,43.72509,3646,0,1,1,NA
82450,wy,-109.43546,44.5053,320,0,0,0,NA
82501,wy,-108.2024,43.0351,9145,0,0,0,NA
82510,wy,-108.59791,42.99405,54,0,0,0,NA
82512,wy,-109.25647,43.30054,191,0,0,0,NA
82513,wy,-109.64268,43.59308,2659,0,0,0,NA
82514,wy,-108.9536,43.04968,174,0,0,0,NA
82515,wy,-108.54262,42.90373,321,0,0,0,NA
82516,wy,-108.86385,43.20144,285,0,0,0,NA
82520,wy,-108.62851,42.6905,7452,0,0,0,NA
82523,wy,-108.81412,43.44313,665,0,0,0,NA
82601,wy,-106.38743,43.09721,15980,0,0,0,NA
82604,wy,-106.76931,42.85793,14801,0,0,0,NA
82609,wy,-106.18908,42.80683,6847,0,0,0,NA
82620,wy,-107.09999,42.46957,599,0,0,0,NA
82630,wy,-107.30616,43.15277,63,0,0,0,NA
82633,wy,-105.42222,43.02568,6842,0,0,0,NA
82635,wy,-106.22238,43.39815,304,0,0,0,NA
82636,wy,-106.16894,42.90925,2772,0,0,0,NA
82637,wy,-105.88634,42.81438,2637,0,0,0,NA
82638,wy,-107.34358,43.11535,37,0,0,0,NA
82639,wy,-106.60927,43.71544,967,0,0,0,NA
82640,wy,-106.19558,43.56592,63,0,0,0,NA
82642,wy,-107.61966,43.26258,301,0,0,0,NA
82643,wy,-106.26901,43.4456,389,0,1,1,NA
82644,wy,-106.37615,42.84306,986,0,0,0,NA
82646,wy,-106.82599,42.99608,52,0,0,0,NA
82648,wy,-107.13997,43.29489,377,0,0,0,NA
82649,wy,-108.05638,43.2993,1000,0,0,0,NA
82701,sd,-104.43782,43.7037,4266,0,1,0,100
82710,wy,-104.27036,44.70774,308,1,1,0,0
82711,wy,-104.45863,44.7093,133,0,1,1,NA
82712,wy,-104.12163,44.45338,250,1,2,1,100
82714,wy,-104.69965,44.57158,86,0,1,1,NA
82715,wy,-104.13339,44.11916,3,0,0,0,NA
82716,wy,-105.68558,44.4807,6884,0,1,1,NA
82718,wy,-105.61299,43.88128,10394,0,0,0,NA
82720,wy,-104.67587,44.79761,1059,1,2,1,100
82721,wy,-104.91263,44.49187,2251,1,2,1,100
82723,wy,-104.41395,43.99629,399,0,1,1,NA
82725,wy,-105.70882,44.87766,337,1,3,2,200
82727,wy,-105.1984,44.3281,1069,0,1,1,NA
82729,wy,-104.36138,44.3517,1963,0,0,0,NA
82730,wy,-104.69892,44.04332,1527,0,2,2,NA
82731,wy,-105.28791,44.82086,287,1,3,2,200
82732,wy,-105.62092,43.70245,912,0,0,0,NA
82801,mt,-106.83971,44.84449,13403,0,2,2,100
82831,wy,-106.06917,44.62404,469,1,4,3,300
82832,wy,-106.79542,44.60032,564,0,0,0,NA
82833,wy,-107.12314,44.61985,254,0,0,0,NA
82834,wy,-106.65631,44.23689,5172,0,0,0,NA
82835,wy,-106.35875,44.77748,532,1,1,0,0
82836,wy,-107.50269,44.78182,706,0,0,0,NA
82837,wy,-106.26495,44.78407,31,1,4,3,300
82838,wy,-107.55815,44.9453,209,0,0,0,NA
82839,wy,-107.15507,44.92377,818,1,2,1,100
82842,wy,-106.92881,44.57675,813,0,0,0,NA
82844,wy,-107.22022,44.78643,13,0,0,0,NA
82845,wy,-106.6739,44.75848,60,0,1,1,NA
82901,wy,-109.00243,41.36491,12445,0,0,0,NA
82922,wy,-110.38958,43.13996,532,0,0,0,NA
82923,wy,-109.46205,42.65395,772,0,0,0,NA
82925,wy,-109.89258,43.23151,498,0,0,0,NA
82929,wy,-109.85007,41.55994,118,0,0,0,NA
82930,ut,-110.63731,41.00815,9265,0,0,0,NA
82932,wy,-109.35556,42.25273,1571,0,0,0,NA
82933,wy,-110.45748,41.27986,948,0,0,0,NA
82934,wy,-110.013,41.6041,303,0,0,0,NA
82935,wy,-109.67217,41.69101,5357,0,0,0,NA
82936,wy,-110.18403,41.0651,376,0,0,0,NA
82937,wy,-110.26617,41.35588,2835,0,0,0,NA
82938,wy,-109.72035,41.14438,945,0,0,0,NA
82939,wy,-110.33111,41.20711,1256,0,0,0,NA
82941,wy,-109.95429,43.04028,3834,0,0,0,NA
82942,wy,-108.85278,41.71746,142,0,0,0,NA
82943,wy,-109.20808,41.75471,331,0,0,0,NA
82944,wy,-110.50675,41.10149,1110,0,0,0,NA
82945,wy,-109.05173,41.73721,619,0,0,0,NA
83001,wy,-110.46125,43.51052,8766,0,0,0,NA
83011,wy,-110.4368,43.56136,239,0,0,0,NA
83012,wy,-110.74198,43.71496,320,0,0,0,NA
83013,wy,-110.43577,43.95453,501,0,0,0,NA
83014,wy,-110.93684,43.45858,2537,0,0,0,NA
83025,wy,-110.83137,43.59237,633,0,0,0,NA
83101,wy,-110.54813,41.96373,3150,0,0,0,NA
83110,wy,-110.90129,42.72279,3225,0,0,0,NA
83111,id,-111.12377,42.76808,721,0,0,0,NA
83112,wy,-110.83089,42.91945,668,0,0,0,NA
83113,wy,-110.25701,42.53213,1674,0,0,0,NA
83114,wy,-110.9452,42.17613,1049,0,0,0,NA
83115,wy,-110.29951,42.89738,1315,0,0,0,NA
83116,wy,-110.53578,41.77259,479,0,0,0,NA
83118,wy,-111.00224,43.04936,1051,0,0,0,NA
83119,wy,-110.98821,42.64392,221,0,0,0,NA
83120,id,-111.13783,42.93373,700,0,0,0,NA
83121,wy,-110.5339,41.81972,21,0,0,0,NA
83122,wy,-110.94654,42.82027,320,0,0,0,NA
83123,wy,-110.26316,42.22389,671,0,0,0,NA
83124,wy,-110.23096,41.7706,210,0,0,0,NA
83126,wy,-110.84467,42.5796,413,0,0,0,NA
83127,wy,-110.96507,42.95542,4610,0,0,0,NA
83128,wy,-110.78853,43.12144,2228,0,0,0,NA
83201,id,-112.38461,42.88939,15143,1,2,1,100
83202,id,-112.34212,42.96803,9111,1,2,1,100
83203,id,-112.49598,43.04241,349,0,1,1,NA
83204,id,-112.52765,42.7964,8905,0,2,2,NA
83209,id,-112.42632,42.85779,57,1,2,1,100
83210,id,-112.86188,43.01935,2874,0,1,1,NA
83211,id,-113.01391,42.70666,4959,0,1,1,NA
83212,id,-112.54199,42.53352,811,0,0,0,NA
83213,id,-113.30076,43.55481,2598,0,1,1,NA
83214,id,-112.29038,42.5452,1112,0,1,1,NA
83215,id,-112.8125,43.44316,78,0,1,1,NA
83217,id,-111.93735,42.77531,1938,0,0,0,NA
83218,id,-112.16534,43.31765,157,0,1,1,NA
83220,id,-111.39083,42.36306,341,0,0,0,NA
83221,id,-112.54504,43.33608,16067,0,1,1,NA
83223,id,-111.40868,42.18399,165,0,0,0,NA
83226,id,-114.36488,44.66893,4050,0,0,0,NA
83227,id,-114.5017,44.24934,318,0,0,0,NA
83228,id,-112.04028,42.19564,580,0,1,1,NA
83232,id,-111.97165,42.13867,254,1,2,1,100
83233,id,-111.23509,42.15799,238,0,0,0,NA
83234,id,-112.09381,42.41859,2349,0,1,1,NA
83235,id,-113.80329,44.60825,385,0,0,0,NA
83236,id,-111.90316,43.24318,3106,0,1,1,NA
83237,id,-111.77513,42.027,729,0,1,1,NA
83238,id,-111.10837,42.33105,413,0,0,0,NA
83239,id,-111.32837,42.5063,615,0,0,0,NA
83241,id,-111.75975,42.52146,1970,0,1,1,NA
83243,id,-112.66527,42.24133,331,0,1,1,NA
83244,id,-113.11641,43.95953,1479,0,0,0,NA
83245,id,-112.22035,42.81817,2316,0,1,1,NA
83246,id,-112.02929,42.61108,2854,0,0,0,NA
83250,id,-112.2043,42.66739,1716,0,1,1,NA
83251,id,-113.8962,43.93757,1830,0,0,0,NA
83252,id,-112.45827,42.1902,7104,0,1,1,NA
83253,id,-113.69029,44.31887,527,0,0,0,NA
83254,id,-111.26813,42.32834,5016,0,0,0,NA
83255,id,-113.57178,43.69685,1804,0,0,0,NA
83261,id,-111.42072,42.21612,773,0,0,0,NA
83262,id,-112.76836,43.18416,1351,0,1,1,NA
83263,id,-111.75709,42.16884,6261,0,2,2,NA
83271,id,-112.84558,42.45793,1092,0,1,1,NA
83272,id,-111.36384,42.10495,1531,0,0,0,NA
83274,id,-112.09882,43.35384,4910,0,1,1,NA
83276,id,-111.5278,42.76926,4074,0,0,0,NA
83277,id,-112.6763,43.07038,186,0,2,2,NA
83278,id,-114.89595,44.37034,982,0,0,0,NA
83281,id,-111.9599,42.31045,280,0,1,1,NA
83283,id,-111.67051,42.35943,278,0,0,0,NA
83285,id,-111.28726,43.09836,836,0,0,0,NA
83286,id,-112.01486,42.05315,1039,1,2,1,100
83287,id,-111.39811,42.04659,2231,0,0,0,NA
83301,id,-114.52218,42.3932,25988,1,2,1,100
83302,id,-115.00149,42.12884,1990,0,0,0,NA
83311,id,-113.55677,42.38958,843,0,0,0,NA
83312,id,-113.65429,41.97584,798,0,0,0,NA
83313,id,-114.25222,43.35825,2764,0,0,0,NA
83314,id,-114.93933,42.97653,1181,3,9,6,200
83316,id,-114.87211,42.61389,6156,1,2,1,100
83318,id,-113.82131,42.43678,8627,0,1,1,NA
83320,id,-113.88364,43.45232,2412,0,1,1,NA
83321,id,-114.91337,42.46495,647,0,1,1,NA
83322,id,-114.97495,43.35582,99,0,0,0,NA
83323,id,-113.39078,42.49417,1823,0,1,1,NA
83324,id,-114.26587,42.87835,648,1,3,2,200
83325,id,-114.24213,42.58784,719,1,2,1,100
83327,id,-114.804,43.48908,3668,0,0,0,NA
83328,id,-114.61384,42.57026,3095,1,2,1,100
83330,id,-114.7082,42.95289,3693,2,5,3,150
83332,id,-114.92049,42.80191,2144,3,11,8,266.7
83333,id,-114.3155,43.56675,7071,0,0,0,NA
83334,id,-114.2849,42.43776,1168,0,1,1,NA
83335,id,-114.06719,42.58125,1423,1,2,1,100
83336,id,-113.81936,42.56348,2718,0,2,2,NA
83337,id,-115.14699,43.22687,1089,0,0,0,NA
83338,id,-114.43291,42.72257,9954,1,4,3,300
83340,id,-114.58321,43.77182,6523,0,0,0,NA
83341,id,-114.3696,42.41952,4010,0,1,1,NA
83342,id,-113.25127,42.1778,3746,0,0,0,NA
83344,id,-114.13051,42.44599,1034,0,1,1,NA
83346,id,-113.93482,42.20983,2432,0,0,0,NA
83347,id,-113.88078,42.73395,2687,0,1,1,NA
83348,id,-114.10783,43.25698,271,0,1,1,NA
83349,id,-114.1816,43.09487,960,0,2,2,NA
83350,id,-113.58023,42.69505,7710,0,2,2,NA
83352,id,-114.41161,43.07068,3145,1,4,3,300
83353,id,-114.33219,43.68559,2511,0,0,0,NA
83354,id,-114.32231,43.67014,16,0,0,0,NA
83355,id,-114.72742,42.75423,2640,2,6,4,200
83401,id,-111.89189,43.55176,18591,0,1,1,NA
83402,id,-112.15452,43.53152,12875,0,1,1,NA
83404,id,-112.012,43.42444,10000,0,1,1,NA
83406,id,-111.81737,43.43888,7465,0,0,0,NA
83414,wy,-110.94925,43.88858,548,0,0,0,NA
83420,id,-111.35129,44.07281,5028,0,0,0,NA
83421,id,-111.53797,44.00502,354,0,0,0,NA
83422,id,-111.23117,43.73314,5318,0,0,0,NA
83423,id,-112.27024,44.29999,2682,0,0,0,NA
83424,id,-111.16597,43.91284,572,0,0,0,NA
83425,id,-112.24277,43.91646,814,0,1,1,NA
83427,id,-111.93248,43.52498,673,0,0,0,NA
83428,id,-111.16481,43.41862,1798,0,0,0,NA
83429,id,-111.40235,44.46771,9605,0,0,0,NA
83431,id,-112.02969,43.68886,550,0,0,0,NA
83433,id,-111.33305,44.48439,312,0,0,0,NA
83434,id,-112.00952,43.7539,1261,0,0,0,NA
83435,id,-112.56822,43.9879,710,0,1,1,NA
83436,id,-111.47648,43.85689,1002,0,0,0,NA
83440,id,-111.82301,43.81596,12440,0,0,0,NA
83442,id,-111.89296,43.672,10940,0,0,0,NA
83443,id,-111.52658,43.51974,2037,0,0,0,NA
83444,id,-112.24937,43.69572,1306,0,0,0,NA
83445,id,-111.76876,43.9787,5524,0,0,0,NA
83446,id,-112.1927,44.4729,300,0,0,0,NA
83448,id,-111.69695,43.84662,1519,0,0,0,NA
83449,id,-111.40768,43.28225,1535,0,0,0,NA
83450,id,-112.41523,43.83223,792,0,1,1,NA
83451,id,-111.6364,43.86876,622,0,0,0,NA
83452,id,-111.21957,43.83659,3077,0,0,0,NA
83454,id,-111.95777,43.59356,210,0,1,1,NA
83455,id,-111.17992,43.61481,5029,0,0,0,NA
83460,id,-111.7822,43.81697,4,0,0,0,NA
83462,id,-113.81075,45.30431,638,0,1,1,NA
83463,id,-113.99128,45.57029,516,0,0,0,NA
83464,id,-113.23656,44.50731,2253,0,0,0,NA
83465,id,-113.69999,44.77716,437,0,0,0,NA
83466,id,-114.04183,45.4242,863,0,1,1,NA
83467,id,-113.89895,45.00976,7606,0,0,0,NA
83468,id,-113.6092,44.93461,421,0,0,0,NA
83469,id,-114.40592,45.36348,823,0,0,0,NA
83501,id,-116.8963,46.20694,17961,4,10,6,150
83520,id,-116.32406,46.53898,190,1,4,3,300
83522,id,-116.50575,45.92292,2750,0,1,1,NA
83523,id,-116.45207,46.24478,1621,0,0,0,NA
83524,id,-116.65718,46.36883,1501,1,2,1,100
83525,id,-115.5024,45.78962,2473,0,0,0,NA
83526,id,-116.40945,46.15139,442,0,0,0,NA
83530,id,-116.08487,45.92139,4837,0,0,0,NA
83533,id,-116.23189,46.10809,243,0,1,1,NA
83535,id,-116.72248,46.53774,1145,2,6,4,200
83536,id,-116.00328,46.22094,3756,3,6,3,100
83537,id,-116.54511,46.63149,2007,1,2,1,100
83539,id,-115.0301,46.22391,5944,1,2,1,100
83540,id,-116.78866,46.35383,1298,3,6,3,100
83541,id,-116.46509,46.51501,1830,1,3,2,200
83542,id,-116.36243,45.56268,338,1,2,1,100
83543,id,-116.23675,46.27488,1174,0,1,1,NA
83544,id,-116.1552,46.49535,5049,2,4,2,100
83545,id,-116.42457,46.4289,658,1,2,1,100
83546,id,-115.81728,46.5674,1168,0,0,0,NA
83547,id,-116.18707,45.19077,462,0,1,1,NA
83548,id,-116.51439,46.36132,284,0,0,0,NA
83549,id,-116.21895,45.38301,1822,0,1,1,NA
83552,id,-115.92691,46.00202,1259,1,4,3,300
83553,id,-115.90472,46.38352,1270,0,1,1,NA
83554,id,-116.28781,45.70361,1356,1,3,2,200
83555,id,-116.69547,46.12356,1286,0,0,0,NA
83601,id,-115.22162,43.85634,788,0,0,0,NA
83602,id,-116.11471,44.07215,161,0,1,1,NA
83604,id,-115.80565,42.50809,3358,1,3,2,200
83605,id,-116.65647,43.6624,16181,4,11,7,175
83607,id,-116.7508,43.70797,11867,3,10,7,233.3
83610,id,-116.77273,44.67505,1972,3,7,4,133.3
83611,id,-115.3959,44.71399,7831,0,0,0,NA
83612,id,-116.56465,44.91445,3543,1,4,3,300
83615,id,-116.05197,44.71689,4833,0,0,0,NA
83616,id,-116.39255,43.77415,15608,2,8,6,300
83617,id,-116.50567,43.92997,8906,2,7,5,250
83619,id,-116.91223,43.96727,3803,5,12,7,140
83622,id,-115.87731,44.10585,3900,1,3,2,200
83623,id,-115.39113,43.08029,1963,5,12,7,140
83624,id,-116.14386,42.91339,1475,2,7,5,250
83626,id,-116.83158,43.66902,619,3,9,6,200
83627,id,-115.53643,42.92063,816,4,13,9,225
83628,id,-116.98142,43.54062,2260,4,11,7,175
83629,id,-116.16261,43.91939,1823,1,3,2,200
83631,id,-115.76422,43.86725,2135,0,1,1,NA
83632,id,-116.40553,44.53617,690,2,5,3,150
83633,id,-115.21426,43.01818,1020,4,12,8,200
83634,id,-116.32789,43.45201,11693,1,5,4,400
83636,id,-116.66127,43.90865,111,3,10,7,233.3
83637,id,-115.28902,44.13536,1540,0,0,0,NA
83638,id,-115.93484,45.09892,11115,0,0,0,NA
83639,id,-116.87116,43.39706,1919,2,8,6,300
83641,id,-116.58623,43.3513,2385,2,7,5,250
83642,id,-116.40134,43.57345,22565,2,6,4,200
83643,id,-116.44391,44.63049,239,3,8,5,166.7
83644,id,-116.58225,43.75013,6208,4,12,8,200
83645,id,-116.58087,44.37088,1869,2,6,4,200
83646,id,-116.43066,43.64979,28598,2,7,5,250
83647,id,-115.50266,43.43417,14286,2,7,5,250
83648,id,-115.8656,43.04963,20,2,7,5,250
83650,id,-116.63713,42.84803,3942,1,2,1,100
83651,id,-116.6201,43.58809,11364,5,14,9,180
83654,id,-116.35662,45.09731,2775,0,1,1,NA
83655,id,-116.79079,43.95155,2681,4,11,7,175
83656,id,-116.79873,43.72648,266,4,12,8,200
83657,id,-116.3018,44.22453,764,1,2,1,100
83660,id,-116.93134,43.79911,3852,4,12,8,200
83661,id,-116.7043,44.07774,5237,5,13,8,160
83666,id,-115.97588,43.96333,160,0,1,1,NA
83669,id,-116.4976,43.71786,6788,3,9,6,200
83670,id,-116.3069,44.01726,680,2,5,3,150
83671,id,-115.20868,45.35632,1663,0,0,0,NA
83672,id,-116.94236,44.36693,6438,5,12,7,140
83676,id,-116.91158,43.65716,2572,4,11,7,175
83677,id,-115.53302,45.0803,370,0,0,0,NA
83686,id,-116.61139,43.49528,20449,3,10,7,233.3
83687,id,-116.5295,43.60956,13380,4,11,7,175
83702,id,-116.16937,43.67576,9349,1,5,4,400
83703,id,-116.24046,43.66443,7108,2,6,4,200
83704,id,-116.28722,43.62772,13353,2,6,4,200
83705,id,-116.22277,43.56624,10186,2,6,4,200
83706,id,-116.1949,43.59143,11043,2,6,4,200
83709,id,-116.2893,43.54979,24138,1,5,4,400
83712,id,-116.11492,43.6134,4158,1,5,4,400
83713,id,-116.33399,43.63894,10129,2,6,4,200
83714,id,-116.27974,43.73196,12096,2,6,4,200
83716,id,-115.97113,43.53454,12249,1,4,3,300
83801,id,-116.65884,47.93829,4466,0,1,1,NA
83802,id,-115.52854,47.08005,2000,0,0,0,NA
83803,id,-116.44405,48.03636,1588,0,0,0,NA
83804,id,-116.97368,48.03619,1490,0,0,0,NA
83805,id,-116.49064,48.8439,7031,0,1,1,NA
83806,id,-116.36232,46.89361,342,0,1,1,NA
83808,id,-116.07029,47.32187,850,0,0,0,NA
83809,id,-116.57353,48.0636,336,0,0,0,NA
83810,id,-116.45903,47.54765,1600,0,1,1,NA
83811,id,-116.2374,48.0615,1979,0,0,0,NA
83812,id,-116.22866,47.01608,593,0,0,0,NA
83813,id,-116.63517,48.09743,1156,0,0,0,NA
83814,id,-116.75212,47.63962,15160,1,2,1,100
83815,id,-116.78902,47.72482,13273,0,2,2,NA
83821,id,-116.85642,48.58115,1513,0,0,0,NA
83822,id,-117.00209,48.16658,1280,0,1,1,NA
83823,id,-116.51547,46.80619,1891,0,1,1,NA
83824,id,-116.91012,47.1136,533,0,1,1,NA
83825,id,-116.60081,48.24753,309,0,1,1,NA
83826,id,-116.18886,48.97603,102,0,0,0,NA
83827,id,-116.17472,46.78,681,0,1,1,NA
83830,id,-116.36532,47.07831,1293,0,1,1,NA
83832,id,-116.90687,46.55358,1707,1,2,1,100
83833,id,-116.72229,47.5156,3910,0,1,1,NA
83834,id,-116.66266,46.97495,463,0,1,1,NA
83835,id,-116.65832,47.79611,11414,0,1,1,NA
83836,id,-116.25138,48.26371,1526,0,0,0,NA
83837,id,-116.08107,47.5096,2885,0,0,0,NA
83839,id,-116.16986,47.61009,2049,0,1,1,NA
83840,id,-116.51517,48.31057,124,0,1,1,NA
83841,id,-116.75113,48.20148,367,0,1,1,NA
83842,id,-116.5506,47.44069,274,0,0,0,NA
83843,id,-116.94185,46.72265,8663,1,1,0,0
83844,id,-117.01281,46.72937,10,0,1,1,NA
83845,id,-116.11776,48.77844,1391,0,1,1,NA
83846,id,-115.76684,47.47489,1014,0,0,0,NA
83847,id,-116.44369,48.57775,1573,0,1,1,NA
83848,id,-116.91595,48.71587,765,0,1,1,NA
83849,id,-116.00054,47.5166,1253,0,0,0,NA
83850,id,-116.23094,47.4546,1636,0,1,1,NA
83851,id,-116.91035,47.29941,1363,0,1,1,NA
83852,id,-116.54204,48.30904,435,0,1,1,NA
83854,id,-116.97288,47.71871,18677,0,1,1,NA
83855,id,-116.92184,46.97081,1698,0,1,1,NA
83856,id,-116.90063,48.31052,7349,0,1,1,NA
83857,id,-116.79402,46.89205,762,0,1,1,NA
83858,id,-116.90767,47.85308,8430,0,1,1,NA
83860,id,-116.53221,48.18925,6199,0,1,1,NA
83861,id,-116.55111,47.2632,7396,0,1,1,NA
83864,id,-116.52867,48.46778,13468,0,1,1,NA
83866,id,-116.42463,47.15513,590,0,1,1,NA
83867,id,-115.94879,47.50573,346,0,0,0,NA
83868,id,-116.18142,47.53431,617,0,0,0,NA
83869,id,-116.89143,47.97904,3182,0,1,1,NA
83870,id,-116.83168,47.12588,586,0,1,1,NA
83871,id,-116.73932,46.74624,1815,1,1,0,0
83872,id,-116.97011,46.8621,761,0,1,1,NA
83873,id,-115.88754,47.61274,2451,0,0,0,NA
83874,id,-115.78438,47.63917,164,0,0,0,NA
83876,id,-116.9286,47.44888,2555,0,1,1,NA
84001,ut,-110.27547,40.35139,523,0,0,0,NA
84002,ut,-110.30781,40.45199,288,0,0,0,NA
84003,ut,-111.71916,40.46016,19272,1,3,2,200
84004,ut,-111.74907,40.48809,4169,0,1,1,NA
84005,ut,-111.99653,40.32513,14120,0,1,1,NA
84006,ut,-112.11725,40.60147,531,0,1,1,NA
84007,ut,-110.20176,40.32135,723,0,0,0,NA
84010,ut,-111.86722,40.86778,15702,0,0,0,NA
84013,ut,-112.09226,40.29588,1715,0,1,1,NA
84014,ut,-111.88505,40.93214,5889,0,1,1,NA
84015,ut,-112.06118,41.12089,21040,1,2,1,100
84017,ut,-111.20392,40.9335,4987,0,0,0,NA
84018,ut,-111.44542,41.21541,631,0,0,0,NA
84020,ut,-111.86743,40.50025,16164,1,2,1,100
84021,ut,-110.52756,40.1302,11853,0,0,0,NA
84022,ut,-112.76584,40.27882,1085,1,3,2,200
84023,ut,-109.20411,40.84505,1496,0,1,1,NA
84024,ut,-111.44733,41.00767,79,0,0,0,NA
84025,ut,-111.90361,40.9803,8317,1,3,2,200
84026,ut,-109.83943,40.28104,688,1,2,1,100
84027,ut,-110.82257,40.15753,4868,0,0,0,NA
84028,id,-111.40551,41.93366,5526,0,0,0,NA
84029,ut,-112.72176,40.6265,6259,1,3,2,200
84031,ut,-110.76884,40.53286,1136,0,0,0,NA
84032,ut,-111.20113,40.36185,14132,0,0,0,NA
84033,ut,-111.50112,40.98567,920,0,0,0,NA
84034,nv,-113.8953,40.06007,543,0,0,0,NA
84035,ut,-109.26356,40.20705,1031,1,2,1,100
84036,ut,-111.14476,40.64135,7925,0,0,0,NA
84037,ut,-111.95055,41.02503,12604,1,3,2,200
84038,ut,-111.31771,41.87585,1463,0,0,0,NA
84039,ut,-109.80849,40.48557,1007,0,1,1,NA
84040,ut,-111.92697,41.09143,9081,0,1,1,NA
84041,ut,-111.98381,41.07144,15730,1,3,2,200
84042,ut,-111.72452,40.34077,4550,1,3,2,200
84043,ut,-111.87328,40.41087,25650,1,2,1,100
84044,ut,-112.15592,40.7198,9277,1,2,1,100
84045,ut,-111.91175,40.33845,14085,0,2,2,NA
84046,ut,-109.8227,40.94372,1707,0,0,0,NA
84047,ut,-111.89075,40.61523,9958,1,4,3,300
84049,ut,-111.50986,40.5248,5848,0,1,1,NA
84050,ut,-111.67579,41.01959,6930,0,1,1,NA
84051,ut,-110.42922,40.39214,471,0,0,0,NA
84052,ut,-109.99557,40.17198,1600,0,1,1,NA
84053,ut,-110.01811,40.44996,846,0,0,0,NA
84054,ut,-111.91687,40.84114,6726,1,2,1,100
84055,ut,-111.08252,40.7787,2679,0,0,0,NA
84056,ut,-111.99016,41.12649,72,0,2,2,NA
84057,ut,-111.7104,40.31428,10476,1,3,2,200
84058,ut,-111.7278,40.28729,13070,1,3,2,200
84060,ut,-111.50182,40.65237,7350,0,0,0,NA
84061,ut,-111.3429,40.75269,554,0,0,0,NA
84062,ut,-111.67778,40.43485,14121,0,2,2,NA
84063,ut,-109.70236,39.98761,926,1,3,2,200
84064,ut,-111.12543,41.68374,1443,0,0,0,NA
84065,ut,-111.94442,40.4954,18740,1,4,3,300
84066,ut,-110.02872,40.32926,9479,1,2,1,100
84067,ut,-112.04812,41.17186,12796,1,2,1,100
84069,ut,-112.49744,40.38139,806,1,2,1,100
84070,ut,-111.88905,40.57711,9222,1,4,3,300
84071,ut,-112.31834,40.41818,1748,0,1,1,NA
84072,ut,-110.66025,40.3554,748,0,0,0,NA
84073,ut,-110.43504,40.35656,231,0,0,0,NA
84074,ut,-112.27333,40.55927,19497,0,2,2,NA
84075,ut,-112.07976,41.0814,10505,1,4,3,300
84076,ut,-109.84553,40.46647,269,0,1,1,NA
84078,ut,-109.48287,40.62968,14947,0,1,1,NA
84080,ut,-112.43011,40.09998,713,0,1,1,NA
84081,ut,-112.03763,40.60284,14185,1,3,2,200
84082,ut,-111.39532,40.36581,912,0,0,0,NA
84083,ut,-113.67263,40.86026,12082,1,3,2,200
84084,ut,-111.96455,40.62287,11468,1,5,4,400
84085,ut,-109.92909,40.58692,157,0,0,0,NA
84086,ut,-111.22869,41.47986,1014,0,0,0,NA
84087,ut,-111.93132,40.88567,6317,1,3,2,200
84088,ut,-111.96092,40.59516,10822,1,4,3,300
84092,ut,-111.74316,40.55775,11333,0,1,1,NA
84093,ut,-111.8285,40.59475,8226,0,2,2,NA
84094,ut,-111.86214,40.57188,9505,1,4,3,300
84095,ut,-111.97892,40.55725,27070,1,4,3,300
84096,ut,-112.09852,40.51367,19279,0,2,2,NA
84097,ut,-111.67312,40.30483,7282,1,2,1,100
84098,ut,-111.53432,40.73471,11369,0,0,0,NA
84101,ut,-111.90007,40.7564,2718,1,4,3,300
84102,ut,-111.86439,40.76025,5629,1,3,2,200
84103,ut,-111.84245,40.79521,8869,1,2,1,100
84104,ut,-111.98218,40.74865,8501,1,4,3,300
84105,ut,-111.85955,40.7383,8313,1,3,2,200
84106,ut,-111.85566,40.70676,13112,1,3,2,200
84107,ut,-111.88445,40.65804,11520,1,4,3,300
84108,ut,-111.7378,40.78992,8555,0,1,1,NA
84109,ut,-111.70613,40.70268,9820,0,1,1,NA
84111,ut,-111.88398,40.75596,3880,1,3,2,200
84112,ut,-111.84148,40.76508,28,0,1,1,NA
84113,ut,-111.83581,40.76035,3,0,1,1,NA
84115,ut,-111.89269,40.71451,9908,1,4,3,300
84116,ut,-111.9573,40.79988,9905,1,4,3,300
84117,ut,-111.83471,40.66104,9247,1,2,1,100
84118,ut,-112.01341,40.65351,20410,1,4,3,300
84119,ut,-111.94613,40.70159,13837,1,5,4,400
84120,ut,-112.00124,40.69748,13315,1,4,3,300
84121,ut,-111.69815,40.62562,17771,0,2,2,NA
84123,ut,-111.92163,40.6589,10419,1,4,3,300
84124,ut,-111.81329,40.67719,7899,0,1,1,NA
84128,ut,-112.04677,40.70045,8188,1,3,2,200
84144,ut,-111.89253,40.76826,34,1,4,3,300
84180,ut,-111.9011,40.77044,682,1,4,3,300
84301,ut,-112.13012,41.6082,506,1,3,2,200
84302,ut,-112.04564,41.54813,10424,0,1,1,NA
84304,ut,-111.99685,41.8166,162,1,3,2,200
84305,ut,-112.07565,41.94416,931,0,2,2,NA
84306,ut,-112.06396,41.79267,458,0,1,1,NA
84307,ut,-112.49332,41.51552,2901,1,3,2,200
84308,ut,-111.98649,41.9611,354,1,2,1,100
84309,ut,-112.09837,41.71409,480,0,1,1,NA
84310,ut,-111.84947,41.33538,5333,0,0,0,NA
84311,ut,-112.11602,41.82367,495,1,3,2,200
84312,ut,-112.15364,41.7791,2400,1,3,2,200
84313,ut,-113.96185,41.6575,1148,0,1,1,NA
84314,ut,-112.09286,41.64841,702,0,2,2,NA
84315,ut,-112.13651,41.16686,3778,1,3,2,200
84316,ut,-112.47773,41.76769,551,1,2,1,100
84317,ut,-111.6187,41.30437,4350,0,0,0,NA
84318,ut,-111.81367,41.80257,2050,0,2,2,NA
84319,ut,-111.66645,41.61012,4836,0,1,1,NA
84320,ut,-111.84864,41.96477,1694,1,2,1,100
84321,ut,-111.68546,41.80001,15037,0,1,1,NA
84324,ut,-111.95263,41.48796,954,0,0,0,NA
84325,ut,-111.99277,41.72577,1472,0,2,2,NA
84326,ut,-111.81779,41.67066,821,0,1,1,NA
84327,ut,-111.99468,41.87169,705,1,3,2,200
84328,ut,-111.83478,41.54586,1276,0,0,0,NA
84329,ut,-113.41929,41.76548,2453,0,1,1,NA
84330,ut,-112.16331,41.92619,527,1,2,1,100
84331,ut,-112.27366,41.94843,592,1,2,1,100
84332,ut,-111.81215,41.69998,3145,0,1,1,NA
84333,ut,-111.81098,41.90907,1540,0,2,2,NA
84334,ut,-112.14764,41.78259,151,1,3,2,200
84335,ut,-111.87882,41.83119,6345,1,2,1,100
84336,ut,-112.77875,41.90956,1405,0,2,2,NA
84337,ut,-112.31801,41.76587,7160,1,3,2,200
84338,ut,-111.9387,41.91123,443,1,3,2,200
84339,ut,-111.94444,41.62532,3095,0,1,1,NA
84340,ut,-112.04637,41.37978,1949,0,1,1,NA
84341,ut,-111.80692,41.77586,7024,0,1,1,NA
84401,ut,-112.03816,41.21869,18286,1,2,1,100
84403,ut,-111.90256,41.19445,13687,0,1,1,NA
84404,ut,-112.11645,41.27065,24837,1,2,1,100
84405,ut,-111.96656,41.15796,12181,0,1,1,NA
84414,ut,-111.97618,41.32192,12299,0,1,1,NA
84501,ut,-110.76041,39.54696,7346,0,1,1,NA
84511,ut,-109.4144,37.56295,2889,0,1,1,NA
84512,ut,-109.57125,37.13716,360,3,9,6,200
84513,ut,-111.00987,39.24427,1303,0,1,1,NA
84515,ut,-109.1793,38.94263,168,6,14,8,133.3
84516,ut,-111.06885,39.143,368,0,1,1,NA
84518,ut,-110.8903,39.39247,820,0,1,1,NA
84520,ut,-110.42044,39.52916,1276,0,0,0,NA
84521,ut,-110.78185,39.42155,852,0,1,1,NA
84522,ut,-111.19991,38.92043,826,0,0,0,NA
84523,ut,-111.1999,39.09447,1451,0,1,1,NA
84525,ut,-110.25453,38.94653,1702,4,11,7,175
84526,ut,-110.94592,39.74544,6434,0,0,0,NA
84528,ut,-111.07846,39.40953,2081,0,1,1,NA
84529,ut,-110.82075,39.67945,202,0,0,0,NA
84530,ut,-109.16148,38.28903,840,0,0,0,NA
84531,ut,-109.88443,37.15823,41,5,13,8,160
84532,ut,-109.53378,38.50073,7209,2,6,4,200
84533,ut,-110.43125,37.56106,1108,4,10,6,150
84534,ut,-109.2331,37.2531,106,4,11,7,175
84535,ut,-109.56788,37.99931,3558,0,0,0,NA
84536,ut,-110.35055,37.12294,21,1,3,2,200
84537,ut,-111.19807,39.32971,1337,0,0,0,NA
84539,ut,-110.27232,39.69371,1040,0,0,0,NA
84540,ut,-109.43536,39.24348,325,1,2,1,100
84542,ut,-110.73502,39.54226,1021,0,1,1,NA
84601,ut,-111.69696,40.22722,9752,1,4,3,300
84604,ut,-111.59131,40.3432,12002,1,3,2,200
84606,ut,-111.62555,40.21444,6714,1,2,1,100
84620,ut,-111.92767,38.91483,12,0,1,1,NA
84621,ut,-111.82566,39.05131,72,0,1,1,NA
84622,ut,-111.82168,39.10383,307,0,1,1,NA
84623,ut,-111.58602,39.45611,177,0,1,1,NA
84624,ut,-112.83991,39.40751,6184,1,5,4,400
84626,ut,-112.00197,39.90255,1015,1,2,1,100
84627,ut,-111.56521,39.35415,1047,0,1,1,NA
84628,ut,-112.20576,39.97341,3230,0,0,0,NA
84629,ut,-111.4703,39.80008,4552,0,0,0,NA
84630,ut,-111.81731,39.29524,532,0,1,1,NA
84631,ut,-112.38344,38.95991,3545,0,1,1,NA
84632,ut,-111.65827,39.62016,65,0,0,0,NA
84633,ut,-111.90428,39.96998,1087,1,4,3,300
84634,ut,-111.81111,39.1584,421,0,1,1,NA
84635,ut,-112.7251,39.40216,977,1,5,4,400
84636,ut,-112.33895,39.14061,1114,0,1,1,NA
84637,ut,-112.49285,38.7228,1627,0,1,1,NA
84638,ut,-112.26359,39.49964,658,1,2,1,100
84639,ut,-111.88128,39.5044,2273,0,1,1,NA
84640,ut,-112.38176,39.4982,553,1,4,3,300
84642,ut,-111.61539,39.28855,776,0,0,0,NA
84643,ut,-111.71286,39.1152,246,0,0,0,NA
84645,ut,-111.84428,39.84435,1748,0,2,2,NA
84646,ut,-111.61378,39.5422,124,0,1,1,NA
84647,ut,-111.41586,39.54112,2593,0,0,0,NA
84648,ut,-111.86443,39.68581,4932,0,1,1,NA
84649,ut,-112.33759,39.33901,1138,0,2,2,NA
84651,ut,-111.71465,39.9542,10923,1,2,1,100
84652,ut,-111.8682,39.01694,46,0,1,1,NA
84653,ut,-111.64407,40.02759,4800,0,1,1,NA
84654,ut,-111.62472,38.87875,1537,0,0,0,NA
84655,ut,-111.8037,39.97374,5920,0,1,1,NA
84656,ut,-112.07472,39.13991,1012,0,1,1,NA
84657,ut,-111.93928,38.81495,46,0,0,0,NA
84660,ut,-111.5686,40.06445,17155,1,3,2,200
84662,ut,-111.47364,39.43194,465,0,0,0,NA
84663,ut,-111.49506,40.16565,13358,1,3,2,200
84664,ut,-111.56512,40.11511,4454,0,1,1,NA
84665,ut,-111.6652,39.19799,249,0,0,0,NA
84667,ut,-111.65326,39.49215,64,0,1,1,NA
84701,ut,-111.83314,38.67465,474,0,0,0,NA
84710,ut,-112.49917,37.47556,658,0,0,0,NA
84711,ut,-112.00584,38.67623,36,0,0,0,NA
84712,ut,-111.94426,37.99957,1395,0,0,0,NA
84713,ut,-112.54941,38.3264,4407,0,0,0,NA
84714,ut,-113.72812,37.84775,10407,0,1,1,NA
84715,ut,-111.54894,38.29,773,0,0,0,NA
84716,ut,-111.44662,37.96472,1125,0,0,0,NA
84718,ut,-112.04515,37.53955,377,0,1,1,NA
84719,ut,-112.80149,37.67543,3481,0,0,0,NA
84720,ut,-113.16813,37.58863,11909,0,0,0,NA
84721,ut,-113.20453,37.87876,15446,0,1,1,NA
84722,ut,-113.61312,37.44017,545,0,0,0,NA
84723,ut,-112.25043,38.17959,855,0,0,0,NA
84724,ut,-112.14888,38.67528,1136,0,1,1,NA
84725,ut,-113.76935,37.53619,1762,0,0,0,NA
84726,ut,-111.59131,37.73908,2276,0,1,1,NA
84728,ut,-113.92767,39.25755,243,0,2,2,NA
84729,ut,-112.60246,37.36655,791,0,0,0,NA
84730,ut,-112.00507,38.73618,4,0,0,0,NA
84731,ut,-112.85383,38.27526,515,0,1,1,NA
84732,ut,-111.9023,38.44541,193,0,0,0,NA
84733,ut,-113.89665,37.33085,313,3,8,5,166.7
84734,ut,-110.64162,38.30065,853,4,11,7,175
84735,ut,-112.43071,37.64059,1515,0,0,0,NA
84736,ut,-111.99604,37.55016,315,0,0,0,NA
84737,ut,-113.23301,37.09789,13874,9,21,12,133.3
84738,ut,-113.70686,37.17881,6051,19,35,16,84.2
84739,ut,-112.31558,38.63432,407,0,1,1,NA
84740,ut,-112.25308,38.27517,395,0,0,0,NA
84741,ut,-112.30601,37.18051,7397,2,5,3,150
84742,ut,-113.20511,37.54022,391,0,0,0,NA
84743,ut,-112.13847,38.17418,98,0,0,0,NA
84744,ut,-111.89868,38.58052,141,0,0,0,NA
84745,ut,-113.24461,37.23155,2222,9,22,13,144.4
84746,ut,-113.35616,37.24278,848,8,20,12,150
84747,ut,-111.64383,38.40659,1751,0,0,0,NA
84749,ut,-111.53619,38.41846,401,0,0,0,NA
84750,ut,-112.19559,38.44544,1044,0,0,0,NA
84751,ut,-113.05785,38.48631,2729,0,2,2,NA
84752,ut,-112.89067,38.209,1145,0,1,1,NA
84753,ut,-113.88562,37.98975,521,0,1,1,NA
84754,ut,-112.10995,38.62332,61,0,0,0,NA
84755,ut,-112.78612,37.2367,794,0,0,0,NA
84756,ut,-113.5419,37.59007,1378,0,1,1,NA
84757,ut,-113.25131,37.45599,1242,0,1,1,NA
84758,ut,-112.76237,37.30206,851,0,0,0,NA
84759,ut,-112.39487,37.90781,5844,0,0,0,NA
84760,ut,-112.67603,37.93733,986,0,0,0,NA
84761,ut,-112.84232,37.87442,3690,0,0,0,NA
84762,ut,-112.74158,37.4713,6863,0,0,0,NA
84763,ut,-113.07055,37.14226,377,5,14,9,180
84764,ut,-112.17353,37.61845,354,0,0,0,NA
84765,ut,-113.67606,37.12813,3325,25,43,18,72
84766,ut,-112.31711,38.57637,134,0,0,0,NA
84767,ut,-112.98644,37.237,1309,2,7,5,250
84770,ut,-113.60824,37.17562,22648,26,43,17,65.4
84772,ut,-112.93861,37.78079,231,0,0,0,NA
84773,ut,-111.34209,38.22647,1269,0,0,0,NA
84774,ut,-113.28117,37.2905,1071,8,19,11,137.5
84775,ut,-111.00526,38.07001,2573,0,1,1,NA
84776,ut,-112.08027,37.63062,700,0,0,0,NA
84779,ut,-113.12072,37.33948,2017,3,7,4,133.3
84780,ut,-113.49026,37.12646,15367,24,42,18,75
84781,ut,-113.46608,37.41281,938,0,0,0,NA
84782,ut,-113.66484,37.34952,644,0,1,1,NA
84783,ut,-113.69301,37.2464,527,1,2,1,100
84784,ut,-112.99448,37.03292,608,1,2,1,100
84790,ut,-113.5581,37.04632,25687,29,48,19,65.5
85003,az,-112.07835,33.45067,3216,87,103,16,18.4
85004,az,-112.06989,33.45157,2255,87,103,16,18.4
85006,az,-112.04787,33.46514,7131,87,103,16,18.4
85007,az,-112.09115,33.44715,5449,86,103,17,19.8
85008,az,-111.98675,33.4633,10787,86,102,16,18.6
85009,az,-112.12823,33.44285,12344,88,104,16,18.2
85012,az,-112.07037,33.50726,2664,87,104,17,19.5
85013,az,-112.08294,33.51013,6667,87,104,17,19.5
85014,az,-112.05674,33.5085,8420,86,102,16,18.6
85015,az,-112.10185,33.50911,9520,88,104,16,18.2
85016,az,-112.02969,33.51386,12844,85,102,17,20
85017,az,-112.12372,33.50904,7794,88,104,16,18.2
85018,az,-111.98579,33.50536,13992,84,101,17,20.2
85019,az,-112.14299,33.50924,6863,88,104,16,18.2
85020,az,-112.05474,33.56748,13799,80,97,17,21.3
85021,az,-112.0939,33.55997,9589,84,101,17,20.2
85022,az,-112.05182,33.62719,16211,75,94,19,25.3
85023,az,-112.0947,33.63151,9825,76,95,19,25
85024,az,-112.03345,33.73552,9954,74,93,19,25.7
85027,az,-112.0996,33.68188,13675,77,95,18,23.4
85028,az,-112.00913,33.57559,8577,74,93,19,25.7
85029,az,-112.11024,33.59504,12591,83,100,17,20.5
85031,az,-112.16834,33.4949,6646,88,105,17,19.3
85032,az,-112.0038,33.62629,21916,76,95,19,25
85033,az,-112.21163,33.49437,13103,88,104,16,18.2
85034,az,-112.02007,33.43488,4714,86,102,16,18.6
85035,az,-112.19472,33.47145,9703,89,105,16,18
85037,az,-112.26469,33.49057,14192,89,105,16,18
85040,az,-112.02655,33.40614,11243,81,98,17,21
85041,az,-112.10884,33.38584,20152,80,97,17,21.3
85042,az,-112.0424,33.36883,14486,75,94,19,25.3
85043,az,-112.19646,33.43245,11419,90,106,16,17.8
85044,az,-112.00177,33.34239,13712,84,101,17,20.2
85045,az,-112.10844,33.29919,3318,89,105,16,18
85048,az,-112.05578,33.31257,13321,87,104,17,19.5
85050,az,-111.9963,33.68633,11891,74,93,19,25.7
85051,az,-112.13317,33.55913,12012,86,103,17,19.8
85053,az,-112.13161,33.62992,9081,79,97,18,22.8
85054,az,-111.94613,33.6731,2499,75,93,18,24
85083,az,-112.15855,33.72457,7587,78,96,18,23.1
85085,az,-112.08931,33.75292,8560,72,91,19,26.4
85086,az,-112.12017,33.81545,17675,67,86,19,28.4
85087,az,-112.12792,33.92351,5038,59,79,20,33.9
85118,az,-111.35047,33.3534,9668,76,94,18,23.7
85119,az,-111.50196,33.40972,11118,80,98,18,22.5
85120,az,-111.56785,33.40302,10151,81,99,18,22.2
85121,az,-111.92124,33.14353,172,95,110,15,15.8
85122,az,-111.74422,32.91714,24552,95,110,15,15.8
85123,az,-111.69563,32.71587,10011,89,106,17,19.1
85128,az,-111.53805,32.99045,11735,95,110,15,15.8
85131,az,-111.55012,32.67389,19257,88,105,17,19.3
85132,az,-111.20452,32.93337,20237,84,101,17,20.2
85135,az,-110.786,33.00428,432,69,88,19,27.5
85137,az,-111.00197,33.13729,1684,63,82,19,30.2
85138,az,-111.98905,33.00689,24752,98,112,14,14.3
85139,az,-112.14616,32.97589,14178,97,112,15,15.5
85140,az,-111.54381,33.24453,17918,80,98,18,22.5
85141,az,-111.45437,32.67335,552,86,103,17,19.8
85142,az,-111.63811,33.19864,35539,80,98,18,22.5
85143,az,-111.51904,33.15865,16280,84,101,17,20.2
85145,az,-111.36788,32.55745,1081,81,99,18,22.2
85147,az,-111.73723,33.1259,121,90,106,16,17.8
85172,az,-111.95379,32.88609,1092,97,111,14,14.4
85173,az,-111.12331,33.27015,2331,20,36,16,80
85192,az,-110.68872,32.96057,1678,48,68,20,41.7
85193,az,-111.82023,32.79405,12179,94,109,15,16
85194,az,-111.6261,32.89839,6262,93,109,16,17.2
85201,az,-111.85017,33.43389,12475,83,100,17,20.5
85202,az,-111.87449,33.3825,10816,83,101,18,21.7
85203,az,-111.80397,33.45005,10193,81,99,18,22.2
85204,az,-111.78808,33.39679,16119,81,99,18,22.2
85205,az,-111.7187,33.43232,17266,78,97,19,24.4
85206,az,-111.71773,33.39668,14495,78,96,18,23.1
85207,az,-111.63686,33.45354,19620,79,97,18,22.8
85208,az,-111.62825,33.40163,15334,80,98,18,22.5
85209,az,-111.63762,33.37833,19750,78,97,19,24.4
85210,az,-111.8432,33.38986,10256,83,101,18,21.7
85212,az,-111.63546,33.32216,18261,78,96,18,23.1
85213,az,-111.76999,33.44857,10576,78,97,19,24.4
85215,az,-111.57873,33.51108,9659,79,97,18,22.8
85224,az,-111.87647,33.32366,14670,84,101,17,20.2
85225,az,-111.8322,33.31736,23499,84,101,17,20.2
85226,az,-112.00762,33.25899,14262,85,102,17,20
85233,az,-111.81136,33.3521,14827,83,100,17,20.5
85234,az,-111.73945,33.36453,17692,78,97,19,24.4
85248,az,-111.86964,33.21801,18687,87,104,17,19.5
85249,az,-111.79707,33.22556,18211,86,102,16,18.6
85250,az,-111.88855,33.53576,9353,84,101,17,20.2
85251,az,-111.91954,33.4939,16611,84,102,18,21.4
85253,az,-111.95853,33.54501,9450,81,99,18,22.2
85254,az,-111.95193,33.61505,17521,79,97,18,22.8
85255,az,-111.82113,33.68316,22305,68,87,19,27.9
85256,az,-111.84068,33.50196,5,84,101,17,20.2
85257,az,-111.91595,33.4642,10838,86,103,17,19.8
85258,az,-111.89564,33.56469,13665,82,100,18,22
85259,az,-111.8095,33.60112,10270,84,101,17,20.2
85260,az,-111.89156,33.6096,16181,80,98,18,22.5
85262,az,-111.81057,33.8318,13011,50,70,20,40
85263,az,-111.51459,33.82703,3822,79,96,17,21.5
85264,az,-111.53257,33.63084,396,77,95,18,23.4
85266,az,-111.91825,33.76691,8132,58,78,20,34.5
85268,az,-111.74006,33.607,14894,88,104,16,18.2
85281,az,-111.93114,33.42817,13669,84,101,17,20.2
85282,az,-111.93188,33.39416,14969,83,101,18,21.7
85283,az,-111.93205,33.36458,13493,83,100,17,20.5
85284,az,-111.93428,33.33715,7384,84,101,17,20.2
85286,az,-111.83122,33.27106,16082,84,101,17,20.2
85295,az,-111.74084,33.30545,17408,79,97,18,22.8
85296,az,-111.74062,33.33539,17119,78,97,19,24.4
85297,az,-111.73351,33.27781,12869,80,98,18,22.5
85298,az,-111.72568,33.24189,13994,81,99,18,22.2
85301,az,-112.17793,33.53175,12845,88,104,16,18.2
85302,az,-112.17797,33.56797,11562,86,103,17,19.8
85303,az,-112.22106,33.5327,9540,88,104,16,18.2
85304,az,-112.17699,33.59646,9072,86,102,16,18.6
85305,az,-112.2563,33.53081,3920,88,104,16,18.2
85306,az,-112.17639,33.62393,7886,84,101,17,20.2
85307,az,-112.31367,33.53756,3132,90,105,15,16.7
85308,az,-112.18458,33.66054,23608,83,100,17,20.5
85309,az,-112.37667,33.53548,21,91,106,15,16.5
85310,az,-112.17186,33.69581,7727,80,98,18,22.5
85320,az,-113.2136,33.91838,1388,45,66,21,46.7
85321,az,-112.65427,32.22941,3285,73,92,19,26
85322,az,-112.85103,33.1741,1564,102,115,13,12.7
85323,az,-112.32607,33.41939,13093,88,104,16,18.2
85324,az,-112.04425,34.11917,2085,52,72,20,38.5
85325,az,-113.9016,33.99884,1808,94,108,14,14.9
85326,az,-112.57794,33.28903,31678,98,112,14,14.3
85328,az,-114.63447,33.22625,569,101,114,13,12.9
85331,az,-111.93492,33.88509,16594,62,81,19,30.6
85332,az,-112.90462,34.19084,2321,26,44,18,69.2
85333,az,-113.28099,33.02346,6127,108,120,12,11.1
85334,az,-114.53392,33.5221,517,104,117,13,12.5
85335,az,-112.32664,33.59193,11873,91,106,15,16.5
85336,az,-114.78945,32.5453,338,96,110,14,14.6
85337,az,-112.70335,32.95962,3062,106,119,13,12.3
85338,az,-112.40789,33.37348,25131,89,105,16,18
85339,az,-112.16082,33.23771,17237,89,105,16,18
85340,az,-112.4132,33.50982,15285,93,108,15,16.1
85341,az,-112.7844,31.87352,7,89,104,15,16.9
85342,az,-112.45315,33.94482,2581,66,84,18,27.3
85343,az,-112.68913,33.33911,225,101,115,14,13.9
85344,az,-114.22199,34.07552,4947,97,111,14,14.4
85345,az,-112.2462,33.57195,19214,88,104,16,18.2
85346,az,-114.14595,33.63621,2862,95,109,14,14.7
85347,az,-113.78952,32.79743,2619,107,120,13,12.1
85348,az,-113.71429,33.70878,4372,69,88,19,27.5
85349,az,-114.75241,32.49748,7844,96,109,13,13.5
85350,az,-114.69738,32.55358,6106,95,109,14,14.7
85351,az,-112.28211,33.60649,20767,92,107,15,16.3
85352,az,-113.83949,32.71937,1564,99,113,14,14.1
85353,az,-112.27287,33.41825,13226,87,103,16,18.4
85354,az,-113.049,33.4332,13031,92,107,15,16.3
85355,az,-112.45385,33.57618,5908,85,101,16,18.8
85356,az,-114.16224,32.689,4507,91,106,15,16.5
85357,az,-113.50322,33.9777,795,56,76,20,35.7
85360,az,-113.56842,34.70936,2499,28,43,15,53.6
85361,az,-112.61465,33.76393,8494,80,97,17,21.3
85362,az,-112.83477,34.27994,1006,3,8,5,166.7
85363,az,-112.30507,33.58443,2386,90,106,16,17.8
85364,az,-114.65865,32.70315,22189,99,112,13,13.1
85365,az,-114.15049,33.07898,22714,98,112,14,14.3
85367,az,-114.39555,32.67171,15933,94,109,15,16
85371,az,-114.37575,33.8287,42,102,115,13,12.7
85373,az,-112.29956,33.67376,10120,93,109,16,17.2
85374,az,-112.37679,33.644,24063,89,105,16,18
85375,az,-112.36601,33.68564,20505,94,109,15,16
85377,az,-111.91521,33.8243,3202,51,72,21,41.2
85379,az,-112.37356,33.60206,17503,87,104,17,19.5
85381,az,-112.23168,33.60957,8963,89,105,16,18
85382,az,-112.24745,33.65514,16726,90,106,16,17.8
85383,az,-112.24701,33.80232,28905,86,102,16,18.6
85387,az,-112.43807,33.7128,10586,86,103,17,19.8
85388,az,-112.43385,33.60789,11396,84,101,17,20.2
85390,az,-112.86034,33.8944,9105,60,80,20,33.3
85392,az,-112.30936,33.47778,11988,90,106,16,17.8
85395,az,-112.3945,33.47905,13568,92,107,15,16.3
85396,az,-112.65076,33.52696,18668,87,103,16,18.4
85501,az,-110.75349,33.53901,6839,8,21,13,162.5
85530,az,-110.23734,33.10619,42,8,20,12,150
85531,az,-109.78937,32.87715,390,26,48,22,84.6
85533,az,-109.3857,33.321,1901,11,25,14,127.3
85534,az,-109.14062,32.75446,2455,12,27,15,125
85535,az,-109.91385,32.98995,107,28,50,22,78.6
85536,az,-110.00253,33.13902,512,27,48,21,77.8
85539,az,-110.91301,33.36099,3248,8,19,11,137.5
85540,az,-109.35747,32.97735,84,13,28,15,115.4
85541,az,-111.30517,34.19487,14687,2,6,4,200
85542,az,-110.30316,33.29656,49,17,34,17,100
85543,az,-109.96759,32.98245,3021,24,44,20,83.3
85544,az,-111.53525,34.34351,4646,0,1,1,NA
85545,az,-111.12487,33.54552,131,7,17,10,142.9
85546,az,-109.58407,32.71131,9397,20,40,20,100
85551,az,-109.58369,32.72086,263,20,40,20,100
85552,az,-109.7695,32.82175,3231,22,43,21,95.5
85553,az,-111.22883,33.81554,1475,51,71,20,39.2
85554,az,-110.95425,33.98597,910,0,1,1,NA
85601,az,-111.31585,31.58835,1056,9,23,14,155.6
85602,az,-110.377,32.17426,9402,8,19,11,137.5
85603,az,-109.9105,31.43401,7067,1,4,3,300
85605,az,-109.47777,32.29935,1779,13,29,16,123.1
85606,az,-109.91028,32.03952,11203,3,11,8,266.7
85607,az,-109.35159,31.52119,18193,5,14,9,180
85608,az,-109.58608,31.45591,2,4,13,9,225
85609,az,-110.10553,32.06588,536,1,4,3,300
85610,az,-109.71772,31.74109,5153,2,7,5,250
85611,az,-110.51207,31.66159,1339,0,2,2,NA
85613,az,-110.38513,31.56692,1,1,5,4,400
85614,az,-110.92578,31.82285,18935,34,57,23,67.6
85615,az,-110.2199,31.40203,7107,2,6,4,200
85616,az,-110.33315,31.69331,3502,2,8,6,300
85617,az,-109.72296,31.54829,3340,4,12,8,200
85618,az,-110.55581,32.71315,1143,44,66,22,50
85619,az,-110.73321,32.40761,1130,0,0,0,NA
85620,az,-109.94137,31.33751,359,1,4,3,300
85621,az,-111.04023,31.42293,12813,4,13,9,225
85622,az,-111.07551,31.82685,5660,30,53,23,76.7
85623,az,-110.80528,32.70637,4539,7,17,10,142.9
85624,az,-110.69851,31.51525,1700,1,5,4,400
85625,az,-109.61187,31.8885,11542,2,8,6,300
85626,az,-109.56668,31.35781,543,7,19,12,171.4
85627,az,-110.24127,32.00501,626,11,26,15,136.4
85629,az,-111.01903,31.91781,13250,35,57,22,62.9
85630,az,-110.16897,31.88884,2175,8,19,11,137.5
85631,az,-110.55228,32.59134,1668,21,40,19,90.5
85632,az,-109.17492,32.04248,2663,7,18,11,157.1
85633,az,-111.4957,31.62281,260,14,30,16,114.3
85634,az,-112.00656,32.03143,463,65,84,19,29.2
85635,az,-110.17697,31.57038,13830,2,8,6,300
85637,az,-110.6897,31.72821,1315,1,3,2,200
85638,az,-110.05094,31.71509,3016,2,7,5,250
85640,az,-111.04935,31.56188,351,12,27,15,125
85641,az,-110.62278,32.04918,17174,10,24,14,140
85643,az,-109.96362,32.40373,16029,5,14,9,180
85645,az,-111.15951,31.70305,1203,18,36,18,100
85646,az,-110.99018,31.60614,2821,11,25,14,127.3
85648,az,-111.04116,31.48735,23381,7,19,12,171.4
85650,az,-110.20214,31.50007,7705,1,6,5,500
85653,az,-111.37701,32.38975,14391,74,94,20,27
85654,az,-111.15441,32.41526,53,72,93,21,29.2
85658,az,-111.1484,32.54922,9207,48,72,24,50
85701,az,-110.971,32.21696,2322,44,68,24,54.5
85704,az,-110.98553,32.33791,12785,45,69,24,53.3
85705,az,-110.99211,32.27128,15228,50,74,24,48
85706,az,-110.93334,32.14761,13979,37,61,24,64.9
85707,az,-110.88691,32.17921,14,31,54,23,74.2
85708,az,-110.86641,32.18192,2,28,50,22,78.6
85710,az,-110.82373,32.21414,18073,35,59,24,68.6
85711,az,-110.8834,32.21524,13771,35,59,24,68.6
85712,az,-110.88648,32.25232,11616,45,69,24,53.3
85713,az,-111.0162,32.19504,17096,42,66,24,57.1
85714,az,-110.95086,32.16739,5363,40,64,24,60
85715,az,-110.83084,32.24889,8470,45,70,25,55.6
85716,az,-110.9232,32.24154,11969,42,67,25,59.5
85718,az,-110.91662,32.33333,13908,43,67,24,55.8
85719,az,-110.94866,32.24671,12985,45,70,25,55.6
85723,az,-110.96515,32.18023,2,40,64,24,60
85724,az,-110.9456,32.24079,8,45,70,25,55.6
85726,az,-110.94561,32.20474,45,43,67,24,55.8
85730,az,-110.74709,32.1828,13375,29,51,22,75.9
85735,az,-111.34715,32.09308,5941,49,73,24,49
85736,az,-111.37021,31.90109,7762,18,35,17,94.4
85737,az,-110.94657,32.41419,10043,33,55,22,66.7
85739,az,-110.98579,32.61652,10926,18,36,18,100
85741,az,-111.03948,32.3374,11967,56,80,24,42.9
85742,az,-111.0657,32.39472,13448,55,79,24,43.6
85743,az,-111.18822,32.31087,15702,63,85,22,34.9
85745,az,-111.08972,32.2588,15803,49,73,24,49
85746,az,-111.04422,32.09099,13447,44,68,24,54.5
85747,az,-110.76542,32.09499,12411,23,44,21,91.3
85748,az,-110.7521,32.21895,7512,31,54,23,74.2
85749,az,-110.73176,32.28948,8830,41,65,24,58.5
85750,az,-110.84019,32.302,12115,47,71,24,51.1
85755,az,-110.98149,32.46841,10436,35,59,24,68.6
85756,az,-110.89892,32.07928,11448,33,57,24,72.7
85757,az,-111.12206,32.12851,9711,44,68,24,54.5
85901,az,-109.99996,34.29984,21201,0,1,1,NA
85911,az,-110.36939,34.1355,1,0,0,0,NA
85912,az,-109.92743,34.42675,975,0,1,1,NA
85920,az,-109.17662,33.86018,1612,0,0,0,NA
85922,az,-109.13676,33.50845,96,0,1,1,NA
85923,az,-110.34055,34.32497,574,0,0,0,NA
85924,az,-109.66168,34.57456,21113,0,1,1,NA
85925,az,-109.32323,34.088,2926,0,0,0,NA
85927,az,-109.46644,34.00518,999,0,0,0,NA
85928,az,-110.55813,34.53346,2978,0,0,0,NA
85929,az,-109.93653,34.18581,7194,0,0,0,NA
85930,az,-109.72263,34.04314,5,0,0,0,NA
85931,az,-110.86445,34.45126,1032,0,0,0,NA
85932,az,-109.21467,33.9525,1258,0,0,0,NA
85933,az,-110.50679,34.35622,6926,0,0,0,NA
85934,az,-110.24572,34.30027,1043,0,0,0,NA
85935,az,-109.89584,34.11523,7267,0,0,0,NA
85936,az,-109.27649,34.64542,11336,0,1,1,NA
85937,az,-110.06058,34.55936,10218,1,1,0,0
85938,az,-109.33154,34.17017,1881,0,0,0,NA
85939,az,-110.08577,34.43897,2558,0,1,1,NA
85940,az,-109.68806,34.25245,2934,0,0,0,NA
85941,az,-109.97092,33.82047,1,0,0,0,NA
85942,az,-109.97073,34.74308,218,1,3,2,200
86001,az,-111.63773,35.28949,18709,0,0,0,NA
86004,az,-111.3848,35.38762,15504,0,0,0,NA
86011,az,-111.65503,35.18007,40,0,0,0,NA
86015,az,-111.83768,35.23244,422,0,0,0,NA
86016,az,-111.6188,35.75043,20,1,4,3,300
86017,az,-111.63621,34.89803,3551,0,0,0,NA
86018,az,-111.9643,35.27143,913,0,0,0,NA
86020,az,-111.50377,35.99217,142,4,12,8,200
86021,az,-113.01697,36.97177,1249,1,3,2,200
86022,az,-112.57614,36.84138,1822,1,4,3,300
86023,az,-112.07705,36.0572,105,0,0,0,NA
86024,az,-111.34043,34.66154,3343,0,0,0,NA
86025,az,-110.09967,34.93772,8384,1,4,3,300
86028,az,-109.74045,34.96758,2170,1,4,3,300
86029,az,-109.99541,35.0033,9663,2,4,2,100
86032,az,-110.32496,35.04268,2672,2,4,2,100
86035,az,-110.96229,35.44607,5,0,1,1,NA
86036,az,-111.82286,36.73699,255,6,15,9,150
86038,az,-111.43068,34.94198,440,0,0,0,NA
86040,az,-111.41908,36.69623,3792,4,10,6,150
86044,az,-110.84112,36.70926,1,0,1,1,NA
86045,az,-111.12132,36.05919,23,2,6,4,200
86046,az,-112.1549,35.43005,17641,0,0,0,NA
86047,az,-110.65319,35.15124,7221,1,4,3,300
86052,az,-112.11897,36.34731,14,2,6,4,200
86301,az,-112.42643,34.59169,14512,0,1,1,NA
86303,az,-112.44798,34.48255,14726,0,0,0,NA
86305,az,-112.95841,34.81851,14102,0,1,1,NA
86313,az,-112.45242,34.5536,2,0,0,0,NA
86314,az,-112.30597,34.62603,18575,1,2,1,100
86315,az,-112.27009,34.70345,5761,1,2,1,100
86320,az,-112.63609,35.35374,8408,1,2,1,100
86321,az,-113.10313,34.49283,337,12,23,11,91.7
86322,az,-111.79598,34.49818,7616,28,47,19,67.9
86323,az,-112.40788,34.77473,10715,1,4,3,300
86324,az,-112.12483,34.85459,3222,16,31,15,93.8
86325,az,-111.89794,34.73458,3829,17,33,16,94.1
86326,az,-112.02365,34.70003,11969,19,36,17,89.5
86327,az,-112.10493,34.57127,7313,1,4,3,300
86329,az,-112.22503,34.47161,1302,1,4,3,300
86331,az,-112.14386,34.72685,717,1,2,1,100
86332,az,-112.63315,34.32055,2482,2,6,4,200
86333,az,-112.08158,34.32832,6742,7,17,10,142.9
86334,az,-112.5453,34.95115,5775,2,7,5,250
86335,az,-111.68296,34.69417,5499,11,23,12,109.1
86336,az,-111.87411,34.89399,10705,3,9,6,200
86337,az,-113.02147,35.35561,10220,1,2,1,100
86338,az,-112.75389,34.58181,741,2,7,5,250
86343,az,-112.29584,34.19333,640,1,2,1,100
86351,az,-111.78504,34.77853,5355,3,9,6,200
86401,az,-113.70331,35.13281,32119,6,15,9,150
86403,az,-114.34833,34.48143,12594,98,112,14,14.3
86404,az,-114.30646,34.61886,15046,91,106,15,16.5
86406,az,-114.12499,34.42284,16159,90,105,15,16.7
86409,az,-114.02851,35.46102,28028,11,23,12,109.1
86411,az,-113.64072,35.42687,5139,10,20,10,100
86413,az,-114.33195,35.20489,26889,23,40,17,73.9
86426,az,-114.56874,35.00524,10346,101,114,13,12.9
86429,az,-114.48868,35.1626,5991,75,91,16,21.3
86431,az,-114.21984,35.4156,3234,3,9,6,200
86432,az,-113.58933,36.46119,4403,39,55,16,41
86433,az,-114.34882,34.91759,447,13,23,10,76.9
86434,az,-113.61062,35.69309,867,1,3,2,200
86435,az,-112.90198,36.05403,57,0,1,1,NA
86436,az,-114.3862,34.75697,5665,93,107,14,15.1
86437,az,-113.61409,35.37885,204,2,6,4,200
86438,az,-113.84302,34.57119,14347,36,55,19,52.8
86440,az,-114.53227,34.88759,7746,107,119,12,11.2
86441,az,-114.37774,35.56922,22073,9,19,10,111.1
86442,az,-114.5671,35.08681,22970,100,113,13,13
86443,az,-114.45733,35.9835,1218,9,19,10,111.1
86444,az,-114.04871,35.90036,17292,14,25,11,78.6
86445,az,-114.50015,35.776,3286,9,19,10,111.1
86502,az,-109.5817,35.22201,2463,1,2,1,100
86505,az,-109.71435,35.62444,2,0,1,1,NA
86506,az,-109.22934,35.35244,30,0,1,1,NA
86508,az,-109.08954,35.32968,53,0,1,1,NA
86511,az,-109.24555,35.6475,376,0,0,0,NA
86512,az,-109.26939,35.09848,5551,1,1,0,0
86515,az,-108.94852,35.68281,121,0,0,0,NA
87001,nm,-106.35167,35.38884,1004,1,2,1,100
87002,nm,-106.65986,34.60273,92570,2,6,4,200
87004,nm,-106.58333,35.35823,5254,1,2,1,100
87005,nm,-107.97683,35.2642,937,0,1,1,NA
87006,nm,-106.84308,34.49197,2068,5,14,9,180
87007,nm,-107.50278,35.03789,16,0,1,1,NA
87008,nm,-106.39181,35.14568,1730,0,0,0,NA
87010,nm,-106.12892,35.39866,1479,0,0,0,NA
87011,nm,-105.94955,34.06462,720,0,1,1,NA
87012,nm,-106.66922,36.1018,518,0,0,0,NA
87013,nm,-107.39221,35.90922,2977,0,0,0,NA
87014,nm,-107.38678,35.2192,1277,0,1,1,NA
87015,nm,-106.18007,35.07416,10577,0,0,0,NA
87016,nm,-105.92203,34.77803,5408,0,1,1,NA
87017,nm,-106.76867,36.32025,404,0,0,0,NA
87018,nm,-107.51125,36.13054,51,0,0,0,NA
87020,nm,-107.93993,34.93005,8605,0,1,1,NA
87021,nm,-107.88385,35.19141,1624,0,1,1,NA
87022,nm,-106.7055,34.89773,7,1,4,3,300
87023,nm,-106.76055,34.59837,426,3,9,6,200
87024,nm,-106.73001,35.68403,527,0,1,1,NA
87025,nm,-106.63482,35.83955,2536,0,0,0,NA
87026,nm,-107.23245,34.96248,2773,1,2,1,100
87027,nm,-106.94787,36.12627,640,0,0,0,NA
87028,nm,-106.77278,34.3621,421,5,16,11,220
87029,nm,-106.99752,36.39638,519,0,0,0,NA
87031,nm,-106.88838,34.73167,97759,1,3,2,200
87032,nm,-106.01145,34.85127,680,0,1,1,NA
87034,nm,-107.56151,34.78191,267,0,1,1,NA
87035,nm,-105.98057,34.96,13129,0,0,0,NA
87036,nm,-106.25929,34.37813,3106,0,1,1,NA
87037,nm,-107.76633,36.15984,38,0,0,0,NA
87038,nm,-107.43519,35.08946,2,0,0,0,NA
87040,nm,-107.39163,35.12355,5,0,1,1,NA
87041,nm,-106.32983,35.68785,658,1,2,1,100
87042,nm,-106.68651,34.82801,1762,1,4,3,300
87043,nm,-106.46608,35.28806,4657,0,1,1,NA
87044,nm,-106.64427,35.66549,288,0,0,0,NA
87045,nm,-108.02155,35.39239,617,0,0,0,NA
87046,nm,-106.91617,36.2469,1576,0,0,0,NA
87047,nm,-106.28952,35.24326,5145,0,0,0,NA
87048,nm,-106.62008,35.23602,5126,1,3,2,200
87049,nm,-107.59337,35.12404,253,0,1,1,NA
87051,nm,-107.83426,35.04867,1063,0,1,1,NA
87052,nm,-106.30686,35.50469,45,1,2,1,100
87053,nm,-107.03358,35.65122,1386,1,1,0,0
87056,nm,-105.88651,35.18882,1578,0,0,0,NA
87059,nm,-106.29712,34.99395,9092,0,0,0,NA
87061,nm,-106.37987,34.73119,1346,0,0,0,NA
87062,nm,-106.65886,34.44002,16334,2,8,6,300
87063,nm,-105.85747,34.50108,642,0,1,1,NA
87064,nm,-106.57688,36.18618,614,0,0,0,NA
87068,nm,-106.5731,34.86117,1996,1,4,3,300
87070,nm,-105.77801,35.02185,302,0,0,0,NA
87072,nm,-106.38807,35.61193,39,1,2,1,100
87083,nm,-106.34276,35.64847,664,1,2,1,100
87102,nm,-106.64666,35.081,8239,1,3,2,200
87104,nm,-106.67539,35.10336,5539,1,4,3,300
87105,nm,-106.63097,34.96925,20974,1,3,2,200
87106,nm,-106.62161,35.05819,8298,1,2,1,100
87107,nm,-106.64305,35.1374,13307,1,4,3,300
87108,nm,-106.57837,35.07248,10480,1,2,1,100
87109,nm,-106.57545,35.15295,11959,1,2,1,100
87110,nm,-106.5781,35.10806,15010,1,2,1,100
87111,nm,-106.48623,35.14382,19568,0,1,1,NA
87112,nm,-106.51628,35.10105,15620,0,1,1,NA
87113,nm,-106.59236,35.18355,6339,1,2,1,100
87114,nm,-106.68406,35.19711,23466,1,4,3,300
87116,nm,-106.57168,35.05193,21,1,2,1,100
87117,nm,-106.55006,35.02018,41,1,1,0,0
87120,nm,-106.73711,35.13509,26635,2,6,4,200
87121,nm,-106.878,35.05848,26540,1,3,2,200
87122,nm,-106.49888,35.19067,8192,0,1,1,NA
87123,nm,-106.46793,35.07106,14803,0,1,1,NA
87124,nm,-106.78291,35.26775,50393,1,2,1,100
87144,nm,-106.70972,35.32392,66739,1,2,1,100
87301,nm,-108.83468,35.4748,7308,0,0,0,NA
87305,nm,-108.80096,35.38386,536,0,0,0,NA
87311,nm,-108.51291,35.61009,69,0,0,0,NA
87312,nm,-108.32303,35.42262,151,0,0,0,NA
87313,nm,-108.07866,35.8141,119,0,0,0,NA
87315,nm,-108.683,34.74302,912,0,0,0,NA
87316,nm,-108.45322,35.43961,78,0,0,0,NA
87317,nm,-108.76102,35.58756,739,0,0,0,NA
87319,nm,-108.95053,35.4723,130,0,0,0,NA
87321,nm,-108.37078,35.00131,5097,0,0,0,NA
87322,nm,-108.65311,35.52608,60,0,0,0,NA
87323,nm,-108.1991,35.45501,1694,0,0,0,NA
87326,nm,-108.83129,35.26586,255,0,0,0,NA
87327,nm,-108.78817,34.98039,183,0,0,0,NA
87347,nm,-108.44645,35.42725,262,0,0,0,NA
87357,nm,-108.35875,34.94698,934,0,0,0,NA
87375,nm,-108.75617,35.67201,134,0,0,0,NA
87401,nm,-108.17994,36.74127,17280,0,1,1,NA
87402,nm,-108.14403,36.78062,5145,0,1,1,NA
87410,nm,-107.87986,36.86688,8329,0,0,0,NA
87412,nm,-107.47846,36.69883,810,0,0,0,NA
87413,nm,-107.97672,36.41521,5864,0,1,1,NA
87415,nm,-108.09743,36.81834,883,0,1,1,NA
87416,nm,-108.42124,36.69316,512,0,1,1,NA
87417,nm,-108.34504,36.74407,2267,0,1,1,NA
87418,nm,-108.15533,36.95218,779,0,0,0,NA
87419,nm,-107.50234,36.88505,1178,0,0,0,NA
87420,nm,-108.84931,36.69063,1,0,2,2,NA
87421,nm,-108.51857,36.7637,412,0,2,2,NA
87499,nm,-108.21085,36.34902,15,0,0,0,NA
87501,nm,-105.84144,35.74236,10750,0,0,0,NA
87505,nm,-105.86873,35.62192,15597,0,0,0,NA
87506,nm,-105.9886,35.81949,7953,0,0,0,NA
87507,nm,-106.10779,35.59347,17375,0,0,0,NA
87508,nm,-105.96877,35.52744,9879,0,0,0,NA
87510,nm,-106.41424,36.29327,1368,0,0,0,NA
87511,nm,-105.92577,36.10228,1206,0,0,0,NA
87512,nm,-105.37436,36.90885,711,0,0,0,NA
87513,nm,-105.68734,36.57962,920,0,0,0,NA
87514,nm,-105.52519,36.54123,1227,0,0,0,NA
87515,nm,-106.37719,36.50231,502,0,0,0,NA
87516,nm,-106.46573,36.16237,163,0,0,0,NA
87517,nm,-105.78757,36.39488,7526,0,0,0,NA
87518,nm,-106.56265,36.5073,257,0,0,0,NA
87519,nm,-105.62793,36.76991,714,0,0,0,NA
87520,nm,-106.62693,36.88269,3051,0,0,0,NA
87521,nm,-105.69798,36.07624,1154,0,0,0,NA
87522,nm,-105.83647,35.93801,2178,0,0,0,NA
87523,nm,-105.84276,36.01365,271,0,0,0,NA
87524,nm,-105.67226,36.93244,438,0,0,0,NA
87525,nm,-105.46138,36.58687,356,0,0,0,NA
87527,nm,-105.86271,36.16449,662,0,0,0,NA
87528,nm,-106.98169,36.6689,312,0,0,0,NA
87529,nm,-105.62279,36.4701,2963,0,0,0,NA
87530,nm,-106.19132,36.34927,1216,0,0,0,NA
87531,nm,-105.85097,36.24748,385,0,0,0,NA
87532,nm,-106.0899,35.99328,7077,0,0,0,NA
87533,nm,-106.06566,36.0238,4,0,1,1,NA
87535,nm,-105.74775,35.52872,1052,0,0,0,NA
87537,nm,-106.18533,36.04962,1189,0,0,0,NA
87538,nm,-105.57127,35.49453,770,0,0,0,NA
87539,nm,-106.03923,36.38172,265,0,0,0,NA
87540,nm,-105.90365,35.44515,936,0,0,0,NA
87543,nm,-105.66122,36.10704,530,0,0,0,NA
87544,nm,-106.29079,35.84232,8437,0,0,0,NA
87548,nm,-106.15595,36.18299,1008,0,0,0,NA
87549,nm,-106.01217,36.24139,1472,0,0,0,NA
87551,nm,-106.66862,36.69435,1045,0,0,0,NA
87552,nm,-105.60164,35.64618,2787,0,0,0,NA
87553,nm,-105.70694,36.20598,901,0,0,0,NA
87554,nm,-106.02537,36.48757,115,0,0,0,NA
87556,nm,-105.53862,36.76309,2928,0,0,0,NA
87557,nm,-105.68353,36.28666,4806,0,0,0,NA
87558,nm,-105.39021,36.68694,2015,0,0,0,NA
87560,nm,-105.50234,35.22433,2230,0,0,0,NA
87562,nm,-105.68454,35.4169,510,0,0,0,NA
87564,nm,-105.62791,36.60798,341,0,0,0,NA
87565,nm,-105.49288,35.456,525,0,0,0,NA
87566,nm,-106.07006,36.07119,804,0,0,0,NA
87567,nm,-106.02018,35.9939,771,0,0,0,NA
87569,nm,-105.30061,35.34637,592,0,0,0,NA
87571,nm,-105.53626,36.39917,8022,0,0,0,NA
87573,nm,-105.67127,35.77289,618,0,0,0,NA
87574,nm,-105.88859,35.81669,88,0,0,0,NA
87575,nm,-106.38488,36.74611,4345,0,0,0,NA
87577,nm,-105.98127,36.6725,22844,0,0,0,NA
87578,nm,-105.76537,36.03906,881,0,0,0,NA
87579,nm,-105.55657,36.12477,1330,0,0,0,NA
87580,nm,-105.56577,36.57007,500,0,0,0,NA
87581,nm,-106.14479,36.52861,366,0,0,0,NA
87582,nm,-106.01297,36.15506,966,0,0,0,NA
87583,nm,-105.33627,35.23134,435,0,0,0,NA
87701,nm,-104.92707,35.53865,11195,0,0,0,NA
87710,nm,-105.24387,36.38476,9149,0,0,0,NA
87711,nm,-105.1045,35.22449,194,0,1,1,NA
87714,nm,-105.03182,36.51458,727,0,0,0,NA
87718,nm,-105.29664,36.59003,3654,0,0,0,NA
87724,nm,-105.07815,35.17355,2,0,1,1,NA
87728,nm,-104.61985,36.59612,1255,0,0,0,NA
87729,nm,-104.8006,36.33247,741,0,0,0,NA
87730,nm,-104.21113,36.14839,434,0,0,0,NA
87731,nm,-105.41386,35.73195,521,0,0,0,NA
87733,nm,-103.82485,35.80997,1176,0,2,2,NA
87734,nm,-105.0779,36.1693,45,0,0,0,NA
87740,nm,-104.41052,36.75536,4827,0,0,0,NA
87742,nm,-105.5185,35.8884,1606,0,0,0,NA
87743,nm,-104.08692,35.98142,1722,0,0,0,NA
87745,nm,-105.24437,35.7816,840,0,0,0,NA
87746,nm,-104.23614,35.64111,731,1,3,2,200
87747,nm,-104.46309,36.36662,3756,0,0,0,NA
87749,nm,-105.08385,36.54831,216,0,0,0,NA
87752,nm,-104.64811,36.01906,2,0,0,0,NA
87801,nm,-106.84602,34.13038,4894,2,7,5,250
87821,nm,-108.05941,33.97959,2,0,1,1,NA
87823,nm,-106.9488,34.19272,861,2,7,5,250
87825,nm,-107.63261,33.87564,1347,0,1,1,NA
87828,nm,-106.91672,34.20586,252,2,8,6,300
87829,nm,-108.65873,34.32594,276,0,0,0,NA
87831,nm,-106.93318,34.26511,312,3,9,6,200
87832,nm,-106.82839,33.81886,833,4,15,11,275
87901,nm,-107.14353,33.19998,7468,2,11,9,450
87930,nm,-107.43341,32.83387,743,7,21,14,200
87931,nm,-107.41023,32.9641,693,6,20,14,233.3
87933,nm,-107.27793,32.79021,62,6,21,15,250
87935,nm,-107.22751,33.25399,4352,3,14,11,366.7
87936,nm,-107.26367,32.7532,421,6,20,14,233.3
87937,nm,-107.19128,32.5998,1801,4,17,13,325
87939,nm,-107.48855,33.41268,251,0,3,3,NA
87940,nm,-106.99733,32.61066,626,5,19,14,280
87941,nm,-107.22014,32.71095,451,5,20,15,300
87942,nm,-107.43511,33.09826,773,5,17,12,240
87943,nm,-107.73214,33.39162,616,0,1,1,NA
88001,nm,-106.75392,32.29009,10421,6,23,17,283.3
88002,nm,-106.4801,32.46282,359,4,16,12,300
88003,nm,-106.74594,32.28065,1,6,22,16,266.7
88004,nm,-106.98743,32.2231,58,5,20,15,300
88005,nm,-106.82183,32.25812,10383,7,25,18,257.1
88007,nm,-107.02658,32.31083,11222,7,24,17,242.9
88008,nm,-106.68175,31.8393,3428,12,33,21,175
88009,nm,-108.59648,32.00995,166,3,12,9,300
88011,nm,-106.6437,32.31585,13042,4,17,13,325
88012,nm,-106.77144,32.58349,14023,4,16,12,300
88020,nm,-108.82833,31.77066,1945,3,10,7,233.3
88021,nm,-107.01793,31.95491,7144,10,31,21,210
88022,nm,-108.18002,32.79987,645,0,2,2,NA
88023,nm,-108.13238,32.75128,1720,0,1,1,NA
88024,nm,-106.63941,32.07056,76,11,33,22,200
88025,nm,-108.75149,33.04514,696,1,3,2,200
88026,nm,-108.15743,32.75965,1348,0,2,2,NA
88027,nm,-106.78959,32.04413,317,11,32,21,190.9
88028,nm,-108.63591,32.9329,773,1,6,5,500
88029,nm,-107.69122,31.84591,8033,10,29,19,190
88030,nm,-107.72938,32.18771,107470,7,23,16,228.6
88032,nm,-106.81644,32.39599,69,7,25,18,257.1
88033,nm,-107.02885,32.31962,117,4,18,14,350
88034,nm,-107.93924,32.60966,282,1,5,4,400
88038,nm,-108.42652,33.07211,1160,1,3,2,200
88040,nm,-108.43769,31.61678,1639,3,11,8,266.7
88041,nm,-107.91403,32.79073,3314,0,2,2,NA
88042,nm,-107.58905,32.80695,838,1,5,4,400
88043,nm,-108.11155,32.62093,1180,0,3,3,NA
88044,nm,-106.79985,32.13827,2046,10,32,22,220
88045,nm,-108.77287,32.37965,3585,9,22,13,144.4
88046,nm,-106.80227,32.25002,429,8,27,19,237.5
88047,nm,-106.7147,32.21007,772,8,27,19,237.5
88048,nm,-106.65916,32.16356,1214,9,30,21,233.3
88049,nm,-107.96275,33.05048,867,0,1,1,NA
88051,nm,-108.94874,33.01623,1132,0,2,2,NA
88052,nm,-106.59942,32.42536,230,1,6,5,500
88053,nm,-108.20592,32.9025,184,0,1,1,NA
88055,nm,-108.73387,32.73817,975,1,6,5,500
88056,nm,-108.98267,31.84429,757,4,12,8,200
88061,nm,-108.33016,32.64982,17949,0,2,2,NA
88063,nm,-106.59929,31.81821,3895,10,30,20,190.9
88065,nm,-108.32027,32.68488,364,0,2,2,NA
88072,nm,-106.61289,32.1405,825,9,30,21,233.3
88081,nm,-106.26306,32.22397,7254,9,29,20,222.2
88101,nm,-103.28375,34.49873,20330,1,6,5,500
88103,nm,-103.31538,34.38413,6,1,5,4,400
88112,nm,-103.17116,34.86448,482,1,4,3,300
88113,nm,-103.08655,33.77802,322,2,8,6,300
88114,nm,-103.28901,33.51846,376,2,7,5,250
88115,nm,-103.34251,33.92317,59,1,6,5,500
88116,nm,-103.87992,33.91828,2317,2,7,5,250
88118,nm,-103.67164,34.21924,441,2,7,5,250
88119,nm,-104.40797,34.32304,2541,2,7,5,250
88120,nm,-103.4542,34.87867,424,1,4,3,300
88124,nm,-103.65357,34.54612,2405,1,6,5,500
88125,nm,-103.28024,33.6852,609,2,7,5,250
88126,nm,-103.3769,33.83091,122,1,6,5,500
88130,nm,-103.31057,34.13555,9618,2,8,6,300
88132,nm,-103.19464,33.92427,576,2,7,5,250
88134,nm,-104.01581,34.327,301,1,6,5,500
88135,nm,-103.09337,34.58656,1252,2,7,5,250
88136,nm,-104.7452,34.45505,230,1,3,2,200
88201,nm,-104.37485,33.63973,14006,6,17,11,183.3
88203,nm,-104.34431,33.1861,15395,5,14,9,180
88210,nm,-104.21959,32.77174,19020,10,25,15,150
88220,nm,-104.4134,32.29627,24587,13,29,16,130.75
88230,nm,-104.39876,33.21777,2976,6,18,12,200
88231,nm,-103.25504,32.44906,3005,10,25,15,150
88232,nm,-104.45937,33.07945,1790,9,23,14,155.6
88240,nm,-103.47152,32.7078,17279,7,19,12,171.4
88242,nm,-103.15868,32.81047,3522,7,18,11,157.1
88250,nm,-104.91837,32.72829,1490,2,9,7,350
88252,nm,-103.38997,32.16929,3421,16,35,19,118.8
88253,nm,-104.45498,32.98606,1196,10,26,16,160
88254,nm,-104.44894,32.60869,1646,14,32,18,128.6
88255,nm,-103.99645,32.8142,209,11,25,14,127.3
88256,nm,-103.89275,32.19582,2569,25,46,21,84
88260,nm,-103.39911,32.99148,8338,4,12,8,200
88262,nm,-103.42594,33.13287,149,3,9,6,200
88263,nm,-104.07826,32.09406,2374,29,51,22,75.9
88264,nm,-103.70225,32.89767,308,8,20,12,150
88265,nm,-103.30287,32.62044,572,6,17,11,183.3
88267,nm,-103.42178,33.33187,3017,2,8,6,300
88268,nm,-104.37945,32.17628,1,11,27,16,145.5
88301,nm,-105.7857,33.79259,5013,0,2,2,NA
88310,nm,-106.00575,32.7008,19119,2,10,8,400
88311,nm,-105.98851,32.8074,552,7,22,15,214.3
88312,nm,-105.67742,33.43147,6539,0,0,0,NA
88314,nm,-105.86724,33.10075,290,0,1,1,NA
88316,nm,-105.31886,33.79598,4727,0,1,1,NA
88317,nm,-105.63906,32.91588,6577,0,0,0,NA
88318,nm,-105.38549,34.20837,2416,0,1,1,NA
88321,nm,-105.44882,34.76221,581,0,0,0,NA
88323,nm,-105.52756,33.4947,1,0,0,0,NA
88324,nm,-105.43908,33.38978,321,0,1,1,NA
88325,nm,-105.8626,32.85128,1071,0,0,0,NA
88330,nm,-106.07747,32.83652,2,7,22,15,214.3
88336,nm,-105.29486,33.31788,550,0,1,1,NA
88337,nm,-105.89145,32.99132,1683,1,4,3,300
88338,nm,-105.38178,33.4869,470,0,1,1,NA
88339,nm,-105.25429,32.93508,1338,0,0,0,NA
88340,nm,-105.61191,33.17843,26,0,0,0,NA
88341,nm,-105.78796,33.49515,1072,0,0,0,NA
88342,nm,-106.10152,32.38795,550,11,31,20,181.8
88343,nm,-105.07694,33.22587,582,0,2,2,NA
88344,nm,-105.31132,32.56989,361,0,2,2,NA
88345,nm,-105.67982,33.34797,13531,0,0,0,NA
88346,nm,-105.54005,33.35384,1717,0,0,0,NA
88347,nm,-105.6571,32.76768,424,0,0,0,NA
88348,nm,-105.35839,33.39617,267,0,1,1,NA
88349,nm,-105.78609,32.76438,5,0,0,0,NA
88350,nm,-105.67737,32.64305,7691,0,1,1,NA
88351,nm,-105.08763,33.54955,1723,0,2,2,NA
88352,nm,-106.10169,33.03766,4164,3,11,8,266.7
88353,nm,-105.11608,34.57142,192,0,1,1,NA
88354,nm,-105.51457,32.74363,263,0,0,0,NA
88355,nm,-105.66838,33.36355,29,0,0,0,NA
88401,nm,-103.8317,35.11261,36,3,10,7,233.3
88410,nm,-103.29184,35.87395,1806,1,4,3,300
88414,nm,-103.99846,36.77855,112,0,0,0,NA
88415,nm,-103.32575,36.31374,6326,0,1,1,NA
88416,nm,-104.20724,35.31353,1534,4,12,8,200
88417,nm,-104.39125,35.05146,10,1,4,3,300
88418,nm,-103.68344,36.72513,2496,0,0,0,NA
88419,nm,-103.53905,36.88274,3674,0,1,1,NA
88421,nm,-104.48126,35.29835,2727,1,6,5,500
88422,nm,-103.99941,36.3469,672,0,0,0,NA
88424,nm,-103.66099,36.40933,2973,0,0,0,NA
88426,nm,-103.51088,35.53806,1028,2,8,6,300
88430,tx,-103.18119,35.59029,19,2,8,6,300
88431,nm,-104.27803,35.17597,833,2,8,6,300
88435,nm,-104.69768,34.913,427,1,3,2,200
88436,nm,-103.12167,36.1315,515,0,3,3,NA
89001,nv,-115.39072,37.27407,1294,8,17,9,112.5
89002,nv,-114.96171,35.99858,14493,32,52,20,62.5
89003,nv,-116.72625,36.95748,866,5,13,8,160
89004,nv,-115.47072,36.08542,305,9,20,11,122.2
89005,nv,-114.82472,35.98683,7483,45,65,20,44.4
89007,nv,-114.18812,36.63479,1716,46,64,18,39.1
89008,nv,-114.54654,37.27622,1296,3,6,3,100
89010,ca,-118.08401,37.77763,1223,0,2,2,NA
89011,nv,-114.96852,36.08277,16063,55,74,19,34.5
89012,nv,-115.04395,36.01194,14700,28,46,18,64.3
89013,nv,-117.40308,37.3978,1600,0,0,0,NA
89014,nv,-115.05806,36.06172,11401,50,70,20,40
89015,nv,-114.92815,36.03921,15508,43,64,21,48.8
89017,nv,-115.24783,37.73093,165,3,8,5,166.7
89018,nv,-115.6686,36.54162,777,21,39,18,85.7
89019,ca,-115.73444,35.7662,3867,24,40,16,70.15
89020,nv,-116.43481,36.53662,2072,36,57,21,58.3
89021,nv,-114.46702,36.63095,2080,64,82,18,28.1
89022,nv,-117.02061,38.54102,605,0,0,0,NA
89025,nv,-114.91068,36.61513,2208,44,63,19,43.2
89026,nv,-115.28972,35.75525,74,14,28,14,100
89027,nv,-114.12351,36.81126,12424,63,81,18,28.6
89029,nv,-114.68609,35.12567,3273,104,116,12,11.5
89030,nv,-115.12413,36.21152,14247,57,77,20,35.1
89031,nv,-115.1718,36.25892,25217,48,68,20,41.7
89032,nv,-115.17272,36.22318,15779,47,68,21,44.7
89039,nv,-114.87985,35.28799,420,24,42,18,75
89040,nv,-114.53864,36.35794,4292,66,83,17,25.8
89042,nv,-114.32224,37.74397,702,0,2,2,NA
89043,nv,-114.4722,38.25745,1827,0,1,1,NA
89044,nv,-115.17891,35.90241,14704,14,27,13,92.9
89045,nv,-116.95219,38.87855,2281,0,0,0,NA
89046,nv,-114.88656,35.51318,2701,23,37,14,60.9
89047,nv,-117.64787,37.76595,105,4,13,9,225
89048,nv,-116.00381,36.16609,24196,19,36,17,89.5
89049,nv,-116.26148,38.36443,2362,0,0,0,NA
89052,nv,-115.05675,35.95511,23944,23,40,17,73.9
89054,nv,-115.20827,35.92721,149,17,33,16,94.1
89060,ca,-116.06344,36.39429,20533,20,38,18,88.35
89061,ca,-115.89649,36.08748,7051,18,36,17,92.85
89074,nv,-115.08091,36.03658,18338,44,65,21,47.7
89081,nv,-115.10676,36.25831,12997,56,75,19,33.9
89084,nv,-115.17411,36.29691,13685,44,65,21,47.7
89085,nv,-115.1982,36.30963,1476,41,62,21,51.2
89086,nv,-115.1085,36.29228,1937,48,68,20,41.7
89101,nv,-115.12223,36.17255,8387,54,74,20,37
89102,nv,-115.18682,36.14543,7664,42,63,21,50
89103,nv,-115.21167,36.11184,8630,37,57,20,54.1
89104,nv,-115.10865,36.15138,10912,55,75,20,36.4
89106,nv,-115.16323,36.18171,8426,46,66,20,43.5
89107,nv,-115.21023,36.17065,10893,39,60,21,53.8
89108,nv,-115.22364,36.20526,18814,39,59,20,51.3
89109,nv,-115.16374,36.12533,2038,47,67,20,42.6
89110,nv,-115.04774,36.17143,18163,55,75,20,36.4
89113,nv,-115.26351,36.06116,13397,29,48,19,65.5
89115,nv,-115.04103,36.25366,13511,58,78,20,34.5
89117,nv,-115.28001,36.14259,17316,29,49,20,69
89118,nv,-115.21399,36.0774,9297,34,54,20,58.8
89119,nv,-115.14612,36.08471,8163,45,66,21,46.7
89120,nv,-115.09545,36.08132,8823,53,73,20,37.7
89121,nv,-115.09128,36.12153,17523,57,77,20,35.1
89122,nv,-115.0403,36.10642,15333,62,82,20,32.3
89123,nv,-115.14878,36.0352,19051,38,58,20,52.6
89124,nv,-115.48087,36.42572,4456,8,15,7,87.5
89128,nv,-115.26436,36.19682,11518,32,53,21,65.6
89129,nv,-115.29016,36.23331,19934,30,50,20,66.7
89130,nv,-115.22711,36.25399,13811,40,61,21,52.5
89131,nv,-115.24266,36.30616,19878,37,58,21,56.8
89134,nv,-115.30775,36.20274,13996,26,45,19,73.1
89135,nv,-115.37591,36.10098,15453,22,40,18,81.8
89138,nv,-115.36136,36.16684,9221,15,30,15,100
89139,nv,-115.21165,36.03467,17456,32,52,20,62.5
89141,nv,-115.20706,35.98841,15715,31,50,19,61.3
89142,nv,-115.03638,36.14795,9155,57,77,20,35.1
89143,nv,-115.29316,36.32231,4912,32,53,21,65.6
89144,nv,-115.32075,36.17889,7479,21,38,17,81
89145,nv,-115.27786,36.16769,8685,31,50,19,61.3
89146,nv,-115.22691,36.14325,5996,38,59,21,55.3
89147,nv,-115.28011,36.11279,16585,30,50,20,66.7
89148,nv,-115.31038,36.05878,20641,25,44,19,76
89149,nv,-115.29254,36.27226,17136,32,53,21,65.6
89156,nv,-114.98819,36.16343,9056,43,64,21,48.8
89161,nv,-115.36388,36.00036,316,16,32,16,100
89166,nv,-115.50693,36.38067,10946,24,43,19,79.2
89169,nv,-115.1413,36.12414,3282,50,70,20,40
89178,nv,-115.28606,35.99765,18489,25,43,18,72
89179,nv,-115.33187,35.89458,3541,27,46,19,70.4
89183,nv,-115.15761,35.99585,12799,32,51,19,59.4
89191,nv,-115.02565,36.23962,104,42,62,20,47.6
89301,nv,-114.77306,39.54458,5357,0,0,0,NA
89310,nv,-117.16464,39.41361,2406,0,0,0,NA
89311,nv,-114.19446,38.98719,360,0,1,1,NA
89314,nv,-115.76709,38.85482,96,0,1,1,NA
89316,nv,-116.17729,39.63068,1459,0,0,0,NA
89317,nv,-115.09908,38.65822,778,0,0,0,NA
89318,nv,-114.80356,39.43859,755,0,0,0,NA
89319,nv,-114.976,39.29629,352,0,0,0,NA
89402,nv,-120.00288,39.22531,73,0,0,0,NA
89403,nv,-119.47036,39.19839,7716,0,1,1,NA
89404,nv,-118.70583,41.88686,151,0,1,1,NA
89405,nv,-119.42455,40.48069,132,0,2,2,NA
89406,nv,-118.31664,39.52216,13478,1,3,2,200
89408,nv,-119.17176,39.56424,9844,1,4,3,300
89409,nv,-118.10326,38.78473,367,0,1,1,NA
89410,nv,-119.61146,38.87034,5832,0,0,0,NA
89411,nv,-119.85021,39.01901,1054,0,0,0,NA
89412,nv,-119.69958,41.10784,2013,0,1,1,NA
89413,nv,-119.92096,39.07386,1051,0,0,0,NA
89414,nv,-117.17821,41.04621,3097,0,2,2,NA
89415,nv,-118.64155,38.48548,3044,1,4,3,300
89418,nv,-118.03439,40.54843,2476,1,3,2,200
89419,nv,-118.17875,40.27164,7683,1,3,2,200
89420,nv,-118.2267,38.54456,166,1,6,5,500
89421,nv,-117.90089,42.05134,586,0,1,1,NA
89422,nv,-118.41483,38.17365,536,1,4,3,300
89423,nv,-119.74877,39.01762,5910,0,1,1,NA
89424,nv,-119.32376,39.8513,352,0,1,1,NA
89425,nv,-117.90826,41.66539,780,0,1,1,NA
89426,nv,-117.43102,41.48813,697,0,1,1,NA
89427,nv,-118.70038,38.92057,91,1,3,2,200
89428,nv,-119.63472,39.26109,238,0,1,1,NA
89429,nv,-119.30532,39.36401,7850,1,4,3,300
89430,nv,-119.30508,38.77511,516,0,0,0,NA
89431,nv,-119.74947,39.54043,11042,0,2,2,NA
89433,nv,-119.77665,39.60895,7087,0,1,1,NA
89434,nv,-119.64036,39.53212,9222,0,1,1,NA
89436,nv,-119.68781,39.60436,19456,0,1,1,NA
89438,nv,-117.1078,40.77333,447,1,3,2,200
89439,ca,-120.00395,39.52955,1451,0,0,0,NA
89440,nv,-119.65863,39.29664,1327,0,0,0,NA
89441,nv,-119.67584,39.67637,5973,0,1,1,NA
89442,nv,-119.42118,39.65981,624,1,4,3,300
89444,nv,-119.37187,38.70693,2452,0,0,0,NA
89445,nv,-118.27423,41.16903,14378,0,1,1,NA
89446,nv,-117.87032,41.21701,4,0,2,2,NA
89447,nv,-119.13095,38.81237,5232,0,2,2,NA
89448,nv,-119.92409,39.00787,2007,0,0,0,NA
89449,nv,-119.90684,38.96432,2568,0,0,0,NA
89450,nv,-119.93906,39.24052,98,0,0,0,NA
89451,nv,-119.93407,39.24155,8828,0,0,0,NA
89460,nv,-119.79059,38.9012,6073,0,0,0,NA
89501,nv,-119.81305,39.52575,1332,0,2,2,NA
89502,nv,-119.74511,39.49206,11816,0,1,1,NA
89503,nv,-119.83987,39.5408,9460,0,2,2,NA
89506,nv,-119.82279,39.7014,15888,0,1,1,NA
89508,nv,-119.91948,39.79299,6083,0,0,0,NA
89509,nv,-119.82729,39.49661,12487,0,1,1,NA
89510,nv,-119.66309,40.05587,3130,0,1,1,NA
89511,nv,-119.89556,39.39512,12707,0,1,1,NA
89512,nv,-119.80073,39.5529,5533,0,2,2,NA
89519,nv,-119.85907,39.48137,4500,0,1,1,NA
89521,nv,-119.68594,39.38101,18102,0,1,1,NA
89523,nv,-119.91373,39.52401,12658,0,1,1,NA
89701,nv,-119.7184,39.13966,9538,0,0,0,NA
89702,nv,-119.73598,39.15923,7,0,0,0,NA
89703,nv,-119.81276,39.16394,4724,0,0,0,NA
89704,nv,-119.81739,39.26685,2562,0,0,0,NA
89705,nv,-119.86225,39.11059,2530,0,0,0,NA
89706,nv,-119.70608,39.21979,7117,0,0,0,NA
89801,nv,-115.75892,41.24909,18173,0,0,0,NA
89815,nv,-115.59561,40.61714,8323,0,0,0,NA
89820,nv,-116.97364,40.42656,5586,1,4,3,300
89821,nv,-116.46226,40.49243,2656,1,2,1,100
89822,nv,-116.1942,40.53131,1757,0,1,1,NA
89823,nv,-115.27447,41.00478,885,0,0,0,NA
89825,nv,-114.72324,41.88825,308,0,1,1,NA
89826,nv,-115.38129,41.88736,275,0,0,0,NA
89828,nv,-115.36308,40.75054,293,0,0,0,NA
89830,nv,-114.28814,41.27533,7684,0,1,1,NA
89831,nv,-116.11221,41.73256,177,0,0,0,NA
89832,id,-116.16575,41.98651,60,0,0,0,NA
89833,nv,-115.31692,40.47108,347,0,0,0,NA
89834,nv,-116.2641,41.37383,382,0,0,0,NA
89835,nv,-114.8545,41.11472,4044,0,0,0,NA
89883,nv,-114.24165,40.72562,2267,0,1,1,NA
90001,ca,-118.24951,33.97403,8937,0,1,1,NA
90002,ca,-118.24674,33.9491,8427,0,1,1,NA
90003,ca,-118.27372,33.96414,10611,0,0,0,NA
90004,ca,-118.31072,34.0762,6466,0,1,1,NA
90005,ca,-118.30689,34.05916,1793,0,1,1,NA
90006,ca,-118.29418,34.04804,4241,0,1,1,NA
90007,ca,-118.28483,34.02813,4116,0,1,1,NA
90008,ca,-118.34707,34.00961,6299,0,0,0,NA
90010,ca,-118.31589,34.06215,363,0,0,0,NA
90011,ca,-118.25867,34.00707,12451,0,1,1,NA
90012,ca,-118.23821,34.06601,1892,1,3,2,200
90013,ca,-118.24042,34.04488,773,1,3,2,200
90014,ca,-118.25175,34.04315,413,1,3,2,200
90015,ca,-118.2663,34.03938,2006,0,2,2,NA
90016,ca,-118.35456,34.02877,8488,0,0,0,NA
90017,ca,-118.26434,34.05291,759,0,2,2,NA
90018,ca,-118.31718,34.02889,7526,0,0,0,NA
90019,ca,-118.33874,34.04864,9991,0,0,0,NA
90020,ca,-118.30987,34.06638,1507,0,1,1,NA
90021,ca,-118.23877,34.02934,2111,1,2,1,100
90022,ca,-118.15605,34.02452,10514,1,4,3,300
90023,ca,-118.19984,34.02272,6338,1,3,2,200
90024,ca,-118.43503,34.06574,3747,0,0,0,NA
90025,ca,-118.44592,34.0455,4902,0,0,0,NA
90026,ca,-118.26298,34.07922,10699,1,2,1,100
90027,ca,-118.29057,34.12522,6761,0,2,2,NA
90028,ca,-118.32691,34.09991,2144,0,0,0,NA
90029,ca,-118.29466,34.08985,3239,0,1,1,NA
90031,ca,-118.21078,34.0803,6464,2,7,5,250
90032,ca,-118.17805,34.0796,10956,2,9,7,350
90033,ca,-118.21162,34.05102,4954,1,4,3,300
90034,ca,-118.39945,34.0307,7382,0,0,0,NA
90035,ca,-118.38358,34.05182,5581,0,0,0,NA
90036,ca,-118.34985,34.07014,4855,0,0,0,NA
90037,ca,-118.28749,34.00272,7697,0,0,0,NA
90038,ca,-118.32653,34.08875,3082,0,0,0,NA
90039,ca,-118.26006,34.11184,8252,1,5,4,400
90040,ca,-118.14908,33.99346,3688,1,3,2,200
90041,ca,-118.20764,34.13758,6942,3,10,7,233.3
90042,ca,-118.19195,34.11463,11629,2,9,7,350
90043,ca,-118.33524,33.98885,11869,0,0,0,NA
90044,ca,-118.2919,33.95273,14217,0,0,0,NA
90045,ca,-118.40017,33.95296,11049,0,0,0,NA
90046,ca,-118.36522,34.10742,10320,0,1,1,NA
90047,ca,-118.309,33.95448,13378,0,0,0,NA
90048,ca,-118.37271,34.07293,4888,0,0,0,NA
90049,ca,-118.48927,34.08719,8894,0,0,0,NA
90056,ca,-118.37036,33.98805,2467,0,0,0,NA
90057,ca,-118.2771,34.06216,1402,0,1,1,NA
90058,ca,-118.21387,34.00245,2495,0,1,1,NA
90059,ca,-118.24963,33.92631,7480,0,1,1,NA
90061,ca,-118.27407,33.92036,5252,0,0,0,NA
90062,ca,-118.30882,34.00363,6352,0,0,0,NA
90063,ca,-118.18591,34.04511,8774,1,5,4,400
90064,ca,-118.42493,34.03699,7511,0,0,0,NA
90065,ca,-118.22761,34.10892,12405,2,7,5,250
90066,ca,-118.43061,34.00123,12184,0,0,0,NA
90067,ca,-118.414,34.0576,42,0,0,0,NA
90068,ca,-118.32822,34.12835,8142,0,1,1,NA
90069,ca,-118.3817,34.09383,4300,0,0,0,NA
90071,ca,-118.25494,34.05288,23,1,3,2,200
90073,ca,-118.45703,34.05453,4,0,0,0,NA
90077,ca,-118.45613,34.10545,4785,0,0,0,NA
90079,ca,-118.2554,34.04059,1,1,3,2,200
90089,ca,-118.28028,34.02444,28,0,0,0,NA
90090,ca,-118.24092,34.07285,3,1,4,3,300
90094,ca,-118.417,33.97541,232,0,0,0,NA
90095,ca,-118.44337,34.07123,1,0,0,0,NA
90201,ca,-118.17092,33.97074,9900,0,2,2,NA
90210,ca,-118.41473,34.10106,8326,0,0,0,NA
90211,ca,-118.38298,34.06496,1781,0,0,0,NA
90212,ca,-118.40197,34.06221,2067,0,0,0,NA
90220,ca,-118.23607,33.88077,10367,0,0,0,NA
90221,ca,-118.20594,33.88617,9627,0,1,1,NA
90222,ca,-118.23651,33.91238,6488,0,1,1,NA
90230,ca,-118.3946,33.99724,6258,0,0,0,NA
90232,ca,-118.39175,34.01877,4212,0,0,0,NA
90240,ca,-118.1187,33.95681,6269,1,5,4,400
90241,ca,-118.12913,33.94084,8403,1,4,3,300
90242,ca,-118.14145,33.92211,7745,1,3,2,200
90245,ca,-118.40387,33.9165,4521,0,0,0,NA
90247,ca,-118.29737,33.89135,7724,0,0,0,NA
90248,ca,-118.28351,33.8766,3789,0,0,0,NA
90249,ca,-118.31705,33.90149,6535,0,0,0,NA
90250,ca,-118.34931,33.91432,14155,0,0,0,NA
90254,ca,-118.39928,33.86482,5639,0,0,0,NA
90255,ca,-118.21725,33.977,9681,0,1,1,NA
90260,ca,-118.3513,33.8883,5883,0,0,0,NA
90262,ca,-118.2005,33.9236,10339,0,1,1,NA
90263,ca,-118.70799,34.03903,19,0,0,0,NA
90265,ca,-118.84572,34.06947,10353,0,0,0,NA
90266,ca,-118.40062,33.88967,12359,0,0,0,NA
90270,ca,-118.18614,33.98806,3384,0,2,2,NA
90272,ca,-118.54223,34.07872,8055,0,0,0,NA
90274,ca,-118.37209,33.77773,9716,0,0,0,NA
90275,ca,-118.36705,33.75154,13512,0,0,0,NA
90277,ca,-118.38718,33.82964,7665,0,0,0,NA
90278,ca,-118.37037,33.87323,9095,0,0,0,NA
90280,ca,-118.19257,33.9446,16268,0,1,1,NA
90290,ca,-118.60708,34.09588,4965,1,2,1,100
90291,ca,-118.46504,33.99335,7857,0,0,0,NA
90292,ca,-118.44977,33.97681,1698,0,0,0,NA
90293,ca,-118.44059,33.94684,2313,0,0,0,NA
90301,ca,-118.35865,33.95653,4835,0,0,0,NA
90302,ca,-118.35551,33.97474,4176,0,0,0,NA
90303,ca,-118.33231,33.93805,4451,0,0,0,NA
90304,ca,-118.35856,33.93789,3380,0,0,0,NA
90305,ca,-118.33013,33.95957,4471,0,0,0,NA
90401,ca,-118.49412,34.01419,921,0,0,0,NA
90402,ca,-118.5045,34.03473,3837,0,0,0,NA
90403,ca,-118.49153,34.02991,2799,0,0,0,NA
90404,ca,-118.47364,34.02661,2920,0,0,0,NA
90405,ca,-118.46939,34.01108,5563,0,0,0,NA
90501,ca,-118.31425,33.83344,8372,0,0,0,NA
90502,ca,-118.2929,33.83502,3223,0,0,0,NA
90503,ca,-118.35364,33.84077,8546,0,0,0,NA
90504,ca,-118.33118,33.86682,8207,0,0,0,NA
90505,ca,-118.34817,33.80917,8953,0,0,0,NA
90506,ca,-118.33038,33.8849,2,0,0,0,NA
90601,ca,-118.03139,34.00831,8293,4,13,9,225
90602,ca,-118.02214,33.97199,4775,2,7,5,250
90603,ca,-117.99249,33.94539,6273,2,8,6,300
90604,ca,-118.01227,33.93015,8971,1,5,4,400
90605,ca,-118.02339,33.94975,9351,2,6,4,200
90606,ca,-118.06576,33.97766,7560,2,7,5,250
90620,ca,-118.0117,33.84615,11886,0,1,1,NA
90621,ca,-117.99346,33.87424,6063,0,1,1,NA
90623,ca,-118.04074,33.85037,4195,0,0,0,NA
90630,ca,-118.03817,33.81811,12621,0,0,0,NA
90631,ca,-117.95134,33.94246,15366,2,8,6,300
90638,ca,-118.00921,33.90242,13189,1,4,3,300
90640,ca,-118.11075,34.01505,12020,2,8,6,300
90650,ca,-118.08262,33.90681,21737,1,3,2,200
90660,ca,-118.09062,33.98881,14290,2,7,5,250
90670,ca,-118.06265,33.93301,5504,1,5,4,400
90680,ca,-117.99491,33.80112,4628,0,1,1,NA
90701,ca,-118.08061,33.8676,3816,0,0,0,NA
90703,ca,-118.06871,33.86789,15397,0,0,0,NA
90704,ca,-118.44846,33.39149,1252,0,0,0,NA
90706,ca,-118.12709,33.88803,11935,0,1,1,NA
90710,ca,-118.29904,33.79815,4312,0,0,0,NA
90712,ca,-118.14674,33.84898,10066,0,0,0,NA
90713,ca,-118.1126,33.84799,9543,0,0,0,NA
90715,ca,-118.07888,33.84029,3978,0,0,0,NA
90716,ca,-118.07303,33.8304,2030,0,0,0,NA
90717,ca,-118.31717,33.7938,4490,0,0,0,NA
90720,ca,-118.06357,33.79558,6269,0,0,0,NA
90723,ca,-118.1648,33.89741,7019,0,1,1,NA
90731,ca,-118.27748,33.72986,11089,0,0,0,NA
90732,ca,-118.31207,33.74206,4795,0,0,0,NA
90740,ca,-118.07559,33.75803,5295,0,0,0,NA
90742,ca,-118.07483,33.71717,420,0,0,0,NA
90743,ca,-118.08986,33.72725,279,0,0,0,NA
90744,ca,-118.26166,33.77864,10511,0,0,0,NA
90745,ca,-118.26441,33.82126,10937,0,0,0,NA
90746,ca,-118.25523,33.85886,7440,0,0,0,NA
90755,ca,-118.16768,33.80288,3063,0,0,0,NA
90802,ca,-118.20764,33.74972,2872,0,0,0,NA
90803,ca,-118.13075,33.75529,8641,0,0,0,NA
90804,ca,-118.14859,33.78185,4894,0,0,0,NA
90805,ca,-118.18054,33.86491,15753,0,0,0,NA
90806,ca,-118.18759,33.8045,7137,0,0,0,NA
90807,ca,-118.17465,33.82796,8142,0,0,0,NA
90808,ca,-118.11241,33.82408,13724,0,0,0,NA
90810,ca,-118.22109,33.81891,7565,0,0,0,NA
90813,ca,-118.19691,33.78236,6191,0,0,0,NA
90814,ca,-118.14363,33.77162,3757,0,0,0,NA
90815,ca,-118.11623,33.79584,11594,0,0,0,NA
90822,ca,-118.11865,33.77844,1,0,0,0,NA
90831,ca,-118.20164,33.76833,4,0,0,0,NA
91001,ca,-118.13795,34.19542,12243,2,7,5,250
91006,ca,-118.02677,34.13601,9514,6,17,11,183.3
91007,ca,-118.04815,34.12865,6540,5,15,10,200
91008,ca,-117.96809,34.15345,471,6,18,12,200
91010,ca,-117.95671,34.14071,6603,8,21,13,162.5
91011,ca,-118.20514,34.22166,7730,2,8,6,300
91016,ca,-118.00067,34.15222,10840,7,19,12,171.4
91020,ca,-118.23065,34.21134,1507,2,7,5,250
91024,ca,-118.05034,34.16871,3910,5,14,9,180
91030,ca,-118.1573,34.11024,6155,3,10,7,233.3
91040,ca,-118.33713,34.26178,6736,2,8,6,300
91042,ca,-118.24924,34.31651,8768,1,4,3,300
91046,ca,-118.24104,34.21145,21,2,7,5,250
91101,ca,-118.13948,34.14663,1555,3,11,8,266.7
91103,ca,-118.16598,34.169,5586,3,10,7,233.3
91104,ca,-118.12344,34.16779,9247,3,10,7,233.3
91105,ca,-118.16677,34.13824,4072,3,9,6,200
91106,ca,-118.12823,34.13859,4216,4,12,8,200
91107,ca,-118.08715,34.15831,10710,4,12,8,200
91108,ca,-118.11341,34.12233,4820,4,13,9,225
91201,ca,-118.28909,34.17029,4396,2,9,7,350
91202,ca,-118.26843,34.16787,4131,3,10,7,233.3
91203,ca,-118.26412,34.15292,1443,2,9,7,350
91204,ca,-118.26093,34.13619,1833,2,8,6,300
91205,ca,-118.24334,34.13668,4044,2,8,6,300
91206,ca,-118.21344,34.16068,5913,3,10,7,233.3
91207,ca,-118.25863,34.1836,2996,3,11,8,266.7
91208,ca,-118.23652,34.19249,5661,3,9,6,200
91210,ca,-118.25651,34.14456,32,2,8,6,300
91214,ca,-118.24927,34.23671,9507,1,5,4,400
91301,ca,-118.75718,34.12274,8722,5,13,8,160
91302,ca,-118.67011,34.12426,8945,5,13,8,160
91303,ca,-118.60153,34.19792,3386,19,35,16,84.2
91304,ca,-118.63246,34.22462,10063,19,36,17,89.5
91306,ca,-118.57539,34.20927,9180,17,33,16,94.1
91307,ca,-118.66221,34.20164,8289,18,35,17,94.4
91311,ca,-118.60744,34.28937,11259,9,23,14,155.6
91316,ca,-118.51668,34.16041,5726,6,17,11,183.3
91320,ca,-118.94509,34.17597,16039,3,9,6,200
91321,ca,-118.48601,34.36909,7216,3,10,7,233.3
91324,ca,-118.54961,34.23899,5833,9,22,13,144.4
91325,ca,-118.51759,34.23603,6293,7,19,12,171.4
91326,ca,-118.55758,34.28047,11350,7,18,11,157.1
91330,ca,-118.52608,34.24761,4,6,18,12,200
91331,ca,-118.42078,34.25562,15722,3,11,8,266.7
91335,ca,-118.54068,34.20105,13680,11,26,15,136.4
91340,ca,-118.43508,34.28669,6896,7,20,13,185.7
91342,ca,-118.3851,34.31515,17123,6,17,11,183.3
91343,ca,-118.48068,34.23828,9460,5,16,11,220
91344,ca,-118.50751,34.29392,14748,7,19,12,171.4
91345,ca,-118.45947,34.26593,4232,4,14,10,250
91350,ca,-118.50072,34.43357,10918,5,14,9,180
91351,ca,-118.46293,34.43322,5801,3,11,8,266.7
91352,ca,-118.36642,34.2319,9846,2,8,6,300
91354,ca,-118.55429,34.46491,8228,7,18,11,157.1
91355,ca,-118.58927,34.42466,8674,6,16,10,166.7
91356,ca,-118.54755,34.1551,6469,8,20,12,150
91360,ca,-118.88213,34.21272,13186,4,11,7,175
91361,ca,-118.88895,34.1365,8557,3,9,6,200
91362,ca,-118.81869,34.19334,12902,10,22,12,120
91364,ca,-118.59509,34.15478,9790,13,26,13,100
91367,ca,-118.61546,34.17705,8800,15,31,16,106.7
91371,ca,-118.57644,34.18452,1,15,30,15,100
91377,ca,-118.76691,34.18498,4944,9,21,12,133.3
91381,ca,-118.61311,34.37747,4733,5,13,8,160
91384,ca,-118.68636,34.5307,9227,10,22,12,120
91387,ca,-118.3732,34.39879,8365,2,7,5,250
91390,ca,-118.39215,34.52287,8633,3,10,7,233.3
91401,ca,-118.43146,34.17811,7106,3,10,7,233.3
91402,ca,-118.44483,34.22408,6747,3,11,8,266.7
91403,ca,-118.46284,34.14656,5529,1,5,4,400
91405,ca,-118.44814,34.20116,6073,3,11,8,266.7
91406,ca,-118.48976,34.19816,9597,5,16,11,220
91411,ca,-118.45923,34.17852,3633,3,10,7,233.3
91423,ca,-118.43269,34.1485,6850,2,5,3,150
91436,ca,-118.4923,34.15086,5326,2,7,5,250
91501,ca,-118.29575,34.20051,3339,2,8,6,300
91502,ca,-118.3093,34.17683,1540,2,9,7,350
91504,ca,-118.32695,34.20452,5877,2,8,6,300
91505,ca,-118.34683,34.17476,9091,2,9,7,350
91506,ca,-118.32391,34.17119,5955,2,9,7,350
91601,ca,-118.37256,34.16854,5699,2,9,7,350
91602,ca,-118.36626,34.15102,3324,2,6,4,200
91604,ca,-118.39349,34.13881,7753,1,2,1,100
91605,ca,-118.40035,34.20716,8759,2,8,6,300
91606,ca,-118.38868,34.18654,6907,2,9,7,350
91607,ca,-118.40009,34.16614,4857,3,9,6,200
91608,ca,-118.35281,34.13825,50,0,1,1,NA
91701,ca,-117.60001,34.13763,12051,6,18,12,200
91702,ca,-117.86728,34.26559,11642,5,14,9,180
91706,ca,-117.9682,34.0964,14372,8,22,14,175
91708,ca,-117.64043,33.95398,717,11,27,16,145.5
91709,ca,-117.73601,33.96433,24362,7,19,12,171.4
91710,ca,-117.68472,34.00449,26853,8,22,14,175
91711,ca,-117.71562,34.12853,10442,4,13,9,225
91722,ca,-117.9062,34.09726,8398,5,15,10,200
91723,ca,-117.88647,34.08476,4311,5,14,9,180
91724,ca,-117.855,34.08068,6376,5,14,9,180
91730,ca,-117.57849,34.09952,18450,9,22,13,144.4
91731,ca,-118.04066,34.07882,4798,5,14,9,180
91732,ca,-118.01446,34.07341,9251,7,19,12,171.4
91733,ca,-118.05314,34.04555,7731,6,16,10,166.7
91737,ca,-117.57774,34.15257,7556,6,18,12,200
91739,ca,-117.5182,34.17052,11731,10,24,14,140
91740,ca,-117.85383,34.11878,6552,4,12,8,200
91741,ca,-117.84371,34.15372,8932,4,12,8,200
91744,ca,-117.93732,34.02887,15882,7,20,13,185.7
91745,ca,-117.97318,33.99929,14700,5,16,11,220
91746,ca,-117.98622,34.04427,6708,8,22,14,175
91748,ca,-117.89965,33.9766,11095,4,15,11,275
91750,ca,-117.77274,34.16088,10006,4,13,9,225
91752,ca,-117.53397,33.99575,9498,11,28,17,154.5
91754,ca,-118.14461,34.05099,8162,3,10,7,233.3
91755,ca,-118.11499,34.04799,5135,4,13,9,225
91759,ca,-117.69151,34.25413,543,1,2,1,100
91761,ca,-117.59209,34.03455,19196,9,23,14,155.6
91762,ca,-117.64488,34.02912,16707,8,21,13,162.5
91763,ca,-117.69833,34.07236,8083,6,17,11,183.3
91764,ca,-117.6022,34.07524,11090,8,21,13,162.5
91765,ca,-117.81447,33.98826,11882,4,12,8,200
91766,ca,-117.7569,34.0418,13999,7,19,12,171.4
91767,ca,-117.73851,34.08146,10265,5,16,11,220
91768,ca,-117.79057,34.06391,6922,6,16,10,166.7
91770,ca,-118.08364,34.06433,12590,4,13,9,225
91773,ca,-117.80978,34.11004,10503,4,13,9,225
91775,ca,-118.08942,34.11446,6720,4,14,10,250
91776,ca,-118.0949,34.08988,7074,4,13,9,225
91780,ca,-118.05548,34.10147,8857,4,14,10,250
91784,ca,-117.65813,34.14122,10127,4,14,10,250
91786,ca,-117.66209,34.1053,13139,6,17,11,183.3
91789,ca,-117.85462,34.01831,13180,5,15,10,200
91790,ca,-117.93771,34.06732,10678,8,20,12,150
91791,ca,-117.89406,34.06108,7867,5,16,11,220
91792,ca,-117.89991,34.02582,6027,5,16,11,220
91801,ca,-118.12753,34.09073,8676,5,14,9,180
91803,ca,-118.14623,34.07495,6913,3,11,8,266.7
91901,ca,-116.71231,32.80639,6100,2,8,6,300
91902,ca,-117.01825,32.66704,5651,0,2,2,NA
91905,ca,-116.31606,32.67982,1534,0,2,2,NA
91906,ca,-116.46058,32.65941,2137,2,7,5,250
91910,ca,-117.05711,32.63826,14941,0,1,1,NA
91911,ca,-117.05406,32.60735,14892,0,1,1,NA
91913,ca,-116.98706,32.62003,11561,0,1,1,NA
91914,ca,-116.95235,32.66543,4265,1,4,3,300
91915,ca,-116.94959,32.62235,5214,0,2,2,NA
91916,ca,-116.62135,32.888,1230,0,2,2,NA
91917,ca,-116.71983,32.60875,619,3,12,9,300
91931,ca,-116.55772,32.84637,184,0,1,1,NA
91932,ca,-117.12092,32.5736,4597,0,0,0,NA
91934,ca,-116.17247,32.65855,826,1,5,4,400
91935,ca,-116.7905,32.7088,4228,3,10,7,233.3
91941,ca,-116.99347,32.75988,9850,1,5,4,400
91942,ca,-117.02172,32.77747,9102,1,5,4,400
91945,ca,-117.03418,32.73317,7021,0,2,2,NA
91948,ca,-116.45319,32.86942,167,0,0,0,NA
91950,ca,-117.09418,32.67005,9231,0,1,1,NA
91962,ca,-116.47426,32.77763,1193,0,1,1,NA
91963,ca,-116.60998,32.62619,628,2,7,5,250
91977,ca,-116.99655,32.72597,14034,1,4,3,300
91978,ca,-116.94238,32.72418,2053,2,8,6,300
91980,ca,-116.61915,32.58886,165,2,9,7,350
92003,ca,-117.19873,33.28568,1926,0,2,2,NA
92004,ca,-116.10359,33.13945,9157,93,108,15,16.1
92007,ca,-117.27419,33.02175,3857,0,0,0,NA
92008,ca,-117.31878,33.14425,7860,0,0,0,NA
92009,ca,-117.24579,33.0943,11665,0,1,1,NA
92010,ca,-117.28476,33.15687,5064,0,0,0,NA
92011,ca,-117.29425,33.10723,6965,0,0,0,NA
92014,ca,-117.24901,32.96648,5107,0,1,1,NA
92019,ca,-116.87888,32.7791,10811,3,12,9,300
92020,ca,-116.96976,32.79551,11236,4,14,10,250
92021,ca,-116.87082,32.8355,11705,5,15,10,200
92024,ca,-117.25844,33.0562,15329,0,0,0,NA
92025,ca,-117.02935,33.08531,9666,4,13,9,225
92026,ca,-117.11611,33.21246,13965,2,9,7,350
92027,ca,-116.98429,33.13448,12120,4,14,10,250
92028,ca,-117.21251,33.38811,17470,0,3,3,NA
92029,ca,-117.12997,33.0851,7792,3,11,8,266.7
92036,ca,-116.49121,33.02134,5565,5,9,4,80
92037,ca,-117.25202,32.85657,10719,0,1,1,NA
92040,ca,-116.88481,32.90753,10915,4,13,9,225
92054,ca,-117.4286,33.26948,8897,0,0,0,NA
92055,ca,-117.44483,33.38771,30,0,1,1,NA
92056,ca,-117.28905,33.20149,16855,0,0,0,NA
92057,ca,-117.28727,33.25408,16521,0,0,0,NA
92058,ca,-117.34222,33.26965,4213,0,0,0,NA
92059,ca,-117.06613,33.37648,562,2,9,7,350
92060,ca,-116.84857,33.34076,932,1,5,4,400
92061,ca,-116.92481,33.29852,1349,5,15,10,200
92064,ca,-117.01934,32.98408,14626,3,10,7,233.3
92065,ca,-116.84562,33.05146,12706,4,13,9,225
92066,ca,-116.53525,33.21937,377,1,2,1,100
92067,ca,-117.19382,33.02141,4739,0,1,1,NA
92069,ca,-117.15868,33.17078,9829,1,5,4,400
92070,ca,-116.72664,33.15943,1194,1,3,2,200
92071,ca,-116.99143,32.85128,13869,4,12,8,200
92075,ca,-117.25956,32.99726,3514,0,1,1,NA
92078,ca,-117.185,33.1193,10639,1,4,3,300
92081,ca,-117.2403,33.16434,7246,0,1,1,NA
92082,ca,-117.00048,33.2508,7947,4,14,10,250
92083,ca,-117.24815,33.19786,6659,0,1,1,NA
92084,ca,-117.20533,33.22215,12224,0,1,1,NA
92086,ca,-116.65266,33.30956,1262,2,5,3,150
92091,ca,-117.21117,33.01111,537,0,1,1,NA
92101,ca,-117.17076,32.72396,2474,0,1,1,NA
92102,ca,-117.11705,32.71622,7453,0,1,1,NA
92103,ca,-117.16688,32.74742,6996,0,1,1,NA
92104,ca,-117.12819,32.74165,8906,0,1,1,NA
92105,ca,-117.09266,32.73784,10356,0,1,1,NA
92106,ca,-117.23723,32.71027,5839,0,1,1,NA
92107,ca,-117.2453,32.73908,7154,0,0,0,NA
92108,ca,-117.14254,32.77387,603,0,1,1,NA
92109,ca,-117.23428,32.78627,9780,0,1,1,NA
92110,ca,-117.19991,32.7651,5090,0,1,1,NA
92111,ca,-117.16888,32.80645,10203,0,1,1,NA
92113,ca,-117.11822,32.69601,7810,0,1,1,NA
92114,ca,-117.05509,32.70776,15982,0,1,1,NA
92115,ca,-117.07176,32.7614,11036,0,2,2,NA
92116,ca,-117.12278,32.76499,7301,0,1,1,NA
92117,ca,-117.19952,32.82457,14421,0,1,1,NA
92118,ca,-117.17699,32.67112,4829,0,0,0,NA
92119,ca,-117.03279,32.81007,6751,2,7,5,250
92120,ca,-117.07117,32.79467,8823,1,3,2,200
92121,ca,-117.20228,32.89916,2195,0,2,2,NA
92122,ca,-117.17006,32.85925,5270,0,1,1,NA
92123,ca,-117.13494,32.80678,5522,0,2,2,NA
92124,ca,-117.08601,32.82652,5295,1,3,2,200
92126,ca,-117.1414,32.90849,14126,1,3,2,200
92127,ca,-117.12386,33.0198,11625,2,7,5,250
92128,ca,-117.07178,32.99946,10333,3,11,8,266.7
92129,ca,-117.12602,32.96488,13845,1,5,4,400
92130,ca,-117.20739,32.94759,13868,0,2,2,NA
92131,ca,-117.08011,32.89436,9163,2,9,7,350
92132,ca,-117.17204,32.71367,3,0,1,1,NA
92134,ca,-117.14666,32.72418,2,0,1,1,NA
92135,ca,-117.19326,32.69667,6,0,1,1,NA
92139,ca,-117.04888,32.67991,6821,0,1,1,NA
92140,ca,-117.19798,32.74009,8,0,1,1,NA
92145,ca,-117.00806,32.93055,715,3,12,9,300
92147,ca,-117.21929,32.72462,4,0,1,1,NA
92154,ca,-117.00286,32.56759,14636,0,1,1,NA
92155,ca,-117.16177,32.67496,7,0,0,0,NA
92173,ca,-117.04247,32.55406,3040,0,1,1,NA
92201,ca,-116.10291,33.69741,22290,101,116,15,14.9
92203,ca,-116.24649,33.75396,15052,103,118,15,14.6
92210,ca,-116.34014,33.70047,5369,99,114,15,15.2
92211,ca,-116.33107,33.76217,20910,105,119,14,13.3
92220,ca,-116.83238,33.94896,14914,5,16,11,220
92222,ca,-114.54551,32.78583,48,101,114,13,12.9
92223,ca,-116.98802,33.94834,23838,9,24,15,166.7
92225,ca,-114.66805,33.74643,11851,104,117,13,12.5
92227,ca,-115.34867,32.99024,10060,104,117,13,12.5
92230,ca,-116.76598,33.9106,3833,5,14,9,180
92231,ca,-115.54117,32.68763,9252,102,115,13,12.7
92233,ca,-115.55954,33.17378,2382,104,117,13,12.5
92234,ca,-116.46646,33.81821,19959,101,115,14,13.9
92236,ca,-116.17292,33.68615,10461,104,119,15,14.4
92239,ca,-115.47027,33.7648,2453,70,88,18,25.7
92240,ca,-116.5219,33.95312,18387,79,97,18,22.8
92241,ca,-116.30049,33.85303,7364,80,97,17,21.3
92242,ca,-114.31967,34.16516,6234,106,119,13,12.3
92243,ca,-115.59933,32.77252,12506,104,117,13,12.5
92249,ca,-115.4727,32.72558,1765,104,116,12,11.5
92250,ca,-115.23953,32.824,3757,103,115,12,11.7
92251,ca,-115.69004,32.8723,8368,102,115,13,12.7
92252,ca,-116.28841,34.16835,12411,13,26,13,100
92253,ca,-116.27869,33.65398,26225,103,118,15,14.6
92254,ca,-115.9943,33.54484,5482,106,120,14,13.2
92256,ca,-116.60644,34.07706,3411,11,26,15,136.4
92257,ca,-115.32339,33.26436,4866,88,103,15,17
92258,ca,-116.55987,33.91584,1092,83,99,16,19.3
92259,ca,-115.93239,32.73776,1439,88,103,15,17
92260,ca,-116.40473,33.70703,20222,97,113,16,16.5
92262,ca,-116.5615,33.86055,17858,92,107,15,16.3
92264,ca,-116.50423,33.7321,13823,85,102,17,20
92266,ca,-114.92194,33.34542,3145,83,99,16,19.3
92267,ca,-114.1907,34.27594,76,91,106,15,16.5
92268,ca,-116.56436,34.222,1804,0,1,1,NA
92270,ca,-116.4273,33.76592,16149,105,119,14,13.3
92273,ca,-115.69996,32.81775,556,99,112,13,13.1
92274,ca,-116.08564,33.46158,16963,104,118,14,13.5
92275,ca,-115.8566,33.25183,14110,104,117,13,12.5
92276,ca,-116.36425,33.82233,5217,105,119,14,13.3
92277,ca,-115.62223,34.21541,29770,49,67,18,36.7
92278,ca,-116.05507,34.22998,1,66,86,20,30.3
92280,ca,-114.77793,34.12551,1819,91,106,15,16.5
92281,ca,-115.60875,33.05176,802,104,117,13,12.5
92282,ca,-116.65871,33.96549,2705,36,55,19,52.8
92283,ca,-114.74717,32.93769,1840,96,109,13,13.5
92284,ca,-116.43251,34.18621,17407,2,7,5,250
92285,ca,-116.54048,34.34019,8166,10,22,12,120
92301,ca,-117.54085,34.64459,21658,4,12,8,200
92304,ca,-115.64459,34.54147,404,97,110,13,13.4
92305,ca,-116.82851,34.16319,938,0,0,0,NA
92307,ca,-117.13877,34.58835,20529,6,17,11,183.3
92308,ca,-117.15995,34.42503,20092,5,15,10,200
92309,ca,-116.13025,35.2164,2764,63,79,16,25.4
92310,ca,-116.69032,35.26146,636,19,35,16,84.2
92311,ca,-116.98115,34.97826,17372,22,41,19,86.4
92313,ca,-117.31293,34.031,3771,12,28,16,133.3
92314,ca,-116.81304,34.26097,14438,0,0,0,NA
92315,ca,-116.90515,34.235,11044,0,0,0,NA
92316,ca,-117.39066,34.05909,7479,16,34,18,112.5
92320,ca,-117.0521,33.99047,3405,7,19,12,171.4
92321,ca,-117.15334,34.25449,4589,0,0,0,NA
92322,ca,-117.32646,34.25435,4369,0,0,0,NA
92324,ca,-117.28738,34.03146,15930,13,30,17,130.8
92325,ca,-117.28094,34.24332,8677,0,1,1,NA
92327,ca,-116.86212,34.86294,1090,28,47,19,67.9
92328,ca,-116.87043,36.52897,673,56,68,12,21.4
92332,ca,-115.34167,34.91279,4375,29,43,14,48.3
92333,ca,-116.94931,34.2706,1706,0,0,0,NA
92335,ca,-117.46545,34.08718,18542,15,33,18,120
92336,ca,-117.46398,34.14654,29385,11,26,15,136.4
92337,ca,-117.47061,34.04981,9924,15,33,18,120
92338,ca,-116.19048,34.78296,1738,51,70,19,37.3
92339,ca,-116.93623,34.09366,1017,0,0,0,NA
92341,ca,-117.06597,34.23479,1601,0,0,0,NA
92342,ca,-117.34942,34.75839,7843,13,29,16,123.1
92344,ca,-117.40572,34.39115,9136,0,2,2,NA
92345,ca,-117.30941,34.38214,28006,2,8,6,300
92346,ca,-117.18001,34.12429,16247,10,25,15,150
92347,ca,-117.22235,34.95449,7043,25,45,20,80
92352,ca,-117.20156,34.26062,11180,0,0,0,NA
92354,ca,-117.25151,34.04977,5878,11,27,16,145.5
92356,ca,-116.89679,34.51073,15314,9,22,13,144.4
92358,ca,-117.52098,34.25928,731,0,2,2,NA
92359,ca,-117.06637,34.08317,3159,6,19,13,216.7
92363,ca,-114.5505,34.68336,6033,94,108,14,14.9
92364,ca,-115.42619,35.34055,2214,7,14,7,100
92365,ca,-116.64918,34.89969,6052,47,67,20,42.6
92368,ca,-117.33283,34.65227,1614,9,21,12,133.3
92371,ca,-117.54185,34.4427,11665,1,4,3,300
92372,ca,-117.62514,34.44481,4546,1,2,1,100
92373,ca,-117.15066,34.00495,12367,9,24,15,166.7
92374,ca,-117.17187,34.06648,12881,9,24,15,166.7
92376,ca,-117.37896,34.1112,17190,15,32,17,113.3
92377,ca,-117.40412,34.15604,6276,12,28,16,133.3
92378,ca,-117.22593,34.22608,137,1,4,3,300
92382,ca,-117.11804,34.20544,6543,0,0,0,NA
92384,ca,-116.17793,36.0125,217,42,60,18,42.9
92385,ca,-117.19233,34.21474,648,0,0,0,NA
92386,ca,-116.8277,34.23723,3804,0,0,0,NA
92389,ca,-116.15437,35.90206,3133,33,50,17,51.5
92391,ca,-117.23474,34.23785,2364,0,1,1,NA
92392,ca,-117.40818,34.48024,21210,2,7,5,250
92394,ca,-117.35281,34.55628,12323,6,17,11,183.3
92395,ca,-117.29439,34.50158,15752,7,18,11,157.1
92397,ca,-117.62726,34.36698,3522,0,0,0,NA
92398,ca,-116.84717,34.91175,1419,45,66,21,46.7
92399,ca,-117.00516,34.04282,16778,5,14,9,180
92401,ca,-117.29215,34.1048,887,15,33,18,120
92404,ca,-117.25146,34.17834,14539,12,29,17,141.7
92405,ca,-117.3013,34.14463,7942,15,33,18,120
92407,ca,-117.39082,34.21658,18080,11,27,16,145.5
92408,ca,-117.2657,34.08454,4680,13,31,18,138.5
92410,ca,-117.2972,34.10683,9282,15,32,17,113.3
92411,ca,-117.3206,34.12199,6670,16,34,18,112.5
92501,ca,-117.37358,33.99547,6283,15,32,17,113.3
92503,ca,-117.4448,33.88164,23576,15,33,18,120
92504,ca,-117.39662,33.90246,15122,15,33,18,120
92505,ca,-117.49436,33.93324,11294,13,30,17,130.8
92506,ca,-117.36732,33.93433,16616,14,30,16,114.3
92507,ca,-117.32487,33.97101,11855,11,26,15,136.4
92508,ca,-117.32675,33.89116,10607,11,26,15,136.4
92509,ca,-117.44496,34.00325,20482,16,34,18,112.5
92518,ca,-117.27764,33.88867,455,9,22,13,144.4
92530,ca,-117.37509,33.65053,27732,25,43,18,72
92532,ca,-117.30319,33.69268,10049,24,43,19,79.2
92536,ca,-116.83491,33.49289,4002,5,12,7,140
92539,ca,-116.6439,33.51352,4050,1,3,2,200
92543,ca,-116.97686,33.69818,10726,24,43,19,79.2
92544,ca,-116.88204,33.64625,17235,17,34,17,100
92545,ca,-117.03417,33.72969,15650,28,47,19,67.9
92548,ca,-117.10948,33.75866,2982,19,37,18,94.7
92549,ca,-116.74408,33.77046,5840,0,0,0,NA
92551,ca,-117.22612,33.88145,7885,13,29,16,123.1
92553,ca,-117.24482,33.92338,16054,7,20,13,185.7
92555,ca,-117.11838,33.90109,13575,11,27,16,145.5
92557,ca,-117.25965,33.9703,15540,7,19,12,171.4
92561,ca,-116.61995,33.64092,3817,1,2,1,100
92562,ca,-117.34391,33.55113,22994,27,45,18,66.7
92563,ca,-117.1458,33.58001,20912,21,40,19,90.5
92567,ca,-117.10479,33.81233,3981,15,31,16,106.7
92570,ca,-117.3166,33.78519,20638,18,35,17,94.4
92571,ca,-117.20461,33.82426,15193,20,38,18,90
92582,ca,-117.01949,33.80585,6691,27,47,20,74.1
92583,ca,-116.93244,33.79676,9702,24,43,19,79.2
92584,ca,-117.17551,33.66159,21699,30,49,19,63.3
92585,ca,-117.17214,33.7467,10352,29,48,19,65.5
92586,ca,-117.19885,33.70898,9811,31,50,19,61.3
92587,ca,-117.25293,33.69511,9517,25,44,19,76
92590,ca,-117.22261,33.48466,3659,5,16,11,220
92591,ca,-117.10486,33.53523,12210,12,28,16,133.3
92592,ca,-117.03092,33.51116,27905,7,20,13,185.7
92595,ca,-117.25931,33.61784,11907,25,43,18,72
92596,ca,-117.07644,33.64368,14421,27,46,19,70.4
92602,ca,-117.7488,33.74587,7165,1,4,3,300
92603,ca,-117.78885,33.62446,4362,0,1,1,NA
92604,ca,-117.7889,33.68813,5495,0,1,1,NA
92606,ca,-117.81722,33.70041,4578,0,1,1,NA
92610,ca,-117.67605,33.69617,4518,1,4,3,300
92612,ca,-117.82641,33.66075,3430,0,1,1,NA
92614,ca,-117.83296,33.68163,3925,0,1,1,NA
92617,ca,-117.84168,33.64251,1378,0,1,1,NA
92618,ca,-117.73415,33.66817,9826,1,3,2,200
92620,ca,-117.75066,33.71262,12442,1,3,2,200
92624,ca,-117.66251,33.45269,2534,0,0,0,NA
92625,ca,-117.86614,33.60109,4920,0,0,0,NA
92626,ca,-117.90839,33.67893,10686,0,0,0,NA
92627,ca,-117.92038,33.64789,10917,0,0,0,NA
92629,ca,-117.7055,33.47472,8295,0,0,0,NA
92630,ca,-117.68517,33.64467,13569,0,2,2,NA
92637,ca,-117.73188,33.61016,345,0,1,1,NA
92646,ca,-117.96817,33.66292,16687,0,0,0,NA
92647,ca,-118.00673,33.72348,12474,0,0,0,NA
92648,ca,-118.01455,33.68019,12486,0,0,0,NA
92649,ca,-118.05143,33.72557,9496,0,0,0,NA
92651,ca,-117.77693,33.55527,11850,0,0,0,NA
92653,ca,-117.69848,33.59156,6922,0,1,1,NA
92655,ca,-117.98487,33.74513,1276,0,0,0,NA
92656,ca,-117.73037,33.57622,7073,0,1,1,NA
92657,ca,-117.8334,33.59426,4239,0,0,0,NA
92660,ca,-117.8745,33.63377,9902,0,0,0,NA
92661,ca,-117.90234,33.60019,1884,0,0,0,NA
92662,ca,-117.89219,33.6055,1427,0,0,0,NA
92663,ca,-117.93265,33.6224,5795,0,0,0,NA
92672,ca,-117.60972,33.42761,11312,0,0,0,NA
92673,ca,-117.61207,33.46685,9178,0,0,0,NA
92675,ca,-117.60461,33.5021,10363,0,1,1,NA
92676,ca,-117.6347,33.75039,1780,1,3,2,200
92677,ca,-117.7052,33.52763,17770,0,0,0,NA
92678,ca,-117.52658,33.68469,299,1,3,2,200
92679,ca,-117.58968,33.634,12046,0,2,2,NA
92683,ca,-117.99397,33.7525,18594,0,0,0,NA
92688,ca,-117.6123,33.61981,8879,0,2,2,NA
92691,ca,-117.66625,33.61068,13631,0,1,1,NA
92692,ca,-117.64306,33.60674,14315,0,2,2,NA
92694,ca,-117.62375,33.54723,8474,1,4,3,300
92701,ca,-117.85847,33.74823,5305,0,1,1,NA
92703,ca,-117.90608,33.74872,8044,0,1,1,NA
92704,ca,-117.90804,33.72056,11305,0,0,0,NA
92705,ca,-117.81639,33.75562,11346,0,2,2,NA
92706,ca,-117.88222,33.7659,6277,0,1,1,NA
92707,ca,-117.87086,33.70993,8430,0,1,1,NA
92708,ca,-117.95119,33.71049,15816,0,0,0,NA
92780,ca,-117.81917,33.73395,9911,0,1,1,NA
92782,ca,-117.7847,33.73971,4499,1,2,1,100
92801,ca,-117.95224,33.84445,7638,0,1,1,NA
92802,ca,-117.92366,33.80826,5206,0,1,1,NA
92804,ca,-117.97502,33.81827,12772,0,1,1,NA
92805,ca,-117.90579,33.83037,10014,0,2,2,NA
92806,ca,-117.87076,33.83852,6708,1,4,3,300
92807,ca,-117.7893,33.8497,11653,2,7,5,250
92808,ca,-117.74021,33.85651,5003,3,10,7,233.3
92821,ca,-117.88518,33.92741,10533,2,9,7,350
92823,ca,-117.80711,33.92972,1566,4,14,10,250
92831,ca,-117.89635,33.87977,6379,1,3,2,200
92832,ca,-117.92901,33.86861,4627,0,2,2,NA
92833,ca,-117.96173,33.87933,11304,0,2,2,NA
92835,ca,-117.91726,33.90187,7190,2,6,4,200
92840,ca,-117.93223,33.78583,10108,0,1,1,NA
92841,ca,-117.982,33.78686,6579,0,1,1,NA
92843,ca,-117.93145,33.76393,6773,0,0,0,NA
92844,ca,-117.96946,33.76546,3773,0,0,0,NA
92845,ca,-118.02628,33.78311,5308,0,0,0,NA
92860,ca,-117.5517,33.92464,8424,11,26,15,136.4
92861,ca,-117.81004,33.81771,2087,1,6,5,500
92865,ca,-117.84902,33.82887,4852,1,5,4,400
92866,ca,-117.84477,33.78461,3289,1,4,3,300
92867,ca,-117.82211,33.81575,11094,1,5,4,400
92868,ca,-117.8763,33.78809,3798,1,3,2,200
92869,ca,-117.78668,33.79599,9373,1,6,5,500
92870,ca,-117.85519,33.8808,12876,2,6,4,200
92879,ca,-117.53548,33.87977,12073,10,25,15,150
92880,ca,-117.60971,33.92077,20277,10,25,15,150
92881,ca,-117.51992,33.824,10555,9,23,14,155.6
92882,ca,-117.60423,33.84192,17932,7,20,13,185.7
92883,ca,-117.47397,33.75411,13350,16,32,16,100
92886,ca,-117.79712,33.89667,15177,2,8,6,300
92887,ca,-117.73129,33.8847,6024,3,10,7,233.3
93001,ca,-119.5519,34.16229,10890,0,1,1,NA
93003,ca,-119.22223,34.28461,15820,0,1,1,NA
93004,ca,-119.16548,34.27886,8961,0,1,1,NA
93010,ca,-119.07464,34.2298,14465,0,1,1,NA
93012,ca,-118.99737,34.20358,14628,1,4,3,300
93013,ca,-119.49422,34.43985,6604,0,0,0,NA
93015,ca,-118.89655,34.40573,6066,3,8,5,166.7
93021,ca,-118.88416,34.30375,12494,3,8,5,166.7
93022,ca,-119.30566,34.40737,2238,2,5,3,150
93023,ca,-119.27484,34.52444,8443,3,8,5,166.7
93030,ca,-119.17484,34.20533,11487,0,0,0,NA
93033,ca,-119.12678,34.15195,13031,0,0,0,NA
93035,ca,-119.22293,34.18225,10366,0,0,0,NA
93036,ca,-119.18139,34.23535,10062,0,1,1,NA
93040,ca,-118.79234,34.48174,912,3,10,7,233.3
93041,ca,-119.14549,34.12876,6515,0,0,0,NA
93043,ca,-119.20241,34.17085,14,0,0,0,NA
93060,ca,-119.09934,34.40167,8919,1,5,4,400
93063,ca,-118.68444,34.30459,19278,9,21,12,133.3
93064,ca,-118.70094,34.24755,15,10,23,13,130
93065,ca,-118.77441,34.26021,23239,8,19,11,137.5
93066,ca,-119.02949,34.28857,1311,1,3,2,200
93067,ca,-119.59348,34.42196,418,0,0,0,NA
93101,ca,-119.70917,34.41898,7068,0,0,0,NA
93103,ca,-119.68053,34.43775,5928,0,0,0,NA
93105,ca,-119.79968,34.53229,9252,0,0,0,NA
93108,ca,-119.62044,34.44803,5412,0,0,0,NA
93109,ca,-119.7259,34.40598,3916,0,0,0,NA
93110,ca,-119.76254,34.44781,5416,0,0,0,NA
93111,ca,-119.80353,34.44945,5972,0,0,0,NA
93117,ca,-120.08269,34.49096,11508,0,0,0,NA
93201,ca,-119.48756,35.85889,1573,33,51,18,54.5
93202,ca,-119.70833,36.31346,1240,25,42,17,68
93203,ca,-118.83073,35.11188,5877,27,45,18,66.7
93204,ca,-120.0864,35.92647,2987,17,31,14,82.4
93205,ca,-118.4251,35.52026,2066,0,0,0,NA
93206,ca,-119.47435,35.44107,3119,20,36,16,80
93207,ca,-118.63058,35.88983,700,0,0,0,NA
93208,ca,-118.56849,36.05662,781,0,0,0,NA
93210,ca,-120.42309,36.19943,8658,22,36,14,63.6
93212,ca,-119.52776,36.04218,4792,29,47,18,62.1
93215,ca,-119.19796,35.77637,12341,31,50,19,61.3
93218,ca,-119.03616,35.86092,806,29,48,19,65.5
93219,ca,-119.28093,35.87443,4037,31,49,18,58.1
93220,ca,-118.75681,35.39693,300,20,34,14,70
93221,ca,-119.02604,36.295,6023,28,47,19,67.9
93222,ca,-119.19965,34.84498,2940,0,0,0,NA
93223,ca,-119.20489,36.30455,2702,28,46,18,64.3
93224,ca,-119.56927,35.22814,599,12,24,12,100
93225,ca,-119.01985,34.77469,6388,0,0,0,NA
93226,ca,-118.72865,35.73667,507,1,2,1,100
93230,ca,-119.62298,36.288,23266,25,42,17,68
93234,ca,-120.09011,36.19128,1890,30,47,17,56.7
93235,ca,-119.2199,36.38983,1208,26,45,19,73.1
93238,ca,-118.44198,35.80229,1909,4,12,8,200
93239,ca,-119.94601,35.97536,4302,29,46,17,58.6
93240,ca,-118.44269,35.6136,5030,1,4,3,300
93241,ca,-118.91286,35.25578,3170,29,49,20,69
93242,ca,-119.72772,36.44207,1409,25,42,17,68
93243,ca,-118.8014,34.77689,1768,1,2,1,100
93244,ca,-119.01556,36.46691,482,19,36,17,89.5
93245,ca,-119.82876,36.29518,10608,27,44,17,63
93247,ca,-119.06997,36.20457,5699,29,48,19,65.5
93249,ca,-119.87677,35.68826,4345,22,37,15,68.2
93250,ca,-119.19747,35.66575,3927,30,48,18,60
93251,ca,-119.69353,35.36182,2154,13,26,13,100
93252,ca,-119.21477,34.72499,3137,5,11,6,120
93254,ca,-119.77107,34.94866,1434,2,5,3,150
93255,ca,-118.09594,35.68231,1390,2,7,5,250
93256,ca,-119.31555,35.9619,2091,30,49,19,63.3
93257,ca,-118.87179,35.98373,22493,29,48,19,65.5
93258,ca,-119.1504,36.05438,436,31,50,19,61.3
93260,ca,-118.66915,35.81728,1081,0,0,0,NA
93261,ca,-119.12808,35.80853,542,29,48,19,65.5
93262,ca,-118.71107,36.60083,31,0,0,0,NA
93263,ca,-119.28687,35.4928,5819,28,45,17,60.7
93265,ca,-118.6826,36.19565,3620,9,18,9,100
93266,ca,-119.86369,36.15719,1204,30,48,18,60
93267,ca,-119.05192,36.15106,2183,30,49,19,63.3
93268,ca,-119.42516,35.16241,7302,16,31,15,93.8
93270,ca,-119.07285,35.95241,2356,29,48,19,65.5
93271,ca,-118.77801,36.45922,2256,11,22,11,100
93272,ca,-119.34645,36.05087,1261,30,48,18,60
93274,ca,-119.36941,36.18024,23405,28,46,18,64.3
93276,ca,-119.35837,35.29918,155,22,39,17,77.3
93277,ca,-119.381,36.29925,16456,25,42,17,68
93280,ca,-119.44875,35.64807,9371,33,52,19,57.6
93283,ca,-118.2765,35.5694,2795,3,8,5,166.7
93285,ca,-118.50246,35.71608,3821,7,17,10,142.9
93286,ca,-119.10552,36.47024,3396,28,47,19,67.9
93287,ca,-118.93136,35.7293,360,20,34,14,70
93291,ca,-119.36856,36.3896,19346,24,42,18,75
93292,ca,-119.22399,36.37715,15743,25,43,18,72
93301,ca,-119.02082,35.38449,4257,27,46,19,70.4
93304,ca,-119.02345,35.33971,13089,29,47,18,62.1
93305,ca,-118.98519,35.38975,9511,30,49,19,63.3
93306,ca,-118.78982,35.46364,20632,33,53,20,60.6
93307,ca,-118.93633,35.24846,23077,30,49,19,63.3
93308,ca,-118.9357,35.54751,19172,26,43,17,65.4
93309,ca,-119.06629,35.34358,16014,27,45,18,66.7
93311,ca,-119.17444,35.19416,17728,25,43,18,72
93312,ca,-119.12045,35.39348,20107,25,42,17,68
93313,ca,-119.04635,35.16328,17477,28,46,18,64.3
93314,ca,-119.23631,35.38794,12220,25,42,17,68
93401,ca,-120.6171,35.24175,11465,0,0,0,NA
93402,ca,-120.83887,35.29023,6209,0,0,0,NA
93405,ca,-120.7272,35.29784,6052,0,0,0,NA
93420,ca,-120.46509,35.16612,11752,0,0,0,NA
93422,ca,-120.69042,35.46458,12397,0,1,1,NA
93424,ca,-120.73437,35.18681,996,0,0,0,NA
93426,ca,-120.94133,35.84642,2312,11,21,10,90.9
93427,ca,-120.22382,34.60889,2464,0,1,1,NA
93428,ca,-121.03063,35.5893,6518,0,0,0,NA
93429,ca,-120.53651,34.86535,103,0,0,0,NA
93430,ca,-120.92771,35.49082,4278,0,0,0,NA
93432,ca,-120.47106,35.47193,822,5,12,7,140
93433,ca,-120.61951,35.12065,4821,0,0,0,NA
93434,ca,-120.60206,34.92261,2217,0,0,0,NA
93436,ca,-120.39726,34.60522,16122,0,0,0,NA
93437,ca,-120.5435,34.73735,27,0,0,0,NA
93440,ca,-120.24453,34.72943,822,1,1,0,0
93441,ca,-120.03936,34.74775,741,1,2,1,100
93442,ca,-120.80394,35.40186,5968,0,0,0,NA
93444,ca,-120.50428,35.03844,8304,0,0,0,NA
93445,ca,-120.62116,35.03133,2599,0,0,0,NA
93446,ca,-120.73096,35.66351,20521,5,11,6,120
93449,ca,-120.65228,35.15785,4974,0,0,0,NA
93450,ca,-120.82376,36.05642,637,11,21,10,90.9
93451,ca,-120.59289,35.90038,3522,9,18,9,100
93452,ca,-121.20785,35.70953,401,0,0,0,NA
93453,ca,-120.19723,35.34703,10557,4,11,7,175
93454,ca,-120.23478,34.93666,11790,0,1,1,NA
93455,ca,-120.42684,34.82865,17135,0,1,1,NA
93458,ca,-120.49067,34.95708,10609,0,0,0,NA
93460,ca,-120.02448,34.64864,2385,1,3,2,200
93461,ca,-120.27331,35.64706,1615,7,16,9,128.6
93463,ca,-120.14166,34.62186,3456,1,1,0,0
93465,ca,-120.733,35.54013,4005,1,4,3,300
93501,ca,-118.18451,35.06838,19004,9,22,13,144.4
93505,ca,-117.88817,35.16644,53273,11,26,15,136.4
93510,ca,-118.21419,34.46513,4388,2,6,4,200
93512,ca,-118.5647,37.89261,529,0,0,0,NA
93513,ca,-118.13154,37.1186,1525,5,13,8,160
93514,ca,-118.40477,37.50138,8059,2,8,6,300
93516,ca,-117.63211,35.0047,7173,11,25,14,127.3
93517,ca,-119.30296,38.27357,2352,0,0,0,NA
93518,ca,-118.46123,35.37007,3092,1,2,1,100
93519,ca,-117.92931,35.29749,1817,27,46,19,70.4
93522,ca,-117.59572,36.29481,302,5,10,5,100
93523,ca,-117.85027,34.9309,4717,11,26,15,136.4
93524,ca,-117.90713,34.93199,5,10,24,14,140
93526,ca,-118.28514,36.81065,788,5,14,9,180
93527,ca,-118.17705,36.04614,4511,26,44,18,69.2
93528,ca,-117.64322,35.37167,699,5,15,10,200
93529,ca,-119.09808,37.80506,1333,0,0,0,NA
93530,ca,-117.86903,36.48091,177,2,7,5,250
93531,ca,-118.58998,35.21604,487,0,1,1,NA
93532,ca,-118.54421,34.6847,3285,0,1,1,NA
93534,ca,-118.1512,34.71571,12313,12,25,13,108.3
93535,ca,-117.87822,34.71311,42934,11,25,14,127.3
93536,ca,-118.36874,34.74708,42467,7,17,10,142.9
93541,ca,-119.11564,37.98194,1650,0,0,0,NA
93543,ca,-117.97085,34.48919,6914,5,12,7,140
93544,ca,-117.75434,34.493,7454,3,8,5,166.7
93545,ca,-118.05704,36.55786,1674,6,14,8,133.3
93546,ca,-118.85229,37.58418,11477,0,0,0,NA
93549,ca,-117.94903,36.19815,919,4,12,8,200
93550,ca,-118.09169,34.41325,20379,6,15,9,150
93551,ca,-118.23102,34.60168,19498,4,11,7,175
93552,ca,-118.02314,34.57153,12821,7,18,11,157.1
93553,ca,-117.90553,34.42245,3118,3,8,5,166.7
93554,ca,-117.76608,35.41496,934,19,36,17,89.5
93555,ca,-117.68498,35.60745,16907,34,54,20,58.8
93558,ca,-117.62137,35.3479,1172,11,26,15,136.4
93560,ca,-118.34073,34.86643,19030,8,20,12,150
93561,ca,-118.49376,35.11821,20623,0,0,0,NA
93562,ca,-117.38083,35.74808,2504,51,70,19,37.3
93563,ca,-117.76044,34.3966,410,0,0,0,NA
93591,ca,-117.81226,34.60185,10193,8,19,11,137.5
93592,ca,-117.26724,35.93022,874,30,46,16,53.3
93601,ca,-119.74441,37.39377,1102,14,26,12,85.7
93602,ca,-119.31428,37.035,2458,5,12,7,140
93603,ca,-118.95871,36.62048,336,1,2,1,100
93604,ca,-119.47863,37.39172,1671,1,3,2,200
93605,ca,-119.24924,37.20316,68,0,0,0,NA
93606,ca,-120.01856,36.8032,267,25,42,17,68
93608,ca,-120.35799,36.48691,1038,23,38,15,65.2
93609,ca,-119.86411,36.52659,1891,26,44,18,69.2
93610,ca,-120.28774,37.09232,7966,21,37,16,76.2
93611,ca,-119.68023,36.82529,16628,27,44,17,63
93612,ca,-119.7106,36.81488,8592,26,43,17,65.4
93614,ca,-119.73326,37.20789,5911,17,32,15,88.2
93615,ca,-119.28633,36.50332,1416,29,47,18,62.1
93616,ca,-119.59387,36.65535,754,26,44,18,69.2
93618,ca,-119.38943,36.52101,8358,30,49,19,63.3
93619,ca,-119.57918,36.91559,20500,31,50,19,61.3
93620,ca,-120.6288,37.02487,4736,17,31,14,82.4
93621,ca,-119.17208,36.81463,442,7,15,8,114.3
93622,ca,-120.5792,36.80934,4766,13,24,11,84.6
93623,ca,-119.64271,37.49377,235,0,0,0,NA
93624,ca,-120.1163,36.37876,644,27,43,16,59.3
93625,ca,-119.67187,36.62454,2862,25,42,17,68
93626,ca,-119.68071,37.04217,3023,38,58,20,52.6
93627,ca,-120.0876,36.50897,171,27,44,17,63
93628,ca,-118.92517,36.79202,348,0,0,0,NA
93630,ca,-120.12958,36.72116,6030,26,43,17,65.4
93631,ca,-119.52086,36.47562,6204,25,42,17,68
93633,ca,-118.72268,36.79306,302,0,0,0,NA
93634,ca,-118.9422,37.20759,758,0,0,0,NA
93635,ca,-120.84553,37.06907,15641,20,34,14,70
93636,ca,-119.87312,36.98228,7202,31,49,18,58.1
93637,ca,-120.18747,36.91104,13334,27,45,18,66.7
93638,ca,-120.03351,37.04019,12963,27,45,18,66.7
93640,ca,-120.44195,36.67425,3413,17,31,14,82.4
93641,ca,-119.03191,36.69903,746,2,5,3,150
93643,ca,-119.46677,37.22645,2396,7,15,8,114.3
93644,ca,-119.62883,37.37858,5039,6,14,8,133.3
93645,ca,-119.64134,37.17112,325,20,36,16,80
93646,ca,-119.28918,36.64475,2291,31,51,20,64.5
93647,ca,-119.16703,36.59102,2840,28,46,18,64.3
93648,ca,-119.52073,36.62064,3271,28,46,18,64.3
93650,ca,-119.7998,36.84081,1021,26,43,17,65.4
93651,ca,-119.52396,36.99192,896,30,48,18,60
93652,ca,-119.90458,36.59501,138,28,45,17,60.7
93653,ca,-119.94466,37.24956,1356,24,40,16,66.7
93654,ca,-119.40293,36.65712,8835,29,48,19,65.5
93656,ca,-119.93593,36.45515,2449,27,45,18,66.7
93657,ca,-119.44482,36.78349,12480,30,48,18,60
93660,ca,-120.176,36.58284,1472,27,44,17,63
93662,ca,-119.64194,36.53927,8540,25,43,18,72
93664,ca,-119.21103,37.09529,3333,0,0,0,NA
93665,ca,-120.6481,36.96011,266,16,29,13,81.3
93666,ca,-119.33564,36.54707,103,31,50,19,61.3
93667,ca,-119.32517,36.95578,1468,13,26,13,100
93668,ca,-120.285,36.64863,736,26,42,16,61.5
93669,ca,-119.54214,37.28278,305,7,16,9,128.6
93673,ca,-119.48234,36.4527,216,26,43,17,65.4
93675,ca,-119.19349,36.72285,3011,14,28,14,100
93701,ca,-119.78768,36.74966,2571,26,43,17,65.4
93702,ca,-119.75394,36.73918,9695,26,43,17,65.4
93703,ca,-119.76239,36.76886,7976,26,43,17,65.4
93704,ca,-119.80162,36.79911,9030,26,44,18,69.2
93705,ca,-119.82834,36.78668,8997,27,44,17,63
93706,ca,-119.90657,36.65208,11375,26,43,17,65.4
93710,ca,-119.76024,36.82234,7196,26,44,18,69.2
93711,ca,-119.83123,36.83456,13277,27,44,17,63
93720,ca,-119.76159,36.86031,14683,28,46,18,64.3
93721,ca,-119.78374,36.73289,1797,26,43,17,65.4
93722,ca,-119.87726,36.80097,22726,27,44,17,63
93723,ca,-119.95322,36.78624,4773,27,44,17,63
93725,ca,-119.7365,36.62535,7300,25,42,17,68
93726,ca,-119.76145,36.79366,9857,27,44,17,63
93727,ca,-119.68058,36.75155,24206,25,42,17,68
93728,ca,-119.81848,36.75729,4768,26,43,17,65.4
93730,ca,-119.75491,36.90315,5475,31,49,18,58.1
93901,ca,-121.62396,36.63853,7786,0,0,0,NA
93905,ca,-121.60701,36.6832,8999,0,0,0,NA
93906,ca,-121.63229,36.72257,12177,0,0,0,NA
93907,ca,-121.66776,36.76957,7159,0,0,0,NA
93908,ca,-121.60691,36.63426,6287,0,0,0,NA
93920,ca,-121.56162,36.10952,773,0,0,0,NA
93921,ca,-121.92408,36.55343,2990,0,0,0,NA
93923,ca,-121.84576,36.45694,8159,0,0,0,NA
93924,ca,-121.64065,36.39891,3366,0,0,0,NA
93925,ca,-121.43121,36.60064,441,0,1,1,NA
93926,ca,-121.40772,36.52921,2056,0,0,0,NA
93927,ca,-121.37716,36.23358,4456,1,2,1,100
93928,ca,-121.23952,36.03237,9,7,15,8,114.3
93930,ca,-121.03097,36.21474,4517,2,5,3,150
93932,ca,-121.06233,35.99154,583,9,18,9,100
93933,ca,-121.78779,36.6871,5557,0,0,0,NA
93940,ca,-121.84433,36.58019,11119,0,0,0,NA
93943,ca,-121.87414,36.597,1,0,0,0,NA
93950,ca,-121.92535,36.62071,6157,0,0,0,NA
93953,ca,-121.94552,36.58487,3290,0,0,0,NA
93954,ca,-120.94206,36.13313,278,4,10,6,150
93955,ca,-121.79353,36.62171,8864,0,0,0,NA
93960,ca,-121.3411,36.3983,4827,0,1,1,NA
93962,ca,-121.64649,36.62472,272,0,0,0,NA
94002,ca,-122.29892,37.51349,7924,1,2,1,100
94005,ca,-122.4082,37.68868,1832,0,0,0,NA
94010,ca,-122.36526,37.56935,12428,0,0,0,NA
94014,ca,-122.44744,37.69089,9899,0,0,0,NA
94015,ca,-122.48063,37.68125,13571,0,0,0,NA
94019,ca,-122.41612,37.46477,9026,0,0,0,NA
94020,ca,-122.22831,37.28422,1166,1,2,1,100
94021,ca,-122.28071,37.27087,129,1,2,1,100
94022,ca,-122.14438,37.35747,7391,2,3,1,50
94024,ca,-122.09429,37.35229,8146,2,3,1,50
94025,ca,-122.17247,37.46333,12131,1,3,2,200
94027,ca,-122.20404,37.45321,2631,1,3,2,200
94028,ca,-122.21549,37.37861,2759,2,3,1,50
94030,ca,-122.40297,37.59975,6127,0,0,0,NA
94037,ca,-122.49663,37.5543,1405,0,0,0,NA
94038,ca,-122.50621,37.52185,1218,0,0,0,NA
94040,ca,-122.08526,37.38056,6977,1,2,1,100
94041,ca,-122.07573,37.38852,3096,1,2,1,100
94043,ca,-122.07041,37.41751,8551,1,1,0,0
94044,ca,-122.48097,37.6053,12678,0,0,0,NA
94060,ca,-122.337,37.2234,1001,0,1,1,NA
94061,ca,-122.23694,37.46152,8932,2,4,2,100
94062,ca,-122.30717,37.42135,10575,2,4,2,100
94063,ca,-122.20804,37.49511,5355,1,2,1,100
94065,ca,-122.24673,37.53541,2539,0,1,1,NA
94066,ca,-122.43361,37.6251,10629,0,0,0,NA
94070,ca,-122.27003,37.49761,10208,1,3,2,200
94074,ca,-122.34974,37.32592,155,0,1,1,NA
94080,ca,-122.42219,37.6556,15982,0,0,0,NA
94085,ca,-122.01777,37.38857,4992,1,2,1,100
94086,ca,-122.02312,37.37164,9515,1,2,1,100
94087,ca,-122.03694,37.35153,14795,1,3,2,200
94089,ca,-122.01403,37.41157,3269,1,2,1,100
94102,ca,-122.41934,37.77958,1592,0,0,0,NA
94103,ca,-122.41116,37.77315,3108,0,0,0,NA
94104,ca,-122.40213,37.79141,139,0,0,0,NA
94105,ca,-122.39356,37.7899,488,0,0,0,NA
94107,ca,-122.39451,37.76682,3923,0,0,0,NA
94108,ca,-122.40858,37.79202,986,0,0,0,NA
94109,ca,-122.42222,37.79558,3741,0,0,0,NA
94110,ca,-122.41533,37.74998,12732,0,0,0,NA
94111,ca,-122.3979,37.79919,333,0,0,0,NA
94112,ca,-122.44294,37.72037,18745,0,0,0,NA
94114,ca,-122.43541,37.75806,8011,0,0,0,NA
94115,ca,-122.43725,37.78597,3989,0,0,0,NA
94116,ca,-122.48611,37.74461,13930,0,0,0,NA
94117,ca,-122.44824,37.76974,5865,0,0,0,NA
94118,ca,-122.46247,37.78012,7847,0,0,0,NA
94121,ca,-122.49457,37.77652,9319,0,0,0,NA
94122,ca,-122.48513,37.7588,14534,0,0,0,NA
94123,ca,-122.43861,37.80078,4423,0,0,0,NA
94124,ca,-122.38285,37.72907,9581,0,0,0,NA
94127,ca,-122.45947,37.7357,7504,0,0,0,NA
94128,ca,-122.38486,37.6221,22,0,0,0,NA
94129,ca,-122.4668,37.79739,18,0,0,0,NA
94130,ca,-122.36954,37.82069,231,0,0,0,NA
94131,ca,-122.44289,37.74551,7915,0,0,0,NA
94132,ca,-122.48475,37.72205,5416,0,0,0,NA
94133,ca,-122.41075,37.8047,2909,0,0,0,NA
94134,ca,-122.41178,37.71936,9089,0,0,0,NA
94158,ca,-122.3867,37.76936,325,0,0,0,NA
94301,ca,-122.14991,37.44414,5353,1,2,1,100
94303,ca,-122.11858,37.45082,10677,1,1,0,0
94304,ca,-122.17408,37.3816,468,1,3,2,200
94305,ca,-122.17098,37.41699,946,1,2,1,100
94306,ca,-122.13076,37.41571,7922,1,2,1,100
94401,ca,-122.31696,37.57696,5867,0,0,0,NA
94402,ca,-122.33319,37.54098,7514,0,0,0,NA
94403,ca,-122.30457,37.53842,10039,0,0,0,NA
94404,ca,-122.26887,37.55597,7732,0,0,0,NA
94501,ca,-122.27784,37.77392,13650,0,0,0,NA
94502,ca,-122.24555,37.73721,5277,0,0,0,NA
94503,ca,-122.26297,38.18421,5500,1,4,3,300
94505,ca,-121.58632,37.86765,6432,13,23,10,76.9
94506,ca,-121.90636,37.80814,9188,2,5,3,150
94507,ca,-122.02109,37.85042,5943,2,4,2,100
94508,ca,-122.44422,38.57678,999,3,6,3,100
94509,ca,-121.81265,37.99676,19388,8,15,7,87.5
94510,ca,-122.13201,38.09402,11083,2,6,4,200
94511,ca,-121.64068,38.02913,1827,9,17,8,88.9
94512,ca,-121.83823,38.13281,85,6,12,6,100
94513,ca,-121.67508,37.92337,22919,10,18,8,80
94514,ca,-121.62362,37.82532,621,12,22,10,83.3
94515,ca,-122.61863,38.62484,3189,6,12,6,100
94516,ca,-122.16503,37.8339,183,0,0,0,NA
94517,ca,-121.87839,37.89023,5017,2,4,2,100
94518,ca,-122.02205,37.95037,8618,3,6,3,100
94519,ca,-122.01297,37.98845,6455,3,7,4,133.3
94520,ca,-122.04065,37.99545,7868,3,7,4,133.3
94521,ca,-121.95619,37.95601,14212,2,4,2,100
94523,ca,-122.07614,37.95413,11549,3,7,4,133.3
94525,ca,-122.23131,38.05279,1448,1,3,2,200
94526,ca,-121.99154,37.81443,12549,2,5,3,150
94528,ca,-121.95061,37.8456,431,2,4,2,100
94530,ca,-122.29835,37.92153,8937,0,0,0,NA
94531,ca,-121.77582,37.96577,13836,8,15,7,87.5
94533,ca,-122.00673,38.28059,20238,4,9,5,125
94534,ca,-122.13141,38.24227,14750,4,9,5,125
94535,ca,-121.93269,38.28469,29,5,10,5,100
94536,ca,-121.98538,37.57132,17036,1,1,0,0
94538,ca,-121.9636,37.5062,13043,1,1,0,0
94539,ca,-121.91172,37.51693,16274,1,1,0,0
94541,ca,-122.08514,37.67428,13963,0,1,1,NA
94542,ca,-122.03716,37.65989,3903,0,1,1,NA
94544,ca,-122.0572,37.63382,14397,0,1,1,NA
94545,ca,-122.12302,37.61409,8996,0,1,1,NA
94546,ca,-122.08004,37.71485,12977,0,1,1,NA
94547,ca,-122.26433,38.00902,8331,1,2,1,100
94548,ca,-121.6535,37.97345,196,9,18,9,100
94549,ca,-122.11663,37.89746,10339,2,4,2,100
94550,ca,-121.60114,37.52908,17013,3,7,4,133.3
94551,ca,-121.7701,37.75262,15214,4,8,4,100
94552,ca,-122.01792,37.71317,6322,0,1,1,NA
94553,ca,-122.13502,37.99538,17781,3,8,5,166.7
94555,ca,-122.08477,37.55363,9696,1,1,0,0
94556,ca,-122.11492,37.84066,5988,1,1,0,0
94558,ca,-122.25645,38.4549,24685,3,7,4,133.3
94559,ca,-122.30799,38.23291,9445,2,5,3,150
94560,ca,-122.031,37.52048,13396,0,1,1,NA
94561,ca,-121.69259,37.99362,14235,9,16,7,77.8
94563,ca,-122.18456,37.87967,7748,0,1,1,NA
94564,ca,-122.28217,37.99337,6473,0,1,1,NA
94565,ca,-121.90706,38.01582,24846,4,9,5,125
94566,ca,-121.85912,37.64913,13262,3,7,4,133.3
94567,ca,-122.38601,38.70586,994,8,15,7,87.5
94568,ca,-121.91486,37.71526,13455,4,8,4,100
94569,ca,-122.19244,38.03517,159,1,4,3,300
94571,ca,-121.74045,38.15825,5972,8,15,7,87.5
94572,ca,-122.25219,38.03323,2717,1,3,2,200
94573,ca,-122.42612,38.45567,74,6,13,7,116.7
94574,ca,-122.39271,38.53569,4376,5,10,5,100
94575,ca,-122.11057,37.84178,7,0,1,1,NA
94576,ca,-122.47638,38.54942,78,5,11,6,120
94577,ca,-122.16819,37.7126,12846,0,0,0,NA
94578,ca,-122.1253,37.70643,7870,0,0,0,NA
94579,ca,-122.15723,37.6865,5869,0,0,0,NA
94580,ca,-122.13362,37.67701,8140,0,1,1,NA
94582,ca,-121.91537,37.76353,13189,3,7,4,133.3
94583,ca,-121.97267,37.75525,12045,3,6,3,100
94585,ca,-121.92601,38.19381,9267,3,8,5,166.7
94586,ca,-121.85123,37.57374,807,1,3,2,200
94587,ca,-122.01863,37.60315,16272,0,1,1,NA
94588,ca,-121.88189,37.73738,9998,3,7,4,133.3
94589,ca,-122.23586,38.16465,8836,1,3,2,200
94590,ca,-122.24862,38.10306,11382,1,3,2,200
94591,ca,-122.19529,38.12336,18994,2,4,2,100
94592,ca,-122.27468,38.092,401,1,1,0,0
94595,ca,-122.06938,37.87196,5569,2,4,2,100
94596,ca,-122.03756,37.8891,5508,2,6,4,200
94597,ca,-122.07167,37.91819,6700,3,7,4,133.3
94598,ca,-122.00046,37.90109,10231,2,5,3,150
94599,ca,-122.3605,38.41143,915,6,12,6,100
94601,ca,-122.21838,37.77671,9274,0,0,0,NA
94602,ca,-122.20694,37.80412,9029,0,0,0,NA
94603,ca,-122.17944,37.73654,8168,0,0,0,NA
94605,ca,-122.14841,37.7604,13076,0,0,0,NA
94606,ca,-122.24496,37.79171,5872,0,0,0,NA
94607,ca,-122.30212,37.80749,4469,0,0,0,NA
94608,ca,-122.28921,37.83682,6202,0,0,0,NA
94609,ca,-122.26437,37.83439,5027,0,0,0,NA
94610,ca,-122.2424,37.8114,6098,0,0,0,NA
94611,ca,-122.20237,37.83017,12946,0,0,0,NA
94612,ca,-122.26917,37.80877,1295,0,0,0,NA
94613,ca,-122.18285,37.78085,15,0,0,0,NA
94618,ca,-122.23887,37.84396,5719,0,0,0,NA
94619,ca,-122.13144,37.77757,7902,0,0,0,NA
94621,ca,-122.21043,37.73538,7117,0,0,0,NA
94702,ca,-122.28632,37.86577,4723,0,0,0,NA
94703,ca,-122.27564,37.8639,4682,0,0,0,NA
94704,ca,-122.25804,37.86653,2026,0,0,0,NA
94705,ca,-122.23816,37.86519,4293,0,0,0,NA
94706,ca,-122.29553,37.88966,5020,0,0,0,NA
94707,ca,-122.27914,37.89818,4930,0,0,0,NA
94708,ca,-122.26196,37.90267,4994,0,0,0,NA
94709,ca,-122.26684,37.87923,1662,0,0,0,NA
94710,ca,-122.30928,37.86536,2214,0,0,0,NA
94720,ca,-122.25494,37.87383,25,0,0,0,NA
94801,ca,-122.38369,37.95287,7989,0,0,0,NA
94803,ca,-122.28358,37.95955,8868,0,1,1,NA
94804,ca,-122.34308,37.91584,12528,0,0,0,NA
94805,ca,-122.32293,37.9428,5041,0,0,0,NA
94806,ca,-122.33719,37.98059,14632,0,0,0,NA
94850,ca,-122.31903,37.90287,5,0,0,0,NA
94901,ca,-122.49683,37.97876,12405,0,0,0,NA
94903,ca,-122.55047,38.02499,10614,0,1,1,NA
94904,ca,-122.56273,37.9452,4407,0,0,0,NA
94920,ca,-122.46369,37.88426,5280,0,0,0,NA
94922,ca,-122.94952,38.34187,174,0,0,0,NA
94923,ca,-123.03099,38.34163,1880,0,0,0,NA
94924,ca,-122.71829,37.94134,1242,0,0,0,NA
94925,ca,-122.50842,37.92534,3678,0,0,0,NA
94928,ca,-122.69413,38.34642,11970,1,1,0,0
94929,ca,-122.96272,38.25242,527,0,0,0,NA
94930,ca,-122.61275,37.96513,3568,0,1,1,NA
94931,ca,-122.71599,38.32467,3257,1,1,0,0
94933,ca,-122.68748,38.0126,415,0,0,0,NA
94937,ca,-122.91723,38.11373,864,0,0,0,NA
94938,ca,-122.72653,38.02907,438,0,0,0,NA
94939,ca,-122.53405,37.93718,2738,0,0,0,NA
94940,ca,-122.87278,38.17045,251,0,0,0,NA
94941,ca,-122.55876,37.89502,12272,0,0,0,NA
94945,ca,-122.5578,38.12785,6927,1,2,1,100
94946,ca,-122.69434,38.07892,387,0,0,0,NA
94947,ca,-122.6297,38.11324,9028,1,2,1,100
94949,ca,-122.53519,38.06551,5849,1,1,0,0
94950,ca,-122.75994,38.02489,71,0,0,0,NA
94951,ca,-122.64613,38.32086,1843,1,1,0,0
94952,ca,-122.75894,38.2346,12337,1,2,1,100
94954,ca,-122.55818,38.2334,12298,1,2,1,100
94956,ca,-122.85854,38.04733,1174,0,0,0,NA
94957,ca,-122.56362,37.9631,507,0,0,0,NA
94960,ca,-122.57782,37.99586,6123,0,1,1,NA
94963,ca,-122.67012,38.01372,292,0,0,0,NA
94964,ca,-122.49213,37.94324,43,0,0,0,NA
94965,ca,-122.52697,37.85133,4637,0,0,0,NA
94970,ca,-122.64688,37.91447,930,0,0,0,NA
94971,ca,-122.91514,38.24178,266,0,0,0,NA
94972,ca,-122.96086,38.28829,48,0,0,0,NA
94973,ca,-122.6396,38.0127,772,0,1,1,NA
95002,ca,-122.00825,37.4429,873,1,2,1,100
95003,ca,-121.87857,37.00831,12201,0,0,0,NA
95004,ca,-121.63302,36.8741,1429,0,1,1,NA
95005,ca,-122.08716,37.09907,3623,2,3,1,50
95006,ca,-122.1474,37.16995,6902,1,3,2,200
95007,ca,-122.1069,37.10496,438,1,2,1,100
95008,ca,-121.95502,37.27968,13259,2,3,1,50
95010,ca,-121.95335,36.97635,3987,0,0,0,NA
95012,ca,-121.75399,36.77666,2197,0,0,0,NA
95013,ca,-121.74152,37.21536,71,2,5,3,150
95014,ca,-122.08065,37.30493,16322,2,4,2,100
95017,ca,-122.24179,37.10313,639,0,0,0,NA
95018,ca,-122.05935,37.0741,6390,1,2,1,100
95019,ca,-121.78315,36.93554,1334,0,0,0,NA
95020,ca,-121.54993,37.01426,18283,4,8,4,100
95023,ca,-121.35127,36.89992,16931,1,3,2,200
95030,ca,-121.98361,37.22303,5213,1,2,1,100
95032,ca,-121.92795,37.21505,9034,1,3,2,200
95033,ca,-121.98214,37.16014,5464,1,2,1,100
95035,ca,-121.8743,37.44421,20182,1,2,1,100
95037,ca,-121.59374,37.16776,17346,2,6,4,200
95039,ca,-121.77544,36.8266,470,0,0,0,NA
95041,ca,-122.05782,37.05042,97,1,1,0,0
95043,ca,-120.96139,36.52513,2621,4,9,5,125
95045,ca,-121.52742,36.8341,1779,0,1,1,NA
95046,ca,-121.59503,37.0961,2050,3,7,4,133.3
95050,ca,-121.95231,37.35114,8773,1,3,2,200
95051,ca,-121.98437,37.34864,14118,1,3,2,200
95053,ca,-121.93756,37.34872,16,1,3,2,200
95054,ca,-121.9647,37.39341,5250,1,2,1,100
95060,ca,-122.11978,37.03131,15293,0,0,0,NA
95062,ca,-121.9886,36.97018,11613,0,0,0,NA
95064,ca,-122.05902,36.99111,196,0,0,0,NA
95065,ca,-121.98334,37.03148,2883,0,1,1,NA
95066,ca,-122.01398,37.06792,6026,1,2,1,100
95070,ca,-122.04962,37.25636,11525,2,3,1,50
95073,ca,-121.93004,37.04226,3698,0,1,1,NA
95075,ca,-121.14128,36.7802,474,2,5,3,150
95076,ca,-121.74949,36.93871,20561,0,0,0,NA
95110,ca,-121.90984,37.34653,4093,1,3,2,200
95111,ca,-121.82655,37.28347,10348,2,4,2,100
95112,ca,-121.88354,37.34449,9879,1,2,1,100
95113,ca,-121.891,37.33369,304,1,2,1,100
95116,ca,-121.85258,37.35042,8205,1,2,1,100
95117,ca,-121.96188,37.31121,5420,1,3,2,200
95118,ca,-121.88999,37.25552,9243,2,4,2,100
95119,ca,-121.78601,37.22898,3301,2,4,2,100
95120,ca,-121.84391,37.18238,13365,1,2,1,100
95121,ca,-121.80987,37.30416,8912,2,3,1,50
95122,ca,-121.83527,37.32868,9668,1,3,2,200
95123,ca,-121.83306,37.24486,16862,2,4,2,100
95124,ca,-121.92273,37.25684,15106,2,4,2,100
95125,ca,-121.89141,37.29505,16199,1,3,2,200
95126,ca,-121.91675,37.32678,7229,1,3,2,200
95127,ca,-121.80076,37.37109,14142,1,2,1,100
95128,ca,-121.93631,37.31598,8047,1,3,2,200
95129,ca,-122.00093,37.30574,10058,2,4,2,100
95130,ca,-121.98173,37.28821,3828,2,3,1,50
95131,ca,-121.89741,37.3871,8415,1,2,1,100
95132,ca,-121.76421,37.43075,11255,1,2,1,100
95133,ca,-121.86084,37.37161,6955,1,2,1,100
95134,ca,-121.94345,37.42857,1213,1,2,1,100
95135,ca,-121.69567,37.28984,6830,1,1,0,0
95136,ca,-121.8518,37.27049,9808,2,4,2,100
95138,ca,-121.73464,37.24742,5609,1,3,2,200
95139,ca,-121.76407,37.22492,2224,2,5,3,150
95140,ca,-121.6197,37.3897,337,1,3,2,200
95148,ca,-121.77929,37.33539,11502,1,2,1,100
95202,ca,-121.28764,37.95949,1297,14,25,11,78.6
95203,ca,-121.33153,37.95251,5045,14,24,10,71.4
95204,ca,-121.3199,37.97389,10460,14,24,10,71.4
95205,ca,-121.25999,37.9645,10861,14,25,11,78.6
95206,ca,-121.42134,37.9141,18504,14,25,11,78.6
95207,ca,-121.32499,38.00243,12465,14,24,10,71.4
95209,ca,-121.35082,38.04725,12905,14,24,10,71.4
95210,ca,-121.29878,38.03035,9226,13,24,11,84.6
95211,ca,-121.313,37.97972,8,13,24,11,84.6
95212,ca,-121.22814,38.0483,7905,13,23,10,76.9
95215,ca,-121.15291,37.94389,7486,14,25,11,78.6
95219,ca,-121.48582,38.04198,9488,14,24,10,71.4
95220,ca,-121.23817,38.19719,2903,11,20,9,81.8
95222,ca,-120.62049,38.06467,4357,12,24,12,100
95223,ca,-119.97449,38.43419,11106,0,1,1,NA
95224,ca,-120.32717,38.22526,361,2,6,4,200
95225,ca,-120.8889,38.19882,401,17,31,14,82.4
95226,ca,-120.85804,38.22865,141,16,30,14,87.5
95227,ca,-121.04325,38.20667,716,15,27,12,80
95228,ca,-120.69216,37.95167,4940,14,28,14,100
95230,ca,-120.88197,37.96072,647,16,29,13,81.3
95231,ca,-121.29001,37.87392,927,15,26,11,73.3
95232,ca,-120.59401,38.35534,266,5,14,9,180
95233,ca,-120.37053,38.17624,399,5,14,9,180
95234,ca,-121.52777,37.92544,130,14,24,10,71.4
95236,ca,-121.02945,38.0395,2203,15,27,12,80
95237,ca,-121.14981,38.16166,1202,12,22,10,83.3
95240,ca,-121.14902,38.11307,14210,10,20,10,100
95242,ca,-121.39359,38.13458,11219,10,19,9,90
95245,ca,-120.62132,38.29794,2332,9,19,10,111.1
95246,ca,-120.5179,38.23281,1561,6,15,9,150
95247,ca,-120.45321,38.13807,3546,7,16,9,128.6
95248,ca,-120.46134,38.32398,478,2,6,4,200
95249,ca,-120.62658,38.18984,2728,13,26,13,100
95250,ca,-120.42865,38.23784,132,2,7,5,250
95251,ca,-120.45473,38.08235,518,9,20,11,122.2
95252,ca,-120.84696,38.14949,8184,16,29,13,81.3
95254,ca,-120.95509,38.19508,393,18,32,14,77.8
95255,ca,-120.47591,38.41966,1921,2,7,5,250
95257,ca,-120.4445,38.38056,467,1,5,4,400
95258,ca,-121.31025,38.16832,1503,10,19,9,90
95301,ca,-120.63372,37.31798,11089,19,34,15,78.9
95303,ca,-120.66188,37.48293,435,14,28,14,100
95304,ca,-121.3999,37.67836,6286,13,24,11,84.6
95305,ca,-120.27187,37.80468,312,3,8,5,166.7
95306,ca,-120.12909,37.38408,832,17,32,15,88.2
95307,ca,-120.95137,37.55432,11309,12,23,11,91.7
95310,ca,-120.37089,38.09138,1485,4,11,7,175
95311,ca,-120.08201,37.70449,2342,8,17,9,112.5
95312,ca,-120.65298,37.42107,103,14,27,13,92.9
95313,ca,-121.04692,37.42998,758,20,33,13,65
95314,ca,-119.835,38.3248,194,0,0,0,NA
95315,ca,-120.7715,37.42361,3322,14,27,13,92.9
95316,ca,-120.71396,37.55325,2595,12,24,12,100
95317,ca,-120.51503,37.12726,326,20,35,15,75
95318,ca,-119.7994,37.64514,60,1,2,1,100
95319,ca,-120.90309,37.63936,356,12,23,11,91.7
95320,ca,-121.01346,37.82527,5052,14,26,12,85.7
95321,ca,-120.02593,37.86087,5388,1,4,3,300
95322,ca,-121.01677,37.17017,4321,20,34,14,70
95323,ca,-120.68547,37.61004,544,14,26,12,85.7
95324,ca,-120.89379,37.39507,2658,15,28,13,86.7
95325,ca,-120.2415,37.48498,178,28,46,18,64.3
95326,ca,-120.85288,37.59045,3326,11,22,11,100
95327,ca,-120.47967,37.86072,4452,11,23,12,109.1
95328,ca,-120.90985,37.55828,1208,12,23,11,91.7
95329,ca,-120.40342,37.67564,3624,22,39,17,77.3
95330,ca,-121.31052,37.81352,9398,14,25,11,78.6
95333,ca,-120.24044,37.24227,1474,17,32,15,88.2
95334,ca,-120.74312,37.34807,4611,16,30,14,87.5
95335,ca,-120.09666,38.10944,2024,0,0,0,NA
95336,ca,-121.19701,37.83233,15254,13,24,11,84.6
95337,ca,-121.23853,37.74165,13381,13,24,11,84.6
95338,ca,-119.98251,37.50979,7367,7,16,9,128.6
95340,ca,-120.42428,37.33903,12538,21,37,16,76.2
95341,ca,-120.51438,37.23084,8417,22,38,16,72.7
95345,ca,-119.9652,37.59019,379,3,8,5,166.7
95346,ca,-120.17935,38.0675,1672,0,1,1,NA
95348,ca,-120.50012,37.39584,10014,22,37,15,68.2
95350,ca,-121.00732,37.67191,16075,13,23,10,76.9
95351,ca,-120.9964,37.62322,11276,12,23,11,91.7
95354,ca,-120.96596,37.63819,9010,12,23,11,91.7
95355,ca,-120.947,37.67283,17927,12,23,11,91.7
95356,ca,-121.02532,37.72038,10397,13,24,11,84.6
95357,ca,-120.8805,37.66797,4112,12,23,11,91.7
95358,ca,-121.10178,37.61576,9286,13,23,10,76.9
95360,ca,-121.22571,37.29165,4612,24,39,15,62.5
95361,ca,-120.75709,37.78646,12650,13,25,12,92.3
95363,ca,-121.21672,37.46349,9264,16,28,12,75
95364,ca,-119.81336,38.21142,1298,0,0,0,NA
95365,ca,-120.29481,37.33112,1271,16,32,16,100
95366,ca,-121.12449,37.76259,6498,13,23,10,76.9
95367,ca,-120.94077,37.72834,7213,13,24,11,84.6
95368,ca,-121.08997,37.71614,4368,13,24,11,84.6
95369,ca,-120.43175,37.53344,899,18,33,15,83.3
95370,ca,-120.34883,37.98462,15133,4,11,7,175
95372,ca,-120.26088,37.99168,940,1,5,4,400
95374,ca,-120.85284,37.31615,890,20,35,15,75
95375,ca,-120.02601,38.1867,517,0,0,0,NA
95376,ca,-121.43337,37.7372,14738,14,24,10,71.4
95377,ca,-121.49547,37.65668,11358,12,22,10,83.3
95379,ca,-120.19398,37.94692,2456,2,6,4,200
95380,ca,-120.86866,37.47199,11776,12,24,12,100
95382,ca,-120.85305,37.52841,11224,12,23,11,91.7
95383,ca,-120.2328,38.10786,4485,0,1,1,NA
95385,ca,-121.25124,37.60949,235,14,24,10,71.4
95386,ca,-120.63949,37.66918,3386,13,25,12,92.3
95387,ca,-121.32774,37.50588,479,10,19,9,90
95388,ca,-120.59157,37.41811,3747,15,28,13,86.7
95389,ca,-119.53543,37.72675,1260,0,0,0,NA
95391,ca,-121.60533,37.76308,8007,12,21,9,75
95401,ca,-122.79225,38.44898,10826,1,2,1,100
95403,ca,-122.75441,38.5025,13343,1,2,1,100
95404,ca,-122.65196,38.46568,15128,1,2,1,100
95405,ca,-122.66599,38.43711,7583,1,2,1,100
95407,ca,-122.74433,38.39452,10189,1,2,1,100
95409,ca,-122.59752,38.461,11125,1,3,2,200
95410,ca,-123.69264,39.20615,959,0,0,0,NA
95412,ca,-123.34981,38.71343,415,0,0,0,NA
95415,ca,-123.37077,39.01527,1112,3,7,4,133.3
95417,ca,-123.61002,39.68981,555,0,1,1,NA
95420,ca,-123.80636,39.36735,247,0,0,0,NA
95421,ca,-123.19327,38.63032,2688,0,0,0,NA
95422,ca,-122.62312,38.97628,15883,7,15,8,114.3
95423,ca,-122.62739,39.06485,5148,7,14,7,100
95425,ca,-123.04216,38.81933,5383,6,13,7,116.7
95426,ca,-122.73126,38.8323,2083,2,5,3,150
95427,ca,-123.56357,39.24419,524,1,2,1,100
95428,ca,-123.17884,39.82723,3189,6,13,7,116.7
95429,ca,-123.29601,39.72743,339,5,10,5,100
95430,ca,-123.04719,38.46143,40,0,0,0,NA
95432,ca,-123.64021,39.1052,755,0,1,1,NA
95435,ca,-122.86951,39.00721,40,11,20,9,81.8
95436,ca,-122.91419,38.49099,3862,0,0,0,NA
95437,ca,-123.733,39.45614,7065,0,0,0,NA
95439,ca,-122.77755,38.49318,282,0,0,0,NA
95441,ca,-122.90501,38.73091,1564,2,6,4,200
95442,ca,-122.51286,38.37673,1661,2,6,4,200
95443,ca,-122.73957,39.04947,221,7,13,6,85.7
95444,ca,-122.869,38.43322,280,0,1,1,NA
95445,ca,-123.49842,38.83195,2336,0,0,0,NA
95446,ca,-123.00418,38.5266,4904,0,0,0,NA
95448,ca,-122.88593,38.62393,8810,2,5,3,150
95449,ca,-123.10126,38.94215,1487,5,10,5,100
95450,ca,-123.1693,38.49441,799,0,0,0,NA
95451,ca,-122.8041,38.93285,8160,5,11,6,120
95452,ca,-122.5352,38.42552,862,3,6,3,100
95453,ca,-122.93731,39.04561,6274,12,20,8,66.7
95454,ca,-123.51001,39.80655,3458,1,3,2,200
95456,ca,-123.75134,39.26114,547,0,0,0,NA
95457,ca,-122.53158,38.88145,3025,7,14,7,100
95458,ca,-122.74743,39.15051,9123,4,9,5,125
95459,ca,-123.59082,38.98114,1175,0,1,1,NA
95460,ca,-123.76001,39.30988,1966,0,0,0,NA
95461,ca,-122.59665,38.76113,2843,5,10,5,100
95462,ca,-123.02234,38.46167,1794,0,0,0,NA
95463,ca,-123.55838,39.18679,200,1,2,1,100
95464,ca,-122.84935,39.12838,3970,8,16,8,100
95465,ca,-123.01948,38.40641,1807,0,0,0,NA
95466,ca,-123.50397,39.08622,1209,2,5,3,150
95467,ca,-122.54058,38.80355,3678,9,17,8,88.9
95468,ca,-123.6085,38.91183,1193,0,0,0,NA
95469,ca,-123.05398,39.39944,2512,4,10,6,150
95470,ca,-123.24667,39.31171,2850,7,15,8,114.3
95471,ca,-122.96877,38.52408,527,0,0,0,NA
95472,ca,-122.86576,38.39816,11351,0,1,1,NA
95476,ca,-122.45714,38.24859,14361,2,6,4,200
95482,ca,-123.24291,39.1603,12242,7,13,6,85.7
95485,ca,-122.92044,39.2171,2041,5,11,6,120
95486,ca,-123.0242,38.47414,57,0,0,0,NA
95488,ca,-123.75939,39.68971,679,0,0,0,NA
95490,ca,-123.33933,39.49709,12901,1,3,2,200
95492,ca,-122.81714,38.53036,9521,1,1,0,0
95493,ca,-122.97201,39.18533,122,6,12,6,100
95494,ca,-123.33784,38.88967,609,1,3,2,200
95497,ca,-123.45264,38.71655,2756,0,0,0,NA
95501,ca,-124.15096,40.79811,8570,0,0,0,NA
95503,ca,-124.09611,40.72426,10147,0,0,0,NA
95511,ca,-123.63026,40.17126,572,3,8,5,166.7
95514,ca,-123.65245,40.29124,525,2,5,3,150
95519,ca,-124.0478,40.95634,7138,0,0,0,NA
95521,ca,-124.06551,40.84883,6767,0,0,0,NA
95524,ca,-124.04528,40.82108,870,0,0,0,NA
95525,ca,-123.82272,40.92502,1375,0,1,1,NA
95526,ca,-123.69085,40.45667,1170,1,2,1,100
95527,ca,-123.43174,40.85339,713,6,13,7,116.7
95528,ca,-123.92807,40.49924,1079,0,1,1,NA
95531,ca,-124.0331,41.79779,12321,0,0,0,NA
95536,ca,-124.27437,40.51695,2167,0,0,0,NA
95537,ca,-124.21738,40.72675,130,0,0,0,NA
95540,ca,-124.13647,40.57867,5824,0,0,0,NA
95542,ca,-123.78495,40.08673,2502,1,2,1,100
95543,ca,-123.86229,41.87129,735,0,0,0,NA
95545,ca,-124.06366,40.28042,318,0,0,0,NA
95546,ca,-123.73274,41.16041,2346,6,12,6,100
95547,ca,-124.08121,40.55749,608,0,0,0,NA
95548,ca,-124.04835,41.59096,1522,0,0,0,NA
95549,ca,-123.91524,40.67477,872,0,1,1,NA
95550,ca,-123.81845,40.7733,724,0,1,1,NA
95551,ca,-124.22124,40.66946,919,0,0,0,NA
95552,ca,-123.23112,40.1984,2005,0,1,1,NA
95553,ca,-123.89616,40.24435,732,0,2,2,NA
95554,ca,-123.79454,40.28413,735,2,5,3,150
95555,ca,-123.99054,41.30108,972,0,0,0,NA
95556,ca,-123.58462,41.30079,643,5,11,6,120
95558,ca,-124.23454,40.29607,1285,0,0,0,NA
95559,ca,-123.74827,40.18592,207,0,2,2,NA
95560,ca,-123.83859,40.16454,949,0,0,0,NA
95562,ca,-124.12515,40.46242,1476,0,0,0,NA
95563,ca,-123.49848,40.87627,554,9,17,8,88.9
95564,ca,-124.20386,40.78952,319,0,0,0,NA
95565,ca,-124.01097,40.45778,461,0,0,0,NA
95567,ca,-124.11707,41.95041,1346,0,0,0,NA
95568,ca,-123.4634,41.45329,197,6,12,6,100
95569,ca,-123.85533,40.36747,505,0,1,1,NA
95570,ca,-124.11618,41.1396,1774,0,0,0,NA
95571,ca,-123.92056,40.32244,190,0,1,1,NA
95573,ca,-123.66098,40.88935,1750,9,16,7,77.8
95585,ca,-123.657,39.8447,726,0,1,1,NA
95587,ca,-123.77574,39.96326,337,0,0,0,NA
95589,ca,-123.97109,40.05162,5877,0,0,0,NA
95595,ca,-123.42455,40.11673,835,4,8,4,100
95601,ca,-120.82506,38.42594,195,10,20,10,100
95602,ca,-121.11042,38.9906,7551,5,11,6,120
95603,ca,-121.08043,38.91702,12760,7,16,9,128.6
95604,ca,-120.07141,39.2433,147,0,0,0,NA
95605,ca,-121.53928,38.59289,3967,14,25,11,78.6
95606,ca,-122.19545,38.75605,199,14,25,11,78.6
95607,ca,-122.12729,38.79156,619,14,24,10,71.4
95608,ca,-121.32824,38.62584,18932,12,23,11,91.7
95610,ca,-121.27176,38.69491,12729,15,28,13,86.7
95612,ca,-121.57566,38.39226,853,12,22,10,83.3
95614,ca,-120.98287,38.88374,2266,5,13,8,160
95615,ca,-121.5465,38.31429,431,10,19,9,90
95616,ca,-121.79771,38.55933,10377,15,26,11,73.3
95618,ca,-121.68315,38.54065,7998,15,26,11,73.3
95619,ca,-120.81559,38.68311,2317,7,15,8,114.3
95620,ca,-121.75294,38.40975,7698,15,26,11,73.3
95621,ca,-121.30828,38.69573,12726,14,26,12,85.7
95623,ca,-120.85851,38.59674,2095,9,18,9,100
95624,ca,-121.30908,38.43041,20895,12,22,10,83.3
95625,ca,-121.91155,38.35812,97,7,14,7,100
95626,ca,-121.46803,38.73298,2391,13,25,12,92.3
95627,ca,-122.01425,38.72608,1424,20,34,14,70
95628,ca,-121.25429,38.65197,15192,14,26,12,85.7
95629,ca,-120.68849,38.51647,859,5,13,8,160
95630,ca,-121.1418,38.66707,25936,13,26,13,100
95631,ca,-120.79093,39.05606,4019,4,10,6,150
95632,ca,-121.25963,38.27434,10369,11,20,9,81.8
95633,ca,-120.82586,38.84781,1935,5,12,7,140
95634,ca,-120.77168,38.93581,2504,3,8,5,166.7
95635,ca,-120.90862,38.90497,814,5,12,7,140
95636,ca,-120.38324,38.62126,1747,1,4,3,300
95637,ca,-122.23691,38.83413,295,15,26,11,73.3
95638,ca,-121.12261,38.33434,1121,12,22,10,83.3
95639,ca,-121.50018,38.3903,180,12,22,10,83.3
95640,ca,-120.94261,38.32956,4562,17,31,14,82.4
95641,ca,-121.59025,38.14099,1128,9,17,8,88.9
95642,ca,-120.76103,38.34264,3827,12,24,12,100
95645,ca,-121.78687,38.88661,1579,19,33,14,73.7
95646,ca,-120.06181,38.69154,558,0,0,0,NA
95648,ca,-121.3117,38.92542,23996,19,34,15,78.9
95650,ca,-121.17076,38.81288,6141,14,27,13,92.9
95651,ca,-120.92927,38.81782,400,7,16,9,128.6
95652,ca,-121.40112,38.66306,311,13,24,11,84.6
95653,ca,-121.97722,38.69325,192,20,34,14,70
95655,ca,-121.27933,38.54957,1473,11,22,11,100
95658,ca,-121.15385,38.87954,3000,10,21,11,110
95659,ca,-121.57134,38.83994,676,16,29,13,81.3
95660,ca,-121.37998,38.67856,8716,13,24,11,84.6
95661,ca,-121.24914,38.7413,10769,16,30,14,87.5
95662,ca,-121.21981,38.68914,11278,16,29,13,81.3
95663,ca,-121.18233,38.8558,1291,13,25,12,92.3
95664,ca,-121.05066,38.79899,1023,8,17,9,112.5
95665,ca,-120.6514,38.40209,2491,8,18,10,125
95666,ca,-120.36821,38.53215,5121,2,7,5,250
95667,ca,-120.78986,38.73525,18491,6,14,8,133.3
95668,ca,-121.49255,38.82843,620,15,27,12,80
95669,ca,-120.89837,38.48221,1616,12,23,11,91.7
95670,ca,-121.28,38.60475,15921,12,23,11,91.7
95672,ca,-120.99805,38.72527,2299,9,18,9,100
95673,ca,-121.46147,38.68971,5548,13,24,11,84.6
95674,ca,-121.48185,38.95416,517,17,31,14,82.4
95675,ca,-120.7405,38.5447,334,5,13,8,160
95677,ca,-121.23436,38.79136,9380,18,32,14,77.8
95678,ca,-121.2875,38.76401,14347,17,32,15,88.2
95679,ca,-122.32718,38.886,193,10,19,9,90
95680,ca,-121.58458,38.23977,44,10,18,8,80
95681,ca,-121.35289,38.99801,651,17,32,15,88.2
95682,ca,-120.96635,38.61111,12068,10,20,10,100
95683,ca,-121.10149,38.50767,3484,14,27,13,92.9
95684,ca,-120.58454,38.59698,2971,4,10,6,150
95685,ca,-120.76784,38.43109,3243,9,19,10,111.1
95686,ca,-121.48914,38.19165,468,10,20,10,100
95687,ca,-121.92043,38.33692,18863,8,16,8,100
95688,ca,-122.02267,38.40913,13723,13,22,9,69.2
95689,ca,-120.61196,38.47886,1298,4,10,6,150
95690,ca,-121.5785,38.23609,1158,10,19,9,90
95691,ca,-121.58236,38.61719,13391,13,25,12,92.3
95692,ca,-121.40383,39.04588,2147,16,30,14,87.5
95693,ca,-121.2124,38.40001,2770,12,22,10,83.3
95694,ca,-122.00677,38.5559,3974,21,34,13,61.9
95695,ca,-121.85708,38.68709,11756,19,33,14,73.7
95697,ca,-121.81026,38.73237,131,21,35,14,66.7
95698,ca,-121.91209,38.81749,319,22,37,15,68.2
95699,ca,-120.8595,38.43542,168,12,25,13,108.3
95701,ca,-120.76636,39.22737,1112,0,2,2,NA
95703,ca,-120.98528,38.9909,508,4,11,7,175
95709,ca,-120.67937,38.74886,2456,3,9,6,200
95713,ca,-120.91606,39.08997,5161,4,10,6,150
95714,ca,-120.83936,39.20123,468,0,2,2,NA
95715,ca,-120.6762,39.26433,493,0,0,0,NA
95717,ca,-120.85258,39.14453,250,1,5,4,400
95720,ca,-120.2265,38.76709,1081,0,0,0,NA
95721,ca,-120.08181,38.8344,780,0,0,0,NA
95722,ca,-121.02846,39.00591,2399,4,10,6,150
95724,ca,-120.32811,39.31172,106,0,0,0,NA
95726,ca,-120.51645,38.80334,6319,2,6,4,200
95728,ca,-120.42588,39.317,1795,0,0,0,NA
95735,ca,-120.15231,38.82062,528,0,0,0,NA
95736,ca,-120.97752,39.03881,22,4,10,6,150
95742,ca,-121.1983,38.57509,7009,12,23,11,91.7
95746,ca,-121.18103,38.75127,8620,14,27,13,92.9
95747,ca,-121.37295,38.78143,28545,16,29,13,81.3
95757,ca,-121.43367,38.34332,16496,12,22,10,83.3
95758,ca,-121.44345,38.4279,19691,12,23,11,91.7
95762,ca,-121.05773,38.67641,19703,11,22,11,100
95765,ca,-121.27809,38.8186,13531,19,35,16,84.2
95776,ca,-121.70566,38.6825,8019,18,32,14,77.8
95811,ca,-121.48509,38.58752,2526,13,25,12,92.3
95814,ca,-121.49507,38.58045,1878,13,25,12,92.3
95815,ca,-121.44734,38.60548,7405,13,24,11,84.6
95816,ca,-121.46684,38.57153,5107,13,24,11,84.6
95817,ca,-121.45637,38.55055,5272,13,24,11,84.6
95818,ca,-121.49665,38.55589,7982,13,24,11,84.6
95819,ca,-121.43975,38.56971,7868,13,24,11,84.6
95820,ca,-121.44437,38.53488,12400,13,24,11,84.6
95821,ca,-121.38445,38.62589,9186,13,24,11,84.6
95822,ca,-121.4956,38.51277,14522,12,23,11,91.7
95823,ca,-121.44346,38.4741,17648,13,23,10,76.9
95824,ca,-121.44074,38.51758,7247,12,23,11,91.7
95825,ca,-121.40636,38.59036,5926,13,24,11,84.6
95826,ca,-121.37913,38.54514,11688,12,23,11,91.7
95827,ca,-121.32554,38.55506,5891,12,22,10,83.3
95828,ca,-121.39584,38.48879,16892,12,23,11,91.7
95829,ca,-121.33251,38.48924,10554,12,23,11,91.7
95830,ca,-121.27242,38.49413,364,12,22,10,83.3
95831,ca,-121.52937,38.49592,13892,13,24,11,84.6
95832,ca,-121.49647,38.44512,3034,13,23,10,76.9
95833,ca,-121.5159,38.61566,10130,14,25,11,78.6
95834,ca,-121.52025,38.64204,9636,14,25,11,78.6
95835,ca,-121.52576,38.67074,12572,13,25,12,92.3
95837,ca,-121.59151,38.70044,664,14,26,12,85.7
95838,ca,-121.44493,38.64678,11400,13,24,11,84.6
95841,ca,-121.34739,38.66037,4619,13,24,11,84.6
95842,ca,-121.34916,38.68678,7704,13,25,12,92.3
95843,ca,-121.36342,38.71546,12897,13,25,12,92.3
95864,ca,-121.37618,38.5853,9161,12,23,11,91.7
95901,ca,-121.49155,39.22184,12927,19,34,15,78.9
95903,ca,-121.36827,39.10252,257,13,25,12,92.3
95910,ca,-120.82264,39.47441,240,0,1,1,NA
95912,ca,-122.06182,39.01651,3083,20,34,14,70
95914,ca,-121.36329,39.40996,437,9,19,10,111.1
95915,ca,-121.20872,39.97545,79,0,1,1,NA
95916,ca,-121.3636,39.66073,2585,4,10,6,150
95917,ca,-121.76252,39.41905,1866,19,35,16,84.2
95918,ca,-121.33339,39.29653,1713,14,27,13,92.9
95919,ca,-121.26114,39.43289,1031,4,10,6,150
95920,ca,-121.93701,39.46074,484,21,37,16,76.2
95922,ca,-121.07193,39.48486,718,3,8,5,166.7
95923,ca,-121.11557,40.1579,330,0,0,0,NA
95925,ca,-121.17955,39.46889,373,3,8,5,166.7
95926,ca,-121.84383,39.74563,10785,22,39,17,77.3
95928,ca,-121.84455,39.68377,12596,21,38,17,81
95930,ca,-121.19352,39.5519,252,0,2,2,NA
95932,ca,-121.99884,39.27205,3603,18,31,13,72.2
95934,ca,-120.92855,40.0719,355,0,0,0,NA
95935,ca,-121.19117,39.37756,603,5,13,8,160
95936,ca,-120.79217,39.60729,617,0,0,0,NA
95937,ca,-121.99904,38.88524,745,22,37,15,68.2
95938,ca,-121.79877,39.60299,1912,22,39,17,77.3
95939,ca,-122.59294,39.56331,1280,9,17,8,88.9
95941,ca,-121.24228,39.521,750,1,5,4,400
95942,ca,-121.56463,40.01873,1305,2,6,4,200
95943,ca,-122.0367,39.5857,731,23,40,17,73.9
95944,ca,-120.93146,39.49933,224,0,1,1,NA
95945,ca,-120.97702,39.19509,11921,1,5,4,400
95946,ca,-121.20124,39.21534,5294,7,15,8,114.3
95947,ca,-120.8197,40.17455,1683,0,1,1,NA
95948,ca,-121.76037,39.34373,4460,19,34,15,78.9
95949,ca,-121.13517,39.10259,10737,3,9,6,200
95950,ca,-121.92093,39.04397,489,18,32,14,77.8
95951,ca,-122.00225,39.71693,821,24,41,17,70.8
95953,ca,-121.7739,39.25079,4553,19,35,16,84.2
95954,ca,-121.58526,39.89154,7000,2,7,5,250
95955,ca,-122.20735,39.29414,1371,22,38,16,72.7
95956,ca,-121.13636,39.83806,803,0,0,0,NA
95957,ca,-121.82827,39.0622,1084,18,32,14,77.8
95959,ca,-120.9206,39.33851,11815,1,3,2,200
95960,ca,-121.0443,39.3898,867,6,13,7,116.7
95961,ca,-121.5576,39.03343,10368,18,33,15,83.3
95962,ca,-121.26629,39.34594,1024,8,18,10,125
95963,ca,-122.2621,39.73635,7408,21,37,16,76.2
95965,ca,-121.59601,39.59469,10459,18,32,14,77.8
95966,ca,-121.42818,39.47124,15640,17,31,14,82.4
95968,ca,-121.55193,39.43521,614,23,40,17,73.9
95969,ca,-121.64745,39.71629,12316,8,18,10,125
95970,ca,-122.0603,39.40057,726,22,38,16,72.7
95971,ca,-120.90022,39.93719,3547,0,1,1,NA
95973,ca,-121.84823,39.89742,13018,21,36,15,71.4
95974,ca,-121.83846,39.48022,29,20,35,15,75
95975,ca,-121.15159,39.22435,907,3,9,6,200
95977,ca,-121.28792,39.17695,1168,11,22,11,100
95978,ca,-121.53631,39.87561,112,0,1,1,NA
95979,ca,-122.51585,39.30152,2401,10,19,9,90
95981,ca,-121.03597,39.63606,1008,0,0,0,NA
95982,ca,-121.80467,39.18313,1611,19,34,15,78.9
95983,ca,-120.70728,40.07791,629,0,0,0,NA
95984,ca,-121.12265,40.04094,153,0,1,1,NA
95986,ca,-120.77088,39.34255,235,0,0,0,NA
95987,ca,-122.28248,39.09611,3500,20,34,14,70
95988,ca,-122.2743,39.50508,4572,25,41,16,64
95991,ca,-121.61292,39.0224,12760,22,38,16,72.7
95993,ca,-121.68847,39.08189,12671,22,37,15,68.2
96001,ca,-122.46004,40.59652,16399,26,43,17,65.4
96002,ca,-122.31735,40.53021,13090,26,42,16,61.5
96003,ca,-122.23872,40.74374,19425,27,44,17,63
96006,ca,-120.85298,41.17425,1342,0,0,0,NA
96007,ca,-122.27911,40.45868,10613,21,37,16,76.2
96008,ca,-122.1082,40.71234,995,22,37,15,68.2
96009,ca,-121.04104,41.06347,1864,0,0,0,NA
96010,ca,-123.24628,40.91941,677,3,6,3,100
96011,ca,-121.98343,41.05007,805,3,7,4,133.3
96013,ca,-121.68638,41.0015,2847,0,1,1,NA
96014,ca,-122.77793,41.33895,647,0,0,0,NA
96015,ca,-120.91727,41.50374,1379,0,0,0,NA
96016,ca,-121.52314,40.91152,422,1,3,2,200
96017,ca,-122.27,41.11948,700,3,7,4,133.3
96019,ca,-122.37739,40.67916,5050,27,44,17,63
96020,ca,-121.29635,40.36702,2850,0,0,0,NA
96021,ca,-122.26529,39.92648,8945,26,43,17,65.4
96022,ca,-122.44701,40.33505,9595,20,35,15,75
96023,ca,-121.9071,41.92688,2477,0,1,1,NA
96024,ca,-122.89045,40.5754,1280,2,5,3,150
96025,ca,-122.31377,41.21063,2298,1,3,2,200
96027,ca,-123.06883,41.38387,2548,1,3,2,200
96028,ca,-121.47204,41.01056,1828,0,1,1,NA
96029,ca,-122.4781,39.94209,186,22,38,16,72.7
96031,ca,-123.18183,41.18352,601,2,4,2,100
96032,ca,-122.96414,41.60672,3004,1,4,3,300
96033,ca,-122.56918,40.76366,711,4,10,6,150
96034,ca,-122.61542,41.43184,564,1,2,1,100
96035,ca,-122.182,40.04683,1729,26,44,18,69.2
96037,ca,-122.93505,41.548,240,3,7,4,133.3
96038,ca,-122.54643,41.60892,378,3,7,4,133.3
96039,ca,-123.48888,41.69297,1991,4,9,5,125
96040,ca,-121.42265,40.77867,674,0,1,1,NA
96041,ca,-123.19446,40.52364,3169,2,6,4,200
96044,ca,-122.52005,41.94082,3225,2,5,3,150
96046,ca,-123.42904,40.59968,625,6,12,6,100
96047,ca,-122.66394,40.4643,1520,16,29,13,81.3
96048,ca,-123.05215,40.82106,797,6,12,6,100
96049,ca,-123.32591,41.76841,120,5,11,6,120
96050,ca,-122.88689,41.90004,1069,2,5,3,150
96051,ca,-122.40311,40.93259,2469,10,21,11,110
96052,ca,-122.8154,40.72819,1141,1,4,3,300
96054,ca,-121.10044,41.26649,1083,0,0,0,NA
96055,ca,-122.03555,40.0852,2207,24,40,16,66.7
96056,ca,-121.28307,41.02369,3601,0,1,1,NA
96057,ca,-121.93608,41.26796,2965,0,1,1,NA
96058,ca,-121.93254,41.72778,2523,0,0,0,NA
96059,ca,-121.83237,40.42753,838,5,11,6,120
96061,ca,-121.48649,40.33072,815,0,0,0,NA
96062,ca,-122.07101,40.5739,784,21,37,16,76.2
96063,ca,-121.60477,40.36023,536,0,0,0,NA
96064,ca,-122.36204,41.75995,7375,1,4,3,300
96065,ca,-121.88084,40.88819,468,2,5,3,150
96067,ca,-122.36777,41.30917,5468,0,1,1,NA
96068,ca,-121.20864,41.11524,425,0,0,0,NA
96069,ca,-122.00979,40.68676,1106,10,19,9,90
96071,ca,-121.45881,40.66362,721,0,0,0,NA
96073,ca,-122.20187,40.59528,2254,24,40,16,66.7
96074,ca,-122.59375,39.86741,540,13,23,10,76.9
96075,ca,-121.84893,40.3385,765,4,8,4,100
96076,ca,-122.92753,40.38277,850,3,7,4,133.3
96080,ca,-122.38167,40.16516,15536,22,37,15,68.2
96084,ca,-121.96889,40.85037,881,4,10,6,150
96085,ca,-123.05273,41.75227,215,2,4,2,100
96086,ca,-123.2204,41.8746,713,2,5,3,150
96087,ca,-122.61599,40.62393,858,13,24,11,84.6
96088,ca,-121.87943,40.5099,4679,3,6,3,100
96090,ca,-122.12912,40.02044,263,27,45,18,66.7
96091,ca,-122.78816,41.03581,2132,2,6,4,200
96092,ca,-122.01554,39.96239,371,27,44,17,63
96093,ca,-122.93794,40.75872,2287,5,10,5,100
96094,ca,-122.31794,41.53308,7902,0,1,1,NA
96096,ca,-121.8394,40.64527,1013,4,10,6,150
96097,ca,-122.67266,41.75581,5973,2,6,4,200
96101,ca,-120.53624,41.45585,22308,0,0,0,NA
96103,ca,-120.66083,39.80118,2879,0,0,0,NA
96104,ca,-120.12915,41.51615,1156,0,0,0,NA
96105,ca,-120.17824,39.83322,1130,0,0,0,NA
96106,ca,-120.54373,39.73666,1295,0,0,0,NA
96107,ca,-119.47278,38.48028,1087,0,0,0,NA
96108,ca,-120.44572,41.77514,1194,0,0,0,NA
96109,ca,-120.09795,40.01966,1768,0,1,1,NA
96110,ca,-120.09362,41.29331,577,0,0,0,NA
96111,ca,-120.04178,39.47534,352,0,0,0,NA
96112,ca,-120.10599,41.86018,613,0,0,0,NA
96113,ca,-120.15845,40.14286,735,0,2,2,NA
96114,ca,-120.497,40.29472,1867,0,0,0,NA
96115,ca,-120.14957,41.69863,420,0,0,0,NA
96116,ca,-120.42213,41.26314,733,0,0,0,NA
96117,ca,-120.23995,40.54621,1443,0,0,0,NA
96118,ca,-120.22928,39.63881,1519,0,0,0,NA
96119,ca,-120.52525,41.02325,1469,0,0,0,NA
96120,ca,-119.83335,38.75373,1150,0,0,0,NA
96121,ca,-120.37315,40.16886,376,0,0,0,NA
96122,ca,-120.47239,39.82645,4115,0,0,0,NA
96123,ca,-120.29681,40.81018,1007,0,0,0,NA
96124,ca,-120.45043,39.64341,440,0,0,0,NA
96125,ca,-120.62773,39.59567,892,0,0,0,NA
96126,ca,-120.45681,39.5299,595,0,0,0,NA
96128,ca,-120.4105,40.35519,431,0,1,1,NA
96129,ca,-120.35559,39.78761,369,0,0,0,NA
96130,ca,-120.68497,40.54876,12632,0,0,0,NA
96132,ca,-120.37765,40.89052,3214,0,0,0,NA
96133,ca,-119.50412,38.63293,138,0,0,0,NA
96134,ca,-121.40653,41.83828,3503,0,1,1,NA
96135,ca,-120.20566,39.80868,96,0,0,0,NA
96136,ca,-120.11897,40.30837,821,0,1,1,NA
96137,ca,-121.02973,40.26882,6212,0,0,0,NA
96140,ca,-120.09805,39.22463,1838,0,0,0,NA
96141,ca,-120.17343,39.07858,2462,0,0,0,NA
96142,ca,-120.12583,38.9995,3280,0,0,0,NA
96143,ca,-120.02501,39.25126,3805,0,0,0,NA
96145,ca,-120.18669,39.14735,6196,0,0,0,NA
96146,ca,-120.23898,39.19843,2561,0,0,0,NA
96148,ca,-120.05801,39.24691,848,0,0,0,NA
96150,ca,-120.00888,38.87089,27924,0,0,0,NA
96155,ca,-120.09173,38.75191,262,0,0,0,NA
96161,ca,-120.21027,39.30952,23054,0,0,0,NA
97001,or,-120.65003,44.92446,376,1,3,2,200
97002,or,-122.79899,45.23709,3340,1,3,2,200
97004,or,-122.46002,45.25113,2364,0,2,2,NA
97005,or,-122.80359,45.49096,6950,1,3,2,200
97006,or,-122.85986,45.51702,19844,1,3,2,200
97007,or,-122.87968,45.45432,24656,1,2,1,100
97008,or,-122.8042,45.46019,8535,1,3,2,200
97009,or,-122.33788,45.42426,3682,1,2,1,100
97011,or,-122.02653,45.38726,547,0,0,0,NA
97013,or,-122.6717,45.21813,8742,1,3,2,200
97014,or,-122.01836,45.58406,1299,0,0,0,NA
97015,or,-122.53842,45.41482,6758,1,4,3,300
97016,or,-123.26882,46.05878,5045,0,1,1,NA
97017,or,-122.38502,45.17176,1580,0,1,1,NA
97018,or,-122.81083,45.8949,884,2,4,2,100
97019,or,-122.21112,45.51017,2169,1,2,1,100
97020,or,-122.83749,45.22204,256,1,3,2,200
97021,or,-121.14213,45.38707,1179,2,5,3,150
97022,or,-122.33032,45.34597,1818,1,2,1,100
97023,or,-122.22608,45.23533,5454,0,1,1,NA
97024,or,-122.44133,45.54704,2813,1,4,3,300
97026,or,-122.95105,45.10669,1534,1,3,2,200
97027,or,-122.59291,45.38693,3984,2,4,2,100
97028,or,-121.75272,45.28232,932,0,0,0,NA
97029,or,-120.80846,45.28739,622,1,3,2,200
97030,or,-122.43195,45.50896,9923,1,3,2,200
97031,or,-121.54562,45.6249,9010,1,3,2,200
97032,or,-122.78523,45.17923,1858,1,3,2,200
97033,or,-120.58759,45.23357,345,1,3,2,200
97034,or,-122.68391,45.4093,8757,1,3,2,200
97035,or,-122.72513,45.41324,10117,1,3,2,200
97037,or,-121.02613,45.06758,1598,2,5,3,150
97038,or,-122.55768,45.08756,7151,1,2,1,100
97039,or,-120.6644,45.45603,637,1,2,1,100
97040,or,-121.38813,45.62476,1175,1,2,1,100
97041,or,-121.61987,45.43968,1546,0,1,1,NA
97042,or,-122.53454,45.20576,1629,1,2,1,100
97045,or,-122.53076,45.32844,21484,1,3,2,200
97048,or,-122.98086,46.04453,4357,0,1,1,NA
97049,or,-121.86511,45.35858,2858,0,0,0,NA
97050,or,-120.77169,45.68275,256,4,10,6,150
97051,or,-122.91218,45.8847,7168,2,4,2,100
97053,or,-122.88586,45.82713,1644,1,4,3,300
97054,or,-122.93372,45.94812,995,1,2,1,100
97055,or,-122.15498,45.38866,8695,0,1,1,NA
97056,or,-122.95464,45.78126,6220,1,3,2,200
97057,or,-120.74993,45.00276,139,0,1,1,NA
97058,or,-121.15332,45.53874,9328,3,8,5,166.7
97060,or,-122.37031,45.53424,6825,1,3,2,200
97062,or,-122.76197,45.36875,8616,1,3,2,200
97063,or,-121.29268,45.22294,1428,2,6,4,200
97064,or,-123.22829,45.87266,2924,0,1,1,NA
97065,or,-120.65764,45.59894,1040,2,5,3,150
97067,or,-122.01959,45.30635,2358,0,0,0,NA
97068,or,-122.66928,45.35304,12462,1,4,3,300
97070,or,-122.77149,45.30763,8322,1,3,2,200
97071,or,-122.82655,45.13593,8748,1,3,2,200
97080,or,-122.38948,45.47847,14590,1,2,1,100
97086,or,-122.52812,45.44519,10681,1,3,2,200
97089,or,-122.4433,45.42548,5585,1,3,2,200
97101,or,-123.21729,45.09042,2135,1,3,2,200
97102,or,-123.95939,45.79918,941,0,0,0,NA
97103,or,-123.70594,46.13331,11278,0,0,0,NA
97106,or,-123.13345,45.65471,2163,1,2,1,100
97107,or,-123.88078,45.55441,1595,0,0,0,NA
97108,or,-123.70871,45.26888,861,0,0,0,NA
97109,or,-123.18116,45.73782,431,0,1,1,NA
97110,or,-123.95532,45.90108,1675,0,0,0,NA
97111,or,-123.1957,45.29159,1732,1,3,2,200
97112,or,-123.87195,45.2618,2579,0,0,0,NA
97113,or,-123.04616,45.50545,4541,1,3,2,200
97114,or,-123.07179,45.18241,2289,1,3,2,200
97115,or,-123.027,45.2723,1831,1,3,2,200
97116,or,-123.17354,45.5826,8715,1,3,2,200
97117,or,-123.28746,45.61289,459,1,2,1,100
97118,or,-123.91123,45.56098,760,0,0,0,NA
97119,or,-123.19968,45.46868,2542,1,2,1,100
97121,or,-123.95618,46.18155,1058,0,0,0,NA
97122,or,-123.8196,45.17637,433,0,0,0,NA
97123,or,-122.98415,45.44162,15355,1,3,2,200
97124,or,-122.94646,45.56782,15503,1,3,2,200
97125,or,-123.21218,45.66742,114,1,2,1,100
97127,or,-123.11135,45.2461,1420,1,3,2,200
97128,or,-123.25456,45.19703,12869,1,3,2,200
97130,or,-123.92689,45.69458,1888,0,0,0,NA
97131,or,-123.82218,45.74026,3478,0,0,0,NA
97132,or,-122.98711,45.3223,10806,1,3,2,200
97133,or,-123.0196,45.68201,2870,1,2,1,100
97134,or,-123.97437,45.45753,639,0,0,0,NA
97135,or,-123.96335,45.20388,1916,0,0,0,NA
97136,or,-123.91887,45.62289,4782,0,0,0,NA
97137,or,-122.95879,45.21612,757,1,3,2,200
97138,or,-123.6736,45.90276,9441,0,0,0,NA
97140,or,-122.86428,45.35503,10023,1,3,2,200
97141,or,-123.75951,45.47123,9389,0,0,0,NA
97144,or,-123.3096,45.74046,302,0,1,1,NA
97145,or,-123.95073,45.85117,990,0,0,0,NA
97146,or,-123.94706,46.13223,5071,0,0,0,NA
97147,or,-123.88197,45.68879,512,0,0,0,NA
97148,or,-123.24661,45.35589,2184,1,3,2,200
97149,or,-123.95284,45.10524,1786,0,0,0,NA
97201,or,-122.68974,45.50784,6079,1,3,2,200
97202,or,-122.64408,45.48293,14430,1,3,2,200
97203,or,-122.75369,45.60642,10945,1,3,2,200
97204,or,-122.67382,45.51837,327,1,3,2,200
97205,or,-122.70214,45.51894,1679,1,2,1,100
97206,or,-122.59866,45.48195,19282,1,3,2,200
97208,or,-122.67898,45.52867,2,1,3,2,200
97209,or,-122.68439,45.53095,7459,1,3,2,200
97210,or,-122.72994,45.54686,5686,1,3,2,200
97211,or,-122.63429,45.58138,13311,1,3,2,200
97212,or,-122.64347,45.54424,9311,1,3,2,200
97213,or,-122.59954,45.53781,11913,1,3,2,200
97214,or,-122.64326,45.51434,8312,1,3,2,200
97215,or,-122.59972,45.51468,6671,1,3,2,200
97216,or,-122.5584,45.51389,5232,1,3,2,200
97217,or,-122.70388,45.59997,13907,1,3,2,200
97218,or,-122.60078,45.57678,5182,1,3,2,200
97219,or,-122.69987,45.45398,16642,1,3,2,200
97220,or,-122.5592,45.54974,10208,1,3,2,200
97221,or,-122.72786,45.49796,5004,1,2,1,100
97222,or,-122.61711,45.4413,11462,1,4,3,300
97223,or,-122.77946,45.44034,17003,1,3,2,200
97224,or,-122.79507,45.4055,12673,1,3,2,200
97225,or,-122.77007,45.50217,8513,1,2,1,100
97227,or,-122.67852,45.54434,1885,1,3,2,200
97229,or,-122.80994,45.55063,25962,1,2,1,100
97230,or,-122.50729,45.55821,12250,1,3,2,200
97231,or,-122.82749,45.67952,3567,1,2,1,100
97232,or,-122.64361,45.52922,3875,1,3,2,200
97233,or,-122.49945,45.51405,9099,1,3,2,200
97236,or,-122.51055,45.48472,10033,1,3,2,200
97239,or,-122.6906,45.48843,8223,1,3,2,200
97266,or,-122.55845,45.48265,10967,1,3,2,200
97267,or,-122.61494,45.40774,11186,2,4,2,100
97301,or,-123.00398,44.94903,14894,1,3,2,200
97302,or,-123.06786,44.90188,14728,1,2,1,100
97303,or,-123.02438,45.0304,12172,1,3,2,200
97304,or,-123.1081,45.009,12101,1,3,2,200
97305,or,-122.92871,45.01436,10612,1,3,2,200
97306,or,-123.07969,44.84466,11173,1,2,1,100
97317,or,-122.90735,44.90261,7641,1,2,1,100
97321,or,-123.13327,44.65197,12204,1,2,1,100
97322,or,-123.01893,44.62601,11247,1,2,1,100
97324,or,-123.62686,44.35567,1395,0,2,2,NA
97325,or,-122.8517,44.83133,2780,1,2,1,100
97326,or,-123.60118,44.61593,1314,0,1,1,NA
97327,or,-122.9476,44.37506,1756,1,2,1,100
97329,or,-122.38458,44.41124,605,1,2,1,100
97330,or,-123.2766,44.63641,14035,1,2,1,100
97331,or,-123.28041,44.56461,9,1,2,1,100
97333,or,-123.30733,44.47368,7800,1,2,1,100
97338,or,-123.3463,44.927,9621,1,3,2,200
97341,or,-124.05154,44.80966,2794,0,0,0,NA
97342,or,-121.88887,44.73974,805,0,2,2,NA
97343,or,-123.7434,44.55853,783,0,1,1,NA
97344,or,-123.46461,44.8691,878,1,2,1,100
97345,or,-122.57085,44.41465,623,1,2,1,100
97346,or,-122.35783,44.76902,828,0,0,0,NA
97347,or,-123.65655,45.0771,1226,0,1,1,NA
97348,or,-123.12297,44.38452,980,1,2,1,100
97350,or,-121.91591,44.64071,363,0,1,1,NA
97351,or,-123.17489,44.83831,4053,1,3,2,200
97352,or,-123.03142,44.7515,2536,1,2,1,100
97355,or,-122.82271,44.53099,12714,1,2,1,100
97357,or,-123.80477,44.73946,340,0,0,0,NA
97358,or,-122.41264,44.80596,2188,0,1,1,NA
97360,or,-122.47458,44.76526,1462,0,1,1,NA
97361,or,-123.33914,44.76919,4716,1,2,1,100
97362,or,-122.77018,45.06915,1624,1,2,1,100
97364,or,-123.98678,44.99888,436,0,0,0,NA
97365,or,-124.01492,44.66855,7148,0,0,0,NA
97366,or,-124.05144,44.57748,1655,0,0,0,NA
97367,or,-123.97522,44.91557,10139,0,0,0,NA
97368,or,-123.90635,45.00604,3090,0,0,0,NA
97369,or,-124.05177,44.76151,420,0,0,0,NA
97370,or,-123.46029,44.56896,4409,0,2,2,NA
97371,or,-123.20653,44.98779,788,1,3,2,200
97373,or,-122.77175,45.05704,1,1,2,1,100
97374,or,-122.78398,44.69271,2955,1,2,1,100
97375,or,-122.59639,44.97734,1023,0,1,1,NA
97376,or,-123.98024,44.50852,1721,0,0,0,NA
97377,or,-123.10476,44.46393,671,1,2,1,100
97378,or,-123.4296,45.07347,3979,1,3,2,200
97380,or,-123.93681,44.77822,1431,0,0,0,NA
97381,or,-122.7457,44.97267,7000,0,1,1,NA
97383,or,-122.72162,44.79361,3876,0,1,1,NA
97384,or,-122.61888,44.79099,15,0,1,1,NA
97385,or,-122.72834,44.86654,1472,0,1,1,NA
97386,or,-122.75171,44.35983,6741,0,2,2,NA
97388,or,-124.02332,44.89197,1472,0,0,0,NA
97389,or,-123.0898,44.53349,876,1,2,1,100
97390,or,-123.85883,44.31499,923,0,0,0,NA
97391,or,-123.89575,44.62569,3776,0,0,0,NA
97392,or,-122.94134,44.78939,2887,1,2,1,100
97394,or,-123.97712,44.42606,4874,0,0,0,NA
97396,or,-123.52159,45.11934,2089,1,2,1,100
97401,or,-123.08186,44.06822,11093,1,3,2,200
97402,or,-123.23003,44.05155,18143,1,3,2,200
97403,or,-123.05298,44.03585,3582,1,2,1,100
97404,or,-123.133,44.10489,13087,1,3,2,200
97405,or,-123.19153,43.93976,20572,1,2,1,100
97406,or,-124.01398,42.62135,503,1,2,1,100
97408,or,-123.05444,44.14459,5411,1,3,2,200
97410,or,-123.14783,42.79897,839,0,2,2,NA
97411,or,-124.36429,43.07658,6827,0,0,0,NA
97412,or,-123.56091,44.19597,705,1,3,2,200
97413,or,-122.02808,44.10058,1379,1,4,3,300
97414,or,-124.17393,42.96513,272,0,0,0,NA
97415,or,-124.23607,42.13686,8528,0,0,0,NA
97416,or,-123.6854,43.03588,854,0,1,1,NA
97417,or,-123.23004,42.95314,1164,3,7,4,133.3
97419,or,-123.40939,44.17574,668,1,2,1,100
97420,or,-124.15191,43.35501,15487,0,0,0,NA
97423,or,-124.17293,43.19486,4105,0,0,0,NA
97424,or,-123.05441,43.74446,8839,0,2,2,NA
97426,or,-123.03668,43.89991,4407,1,2,1,100
97429,or,-123.06349,42.96831,747,2,5,3,150
97430,or,-123.70522,44.17495,536,1,2,1,100
97431,or,-122.81871,43.87446,1133,0,1,1,NA
97434,or,-122.79333,43.66773,1093,0,1,1,NA
97435,or,-123.33496,43.70036,1885,1,3,2,200
97436,or,-123.59204,43.64042,1048,1,3,2,200
97437,or,-123.38905,44.09687,1290,1,3,2,200
97438,or,-122.68838,43.95087,1043,0,2,2,NA
97439,or,-124.04166,44.06487,12194,0,0,0,NA
97441,or,-124.16288,43.75019,267,0,0,0,NA
97442,or,-123.40464,42.77046,1586,1,4,3,300
97443,or,-123.0107,43.24705,1411,1,2,1,100
97444,or,-124.34449,42.47955,4635,0,0,0,NA
97446,or,-123.05752,44.26784,2261,1,2,1,100
97447,or,-122.5155,43.27533,629,1,2,1,100
97448,or,-123.28154,44.21055,6239,1,3,2,200
97449,or,-124.08394,43.57615,2267,0,0,0,NA
97450,or,-124.39751,42.90428,1841,0,0,0,NA
97451,or,-123.26785,43.81514,353,1,2,1,100
97452,or,-122.72127,43.88053,974,0,1,1,NA
97453,or,-123.8595,43.99817,1226,0,1,1,NA
97454,or,-122.82168,44.22157,1040,1,2,1,100
97455,or,-122.91731,43.96456,1178,0,1,1,NA
97456,or,-123.36051,44.34027,2180,1,2,1,100
97457,or,-123.22018,43.05432,5647,2,5,3,150
97458,or,-124.01849,43.05969,3980,0,0,0,NA
97459,or,-124.17649,43.48707,8055,0,0,0,NA
97461,or,-123.48948,44.09772,580,1,3,2,200
97462,or,-123.38295,43.48633,3139,1,3,2,200
97463,or,-122.40392,43.74776,2463,0,2,2,NA
97465,or,-124.38224,42.75414,2225,0,0,0,NA
97466,or,-124.07256,42.86681,714,0,0,0,NA
97467,or,-123.95642,43.71026,3816,0,0,0,NA
97469,or,-123.42474,42.92196,1781,1,4,3,300
97470,or,-123.23433,43.22975,9851,1,4,3,300
97471,or,-123.47585,43.22016,13598,2,4,2,100
97473,or,-123.87381,43.67799,569,0,1,1,NA
97476,or,-124.41233,42.8355,357,0,0,0,NA
97477,or,-123.01118,44.05878,12604,1,2,1,100
97478,or,-122.85139,44.09094,14750,1,2,1,100
97479,or,-123.19975,43.40241,4680,1,3,2,200
97480,or,-123.83566,44.1358,471,1,2,1,100
97481,or,-123.55218,43.11385,306,1,3,2,200
97484,or,-122.85017,42.94004,543,1,4,3,300
97486,or,-123.52858,43.382,820,1,3,2,200
97487,or,-123.39094,43.98619,4198,1,3,2,200
97488,or,-122.4452,44.12754,1333,1,4,3,300
97489,or,-122.64588,44.13709,642,1,4,3,300
97490,or,-123.612,44.00423,642,1,2,1,100
97492,or,-122.49539,43.72142,524,0,2,2,NA
97493,or,-124.01996,43.89716,703,0,0,0,NA
97494,or,-123.32808,43.3304,23,1,3,2,200
97495,or,-123.30544,43.28777,769,1,3,2,200
97496,or,-123.49005,43.05775,3743,1,4,3,300
97497,or,-123.39221,42.66678,1347,1,3,2,200
97498,or,-124.02309,44.2833,3048,0,0,0,NA
97499,or,-123.25551,43.59277,1614,1,2,1,100
97501,or,-122.90541,42.28177,15172,3,8,5,166.7
97502,or,-122.95624,42.41723,11878,5,11,6,120
97503,or,-122.92742,42.59032,4518,5,10,5,100
97504,or,-122.79865,42.32691,18512,3,7,4,133.3
97520,or,-122.55125,42.1577,12779,1,2,1,100
97522,or,-122.52832,42.58126,670,0,1,1,NA
97523,or,-123.5711,42.12097,4105,4,9,5,125
97524,or,-122.67703,42.45098,7667,5,10,5,100
97525,or,-123.07485,42.44373,2619,3,7,4,133.3
97526,or,-123.34028,42.51405,15660,4,9,5,125
97527,or,-123.40811,42.38228,15389,4,9,5,125
97530,or,-123.05757,42.15192,4529,1,4,3,300
97531,or,-123.64941,42.20419,300,6,13,7,116.7
97532,or,-123.52216,42.57179,1503,5,10,5,100
97534,or,-123.75983,42.08425,587,3,7,4,133.3
97535,or,-122.81146,42.26775,1797,3,6,3,100
97536,or,-122.50562,42.78735,860,1,2,1,100
97537,or,-123.14128,42.54655,3754,3,7,4,133.3
97538,or,-123.58169,42.27369,1560,4,9,5,125
97539,or,-122.79042,42.60009,1720,3,8,5,166.7
97540,or,-122.80855,42.19974,3250,2,5,3,150
97541,or,-122.75469,42.73852,1104,2,5,3,150
97543,or,-123.56213,42.37506,469,5,10,5,100
97544,or,-123.31335,42.13221,1362,1,4,3,300
97601,or,-122.07475,42.44885,15642,0,1,1,NA
97603,or,-121.68075,42.14089,13837,0,1,1,NA
97604,or,-122.17723,42.94659,17,0,0,0,NA
97620,or,-119.78386,42.20633,1035,0,0,0,NA
97621,or,-121.28231,42.47656,3461,0,1,1,NA
97622,or,-121.03405,42.41913,2253,0,1,1,NA
97623,or,-121.31967,42.18157,5608,0,1,1,NA
97624,or,-121.7055,42.74171,8415,0,1,1,NA
97625,or,-121.58098,42.31483,274,0,1,1,NA
97626,or,-122.02786,42.66863,350,0,1,1,NA
97627,or,-122.01887,42.1219,678,0,0,0,NA
97630,or,-120.36646,42.31308,5814,0,0,0,NA
97632,or,-121.42342,42.0321,943,0,1,1,NA
97633,ca,-121.56334,42.03071,873,0,1,1,NA
97634,or,-121.81493,42.1283,132,0,1,1,NA
97635,ca,-120.29871,41.93712,791,0,0,0,NA
97636,or,-120.52184,42.6109,491,0,0,0,NA
97637,or,-119.91402,42.52582,717,0,0,0,NA
97638,or,-120.99843,43.13953,1341,0,1,1,NA
97639,or,-121.43652,42.45144,3537,0,1,1,NA
97640,or,-120.6717,42.89027,752,0,1,1,NA
97641,or,-120.51877,43.26455,6991,0,1,1,NA
97701,or,-121.33106,44.01484,32819,0,1,1,NA
97702,or,-121.24358,43.99864,22645,0,1,1,NA
97707,or,-121.49524,43.8258,10427,0,1,1,NA
97710,or,-118.47581,42.18627,388,0,1,1,NA
97711,or,-120.63168,44.72296,433,0,1,1,NA
97712,or,-120.45308,43.78287,513,0,0,0,NA
97720,or,-118.84711,43.56856,5066,0,1,1,NA
97721,or,-118.5828,42.90399,1390,0,1,1,NA
97722,or,-118.69497,42.95082,343,0,0,0,NA
97730,or,-121.64717,44.50232,377,0,1,1,NA
97731,or,-121.79743,43.14603,348,0,1,1,NA
97732,or,-118.4532,43.39671,246,0,1,1,NA
97733,or,-121.95668,43.37924,2324,0,0,0,NA
97734,or,-121.33487,44.54039,2817,1,2,1,100
97735,or,-120.92595,43.41067,407,0,1,1,NA
97736,or,-119.0058,42.71474,867,0,0,0,NA
97737,or,-121.73111,43.50271,610,0,0,0,NA
97738,or,-119.15178,43.52256,1180,0,0,0,NA
97739,or,-121.46219,43.6996,9831,0,0,0,NA
97741,or,-121.05269,44.65183,6432,1,3,2,200
97750,or,-120.11662,44.6386,796,1,2,1,100
97751,or,-119.87395,44.13759,400,0,1,1,NA
97752,or,-120.29793,44.13731,162,0,1,1,NA
97753,or,-121.01555,44.23519,2110,0,1,1,NA
97754,or,-120.57083,44.15228,14293,0,1,1,NA
97756,or,-121.21384,44.27855,19200,0,1,1,NA
97758,or,-119.87985,43.38857,769,0,0,0,NA
97759,or,-121.78386,44.37717,6713,0,2,2,NA
97760,or,-121.23787,44.39096,4577,1,2,1,100
97761,or,-121.29841,44.84165,154,4,10,6,150
97801,or,-118.81572,45.6682,9617,3,7,4,133.3
97810,or,-118.45807,45.71395,1123,1,4,3,300
97812,or,-120.21616,45.55942,1161,4,9,5,125
97813,or,-118.52811,45.85043,876,1,4,3,300
97814,or,-117.76248,44.82655,8859,0,1,1,NA
97817,or,-118.64697,44.71379,145,0,0,0,NA
97818,or,-119.86998,45.77479,1803,6,14,8,133.3
97819,or,-117.76031,44.48542,88,0,0,0,NA
97820,or,-119.19998,44.16863,1063,0,0,0,NA
97823,or,-120.20546,45.24273,1666,0,1,1,NA
97824,or,-117.75623,45.33993,1301,0,1,1,NA
97825,or,-119.51658,44.3853,428,0,2,2,NA
97826,or,-119.22658,45.65451,1070,5,11,6,120
97827,or,-117.84527,45.58793,2069,1,2,1,100
97828,or,-117.22857,45.70677,2908,0,0,0,NA
97830,or,-120.18942,44.95014,1253,1,2,1,100
97833,or,-118.0149,44.92889,794,0,1,1,NA
97834,or,-117.18911,44.96871,1222,1,4,3,300
97835,or,-118.78661,45.91005,578,2,5,3,150
97836,or,-119.50126,45.29392,2480,0,1,1,NA
97837,or,-118.03641,44.51814,252,0,0,0,NA
97838,or,-119.28691,45.85297,9583,4,10,6,150
97839,or,-119.59275,45.59135,555,2,6,4,200
97840,or,-116.92736,44.90616,207,2,6,4,200
97841,or,-117.94492,45.46511,347,1,2,1,100
97842,or,-116.74865,45.4674,751,0,1,1,NA
97843,or,-119.89785,45.5048,906,2,6,4,200
97844,or,-119.55845,45.87424,1899,6,13,7,116.7
97845,or,-118.90304,44.4018,1667,0,1,1,NA
97846,or,-117.02958,45.46591,2688,0,0,0,NA
97848,or,-119.56604,44.67562,373,1,3,2,200
97850,or,-118.11669,45.30159,8104,1,2,1,100
97856,or,-119.12172,44.80651,777,0,0,0,NA
97857,or,-117.50436,45.37815,517,0,0,0,NA
97859,or,-118.42133,45.52911,545,0,0,0,NA
97862,or,-118.31018,45.92349,5236,3,7,4,133.3
97864,or,-119.44529,44.84581,621,1,3,2,200
97865,or,-119.19103,44.44718,1116,0,2,2,NA
97867,or,-117.99549,45.06907,747,0,1,1,NA
97868,or,-118.87096,45.41185,1563,1,3,2,200
97869,or,-118.6206,44.40191,992,0,0,0,NA
97870,or,-117.18787,44.78893,775,3,7,4,133.3
97873,or,-119.00286,44.13205,299,0,0,0,NA
97874,or,-119.8675,44.77754,625,2,5,3,150
97875,or,-119.13832,45.8194,1390,5,12,7,140
97876,or,-118.03552,45.51646,642,1,2,1,100
97877,or,-118.33938,44.79258,1396,0,0,0,NA
97880,or,-118.89413,45.0836,1032,0,0,0,NA
97882,or,-119.355,45.89993,2422,5,12,7,140
97883,or,-117.61964,45.15516,1563,0,1,1,NA
97884,or,-118.2182,44.45643,336,0,1,1,NA
97885,or,-117.51178,45.65585,1448,0,1,1,NA
97886,or,-118.23476,45.79871,1537,0,1,1,NA
97901,or,-117.09005,43.62895,530,4,13,9,225
97903,or,-117.62057,44.24868,240,2,6,4,200
97904,or,-118.51062,43.88226,504,0,1,1,NA
97905,or,-117.4595,44.57381,445,0,1,1,NA
97906,or,-117.77352,43.5261,742,2,5,3,150
97907,or,-117.34306,44.41021,972,2,7,5,250
97908,or,-117.93943,44.30928,407,0,1,1,NA
97909,or,-117.41894,44.24651,85,3,8,5,166.7
97910,id,-117.50533,42.73829,2832,0,1,0,100
97911,or,-118.05709,43.7542,596,1,2,1,100
97913,id,-117.32014,43.61126,2616,4,11,7,175
97914,or,-117.08405,44.11324,7190,6,15,9,150
97918,or,-117.36113,44.04162,2892,5,13,8,160
97920,or,-117.84643,44.07266,235,1,3,2,200
98001,wa,-122.26525,47.30995,13964,0,1,1,NA
98002,wa,-122.2164,47.30833,6947,0,1,1,NA
98003,wa,-122.31512,47.30514,9143,0,1,1,NA
98004,wa,-122.20597,47.61886,7091,0,1,1,NA
98005,wa,-122.16861,47.61469,4704,0,1,1,NA
98006,wa,-122.15075,47.55745,12558,0,0,0,NA
98007,wa,-122.14379,47.61442,3883,0,1,1,NA
98008,wa,-122.11097,47.60525,7982,0,1,1,NA
98010,wa,-122.00076,47.31311,3599,0,1,1,NA
98011,wa,-122.20192,47.75338,9011,0,1,1,NA
98012,wa,-122.19912,47.84155,19427,0,0,0,NA
98014,wa,-121.89445,47.66125,3782,0,1,1,NA
98019,wa,-121.84937,47.73967,5281,0,1,1,NA
98020,wa,-122.37444,47.8015,6974,0,0,0,NA
98021,wa,-122.20816,47.79257,10587,0,0,0,NA
98022,wa,-121.65485,47.15033,11316,0,0,0,NA
98023,wa,-122.36385,47.31176,13812,0,1,1,NA
98024,wa,-121.90123,47.57493,2753,0,1,1,NA
98026,wa,-122.33248,47.8387,12709,0,0,0,NA
98027,wa,-121.9993,47.50138,10366,0,0,0,NA
98028,wa,-122.24755,47.75423,7511,0,1,1,NA
98029,wa,-122.00544,47.55849,6571,0,0,0,NA
98030,wa,-122.19736,47.36818,7927,0,1,1,NA
98031,wa,-122.19561,47.40494,10089,0,1,1,NA
98032,wa,-122.25873,47.39233,6052,0,1,1,NA
98033,wa,-122.1923,47.6761,11689,0,1,1,NA
98034,wa,-122.21578,47.71579,11567,0,1,1,NA
98036,wa,-122.28161,47.81111,11935,0,0,0,NA
98037,wa,-122.28544,47.83921,7429,0,0,0,NA
98038,wa,-121.95378,47.4174,13997,0,1,1,NA
98039,wa,-122.23965,47.63302,1276,0,1,1,NA
98040,wa,-122.232,47.56612,8021,0,1,1,NA
98042,wa,-122.11721,47.36624,17027,0,1,1,NA
98043,wa,-122.30746,47.792,5768,0,0,0,NA
98045,wa,-121.63472,47.3916,7497,0,0,0,NA
98047,wa,-122.24754,47.2621,2133,0,1,1,NA
98050,wa,-121.94041,47.54401,223,0,0,0,NA
98051,wa,-121.88743,47.34073,2178,0,0,0,NA
98052,wa,-122.12026,47.6812,15487,0,1,1,NA
98053,wa,-122.01946,47.66564,8621,0,1,1,NA
98055,wa,-122.20139,47.44697,5421,0,1,1,NA
98056,wa,-122.18956,47.51284,10089,0,1,1,NA
98057,wa,-122.22033,47.47142,3182,0,1,1,NA
98058,wa,-122.12437,47.44181,13723,0,1,1,NA
98059,wa,-122.12096,47.5022,12921,0,1,1,NA
98065,wa,-121.79168,47.58457,5899,0,0,0,NA
98068,wa,-121.34964,47.44071,1635,0,0,0,NA
98070,wa,-122.47068,47.40897,8026,0,1,1,NA
98072,wa,-122.13211,47.76116,8405,0,0,0,NA
98074,wa,-122.04314,47.6226,10169,0,1,1,NA
98075,wa,-122.03853,47.58652,8317,0,1,1,NA
98077,wa,-122.0582,47.7529,5328,0,1,1,NA
98087,wa,-122.26638,47.86303,8705,0,0,0,NA
98092,wa,-122.12883,47.2876,14418,0,1,1,NA
98101,wa,-122.33633,47.61062,444,0,0,0,NA
98102,wa,-122.32214,47.63637,3446,0,0,0,NA
98103,wa,-122.34257,47.67331,15421,0,1,1,NA
98104,wa,-122.32944,47.60172,674,0,1,1,NA
98105,wa,-122.28401,47.66067,8296,0,1,1,NA
98106,wa,-122.35432,47.54347,8577,0,1,1,NA
98107,wa,-122.3785,47.66768,7363,0,0,0,NA
98108,wa,-122.31293,47.54131,8630,0,1,1,NA
98109,wa,-122.34414,47.63161,4006,0,0,0,NA
98110,wa,-122.53965,47.64455,12262,0,1,1,NA
98112,wa,-122.28891,47.6339,6966,0,1,1,NA
98115,wa,-122.28209,47.685,16555,0,1,1,NA
98116,wa,-122.39827,47.5745,8436,0,1,1,NA
98117,wa,-122.3853,47.68828,12940,0,0,0,NA
98118,wa,-122.2688,47.54251,14056,0,1,1,NA
98119,wa,-122.37091,47.6381,5285,0,0,0,NA
98121,wa,-122.35038,47.615,428,0,0,0,NA
98122,wa,-122.29183,47.6115,7818,0,1,1,NA
98125,wa,-122.29822,47.71638,10857,0,1,1,NA
98126,wa,-122.37524,47.55597,8010,0,1,1,NA
98133,wa,-122.34425,47.73994,12707,0,1,1,NA
98134,wa,-122.33853,47.5791,913,0,1,1,NA
98136,wa,-122.39275,47.53644,6128,0,1,1,NA
98144,wa,-122.29238,47.58599,9503,0,1,1,NA
98146,wa,-122.36035,47.49953,8338,0,1,1,NA
98148,wa,-122.32502,47.44372,2484,0,1,1,NA
98154,wa,-122.33379,47.60621,1,0,1,1,NA
98155,wa,-122.30028,47.75598,11738,0,1,1,NA
98158,wa,-122.30788,47.45017,17,0,1,1,NA
98164,wa,-122.33203,47.60596,2,0,1,1,NA
98166,wa,-122.35302,47.4511,7522,0,1,1,NA
98168,wa,-122.30121,47.48892,10063,0,1,1,NA
98174,wa,-122.33536,47.60457,1,0,1,1,NA
98177,wa,-122.37356,47.74147,7492,0,1,1,NA
98178,wa,-122.24702,47.49929,8509,0,1,1,NA
98188,wa,-122.27309,47.44826,5542,0,1,1,NA
98198,wa,-122.31293,47.39297,9377,0,1,1,NA
98199,wa,-122.4069,47.65195,7622,0,1,1,NA
98201,wa,-122.21498,47.99296,10670,0,0,0,NA
98203,wa,-122.23519,47.9448,11612,0,0,0,NA
98204,wa,-122.26087,47.90135,5801,0,0,0,NA
98205,wa,-122.1486,47.99065,6392,0,0,0,NA
98207,wa,-122.22313,47.9879,8,0,0,0,NA
98208,wa,-122.18647,47.90181,16143,0,0,0,NA
98220,wa,-122.19693,48.685,535,0,0,0,NA
98221,wa,-122.66188,48.50212,15682,0,0,0,NA
98222,wa,-122.81196,48.56184,230,0,0,0,NA
98223,wa,-121.95181,48.21054,19738,0,0,0,NA
98224,wa,-121.51297,47.66385,903,0,0,0,NA
98225,wa,-122.50463,48.75319,13103,0,0,0,NA
98226,wa,-122.44482,48.79741,16948,0,0,0,NA
98229,wa,-122.41238,48.6952,14420,0,0,0,NA
98230,wa,-122.7114,48.95435,10533,0,0,0,NA
98232,wa,-122.41679,48.56543,3695,0,0,0,NA
98233,wa,-122.35077,48.504,7024,0,0,0,NA
98235,wa,-122.23324,48.46448,62,0,0,0,NA
98236,wa,-122.40702,47.95236,5046,0,0,0,NA
98237,wa,-121.68521,48.59322,6074,0,0,0,NA
98238,wa,-122.34462,48.33539,83,0,0,0,NA
98239,wa,-122.66568,48.19014,5814,0,0,0,NA
98240,wa,-122.62138,48.94731,1498,0,0,0,NA
98241,wa,-121.32766,48.2237,2405,0,1,1,NA
98243,wa,-123.00922,48.61506,651,0,0,0,NA
98244,wa,-121.95443,48.80009,5084,0,0,0,NA
98245,wa,-122.90626,48.66452,3234,0,0,0,NA
98247,wa,-122.32251,48.90798,4262,0,0,0,NA
98248,wa,-122.62056,48.86543,10908,0,0,0,NA
98249,wa,-122.54235,48.01272,4620,0,0,0,NA
98250,wa,-123.08337,48.56184,7063,0,0,0,NA
98251,wa,-121.54532,47.90265,3600,0,0,0,NA
98252,wa,-121.68952,48.0731,5958,0,0,0,NA
98253,wa,-122.57521,48.0882,2507,0,0,0,NA
98255,wa,-121.98941,48.52215,317,0,0,0,NA
98256,wa,-121.43042,47.83003,1434,0,0,0,NA
98257,wa,-122.51057,48.41592,3029,0,0,0,NA
98258,wa,-122.06898,48.0424,12568,0,0,0,NA
98260,wa,-122.45046,48.03611,4978,0,0,0,NA
98261,wa,-122.8807,48.48754,3182,0,0,0,NA
98262,wa,-122.66354,48.6925,1513,0,0,0,NA
98263,wa,-122.06663,48.52184,59,0,0,0,NA
98264,wa,-122.46037,48.95017,8243,0,0,0,NA
98266,wa,-122.12826,48.95326,2764,0,0,0,NA
98267,wa,-121.31633,48.44346,1888,0,0,0,NA
98270,wa,-122.14458,48.05962,16462,0,0,0,NA
98271,wa,-122.23834,48.09257,11113,0,0,0,NA
98272,wa,-121.88517,47.84934,11226,0,1,1,NA
98273,wa,-122.37023,48.40431,13741,0,0,0,NA
98274,wa,-122.14561,48.35944,9794,0,0,0,NA
98275,wa,-122.30086,47.91536,6582,0,0,0,NA
98276,wa,-122.32603,48.92675,205,0,0,0,NA
98277,wa,-122.62805,48.31777,14574,0,0,0,NA
98278,wa,-122.66951,48.3402,20,0,0,0,NA
98279,wa,-122.81031,48.63932,965,0,0,0,NA
98280,wa,-122.91094,48.60476,555,0,0,0,NA
98281,wa,-123.04791,48.98913,3582,0,0,0,NA
98282,wa,-122.46673,48.18026,12100,0,0,0,NA
98283,wa,-121.25828,48.80262,789,0,0,0,NA
98284,wa,-122.12049,48.55311,14411,0,0,0,NA
98286,wa,-122.957,48.56952,474,0,0,0,NA
98288,wa,-121.27535,47.66598,1324,0,0,0,NA
98290,wa,-121.98025,47.95104,15941,0,0,0,NA
98292,wa,-122.3105,48.22244,11342,0,0,0,NA
98294,wa,-121.74477,47.87624,3402,0,1,1,NA
98295,wa,-122.22842,48.97182,1635,0,0,0,NA
98296,wa,-122.10169,47.84065,11021,0,0,0,NA
98297,wa,-123.03042,48.69954,249,0,0,0,NA
98303,wa,-122.69276,47.15711,3828,0,1,1,NA
98304,wa,-121.75178,46.86802,1747,0,0,0,NA
98305,wa,-124.43008,48.06027,945,0,0,0,NA
98310,wa,-122.623,47.5927,7720,0,1,1,NA
98311,wa,-122.63701,47.63021,10303,0,1,1,NA
98312,wa,-122.76005,47.57326,15431,0,1,1,NA
98314,wa,-122.63874,47.55591,13,0,1,1,NA
98315,wa,-122.71602,47.72504,36,0,0,0,NA
98320,wa,-122.99008,47.72118,3074,0,1,1,NA
98321,wa,-122.06425,47.15282,6944,0,1,1,NA
98323,wa,-121.88815,47.04061,819,0,0,0,NA
98325,wa,-122.7784,47.96587,1234,0,0,0,NA
98326,wa,-124.38906,48.16778,1749,0,0,0,NA
98327,wa,-122.66558,47.10345,3383,0,1,1,NA
98328,wa,-122.17374,46.86579,6625,0,1,1,NA
98329,wa,-122.71981,47.37361,5751,0,1,1,NA
98330,wa,-122.16873,46.77244,179,0,0,0,NA
98331,wa,-124.19766,47.77983,6242,0,0,0,NA
98332,wa,-122.60502,47.36375,9101,0,1,1,NA
98333,wa,-122.62558,47.24476,1982,0,1,1,NA
98335,wa,-122.62547,47.29647,11799,0,1,1,NA
98336,wa,-122.11247,46.56447,798,0,0,0,NA
98337,wa,-122.63085,47.56857,2828,0,1,1,NA
98338,wa,-122.2832,47.02051,10828,0,1,1,NA
98339,wa,-122.75024,48.02154,2593,0,0,0,NA
98340,wa,-122.56847,47.90648,2548,0,0,0,NA
98342,wa,-122.51957,47.7514,1295,0,1,1,NA
98345,wa,-122.62347,47.69902,254,0,1,1,NA
98346,wa,-122.52885,47.8187,5477,0,0,0,NA
98349,wa,-122.76321,47.27237,4280,0,1,1,NA
98350,wa,-124.61437,47.90545,141,0,0,0,NA
98351,wa,-122.77681,47.19903,1349,0,1,1,NA
98353,wa,-122.49238,47.53899,3,0,1,1,NA
98354,wa,-122.31465,47.25028,2461,0,1,1,NA
98355,wa,-122.05551,46.68688,1102,0,0,0,NA
98356,wa,-122.2922,46.56343,2271,0,0,0,NA
98357,wa,-124.6286,48.33181,1159,0,0,0,NA
98358,wa,-122.70773,48.05564,918,0,0,0,NA
98359,wa,-122.57366,47.43115,2719,0,1,1,NA
98360,wa,-122.15932,47.03025,6329,0,1,1,NA
98361,wa,-121.59129,46.58879,2944,0,0,0,NA
98362,wa,-123.36168,47.98415,15018,0,0,0,NA
98363,wa,-123.87557,48.01052,11380,0,0,0,NA
98364,wa,-122.58835,47.84716,4,0,0,0,NA
98365,wa,-122.70047,47.89559,4744,0,0,0,NA
98366,wa,-122.58348,47.53698,16226,0,1,1,NA
98367,wa,-122.68224,47.46524,16529,0,0,0,NA
98368,wa,-122.84171,48.04349,12604,0,0,0,NA
98370,wa,-122.62357,47.75341,16070,0,0,0,NA
98371,wa,-122.32214,47.19958,8777,0,1,1,NA
98372,wa,-122.26685,47.20597,8371,0,1,1,NA
98373,wa,-122.32515,47.14761,8187,0,1,1,NA
98374,wa,-122.26196,47.12992,14411,0,1,1,NA
98375,wa,-122.32348,47.10366,10552,0,1,1,NA
98376,wa,-122.85828,47.84543,3559,0,0,0,NA
98377,wa,-121.89478,46.52519,2659,0,1,1,NA
98380,wa,-122.90265,47.57852,3588,0,1,1,NA
98381,wa,-124.47496,48.2737,808,0,0,0,NA
98382,wa,-123.07862,48.02727,19276,0,0,0,NA
98383,wa,-122.71952,47.66318,8018,0,1,1,NA
98385,wa,-122.09167,47.13752,246,0,0,0,NA
98387,wa,-122.39546,47.05701,16984,0,1,1,NA
98388,wa,-122.6558,47.19928,2918,0,1,1,NA
98390,wa,-122.22802,47.20999,4333,0,1,1,NA
98391,wa,-122.17229,47.17718,21321,0,1,1,NA
98392,wa,-122.56162,47.73279,1760,0,1,1,NA
98394,wa,-122.77857,47.32199,1014,0,1,1,NA
98396,wa,-122.00989,47.09846,540,0,0,0,NA
98402,wa,-122.43879,47.24984,1708,0,1,1,NA
98403,wa,-122.45853,47.26597,2435,0,1,1,NA
98404,wa,-122.41009,47.20974,11223,0,1,1,NA
98405,wa,-122.47206,47.24581,8295,0,1,1,NA
98406,wa,-122.51217,47.26298,8151,0,1,1,NA
98407,wa,-122.51785,47.29048,8604,0,1,1,NA
98408,wa,-122.44645,47.19803,7341,0,1,1,NA
98409,wa,-122.48193,47.21111,8160,0,1,1,NA
98416,wa,-122.4812,47.26252,5,0,1,1,NA
98418,wa,-122.44652,47.22323,3764,0,1,1,NA
98421,wa,-122.40076,47.25988,942,0,1,1,NA
98422,wa,-122.39211,47.28978,8010,0,1,1,NA
98424,wa,-122.35196,47.23436,3499,0,1,1,NA
98430,wa,-122.56912,47.11734,12,0,1,1,NA
98433,wa,-122.58908,47.11228,31,0,1,1,NA
98439,wa,-122.50166,47.12388,216,0,1,1,NA
98443,wa,-122.37407,47.20469,2336,0,1,1,NA
98444,wa,-122.44898,47.15287,8809,0,1,1,NA
98445,wa,-122.4099,47.13991,10622,0,1,1,NA
98446,wa,-122.37425,47.12965,4511,0,1,1,NA
98447,wa,-122.44357,47.14437,47,0,1,1,NA
98465,wa,-122.5365,47.25036,2057,0,1,1,NA
98466,wa,-122.53961,47.22802,8674,0,1,1,NA
98467,wa,-122.56884,47.20329,4551,0,1,1,NA
98498,wa,-122.55451,47.16231,9719,0,1,1,NA
98499,wa,-122.50695,47.16672,7643,0,1,1,NA
98501,wa,-122.87093,46.97907,17588,0,1,1,NA
98502,wa,-123.01243,47.09053,13087,0,1,1,NA
98503,wa,-122.79819,47.02576,12298,0,1,1,NA
98506,wa,-122.87185,47.1056,8177,0,1,1,NA
98512,wa,-123.04844,46.95652,12631,0,1,1,NA
98513,wa,-122.73474,46.98327,13719,0,1,1,NA
98516,wa,-122.781,47.10955,10974,0,1,1,NA
98520,wa,-123.82591,47.03241,12745,0,0,0,NA
98524,wa,-122.85864,47.35713,2711,0,1,1,NA
98526,wa,-123.97575,47.46137,1609,0,0,0,NA
98527,wa,-123.93434,46.59772,660,0,0,0,NA
98528,wa,-122.89598,47.43606,8587,0,1,1,NA
98530,wa,-122.82353,46.78804,426,1,1,0,0
98531,wa,-122.92108,46.73497,11339,1,2,1,100
98532,wa,-123.0407,46.63123,14543,1,2,1,100
98533,wa,-122.43413,46.67123,799,0,1,1,NA
98535,wa,-124.13927,47.1092,845,0,0,0,NA
98536,wa,-124.09953,47.20063,714,0,0,0,NA
98537,wa,-123.6024,46.83019,1820,0,0,0,NA
98538,wa,-123.15275,46.47764,534,0,1,1,NA
98541,wa,-123.39136,47.06039,6882,0,1,1,NA
98542,wa,-122.7187,46.5246,571,1,2,1,100
98544,wa,-123.02699,46.73897,40,1,2,1,100
98546,wa,-122.9272,47.31693,3320,0,1,1,NA
98547,wa,-124.02216,46.78021,3139,0,0,0,NA
98548,wa,-123.33232,47.43001,4068,0,1,1,NA
98550,wa,-123.9482,47.08411,7393,0,0,0,NA
98552,wa,-123.91913,47.30464,635,0,0,0,NA
98555,wa,-123.06238,47.53572,1746,0,1,1,NA
98557,wa,-123.26795,47.04401,1824,0,1,1,NA
98558,wa,-122.55664,46.93403,93,0,1,1,NA
98559,wa,-123.32736,46.95882,36,0,1,1,NA
98560,wa,-123.41892,47.30751,241,0,1,1,NA
98562,wa,-124.2039,47.23866,593,0,0,0,NA
98563,wa,-123.60307,47.2086,5252,0,1,1,NA
98564,wa,-122.43292,46.45634,2576,0,1,1,NA
98565,wa,-122.90194,46.5783,347,1,2,1,100
98568,wa,-123.31389,46.85487,1991,0,1,1,NA
98569,wa,-124.13561,46.99339,11647,0,0,0,NA
98570,wa,-122.63647,46.6383,3324,1,2,1,100
98571,wa,-124.17611,47.19593,1864,0,0,0,NA
98572,wa,-123.32435,46.55103,822,0,1,1,NA
98575,wa,-123.79553,47.41777,510,0,0,0,NA
98576,wa,-122.63541,46.83746,2793,0,1,1,NA
98577,wa,-123.61398,46.6441,6614,0,0,0,NA
98579,wa,-123.1194,46.79801,6011,1,2,1,100
98580,wa,-122.51612,46.99629,5913,0,1,1,NA
98581,wa,-123.06732,46.35785,404,0,1,1,NA
98582,wa,-122.62377,46.52151,571,1,1,0,0
98583,wa,-123.48747,47.00118,62,0,1,1,NA
98584,wa,-123.14837,47.24244,25747,0,1,1,NA
98585,wa,-122.49577,46.55495,765,0,1,1,NA
98586,wa,-123.84192,46.55574,2548,0,0,0,NA
98587,wa,-124.2178,47.3078,2112,0,0,0,NA
98588,wa,-123.02318,47.44457,3469,0,1,1,NA
98589,wa,-122.81142,46.83934,4402,0,1,1,NA
98590,wa,-123.99698,46.70893,712,0,0,0,NA
98591,wa,-122.74285,46.44268,3368,1,2,1,100
98592,wa,-123.0761,47.32862,2687,0,1,1,NA
98593,wa,-123.00552,46.40796,878,1,2,1,100
98595,wa,-124.11354,46.88709,2783,0,0,0,NA
98596,wa,-122.95322,46.49569,4622,1,2,1,100
98597,wa,-122.49224,46.8514,11248,0,1,1,NA
98601,wa,-122.36143,45.95628,3271,0,1,1,NA
98602,wa,-121.26558,45.86713,415,0,1,1,NA
98603,wa,-122.42016,46.0408,1517,0,1,1,NA
98604,wa,-122.50521,45.8002,14150,1,2,1,100
98605,wa,-121.63295,45.77475,791,1,2,1,100
98606,wa,-122.45637,45.72973,3887,1,2,1,100
98607,wa,-122.38207,45.6434,13759,2,4,2,100
98610,wa,-122.07076,45.86742,1723,0,1,1,NA
98611,wa,-122.89526,46.30811,6548,1,2,1,100
98612,wa,-123.32553,46.21779,2571,0,1,1,NA
98613,wa,-120.96567,45.73673,673,1,3,2,200
98614,wa,-123.90397,46.29219,425,0,0,0,NA
98616,wa,-122.14163,46.19712,1040,0,0,0,NA
98617,wa,-121.15635,45.64396,586,4,9,5,125
98619,wa,-121.27217,45.97512,1082,0,1,1,NA
98620,wa,-120.77468,45.87204,7683,1,3,2,200
98621,wa,-123.54954,46.37784,331,0,0,0,NA
98624,wa,-123.98002,46.359,2062,0,0,0,NA
98625,wa,-122.72785,46.04229,4899,0,1,1,NA
98626,wa,-122.78631,46.1546,12543,0,1,1,NA
98628,wa,-121.09059,45.85926,312,1,2,1,100
98629,wa,-122.61414,45.88167,4417,1,2,1,100
98631,wa,-124.02716,46.3963,4820,0,0,0,NA
98632,wa,-123.06853,46.21681,21550,0,1,1,NA
98635,wa,-121.20389,45.74256,2201,1,2,1,100
98638,wa,-123.74503,46.37896,1840,0,0,0,NA
98639,wa,-121.98952,45.66281,464,0,1,1,NA
98640,wa,-124.02868,46.58065,10576,0,0,0,NA
98641,wa,-124.02994,46.54642,35,0,0,0,NA
98642,wa,-122.70179,45.80249,10711,1,2,1,100
98643,wa,-123.61716,46.29799,559,0,0,0,NA
98644,wa,-124.05799,46.33043,610,0,0,0,NA
98645,wa,-122.78195,46.32644,1255,1,2,1,100
98647,wa,-123.4355,46.3183,639,0,1,1,NA
98648,wa,-121.95446,45.70806,2330,1,2,1,100
98649,wa,-122.53538,46.31411,1474,0,1,1,NA
98650,wa,-121.5288,45.97288,1043,0,1,1,NA
98651,wa,-121.58415,45.74313,579,1,3,2,200
98660,wa,-122.73191,45.68771,4399,1,3,2,200
98661,wa,-122.62576,45.63924,11610,1,3,2,200
98662,wa,-122.57784,45.6885,11269,1,3,2,200
98663,wa,-122.66255,45.65396,5690,1,3,2,200
98664,wa,-122.57749,45.6198,7187,1,3,2,200
98665,wa,-122.65943,45.67974,8690,1,2,1,100
98670,wa,-121.14097,45.85889,222,1,3,2,200
98671,wa,-122.24227,45.61329,10542,1,4,3,300
98672,wa,-121.46293,45.81842,4287,1,2,1,100
98673,wa,-121.03605,45.65216,467,3,8,5,166.7
98674,wa,-122.66495,45.94333,6723,1,2,1,100
98675,wa,-122.34442,45.82701,3459,0,1,1,NA
98682,wa,-122.48176,45.67318,20457,1,3,2,200
98683,wa,-122.51021,45.60302,9216,1,4,3,300
98684,wa,-122.51645,45.63072,8705,1,3,2,200
98685,wa,-122.68994,45.71622,10526,1,2,1,100
98686,wa,-122.62334,45.72417,7783,1,2,1,100
98801,wa,-120.33782,47.42333,16698,2,5,3,150
98802,wa,-120.16773,47.49059,13085,2,5,3,150
98811,wa,-120.37629,47.71385,69,0,1,1,NA
98812,wa,-119.75284,48.1445,4612,2,5,3,150
98813,wa,-119.60652,48.01418,2035,3,7,4,133.3
98814,wa,-120.15828,48.20682,926,1,2,1,100
98815,wa,-120.47433,47.48375,3496,1,4,3,300
98816,wa,-120.32953,47.99848,8321,1,2,1,100
98817,wa,-119.99522,47.79154,231,0,2,2,NA
98819,wa,-119.81464,48.61686,798,0,0,0,NA
98821,wa,-120.55932,47.55164,236,2,5,3,150
98822,wa,-120.47563,47.86643,2071,1,3,2,200
98823,wa,-119.63356,47.32198,8211,2,6,4,200
98824,wa,-119.85867,47.07779,185,2,6,4,200
98826,wa,-120.85453,47.78749,9201,1,2,1,100
98827,wa,-119.76695,48.86472,1594,0,1,1,NA
98828,wa,-120.17606,47.30569,1428,2,4,2,100
98829,wa,-119.80896,48.31245,712,2,4,2,100
98830,wa,-119.51457,47.89517,1829,1,2,1,100
98831,wa,-120.13009,47.93457,3059,1,4,3,300
98832,wa,-119.01771,47.37192,905,2,5,3,150
98833,wa,-120.61132,48.68822,1505,0,0,0,NA
98834,wa,-120.08913,48.11706,654,1,3,2,200
98836,wa,-120.42758,47.4753,331,1,4,3,300
98837,wa,-119.30453,47.14979,20124,2,6,4,200
98840,wa,-119.56659,48.31467,5030,2,4,2,100
98841,wa,-119.26944,48.35888,5445,3,7,4,133.3
98843,wa,-120.05993,47.75198,2301,1,2,1,100
98844,wa,-119.24437,48.91586,8221,1,2,1,100
98845,wa,-119.92736,47.41839,381,1,3,2,200
98846,wa,-119.97864,48.03404,1658,2,5,3,150
98847,wa,-120.64668,47.44056,1444,1,3,2,200
98848,wa,-119.84327,47.17252,8350,2,6,4,200
98849,wa,-119.40401,48.53821,2428,1,2,1,100
98850,wa,-120.07759,47.30763,956,2,6,4,200
98851,wa,-119.42514,47.42068,3904,2,7,5,250
98852,wa,-120.55118,48.25281,425,0,1,1,NA
98853,wa,-119.26024,47.46199,37,2,6,4,200
98855,wa,-119.27045,48.67532,9773,0,1,1,NA
98856,wa,-120.25324,48.37301,3437,1,2,1,100
98857,wa,-119.05059,46.98565,2943,2,6,4,200
98858,wa,-119.90884,47.64659,2731,0,1,1,NA
98859,wa,-118.91407,48.80223,951,0,0,0,NA
98860,wa,-119.16389,47.46882,511,3,7,4,133.3
98862,wa,-120.28821,48.58176,5129,1,2,1,100
98901,wa,-120.41528,46.69316,11565,3,7,4,133.3
98902,wa,-120.53375,46.59663,14541,4,8,4,100
98903,wa,-121.02663,46.53885,8211,2,5,3,150
98908,wa,-120.70949,46.61659,15464,2,6,4,200
98921,wa,-120.31883,46.43111,79,6,13,7,116.7
98922,wa,-120.88147,47.2693,10674,0,0,0,NA
98923,wa,-120.71775,46.66632,627,1,3,2,200
98925,wa,-121.28081,47.25806,1594,0,0,0,NA
98926,wa,-120.46298,47.01295,17015,1,2,1,100
98929,wa,-121.28508,46.88179,31,0,0,0,NA
98930,wa,-119.89353,46.27046,4991,5,11,6,120
98932,wa,-120.16122,46.33244,1951,6,13,7,116.7
98933,wa,-120.63126,46.40222,560,5,11,6,120
98934,wa,-120.41494,46.98178,483,1,3,2,200
98935,wa,-120.08631,46.13138,2465,4,9,5,125
98936,wa,-120.14414,46.53597,3290,2,5,3,150
98937,wa,-121.16101,46.80799,5048,1,2,1,100
98938,wa,-120.09421,46.38824,1167,5,12,7,140
98939,wa,-120.46579,46.49685,141,5,11,6,120
98940,wa,-121.07326,47.40476,2030,0,0,0,NA
98941,wa,-120.98208,47.22325,1096,0,1,1,NA
98942,wa,-120.67488,46.80185,7896,3,7,4,133.3
98943,wa,-120.95848,47.18573,443,0,0,0,NA
98944,wa,-119.64736,46.4932,7730,6,13,7,116.7
98946,wa,-120.72165,47.07911,637,1,2,1,100
98947,wa,-120.80145,46.68755,1703,1,2,1,100
98948,wa,-120.32833,46.28525,4624,6,12,6,100
98950,wa,-119.99059,46.89748,356,5,11,6,120
98951,wa,-120.51618,46.45977,4582,6,12,6,100
98952,wa,-120.76141,46.35435,1274,2,4,2,100
98953,wa,-120.22681,46.44229,3343,5,11,6,120
99001,wa,-117.58629,47.63649,2160,0,1,1,NA
99003,wa,-117.28467,47.9184,2932,1,3,2,200
99004,wa,-117.63768,47.41115,9381,1,2,1,100
99005,wa,-117.36623,47.84424,4350,1,3,2,200
99006,wa,-117.50222,47.98297,7925,1,3,2,200
99008,wa,-117.92445,47.50804,1010,1,2,1,100
99009,wa,-117.25445,48.01867,2772,1,2,1,100
99011,wa,-117.64815,47.61883,31,0,1,1,NA
99012,wa,-117.19279,47.38207,1311,0,1,1,NA
99013,wa,-117.83446,47.89238,1190,1,3,2,200
99016,wa,-117.14625,47.62119,6902,1,2,1,100
99017,wa,-117.8756,47.18878,138,1,3,2,200
99018,wa,-117.15482,47.28978,515,0,1,1,NA
99019,wa,-117.07643,47.64278,5249,0,1,1,NA
99020,wa,-117.4966,47.5626,42,1,2,1,100
99021,wa,-117.18939,47.84832,4402,1,2,1,100
99022,wa,-117.71127,47.60157,4585,1,1,0,0
99023,wa,-117.17179,47.56108,366,0,1,1,NA
99025,wa,-117.08592,47.78996,2956,0,1,1,NA
99026,wa,-117.62779,47.81149,5394,1,3,2,200
99027,wa,-117.12622,47.71045,2728,1,2,1,100
99029,wa,-117.82934,47.69766,1396,0,1,1,NA
99030,wa,-117.11015,47.48411,1327,0,1,1,NA
99031,wa,-117.36244,47.42352,1157,0,2,2,NA
99032,wa,-118.02807,47.31735,1627,1,4,3,300
99033,wa,-117.0992,47.23235,845,0,1,1,NA
99034,wa,-117.74863,47.88562,330,1,2,1,100
99036,wa,-117.27591,47.52529,1280,0,1,1,NA
99037,wa,-117.19722,47.63641,4985,0,1,1,NA
99039,wa,-117.2656,47.34465,144,1,2,1,100
99040,wa,-118.00526,47.90087,84,1,2,1,100
99101,wa,-117.92516,48.32726,1412,0,1,1,NA
99102,wa,-117.25023,46.79203,278,0,1,1,NA
99103,wa,-118.93692,47.73707,1157,1,3,2,200
99105,wa,-118.10475,46.90335,278,3,8,5,166.7
99109,wa,-117.70131,48.28533,4274,1,3,2,200
99110,wa,-117.57641,48.01222,1106,1,2,1,100
99111,wa,-117.42453,46.85371,1995,1,2,1,100
99113,wa,-117.19166,46.59408,295,0,1,1,NA
99114,wa,-117.73965,48.65406,10700,0,1,1,NA
99115,wa,-119.42385,47.64725,3053,1,4,3,300
99116,wa,-118.92864,48.01602,1117,1,4,3,300
99117,wa,-118.52073,47.72409,1335,0,1,1,NA
99118,wa,-118.63895,48.89648,1529,0,0,0,NA
99119,wa,-117.28858,48.50389,2760,0,1,1,NA
99121,wa,-118.46516,48.94775,384,0,0,0,NA
99122,wa,-118.20802,47.67759,6492,0,2,2,NA
99123,wa,-119.14296,47.84583,971,1,2,1,100
99124,wa,-118.95288,47.99985,314,1,2,1,100
99125,wa,-117.77857,46.94299,286,2,5,3,150
99126,wa,-117.9719,48.73967,1003,0,1,1,NA
99128,id,-117.07293,47.09934,389,0,1,1,NA
99129,wa,-118.1927,48.00522,1080,1,2,1,100
99130,wa,-117.18411,46.99731,651,0,1,1,NA
99131,wa,-118.12314,48.27911,389,0,1,1,NA
99133,wa,-119.07678,48.01485,2365,1,3,2,200
99134,wa,-118.31121,47.43012,1272,1,2,1,100
99135,wa,-119.09746,47.66122,766,1,4,3,300
99137,wa,-118.09023,48.16824,796,0,1,1,NA
99138,wa,-118.37874,48.22231,2460,1,2,1,100
99139,wa,-117.40675,48.73459,2005,0,1,1,NA
99140,wa,-118.67678,48.11159,1104,1,2,1,100
99141,wa,-118.14451,48.73762,6123,1,2,1,100
99143,wa,-117.85624,46.73949,375,3,8,5,166.7
99144,wa,-118.50429,47.37776,154,1,3,2,200
99146,wa,-118.29761,48.95744,134,0,1,1,NA
99147,wa,-118.44257,47.8396,422,1,3,2,200
99148,wa,-117.59828,48.10253,3033,0,1,1,NA
99149,wa,-117.46393,47.2171,298,1,2,1,100
99150,wa,-118.58304,48.7944,501,0,0,0,NA
99151,wa,-118.06356,48.66449,123,0,2,2,NA
99152,wa,-117.39628,48.84956,232,0,0,0,NA
99153,wa,-117.21274,48.85147,961,0,0,0,NA
99154,wa,-118.36591,47.38974,81,1,2,1,100
99155,wa,-118.9535,48.25568,1046,0,1,1,NA
99156,wa,-117.19076,48.18479,8643,0,1,1,NA
99157,wa,-117.8159,48.92471,1335,0,1,1,NA
99158,wa,-117.24738,47.13031,580,1,2,1,100
99159,wa,-118.74247,47.3294,2750,1,4,3,300
99160,wa,-118.30632,48.83874,269,0,1,1,NA
99161,id,-117.13044,46.89821,1083,0,1,1,NA
99163,wa,-117.21488,46.72892,7287,0,1,1,NA
99166,wa,-118.64447,48.57168,4600,0,0,0,NA
99167,wa,-118.11898,48.41725,954,0,1,1,NA
99169,wa,-118.35863,47.11201,3246,2,5,3,150
99170,wa,-117.40218,47.24761,1164,1,2,1,100
99171,wa,-117.65625,47.10444,519,1,3,2,200
99173,wa,-117.86311,48.03694,1831,1,2,1,100
99174,wa,-117.35869,47.01056,73,0,1,1,NA
99179,id,-117.11897,46.49004,423,2,5,3,125
99180,wa,-117.32844,48.2958,1621,1,2,1,100
99181,wa,-117.76935,48.14331,2151,1,3,2,200
99185,wa,-118.71946,47.74589,3131,1,2,1,100
99201,wa,-117.43609,47.66276,4467,1,3,2,200
99202,wa,-117.37907,47.65739,7850,1,2,1,100
99203,wa,-117.4033,47.62909,8454,0,1,1,NA
99204,wa,-117.42726,47.64571,1595,1,2,1,100
99205,wa,-117.44622,47.69665,18145,1,3,2,200
99206,wa,-117.25485,47.629,13074,1,2,1,100
99207,wa,-117.38784,47.68896,11257,1,2,1,100
99208,wa,-117.46275,47.7799,19776,1,3,2,200
99212,wa,-117.30916,47.66523,9115,1,2,1,100
99216,wa,-117.2094,47.67999,7989,1,2,1,100
99217,wa,-117.25674,47.73994,8123,1,2,1,100
99218,wa,-117.40847,47.75957,4552,1,2,1,100
99223,wa,-117.34478,47.59129,12151,0,1,1,NA
99224,wa,-117.53686,47.6489,11047,1,2,1,100
99301,wa,-118.94392,46.38445,26590,7,14,7,100
99320,wa,-119.48767,46.26518,5201,4,10,6,150
99321,wa,-119.89281,46.87461,465,3,8,5,166.7
99322,wa,-120.18082,45.94408,976,1,2,1,100
99323,wa,-118.84282,46.19236,2099,7,14,7,100
99324,wa,-118.38686,46.04258,3617,5,11,6,120
99326,wa,-118.85223,46.64972,2031,4,9,5,125
99328,wa,-117.8655,46.25656,4132,1,3,2,200
99329,wa,-118.14529,46.15635,143,1,3,2,200
99330,wa,-119.04321,46.48976,721,3,8,5,166.7
99333,wa,-118.15022,46.69266,53,4,9,5,125
99335,wa,-118.47455,46.65371,601,4,9,5,125
99336,wa,-119.17884,46.21376,13743,6,13,7,116.7
99337,wa,-119.08608,46.07463,12167,5,11,6,120
99338,wa,-119.27357,46.14796,7356,4,9,5,125
99341,wa,-118.65307,46.91292,1523,2,6,4,200
99343,wa,-119.17936,46.59183,1506,3,8,5,166.7
99344,wa,-119.17781,46.81646,7186,2,6,4,200
99345,wa,-119.68955,45.95276,450,6,14,8,133.3
99346,wa,-119.30484,45.99835,498,5,11,6,120
99347,wa,-117.56645,46.42778,3851,1,2,1,100
99348,wa,-118.4518,46.38967,1785,3,9,6,200
99349,wa,-119.70118,46.73155,4035,5,12,7,140
99350,wa,-119.70512,46.18042,6441,4,9,5,125
99352,wa,-119.28782,46.25227,12094,5,11,6,120
99353,wa,-119.37925,46.31672,6347,4,10,6,150
99354,wa,-119.30665,46.32565,7979,6,13,7,116.7
99356,wa,-120.31515,45.82126,952,3,8,5,166.7
99357,wa,-119.66083,46.8915,2238,4,8,4,100
99359,wa,-118.11118,46.52731,519,4,9,5,125
99360,wa,-118.663,46.0903,1338,5,12,7,140
99361,wa,-118.14389,46.2367,2360,2,4,2,100
99362,or,-118.30741,46.08934,17690,2,4,2,125
99363,wa,-118.88841,46.06662,276,5,11,6,120
99371,wa,-118.31676,46.80683,701,3,8,5,166.7
99401,wa,-117.2515,46.08738,1460,0,1,1,NA
99402,wa,-117.14744,46.19396,2573,2,5,3,150
99403,wa,-117.25281,46.3724,9319,7,14,7,100
