tract,state_abbr,lon,lat,count_prop,days_above_100_today,days_above_100_30yrs,change_days_above_100,change_perc_above_100
001950100,tx,-95.55357,31.97153,5106,61,89,28,45.9
001950401,tx,-95.82026,31.7376,46,67,94,27,40.3
001950402,tx,-95.91526,31.79757,15,69,95,26,37.7
001950500,tx,-95.64216,31.78803,2295,62,90,28,45.2
001950600,tx,-95.6694,31.75081,3168,61,89,28,45.9
001950700,tx,-95.63461,31.75044,1942,63,91,28,44.4
001950800,tx,-95.61459,31.73926,2176,63,91,28,44.4
001950901,tx,-95.73594,31.71886,3383,63,91,28,44.4
001950902,tx,-95.51663,31.78842,4067,62,90,28,45.2
001951001,tx,-95.42517,31.6421,2957,63,91,28,44.4
001951002,tx,-95.63625,31.59608,2427,66,93,27,40.9
001951100,tx,-95.84279,31.92184,4353,64,91,27,42.2
003950100,tx,-102.71669,32.35873,2657,13,31,18,138.5
003950200,tx,-102.55387,32.32833,2841,14,33,19,135.7
003950300,tx,-102.54855,32.31442,2269,14,33,19,135.7
003950400,tx,-102.47313,32.1923,2258,14,33,19,135.7
005000102,tx,-94.87112,31.32733,2657,65,92,27,41.5
005000103,tx,-94.81029,31.4587,2113,61,88,27,44.3
005000104,tx,-94.89535,31.4225,2029,59,86,27,45.8
005000201,tx,-94.67232,31.30014,1641,68,94,26,38.2
005000202,tx,-94.67262,31.40093,2936,67,92,25,37.3
005000301,tx,-94.77483,31.37234,2629,65,91,26,40
005000302,tx,-94.78343,31.28144,2234,67,93,26,38.8
005000400,tx,-94.7529,31.34191,2573,67,93,26,38.8
005000500,tx,-94.73606,31.37054,2668,66,93,27,40.9
005000600,tx,-94.69627,31.34904,2996,68,94,26,38.2
005000700,tx,-94.72581,31.33651,1614,67,94,27,40.3
005000800,tx,-94.70616,31.31129,3237,68,94,26,38.2
005000902,tx,-94.72798,31.28258,1218,67,94,27,40.3
005000903,tx,-94.76243,31.31126,1238,66,93,27,40.9
005000904,tx,-94.73997,31.31817,1309,67,93,26,38.8
005001001,tx,-94.81086,31.20239,2286,69,95,26,37.7
005001002,tx,-94.70741,31.16607,2546,69,95,26,37.7
005001101,tx,-94.62704,31.2633,2207,69,95,26,37.7
005001102,tx,-94.56213,31.36802,2546,68,93,25,36.8
005001200,tx,-94.3556,31.14017,4773,69,94,25,36.2
005001300,tx,-94.52018,31.19509,5783,69,94,25,36.2
007950101,tx,-96.94445,28.14251,4419,84,107,23,27.4
007950102,tx,-97.04296,28.09963,2273,79,106,27,34.2
007950103,tx,-97.12745,28.07623,1601,76,103,27,35.5
007950200,tx,-97.02103,28.03537,1503,80,106,26,32.5
007950301,tx,-97.0679,28.03787,3026,79,105,26,32.9
007950302,tx,-97.05562,28.05314,1384,80,106,26,32.5
007950400,tx,-97.07091,28.01716,2390,78,104,26,33.3
007950501,tx,-97.16165,28.01839,1943,72,100,28,38.9
007950502,tx,-97.12857,27.93667,2050,66,97,31,47
007950503,tx,-97.07255,27.96158,2584,74,102,28,37.8
009020100,tx,-98.53357,33.79677,1515,57,77,20,35.1
009020200,tx,-98.77968,33.64713,2796,58,78,20,34.5
009020300,tx,-98.57427,33.52548,2665,58,79,21,36.2
011950100,tx,-101.3574,34.96493,6237,5,14,9,180
013960101,tx,-98.42927,29.05678,2128,86,109,23,26.7
013960102,tx,-98.30196,28.84619,3596,89,112,23,25.8
013960203,tx,-98.78888,29.21209,1485,71,97,26,36.6
013960204,tx,-98.74452,29.13629,2129,73,98,25,34.2
013960205,tx,-98.67094,29.07226,2856,75,100,25,33.3
013960206,tx,-98.57677,29.10801,2766,72,97,25,34.7
013960300,tx,-98.58098,29.03579,1566,83,106,23,27.7
013960401,tx,-98.51205,29.10853,1229,78,102,24,30.8
013960403,tx,-98.50018,28.94821,2039,91,113,22,24.2
013960404,tx,-98.51304,28.99234,1842,91,113,22,24.2
013960500,tx,-98.71223,28.82477,2836,84,108,24,28.6
013960601,tx,-98.60454,28.97358,1624,87,110,23,26.4
013960602,tx,-98.49431,28.76436,4550,91,114,23,25.3
015760100,tx,-96.10298,29.66415,1760,80,107,27,33.8
015760201,tx,-96.12667,29.82062,1444,79,106,27,34.2
015760202,tx,-96.09,29.74774,2223,80,107,27,33.8
015760301,tx,-96.23515,29.85412,1634,78,105,27,34.6
015760302,tx,-96.25492,29.76824,2938,80,107,27,33.8
015760400,tx,-96.45453,29.96097,3911,73,100,27,37
015760501,tx,-96.28303,30.02949,3182,74,101,27,36.5
015760502,tx,-96.17884,29.94196,2972,76,103,27,35.5
017950101,tx,-102.77932,34.22073,107,3,9,6,200
017950102,tx,-102.83096,34.06538,3153,3,9,6,200
019000101,tx,-99.10489,29.68062,5467,39,67,28,71.8
019000103,tx,-99.10452,29.77352,4457,37,65,28,75.7
019000104,tx,-98.93161,29.75989,1265,29,55,26,89.7
019000200,tx,-99.39345,29.77401,5704,25,50,25,100
019000301,tx,-99.00254,29.64957,5875,47,74,27,57.4
019000302,tx,-98.88196,29.67379,2232,33,59,26,78.8
019000400,tx,-98.95026,29.57969,5924,47,75,28,59.6
021950101,tx,-97.40417,30.24228,2549,68,94,26,38.2
021950102,tx,-97.26801,30.32452,2772,67,93,26,38.8
021950201,tx,-97.35902,30.35254,1543,66,93,27,40.9
021950202,tx,-97.38445,30.35457,2366,66,93,27,40.9
021950301,tx,-97.42836,30.15312,2819,67,94,27,40.3
021950302,tx,-97.36176,30.03372,2253,68,94,26,38.2
021950303,tx,-97.46478,30.10047,3094,65,92,27,41.5
021950401,tx,-97.30817,30.12428,2564,71,96,25,35.2
021950402,tx,-97.28955,30.08319,3760,72,97,25,34.7
021950403,tx,-97.32235,30.09287,3695,71,97,26,36.6
021950503,tx,-97.17485,30.13189,3252,70,96,26,37.1
021950504,tx,-97.17728,30.21714,2589,68,94,26,38.2
021950505,tx,-97.2683,30.23322,2058,70,96,26,37.1
021950506,tx,-97.32761,30.18048,1922,71,97,26,36.6
021950601,tx,-97.27904,29.92313,3217,67,93,26,38.8
021950602,tx,-97.11202,30.06884,3181,72,97,25,34.7
021950700,tx,-97.17096,30.01756,2734,72,98,26,36.1
021950803,tx,-97.55967,30.11864,927,63,89,26,41.3
021950804,tx,-97.50794,30.04504,2463,64,90,26,40.6
021950805,tx,-97.59031,30.05203,2344,63,89,26,41.3
021950806,tx,-97.45348,29.95445,1870,63,90,27,42.9
023950301,tx,-99.23083,33.59862,1299,54,74,20,37
023950302,tx,-99.21304,33.61698,4860,56,76,20,35.7
025950100,tx,-97.89787,28.60317,2283,77,102,25,32.5
025950201,tx,-97.55438,28.32488,693,81,107,26,32.1
025950203,tx,-97.84603,28.38305,2114,80,106,26,32.5
025950204,tx,-97.66754,28.45716,1936,77,103,26,33.8
025950300,tx,-97.75454,28.42072,2079,78,104,26,33.3
025950400,tx,-97.75945,28.40303,1369,78,104,26,33.3
025950501,tx,-97.7343,28.39716,1042,79,105,26,32.9
025950502,tx,-97.74704,28.38744,1345,80,106,26,32.5
025950600,tx,-97.67844,28.21875,2203,82,108,26,31.7
027020101,tx,-97.34008,31.22611,1680,55,81,26,47.3
027020102,tx,-97.20207,31.0972,2859,60,86,26,43.3
027020201,tx,-97.47033,31.12795,4705,56,81,25,44.6
027020203,tx,-97.4979,31.16743,4155,54,80,26,48.1
027020204,tx,-97.45645,31.2437,2366,54,80,26,48.1
027020301,tx,-97.42998,31.09624,3728,58,83,25,43.1
027020302,tx,-97.3968,31.15374,2834,56,82,26,46.4
027020401,tx,-97.34848,31.14904,1511,55,81,26,47.3
027020402,tx,-97.29299,31.12383,1385,59,85,26,44.1
027020500,tx,-97.33032,31.121,1612,58,83,25,43.1
027020600,tx,-97.34282,31.11542,1038,58,83,25,43.1
027020701,tx,-97.34087,31.09759,915,59,85,26,44.1
027020702,tx,-97.35278,31.1011,1123,58,84,26,44.8
027020800,tx,-97.29905,31.06341,1836,59,85,26,44.1
027020900,tx,-97.33298,31.05201,1139,60,85,25,41.7
027021000,tx,-97.35623,31.08074,1438,58,84,26,44.8
027021101,tx,-97.37663,31.08248,608,58,83,25,43.1
027021102,tx,-97.36953,31.089,1411,58,83,25,43.1
027021201,tx,-97.38951,31.11592,802,55,81,26,47.3
027021202,tx,-97.37924,31.10063,1208,58,83,25,43.1
027021203,tx,-97.40846,31.07938,1897,59,84,25,42.4
027021301,tx,-97.38285,31.05836,1782,60,85,25,41.7
027021302,tx,-97.39127,31.06763,1136,59,84,25,42.4
027021304,tx,-97.36746,31.06369,1182,60,85,25,41.7
027021305,tx,-97.37367,31.04774,3448,60,85,25,41.7
027021400,tx,-97.34219,31.00537,2320,61,86,25,41
027021501,tx,-97.44835,31.04474,1373,58,84,26,44.8
027021502,tx,-97.4581,31.01661,2360,57,83,26,45.6
027021601,tx,-97.49231,31.05973,2555,58,83,25,43.1
027021602,tx,-97.49487,31.07586,598,58,83,25,43.1
027021701,tx,-97.49716,31.09962,2554,57,82,25,43.9
027021702,tx,-97.45764,31.07849,1462,59,84,25,42.4
027021801,tx,-97.57636,31.0768,2102,53,79,26,49.1
027021802,tx,-97.57797,31.04543,3804,55,81,26,47.3
027021901,tx,-97.66467,31.07679,1475,51,76,25,49
027021905,tx,-97.6628,31.06528,1797,52,78,26,50
027021906,tx,-97.66568,31.04963,1703,53,78,25,47.2
027021907,tx,-97.6346,31.06982,1675,53,78,25,47.2
027021908,tx,-97.63747,31.03302,2727,53,78,25,47.2
027022001,tx,-97.66062,31.08799,1220,51,76,25,49
027022002,tx,-97.58587,31.12001,1980,54,79,25,46.3
027022101,tx,-97.69953,31.12511,1448,51,76,25,49
027022103,tx,-97.69109,31.13219,1906,51,76,25,49
027022104,tx,-97.67764,31.11943,1087,51,76,25,49
027022105,tx,-97.67394,31.12781,832,51,76,25,49
027022200,tx,-97.68986,31.1126,904,51,76,25,49
027022300,tx,-97.69138,31.09593,1457,49,75,26,53.1
027022401,tx,-97.7079,31.09269,1852,49,75,26,53.1
027022402,tx,-97.68451,31.04463,2668,52,78,26,50
027022403,tx,-97.70475,31.06839,1684,50,76,26,52
027022405,tx,-97.71154,31.0801,486,49,75,26,53.1
027022406,tx,-97.68711,31.06924,1300,50,76,26,52
027022407,tx,-97.6979,31.06015,1353,51,77,26,51
027022501,tx,-97.72407,31.10272,1249,49,75,26,53.1
027022503,tx,-97.72706,31.07972,1335,49,74,25,51
027022504,tx,-97.72108,31.04788,3024,51,76,25,49
027022600,tx,-97.7175,31.12161,1380,51,76,25,49
027022801,tx,-97.72934,31.13041,714,50,76,26,52
027022900,tx,-97.73763,31.11257,1098,50,76,26,52
027023001,tx,-97.75329,31.06579,1996,49,75,26,53.1
027023002,tx,-97.73836,31.09241,1401,49,74,25,51
027023103,tx,-97.75274,31.09802,1451,48,74,26,54.2
027023104,tx,-97.75551,31.10707,1070,49,74,25,51
027023109,tx,-97.76669,31.08685,1355,48,74,26,54.2
027023110,tx,-97.753,31.08461,795,48,74,26,54.2
027023111,tx,-97.80491,31.10461,1612,48,73,25,52.1
027023112,tx,-97.79035,31.10098,1271,48,74,26,54.2
027023113,tx,-97.77594,31.10759,1462,48,74,26,54.2
027023114,tx,-97.77008,31.0998,1431,48,73,25,52.1
027023115,tx,-97.78186,31.09083,1351,48,73,25,52.1
027023116,tx,-97.80583,31.08511,2211,47,73,26,55.3
027023117,tx,-97.77731,31.06911,1694,48,74,26,54.2
027023118,tx,-97.8036,31.06891,2244,48,73,25,52.1
027023201,tx,-97.7553,31.12731,3,50,76,26,52
027023202,tx,-97.77747,31.12737,14,49,75,26,53.1
027023203,tx,-97.75582,31.11776,5,50,76,26,52
027023204,tx,-97.67853,31.13692,17,50,76,26,52
027023301,tx,-97.80593,30.97212,3218,50,75,25,50
027023302,tx,-97.70915,31.0062,1989,51,76,25,49
027023402,tx,-97.29515,30.90769,3719,59,85,26,44.1
027023404,tx,-97.56042,30.89995,3182,53,79,26,49.1
027023405,tx,-97.46283,30.93474,2111,55,80,25,45.5
027023406,tx,-97.51381,30.98614,2367,55,81,26,47.3
027023500,tx,-97.73322,31.12305,1045,50,76,26,52
027980001,tx,-97.82149,31.05408,69,47,73,26,55.3
027980002,tx,-97.82712,31.06739,18,47,73,26,55.3
027980003,tx,-97.60124,31.17218,123,53,79,26,49.1
029110100,tx,-98.49054,29.42639,984,67,93,26,38.8
029110300,tx,-98.48085,29.41432,1098,67,93,26,38.8
029110500,tx,-98.5089,29.41735,447,67,93,26,38.8
029110600,tx,-98.50751,29.43018,940,67,93,26,38.8
029110700,tx,-98.50369,29.43894,531,67,93,26,38.8
029111000,tx,-98.47087,29.44035,883,67,92,25,37.3
029111100,tx,-98.48802,29.44062,1177,66,92,26,39.4
029120100,tx,-98.43712,29.46115,42,66,91,25,37.9
029120301,tx,-98.46242,29.48455,1032,64,90,26,40.6
029120302,tx,-98.47117,29.48182,1595,65,90,25,38.5
029120401,tx,-98.43946,29.47522,863,66,91,25,37.9
029120402,tx,-98.45105,29.47664,1299,66,91,25,37.9
029120502,tx,-98.40762,29.50453,1479,63,89,26,41.3
029120503,tx,-98.42507,29.49023,742,63,89,26,41.3
029120504,tx,-98.40989,29.48088,1641,64,90,26,40.6
029120601,tx,-98.43683,29.48976,647,63,90,27,42.9
029120602,tx,-98.45072,29.49018,1065,64,90,26,40.6
029120701,tx,-98.46946,29.51287,1258,63,89,26,41.3
029120702,tx,-98.47246,29.49973,947,63,89,26,41.3
029120800,tx,-98.44626,29.50517,2539,64,90,26,40.6
029120901,tx,-98.43839,29.52173,548,63,89,26,41.3
029120902,tx,-98.42299,29.50821,1414,63,89,26,41.3
029121000,tx,-98.44473,29.531,2377,63,89,26,41.3
029121110,tx,-98.41462,29.58437,1932,57,83,26,45.6
029121111,tx,-98.398,29.5678,2503,58,84,26,44.8
029121112,tx,-98.41655,29.55589,1150,60,86,26,43.3
029121115,tx,-98.45342,29.57538,2009,61,87,26,42.6
029121116,tx,-98.46504,29.58398,1613,60,87,27,45
029121117,tx,-98.46202,29.59581,1268,61,87,26,42.6
029121118,tx,-98.44642,29.59598,1626,60,87,27,45
029121119,tx,-98.4511,29.561,1954,62,88,26,41.9
029121120,tx,-98.43694,29.55706,2002,62,88,26,41.9
029121121,tx,-98.43246,29.58772,1175,59,85,26,44.1
029121122,tx,-98.42633,29.57511,2120,57,84,27,47.4
029121123,tx,-98.47287,29.56587,1283,62,88,26,41.9
029121124,tx,-98.4645,29.56753,1039,62,88,26,41.9
029121203,tx,-98.39115,29.53374,1637,60,86,26,43.3
029121204,tx,-98.42072,29.52636,849,63,89,26,41.3
029121205,tx,-98.40615,29.54117,891,61,87,26,42.6
029121206,tx,-98.3919,29.553,2632,59,86,27,45.8
029121300,tx,-98.38181,29.51975,2394,61,87,26,42.6
029121402,tx,-98.36866,29.49207,2674,62,88,26,41.9
029121403,tx,-98.38437,29.50311,1295,62,88,26,41.9
029121404,tx,-98.39339,29.48094,1218,63,89,26,41.3
029121501,tx,-98.34994,29.53984,3546,60,87,27,45
029121504,tx,-98.36252,29.5297,2875,59,85,26,44.1
029121505,tx,-98.32973,29.52342,1627,63,89,26,41.3
029121506,tx,-98.34069,29.51163,1745,64,90,26,40.6
029121507,tx,-98.35768,29.51605,1932,62,88,26,41.9
029121508,tx,-98.3583,29.50641,1713,62,88,26,41.9
029121601,tx,-98.30622,29.54715,1204,62,88,26,41.9
029121604,tx,-98.3157,29.53333,3187,62,88,26,41.9
029121605,tx,-98.32905,29.54574,817,62,88,26,41.9
029121606,tx,-98.33653,29.55647,1522,62,88,26,41.9
029121701,tx,-98.29436,29.55457,1498,62,88,26,41.9
029121702,tx,-98.31499,29.56832,2442,61,87,26,42.6
029121802,tx,-98.35321,29.57188,3505,56,83,27,48.2
029121803,tx,-98.36769,29.55571,1758,57,84,27,47.4
029121804,tx,-98.37574,29.56705,1574,56,83,27,48.2
029121808,tx,-98.38971,29.5843,1171,55,82,27,49.1
029121809,tx,-98.38214,29.5781,1961,55,82,27,49.1
029121810,tx,-98.40479,29.59196,1572,57,83,26,45.6
029121811,tx,-98.3932,29.59546,1680,56,83,27,48.2
029121812,tx,-98.36732,29.59021,2058,55,82,27,49.1
029121813,tx,-98.37335,29.59939,672,55,82,27,49.1
029121903,tx,-98.43165,29.62127,1963,55,81,26,47.3
029121904,tx,-98.44326,29.63716,1217,55,82,27,49.1
029121905,tx,-98.42809,29.65138,1866,53,79,26,49.1
029121906,tx,-98.45219,29.61535,1779,56,83,27,48.2
029121908,tx,-98.39766,29.7122,1548,47,74,27,57.4
029121909,tx,-98.33134,29.59056,2753,59,86,27,45.8
029121910,tx,-98.38988,29.6211,2950,54,81,27,50
029121911,tx,-98.43169,29.67889,3031,50,77,27,54
029121912,tx,-98.37898,29.65105,4304,52,79,27,51.9
029130200,tx,-98.46738,29.41582,812,67,92,25,37.3
029130300,tx,-98.46725,29.40725,1277,67,92,25,37.3
029130401,tx,-98.4544,29.40804,1565,67,92,25,37.3
029130402,tx,-98.44058,29.40552,1466,67,93,26,38.8
029130500,tx,-98.45217,29.41922,1783,67,92,25,37.3
029130600,tx,-98.4522,29.43032,1800,67,92,25,37.3
029130700,tx,-98.4513,29.43951,785,67,92,25,37.3
029130800,tx,-98.4307,29.43478,1767,67,92,25,37.3
029130900,tx,-98.40756,29.43717,1252,67,92,25,37.3
029131000,tx,-98.40695,29.41741,1947,67,92,25,37.3
029131100,tx,-98.42682,29.4056,1258,67,93,26,38.8
029131200,tx,-98.41417,29.39693,974,68,93,25,36.8
029131300,tx,-98.39761,29.39253,2403,68,93,25,36.8
029131401,tx,-98.37457,29.37881,3486,70,95,25,35.7
029131402,tx,-98.37595,29.40633,1017,69,95,26,37.7
029131503,tx,-98.38921,29.46432,1251,65,91,26,40
029131504,tx,-98.39116,29.44966,1356,65,91,26,40
029131505,tx,-98.36632,29.4728,1394,65,90,25,38.5
029131506,tx,-98.37267,29.43997,2202,65,91,26,40
029131507,tx,-98.37222,29.46526,2039,65,90,25,38.5
029131601,tx,-98.24618,29.5084,3766,64,90,26,40.6
029131606,tx,-98.30168,29.48628,2977,66,91,25,37.9
029131608,tx,-98.30409,29.51742,1839,65,90,25,38.5
029131609,tx,-98.32839,29.50344,2633,64,90,26,40.6
029131610,tx,-98.31801,29.4949,1689,64,90,26,40.6
029131612,tx,-98.32143,29.46478,1003,66,92,26,39.4
029131614,tx,-98.34027,29.47389,1341,66,91,25,37.9
029131615,tx,-98.35159,29.46922,4213,65,91,26,40
029131616,tx,-98.32879,29.48379,2564,64,90,26,40.6
029131700,tx,-98.27835,29.52969,16,64,89,25,39.1
029131801,tx,-98.18773,29.43335,2037,69,94,25,36.2
029131802,tx,-98.28592,29.42467,4324,68,93,25,36.8
029140100,tx,-98.47878,29.40637,757,67,93,26,38.8
029140200,tx,-98.48107,29.3962,1084,69,94,25,36.2
029140300,tx,-98.48314,29.38669,1126,69,95,26,37.7
029140400,tx,-98.46735,29.39674,1298,68,93,25,36.8
029140500,tx,-98.455,29.39641,1354,68,94,26,38.2
029140600,tx,-98.44358,29.39274,1125,68,94,26,38.2
029140700,tx,-98.46098,29.38752,1615,68,94,26,38.2
029140800,tx,-98.46962,29.37766,1758,68,94,26,38.2
029140900,tx,-98.45487,29.37981,761,68,94,26,38.2
029141000,tx,-98.45735,29.37098,901,68,94,26,38.2
029141101,tx,-98.45344,29.35756,468,71,96,25,35.2
029141102,tx,-98.44534,29.3627,800,69,94,25,36.2
029141200,tx,-98.43955,29.38026,2212,68,94,26,38.2
029141300,tx,-98.41464,29.37552,1581,68,94,26,38.2
029141402,tx,-98.41458,29.3455,1688,70,96,26,37.1
029141403,tx,-98.42728,29.35866,1117,69,94,25,36.2
029141404,tx,-98.4257,29.36678,1612,68,94,26,38.2
029141600,tx,-98.4373,29.32911,1643,71,96,25,35.2
029141700,tx,-98.39476,29.3232,2413,72,97,25,34.7
029141800,tx,-98.36168,29.25742,2513,74,99,25,33.8
029141900,tx,-98.29822,29.32928,3366,70,96,26,37.1
029150100,tx,-98.50331,29.40373,1986,68,93,25,36.8
029150300,tx,-98.50164,29.3884,1680,69,95,26,37.7
029150400,tx,-98.51736,29.38797,1425,69,94,25,36.2
029150501,tx,-98.5256,29.37908,1493,68,94,26,38.2
029150502,tx,-98.52548,29.37176,1376,68,94,26,38.2
029150600,tx,-98.5105,29.37529,1532,69,95,26,37.7
029150700,tx,-98.49637,29.37502,1928,69,95,26,37.7
029150800,tx,-98.47716,29.3663,557,70,95,25,35.7
029150900,tx,-98.49323,29.36243,1992,69,95,26,37.7
029151000,tx,-98.51024,29.36253,1056,70,95,25,35.7
029151100,tx,-98.53068,29.36208,2306,68,94,26,38.2
029151200,tx,-98.54264,29.33817,2496,71,96,25,35.2
029151301,tx,-98.52566,29.3473,1523,71,96,25,35.2
029151302,tx,-98.52423,29.32949,1107,71,96,25,35.2
029151400,tx,-98.51006,29.3496,1372,70,96,26,37.1
029151500,tx,-98.49233,29.3526,853,70,96,26,37.1
029151600,tx,-98.49378,29.3412,2246,70,96,26,37.1
029151700,tx,-98.50062,29.32947,2657,70,96,26,37.1
029151900,tx,-98.47044,29.29057,2869,73,98,25,34.2
029152000,tx,-98.53415,29.28329,674,74,99,25,33.8
029152100,tx,-98.52771,29.20717,3130,72,97,25,34.7
029152201,tx,-98.44826,29.19957,4099,74,99,25,33.8
029152202,tx,-98.38961,29.18159,2629,74,99,25,33.8
029160100,tx,-98.52124,29.40848,1802,68,94,26,38.2
029160200,tx,-98.51837,29.39994,934,68,94,26,38.2
029160300,tx,-98.5264,29.39123,1813,68,94,26,38.2
029160400,tx,-98.54124,29.39034,1643,68,94,26,38.2
029160501,tx,-98.53879,29.41128,799,68,94,26,38.2
029160502,tx,-98.53938,29.40274,1255,68,94,26,38.2
029160600,tx,-98.5537,29.41137,1538,68,94,26,38.2
029160701,tx,-98.57391,29.40633,1314,68,94,26,38.2
029160702,tx,-98.55696,29.39625,1137,69,94,25,36.2
029160901,tx,-98.54609,29.36761,1107,69,94,25,36.2
029160902,tx,-98.55772,29.36931,1418,69,95,26,37.7
029161000,tx,-98.57278,29.34401,998,72,97,25,34.7
029161100,tx,-98.57591,29.32754,3121,71,96,25,35.2
029161200,tx,-98.6033,29.29903,1400,74,99,25,33.8
029161302,tx,-98.61317,29.33278,1468,72,97,25,34.7
029161303,tx,-98.60672,29.34283,1218,72,97,25,34.7
029161304,tx,-98.59223,29.34938,1400,72,97,25,34.7
029161400,tx,-98.61787,29.38664,2,69,95,26,37.7
029161501,tx,-98.60735,29.36485,1691,69,95,26,37.7
029161503,tx,-98.62677,29.35583,1666,71,96,25,35.2
029161504,tx,-98.61706,29.3551,1411,71,96,25,35.2
029161600,tx,-98.61888,29.39277,1211,69,95,26,37.7
029161801,tx,-98.64796,29.3847,1068,69,95,26,37.7
029161802,tx,-98.66025,29.34474,2654,71,97,26,36.6
029161901,tx,-98.69364,29.31086,680,74,99,25,33.8
029161902,tx,-98.75596,29.3188,5267,71,97,26,36.6
029162001,tx,-98.63207,29.25986,1017,74,100,26,35.1
029162003,tx,-98.6342,29.2115,2719,69,95,26,37.7
029162004,tx,-98.70648,29.25649,1766,73,98,25,34.2
029170101,tx,-98.51907,29.43992,1378,68,93,25,36.8
029170102,tx,-98.51961,29.43164,1394,68,94,26,38.2
029170200,tx,-98.52089,29.42166,1836,68,94,26,38.2
029170300,tx,-98.53419,29.42178,2250,68,94,26,38.2
029170401,tx,-98.53164,29.44095,1575,67,93,26,38.8
029170402,tx,-98.53554,29.43429,1725,68,94,26,38.2
029170500,tx,-98.52752,29.44972,1558,66,92,26,39.4
029170600,tx,-98.55005,29.45195,1539,67,92,25,37.3
029170700,tx,-98.55076,29.44327,1744,67,93,26,38.8
029170800,tx,-98.54779,29.43427,846,68,94,26,38.2
029170900,tx,-98.54824,29.42363,1396,68,94,26,38.2
029171000,tx,-98.55961,29.42316,1963,68,94,26,38.2
029171100,tx,-98.56862,29.42246,1171,68,94,26,38.2
029171200,tx,-98.56564,29.4364,1446,68,94,26,38.2
029171301,tx,-98.56739,29.44541,1014,67,92,25,37.3
029171302,tx,-98.57055,29.45373,1246,66,92,26,39.4
029171401,tx,-98.59474,29.44129,1094,67,93,26,38.8
029171402,tx,-98.58195,29.44254,2034,67,93,26,38.8
029171501,tx,-98.58129,29.41566,1085,68,94,26,38.2
029171502,tx,-98.58005,29.42713,1716,68,94,26,38.2
029171601,tx,-98.61797,29.41747,1333,68,94,26,38.2
029171602,tx,-98.60231,29.42222,1183,68,94,26,38.2
029171700,tx,-98.62726,29.43558,2280,68,94,26,38.2
029171801,tx,-98.63937,29.41312,1466,67,93,26,38.8
029171802,tx,-98.63596,29.40547,1447,68,94,26,38.2
029171903,tx,-98.65645,29.40676,1774,66,93,27,40.9
029171912,tx,-98.68719,29.47987,2309,63,90,27,42.9
029171913,tx,-98.67177,29.42374,1772,66,92,26,39.4
029171914,tx,-98.67896,29.4335,1778,66,93,27,40.9
029171915,tx,-98.68366,29.42309,744,66,93,27,40.9
029171916,tx,-98.70092,29.42292,3414,67,93,26,38.8
029171917,tx,-98.69967,29.44186,2816,64,90,26,40.6
029171918,tx,-98.69608,29.45743,1396,64,90,26,40.6
029171919,tx,-98.6861,29.3911,1567,70,96,26,37.1
029171920,tx,-98.67384,29.40318,2947,67,93,26,38.8
029171921,tx,-98.69858,29.3956,1877,69,95,26,37.7
029171922,tx,-98.6884,29.41132,1623,66,93,27,40.9
029171923,tx,-98.65101,29.45503,2338,66,92,26,39.4
029171924,tx,-98.67621,29.45568,1295,66,92,26,39.4
029171926,tx,-98.64631,29.44424,113,66,92,26,39.4
029171927,tx,-98.65881,29.42949,1951,66,92,26,39.4
029171928,tx,-98.66426,29.47044,1925,66,92,26,39.4
029171929,tx,-98.65585,29.4655,886,66,92,26,39.4
029172002,tx,-98.75565,29.40031,10023,66,92,26,39.4
029172003,tx,-98.72372,29.43866,1934,64,91,27,42.2
029172004,tx,-98.7599,29.48737,4256,60,87,27,45
029172005,tx,-98.72654,29.49286,2843,57,84,27,47.4
029172006,tx,-98.78379,29.46093,5428,61,88,27,44.3
029172008,tx,-98.72307,29.47512,1620,62,89,27,43.5
029172009,tx,-98.73477,29.45077,3534,63,90,27,42.9
029180101,tx,-98.5366,29.45933,1858,67,92,25,37.3
029180102,tx,-98.53678,29.46571,714,67,92,25,37.3
029180201,tx,-98.53293,29.4778,1218,66,92,26,39.4
029180202,tx,-98.54212,29.47426,1237,67,92,25,37.3
029180300,tx,-98.55751,29.46676,1401,67,92,25,37.3
029180400,tx,-98.57087,29.46268,842,66,92,26,39.4
029180501,tx,-98.58963,29.47021,1124,66,92,26,39.4
029180503,tx,-98.59265,29.46029,1498,66,92,26,39.4
029180504,tx,-98.5919,29.4523,1317,66,92,26,39.4
029180602,tx,-98.55627,29.47776,797,66,92,26,39.4
029180603,tx,-98.58386,29.4849,472,62,88,26,41.9
029180604,tx,-98.57063,29.48127,1832,64,90,26,40.6
029180701,tx,-98.56596,29.49881,666,58,85,27,46.6
029180702,tx,-98.58445,29.49363,1250,58,84,26,44.8
029180800,tx,-98.55023,29.49041,398,63,89,26,41.3
029180901,tx,-98.54018,29.49707,1942,63,89,26,41.3
029180902,tx,-98.5303,29.49902,2381,63,89,26,41.3
029181001,tx,-98.54161,29.51402,965,63,89,26,41.3
029181003,tx,-98.5648,29.52191,273,57,83,26,45.6
029181004,tx,-98.55977,29.51277,259,59,85,26,44.1
029181005,tx,-98.55405,29.50239,50,62,88,26,41.9
029181100,tx,-98.55028,29.52693,1890,59,85,26,44.1
029181200,tx,-98.53922,29.5368,1913,57,84,27,47.4
029181301,tx,-98.55995,29.54819,792,55,82,27,49.1
029181302,tx,-98.56579,29.5418,1095,54,81,27,50
029181303,tx,-98.57202,29.53279,201,54,81,27,50
029181402,tx,-98.58031,29.51225,141,58,84,26,44.8
029181403,tx,-98.57972,29.52578,413,55,81,26,47.3
029181404,tx,-98.5882,29.52864,557,57,83,26,45.6
029181503,tx,-98.60275,29.51274,1186,58,85,27,46.6
029181504,tx,-98.59353,29.50548,1097,58,84,26,44.8
029181505,tx,-98.60505,29.49998,1653,58,85,27,46.6
029181506,tx,-98.60925,29.49305,940,58,85,27,46.6
029181601,tx,-98.60242,29.47533,993,65,91,26,40
029181602,tx,-98.61404,29.45793,1328,65,91,26,40
029181703,tx,-98.6515,29.52736,2136,60,86,26,43.3
029181704,tx,-98.63384,29.50017,1895,59,86,27,45.8
029181705,tx,-98.61705,29.48061,1811,62,89,27,43.5
029181711,tx,-98.6527,29.5093,2944,63,89,26,41.3
029181712,tx,-98.65963,29.49302,1367,63,89,26,41.3
029181713,tx,-98.64776,29.48704,2420,63,90,27,42.9
029181715,tx,-98.68591,29.49943,2131,61,88,27,44.3
029181716,tx,-98.69291,29.50712,2478,61,88,27,44.3
029181718,tx,-98.67164,29.52782,1981,59,86,27,45.8
029181720,tx,-98.66341,29.53935,1558,58,85,27,46.6
029181721,tx,-98.67284,29.54153,1191,58,85,27,46.6
029181722,tx,-98.67286,29.51357,1628,63,89,26,41.3
029181723,tx,-98.67843,29.5216,1427,62,88,26,41.9
029181724,tx,-98.68792,29.55092,1927,57,84,27,47.4
029181725,tx,-98.63089,29.4669,754,65,91,26,40
029181726,tx,-98.70086,29.53045,4230,57,84,27,47.4
029181727,tx,-98.6416,29.47184,1114,65,91,26,40
029181729,tx,-98.73775,29.52006,4538,57,84,27,47.4
029181730,tx,-98.67036,29.49288,1275,63,89,26,41.3
029181731,tx,-98.67266,29.50264,2613,63,89,26,41.3
029181732,tx,-98.70872,29.50597,1071,61,87,26,42.6
029181733,tx,-98.7146,29.51361,1965,61,88,27,44.3
029181808,tx,-98.59797,29.53773,541,54,81,27,50
029181809,tx,-98.62398,29.55022,2243,55,83,28,50.9
029181811,tx,-98.63947,29.53233,1569,57,84,27,47.4
029181813,tx,-98.57991,29.55672,768,54,81,27,50
029181814,tx,-98.58916,29.57808,804,53,81,28,52.8
029181815,tx,-98.59435,29.55125,1081,54,82,28,51.9
029181816,tx,-98.60794,29.55549,1713,55,83,28,50.9
029181817,tx,-98.61798,29.51113,938,59,85,26,44.1
029181818,tx,-98.61057,29.52873,1622,56,84,28,50
029181819,tx,-98.60988,29.56611,1877,53,81,28,52.8
029181820,tx,-98.61507,29.57905,566,52,79,27,51.9
029181821,tx,-98.62381,29.54071,974,55,83,28,50.9
029181822,tx,-98.62511,29.52499,1710,57,84,27,47.4
029181823,tx,-98.63882,29.57725,625,52,79,27,51.9
029181824,tx,-98.64116,29.56535,1118,54,82,28,51.9
029181825,tx,-98.65497,29.55314,1389,58,85,27,46.6
029181826,tx,-98.63867,29.55283,2540,56,83,27,48.2
029181901,tx,-98.61484,29.60203,479,49,76,27,55.1
029181902,tx,-98.64562,29.64596,3528,45,72,27,60
029182001,tx,-98.66235,29.56799,1641,56,83,27,48.2
029182002,tx,-98.66959,29.60254,3965,51,79,28,54.9
029182003,tx,-98.64064,29.60084,1676,50,78,28,56
029182101,tx,-98.64557,29.72218,5611,41,68,27,65.9
029182102,tx,-98.66943,29.70201,4647,41,68,27,65.9
029182103,tx,-98.73846,29.66534,3260,41,68,27,65.9
029182105,tx,-98.78415,29.57047,4251,54,81,27,50
029182106,tx,-98.71975,29.57319,4799,52,79,27,51.9
029190100,tx,-98.5071,29.44812,1125,66,92,26,39.4
029190200,tx,-98.48977,29.45252,1561,66,92,26,39.4
029190400,tx,-98.48945,29.46307,874,66,92,26,39.4
029190501,tx,-98.51994,29.46014,1034,67,92,25,37.3
029190503,tx,-98.50359,29.45967,1193,66,92,26,39.4
029190504,tx,-98.51188,29.45976,948,66,92,26,39.4
029190601,tx,-98.52168,29.47212,1266,67,92,25,37.3
029190603,tx,-98.50359,29.47343,1039,66,92,26,39.4
029190604,tx,-98.51367,29.47467,1496,66,92,26,39.4
029190700,tx,-98.49558,29.47746,1109,65,91,26,40
029190800,tx,-98.48663,29.47493,832,66,92,26,39.4
029190901,tx,-98.4983,29.50602,1254,62,89,27,43.5
029190902,tx,-98.48548,29.49614,1548,62,89,27,43.5
029191003,tx,-98.51998,29.50182,1743,63,89,26,41.3
029191004,tx,-98.50661,29.49615,742,62,89,27,43.5
029191005,tx,-98.50401,29.48539,854,63,89,26,41.3
029191006,tx,-98.51681,29.48649,2044,63,89,26,41.3
029191101,tx,-98.52283,29.52806,896,60,86,26,43.3
029191102,tx,-98.51432,29.51381,883,62,89,27,43.5
029191201,tx,-98.50059,29.54098,1108,61,87,26,42.6
029191202,tx,-98.5076,29.53266,1546,61,87,26,42.6
029191303,tx,-98.47879,29.5535,613,62,88,26,41.9
029191304,tx,-98.49016,29.52885,575,61,88,27,44.3
029191405,tx,-98.53871,29.57567,2749,56,83,27,48.2
029191406,tx,-98.52001,29.59811,2441,56,83,27,48.2
029191408,tx,-98.51498,29.54972,161,58,84,26,44.8
029191409,tx,-98.52087,29.54311,932,58,84,26,44.8
029191410,tx,-98.50823,29.55514,271,61,87,26,42.6
029191411,tx,-98.51222,29.56753,809,59,85,26,44.1
029191412,tx,-98.5368,29.59184,924,56,82,26,46.4
029191413,tx,-98.52506,29.57861,1711,56,82,26,46.4
029191503,tx,-98.57317,29.5751,2103,53,81,28,52.8
029191504,tx,-98.56085,29.58235,1276,54,81,27,50
029191505,tx,-98.55391,29.55428,983,56,83,27,48.2
029191506,tx,-98.54321,29.56021,1798,57,83,26,45.6
029191701,tx,-98.48789,29.58313,729,58,85,27,46.6
029191702,tx,-98.49409,29.59828,2320,58,85,27,46.6
029191804,tx,-98.49152,29.71118,5195,45,72,27,60
029191806,tx,-98.53583,29.61621,2902,51,78,27,52.9
029191807,tx,-98.59369,29.62716,3410,47,75,28,59.6
029191808,tx,-98.46577,29.657,1753,48,75,27,56.3
029191809,tx,-98.48809,29.6804,3174,46,74,28,60.9
029191810,tx,-98.46499,29.67566,1666,48,75,27,56.3
029191811,tx,-98.51153,29.65447,1834,48,75,27,56.3
029191812,tx,-98.48776,29.65517,1476,49,76,27,55.1
029191813,tx,-98.49944,29.64515,2166,51,79,28,54.9
029191814,tx,-98.46581,29.70001,2444,46,73,27,58.7
029191815,tx,-98.50857,29.62956,1616,52,80,28,53.8
029191816,tx,-98.50191,29.61726,972,53,80,27,50.9
029191818,tx,-98.47829,29.62109,562,53,80,27,50.9
029191819,tx,-98.47404,29.63855,2624,54,81,27,50
029191900,tx,-98.47042,29.42809,2182,67,93,26,38.8
029192000,tx,-98.46938,29.4598,1288,66,92,26,39.4
029192100,tx,-98.49381,29.40836,1062,67,93,26,38.8
029192200,tx,-98.45732,29.33899,628,71,96,25,35.2
029192300,tx,-98.49614,29.56194,1650,59,86,27,45.8
029980001,tx,-98.5675,29.69143,5,45,72,27,60
029980002,tx,-98.54604,29.37643,6,68,94,26,38.2
029980003,tx,-98.66521,29.36915,1,69,95,26,37.7
029980004,tx,-98.46801,29.53693,187,63,89,26,41.3
029980005,tx,-98.75667,29.56982,6,50,77,27,54
029980100,tx,-98.57882,29.38158,51,69,95,26,37.7
031950101,tx,-98.48793,30.22915,1876,42,68,26,61.9
031950102,tx,-98.37749,30.36737,3058,45,71,26,57.8
031950201,tx,-98.3399,30.09543,4481,45,71,26,57.8
031950202,tx,-98.45973,30.09942,2086,40,65,25,62.5
033950100,tx,-101.43175,32.74369,2373,18,39,21,116.7
035950100,tx,-97.7347,32.02765,4672,54,79,25,46.3
035950200,tx,-97.65786,31.92313,779,56,80,24,42.9
035950300,tx,-97.56075,31.93411,2321,58,83,25,43.1
035950400,tx,-97.58602,31.79225,3906,56,81,25,44.6
035950500,tx,-97.57802,31.78285,1385,58,82,24,41.4
035950600,tx,-97.43387,31.88784,1902,63,86,23,36.5
035950700,tx,-97.53016,31.68435,1910,56,81,25,44.6
037010100,tx,-94.04931,33.45061,2164,58,80,22,37.9
037010400,tx,-94.07544,33.40564,3397,63,86,23,36.5
037010500,tx,-94.05604,33.42706,1859,61,84,23,37.7
037010600,tx,-94.06572,33.43626,1335,63,85,22,34.9
037010700,tx,-94.06699,33.45431,1969,59,82,23,39
037010800,tx,-94.08624,33.43619,1691,62,84,22,35.5
037010903,tx,-94.06525,33.47522,1509,58,81,23,39.7
037010904,tx,-94.09597,33.48374,1685,59,81,22,37.3
037010905,tx,-94.12474,33.44593,1249,61,84,23,37.7
037010906,tx,-94.12318,33.46658,1888,60,83,23,38.3
037011001,tx,-94.1431,33.42536,1561,63,85,22,34.9
037011002,tx,-94.11396,33.42896,1906,63,86,23,36.5
037011101,tx,-94.11742,33.38155,2121,65,87,22,33.8
037011102,tx,-94.0687,33.3722,1096,66,88,22,33.3
037011201,tx,-94.12669,33.53029,2308,58,80,22,37.9
037011202,tx,-94.18033,33.44248,1490,61,83,22,36.1
037011301,tx,-94.26191,33.46849,1734,61,83,22,36.1
037011302,tx,-94.29047,33.47678,2320,61,83,22,36.1
037011402,tx,-94.28345,33.30627,1628,64,87,23,35.9
037011403,tx,-94.11019,33.33335,1968,67,89,22,32.8
037011404,tx,-94.33226,33.37099,2988,63,86,23,36.5
037011501,tx,-94.48057,33.45344,3571,63,86,23,36.5
037011502,tx,-94.41859,33.52662,1878,63,85,22,34.9
037011601,tx,-94.68032,33.48015,2362,63,86,23,36.5
037011602,tx,-94.61206,33.57857,2960,63,86,23,36.5
037011700,tx,-94.59764,33.34495,2668,64,87,23,35.9
039660100,tx,-95.23168,29.55236,2093,56,88,32,57.1
039660200,tx,-95.23724,29.51255,2579,56,88,32,57.1
039660301,tx,-95.27227,29.55407,1199,60,91,31,51.7
039660302,tx,-95.26058,29.54368,1120,58,89,31,53.4
039660303,tx,-95.25231,29.53615,1550,57,89,32,56.1
039660401,tx,-95.27907,29.58289,1254,61,92,31,50.8
039660402,tx,-95.27141,29.57246,1526,61,92,31,50.8
039660403,tx,-95.2622,29.56968,1180,59,90,31,52.5
039660501,tx,-95.33961,29.57329,1114,61,92,31,50.8
039660502,tx,-95.31752,29.57265,1133,61,92,31,50.8
039660503,tx,-95.29628,29.5766,1510,61,92,31,50.8
039660504,tx,-95.31815,29.59074,1178,61,92,31,50.8
039660603,tx,-95.404,29.57892,190,67,97,30,44.8
039660604,tx,-95.42366,29.56177,1306,68,98,30,44.1
039660605,tx,-95.41583,29.5672,1757,68,98,30,44.1
039660606,tx,-95.40314,29.56434,918,68,98,30,44.1
039660607,tx,-95.39394,29.56672,948,68,98,30,44.1
039660608,tx,-95.37292,29.58122,1542,64,94,30,46.9
039660609,tx,-95.36402,29.57481,1794,64,94,30,46.9
039660610,tx,-95.37001,29.56386,2063,64,95,31,48.4
039660611,tx,-95.42036,29.54654,1926,69,98,29,42
039660612,tx,-95.39969,29.54966,1104,68,98,30,44.1
039660613,tx,-95.42811,29.52481,2211,69,99,30,43.5
039660614,tx,-95.43014,29.50384,2314,69,99,30,43.5
039660615,tx,-95.4051,29.50519,2278,68,98,30,44.1
039660616,tx,-95.40142,29.53266,2038,68,98,30,44.1
039660703,tx,-95.37728,29.54863,1114,65,95,30,46.2
039660704,tx,-95.35808,29.54936,1895,64,94,30,46.9
039660705,tx,-95.33954,29.55036,1576,61,92,31,50.8
039660706,tx,-95.37782,29.53464,1346,65,95,30,46.2
039660707,tx,-95.34822,29.53554,1645,64,94,30,46.9
039660708,tx,-95.36445,29.5031,3468,63,94,31,49.2
039660803,tx,-95.31944,29.55141,1444,61,92,31,50.8
039660804,tx,-95.29529,29.55565,1792,60,91,31,51.7
039660805,tx,-95.31238,29.53801,2075,61,92,31,50.8
039660806,tx,-95.29066,29.54319,967,60,91,31,51.7
039660901,tx,-95.28538,29.49097,932,58,90,32,55.2
039660902,tx,-95.28969,29.51866,2330,60,91,31,51.7
039661000,tx,-95.29756,29.46627,4398,58,90,32,55.2
039661100,tx,-95.22844,29.44099,1286,57,89,32,56.1
039661200,tx,-95.23784,29.4151,1252,58,91,33,56.9
039661300,tx,-95.25816,29.42825,1203,58,91,33,56.9
039661400,tx,-95.25991,29.40909,2595,59,91,32,54.2
039661501,tx,-95.3244,29.439,2718,60,91,31,51.7
039661502,tx,-95.31199,29.39186,2200,61,92,31,50.8
039661601,tx,-95.21234,29.3911,2178,61,92,31,50.8
039661602,tx,-95.2516,29.35187,1333,68,97,29,42.6
039661700,tx,-95.20838,29.22679,3688,89,113,24,27
039661800,tx,-95.37418,29.36737,5241,63,94,31,49.2
039661901,tx,-95.50663,29.30475,3362,67,97,30,44.8
039661902,tx,-95.48593,29.40499,4977,68,98,30,44.1
039662000,tx,-95.68511,29.22953,8761,72,101,29,40.3
039662100,tx,-95.50984,29.19689,5175,67,98,31,46.3
039662200,tx,-95.40066,29.25423,2639,73,102,29,39.7
039662300,tx,-95.42295,29.17545,2063,79,106,27,34.2
039662400,tx,-95.34683,29.19798,3977,86,111,25,29.1
039662500,tx,-95.54203,29.11817,4401,72,100,28,38.9
039662600,tx,-95.64411,29.11015,2266,74,101,27,36.5
039662700,tx,-95.78236,29.13929,2254,72,100,28,38.9
039662800,tx,-95.69765,29.01854,3706,77,103,26,33.8
039662900,tx,-95.61221,29.05951,3375,81,106,25,30.9
039663000,tx,-95.53827,29.00764,2755,92,114,22,23.9
039663100,tx,-95.47516,29.0844,3051,90,113,23,25.6
039663200,tx,-95.44889,29.05236,1825,95,116,21,22.1
039663300,tx,-95.44265,29.03678,1259,95,116,21,22.1
039663400,tx,-95.4529,29.02502,2228,98,118,20,20.4
039663500,tx,-95.4276,29.02639,2148,103,122,19,18.4
039663600,tx,-95.42488,29.05063,2366,99,119,20,20.2
039663700,tx,-95.4125,29.05791,1411,100,120,20,20
039663800,tx,-95.41058,29.02958,2090,103,122,19,18.4
039663900,tx,-95.40388,29.01407,1064,107,124,17,15.9
039664000,tx,-95.3828,29.06425,1336,103,121,18,17.5
039664100,tx,-95.31801,29.08144,4376,94,116,22,23.4
039664200,tx,-95.23567,29.04952,7018,90,110,20,22.2
039664300,tx,-95.36378,28.96815,4772,101,119,18,17.8
039664400,tx,-95.38239,28.91476,4341,98,117,19,19.4
039664501,tx,-95.53027,28.92675,5441,107,123,16,15
039990000,tx,-95.29224,28.91226,20,92,112,20,21.7
041000103,tx,-96.2851,30.87574,1450,69,96,27,39.1
041000104,tx,-96.36607,30.76843,2459,68,95,27,39.7
041000105,tx,-96.27054,30.68604,1752,68,96,28,41.2
041000106,tx,-96.20779,30.73195,1855,70,97,27,38.6
041000107,tx,-96.32228,30.68915,1827,68,95,27,39.7
041000108,tx,-96.28522,30.73583,787,68,96,28,41.2
041000203,tx,-96.3833,30.62417,987,66,94,28,42.4
041000204,tx,-96.37236,30.63512,596,66,94,28,42.4
041000205,tx,-96.49139,30.6839,1932,68,95,27,39.7
041000206,tx,-96.40256,30.62397,906,67,95,28,41.8
041000207,tx,-96.43703,30.61861,1403,68,95,27,39.7
041000301,tx,-96.39741,30.71356,1215,67,95,28,41.8
041000302,tx,-96.37575,30.70062,1083,67,94,27,40.3
041000401,tx,-96.35953,30.68477,1459,67,94,27,40.3
041000402,tx,-96.34579,30.67629,390,68,96,28,41.2
041000501,tx,-96.38933,30.68285,1504,67,94,27,40.3
041000502,tx,-96.37705,30.67993,734,67,94,27,40.3
041000603,tx,-96.38866,30.66769,1844,67,94,27,40.3
041000605,tx,-96.38553,30.65041,606,66,94,28,42.4
041000606,tx,-96.38051,30.6612,381,67,94,27,40.3
041000700,tx,-96.36479,30.6689,1061,67,94,27,40.3
041000800,tx,-96.35581,30.6595,1928,67,94,27,40.3
041000900,tx,-96.36698,30.64716,886,66,94,28,42.4
041001001,tx,-96.35886,30.63297,362,66,94,28,42.4
041001002,tx,-96.35074,30.63215,992,66,94,28,42.4
041001101,tx,-96.34138,30.64357,1072,68,95,27,39.7
041001102,tx,-96.33619,30.64736,179,68,95,27,39.7
041001301,tx,-96.32338,30.63823,430,68,95,27,39.7
041001302,tx,-96.31365,30.63223,880,68,96,28,41.2
041001303,tx,-96.32216,30.62454,853,68,95,27,39.7
041001401,tx,-96.3489,30.61904,143,67,95,28,41.8
041001604,tx,-96.31544,30.59577,576,67,95,28,41.8
041001605,tx,-96.32569,30.59769,667,67,95,28,41.8
041001606,tx,-96.31675,30.60583,447,67,95,28,41.8
041001607,tx,-96.32211,30.6138,198,68,95,27,39.7
041001608,tx,-96.33005,30.60563,947,67,95,28,41.8
041001702,tx,-96.297,30.60627,365,68,96,28,41.2
041001703,tx,-96.31087,30.61471,472,68,96,28,41.2
041001704,tx,-96.30288,30.62096,186,68,96,28,41.2
041001801,tx,-96.29799,30.58981,1500,68,96,28,41.2
041001803,tx,-96.31181,30.5822,1641,68,95,27,39.7
041001804,tx,-96.29287,30.57785,420,68,96,28,41.2
041001901,tx,-96.33993,30.66373,1105,68,96,28,41.2
041001902,tx,-96.32646,30.65086,894,68,95,27,39.7
041002001,tx,-96.27831,30.60643,2171,68,96,28,41.2
041002006,tx,-96.30218,30.57007,523,68,96,28,41.2
041002009,tx,-96.24108,30.56706,2025,70,97,27,38.6
041002010,tx,-96.19001,30.50254,1908,70,97,27,38.6
041002011,tx,-96.23382,30.43577,2623,69,96,27,39.1
041002014,tx,-96.37805,30.55618,616,68,96,28,41.2
041002016,tx,-96.23352,30.60731,1410,69,97,28,40.6
041002017,tx,-96.34968,30.60148,27,67,95,28,41.8
041002018,tx,-96.29494,30.56012,1255,69,96,27,39.1
041002019,tx,-96.28487,30.57127,1279,68,96,28,41.2
041002020,tx,-96.31792,30.53158,857,68,96,28,41.2
041002021,tx,-96.33628,30.55883,2327,67,95,28,41.8
041002022,tx,-96.31163,30.6584,1351,68,96,28,41.2
041002023,tx,-96.34251,30.58974,117,67,95,28,41.8
041002024,tx,-96.3352,30.5918,91,67,95,28,41.8
041002025,tx,-96.2751,30.55962,1924,69,96,27,39.1
041002026,tx,-96.2876,30.54492,2203,69,96,27,39.1
041002100,tx,-96.33815,30.61932,128,68,95,27,39.7
041980000,tx,-96.36658,30.58661,15,67,95,28,41.8
043950300,tx,-103.66027,30.37157,2152,0,1,1,NA
043950400,tx,-103.6584,30.35406,1083,0,1,1,NA
043950500,tx,-103.25122,29.81122,16477,21,39,18,85.7
047950100,tx,-98.21913,27.03055,2412,103,127,24,23.3
047950200,tx,-98.14202,27.22351,2883,105,128,23,21.9
049950100,tx,-98.99862,31.97554,5684,44,68,24,54.5
049950201,tx,-99.09072,31.78349,3692,53,76,23,43.4
049950202,tx,-99.11522,31.88439,4387,51,75,24,47.1
049950300,tx,-98.82419,31.75117,2623,44,69,25,56.8
049950500,tx,-99.14552,31.68205,2043,47,72,25,53.2
049950600,tx,-98.99508,31.73019,1409,57,80,23,40.4
049950700,tx,-98.97142,31.71807,1195,56,79,23,41.1
049950800,tx,-98.98916,31.70596,1535,56,79,23,41.1
049950900,tx,-98.98358,31.69183,1954,55,78,23,41.8
049951000,tx,-98.96283,31.70136,1207,56,79,23,41.1
049951100,tx,-98.97402,31.67277,1886,52,75,23,44.2
049951200,tx,-98.94255,31.74983,2520,55,78,23,41.8
049951300,tx,-99.03314,31.57988,2464,50,74,24,48
051970100,tx,-96.62696,30.62445,1605,68,94,26,38.2
051970201,tx,-96.69956,30.44801,1737,66,92,26,39.4
051970202,tx,-96.81056,30.5488,3932,63,91,28,44.4
051970300,tx,-96.70097,30.53305,2292,66,93,27,40.9
051970400,tx,-96.45187,30.47138,3603,68,95,27,39.7
051970501,tx,-96.63849,30.33992,4730,69,95,26,37.7
051970502,tx,-96.57371,30.38531,2178,69,95,26,37.7
053960101,tx,-98.0048,30.90606,3467,46,72,26,56.5
053960102,tx,-98.05679,30.69046,1430,45,71,26,57.8
053960200,tx,-98.27021,30.90659,4442,39,65,26,66.7
053960301,tx,-98.23167,30.73933,1284,33,59,26,78.8
053960302,tx,-98.21916,30.7856,2104,32,58,26,81.3
053960401,tx,-98.36155,30.76475,5427,46,71,25,54.3
053960402,tx,-98.1888,30.687,2557,40,66,26,65
053960501,tx,-98.36213,30.58364,5391,57,81,24,42.1
053960502,tx,-98.3997,30.60226,4044,58,82,24,41.4
053960600,tx,-98.32683,30.64041,2591,52,77,25,48.1
053960701,tx,-98.25875,30.56171,2171,54,79,25,46.3
053960702,tx,-98.26309,30.60621,1722,55,80,25,45.5
053960801,tx,-98.31603,30.5377,4978,51,77,26,51
053960802,tx,-98.21872,30.48502,2845,55,80,25,45.5
053960803,tx,-98.16577,30.57166,2078,56,82,26,46.4
055960102,tx,-97.57556,29.86826,3025,63,89,26,41.3
055960103,tx,-97.63256,29.98364,2630,63,89,26,41.3
055960104,tx,-97.73234,29.95347,1180,62,88,26,41.9
055960200,tx,-97.65667,29.86144,1805,64,90,26,40.6
055960300,tx,-97.69474,29.87279,2021,63,89,26,41.3
055960400,tx,-97.69528,29.90029,1563,63,89,26,41.3
055960501,tx,-97.84049,29.85736,1269,62,88,26,41.9
055960502,tx,-97.76823,29.81855,1770,64,89,25,39.1
055960600,tx,-97.53064,29.7541,2530,65,91,26,40
055960701,tx,-97.65553,29.69609,1596,69,94,25,36.2
055960702,tx,-97.63191,29.66127,1319,69,94,25,36.2
057000100,tx,-96.6236,28.64141,2222,70,100,30,42.9
057000200,tx,-96.6084,28.61287,1641,69,99,30,43.5
057000300,tx,-96.46326,28.62287,3008,66,98,32,48.5
057000401,tx,-96.60829,28.53882,5043,69,100,31,44.9
057000402,tx,-96.74071,28.62168,1909,80,107,27,33.8
057000501,tx,-96.58291,28.47245,3695,74,103,29,39.2
057000502,tx,-96.66918,28.34381,4245,75,104,29,38.7
057990000,tx,-96.6142,28.1915,2,84,107,23,27.4
059030101,tx,-99.48655,32.4026,1868,25,49,24,96
059030102,tx,-99.53387,32.29092,2653,26,49,23,88.5
059030200,tx,-99.27704,32.30027,3733,36,60,24,66.7
061010101,tx,-97.56591,26.25958,1803,97,123,26,26.8
061010102,tx,-97.40974,26.2899,2200,88,114,26,29.5
061010103,tx,-97.51963,26.20313,1395,98,123,25,25.5
061010201,tx,-97.67983,26.28752,1441,96,122,26,27.1
061010204,tx,-97.67946,26.21956,1041,96,122,26,27.1
061010205,tx,-97.65721,26.23482,1906,96,122,26,27.1
061010301,tx,-97.80853,26.28881,2810,98,124,26,26.5
061010303,tx,-97.82586,26.21459,2641,98,123,25,25.5
061010304,tx,-97.78401,26.19797,2327,97,123,26,26.8
061010403,tx,-97.74295,26.23474,1391,97,122,25,25.8
061010404,tx,-97.73756,26.21782,1092,97,122,25,25.8
061010405,tx,-97.7464,26.19857,1878,97,122,25,25.8
061010406,tx,-97.72769,26.19984,766,97,122,25,25.8
061010500,tx,-97.71346,26.20449,1174,97,122,25,25.8
061010602,tx,-97.68068,26.2091,655,96,122,26,27.1
061010603,tx,-97.6996,26.20951,1462,97,122,25,25.8
061010604,tx,-97.70281,26.22107,1525,97,122,25,25.8
061010700,tx,-97.68895,26.20078,1159,96,122,26,27.1
061010801,tx,-97.67487,26.19625,1179,96,122,26,27.1
061010802,tx,-97.63618,26.20101,873,96,122,26,27.1
061010900,tx,-97.69605,26.19246,1064,96,122,26,27.1
061011000,tx,-97.70873,26.18444,1285,96,121,25,26
061011100,tx,-97.69674,26.18461,980,96,121,25,26
061011200,tx,-97.68521,26.18617,713,96,121,25,26
061011301,tx,-97.67425,26.18143,501,96,122,26,27.1
061011302,tx,-97.66128,26.17727,1426,96,122,26,27.1
061011401,tx,-97.59078,26.14431,1556,95,122,27,28.4
061011402,tx,-97.61886,26.17051,2337,96,122,26,27.1
061011500,tx,-97.62581,26.13184,1843,94,122,28,29.8
061011601,tx,-97.62423,26.11622,1207,94,122,28,29.8
061011602,tx,-97.64156,26.12847,1263,94,121,27,28.7
061011701,tx,-97.65589,26.15314,981,96,122,26,27.1
061011702,tx,-97.64372,26.13566,1337,95,121,26,27.4
061011801,tx,-97.68298,26.17009,1765,96,122,26,27.1
061011802,tx,-97.69754,26.16054,1364,96,121,25,26
061011903,tx,-97.82324,26.09056,1510,97,122,25,25.8
061011904,tx,-97.82924,26.15223,887,98,123,25,25.5
061011905,tx,-97.8172,26.15659,522,97,123,26,26.8
061011906,tx,-97.82446,26.17341,957,97,123,26,26.8
061011907,tx,-97.84542,26.14324,995,97,123,26,26.8
061011908,tx,-97.80146,26.15059,1567,97,123,26,26.8
061012002,tx,-97.75964,26.11694,2646,97,122,25,25.8
061012003,tx,-97.72405,26.17744,1140,96,121,25,26
061012004,tx,-97.76229,26.17912,1055,97,122,25,25.8
061012103,tx,-97.66997,26.14271,34,95,121,26,27.4
061012104,tx,-97.68421,26.11733,2528,95,121,26,27.4
061012105,tx,-97.71867,26.05883,1928,95,121,26,27.4
061012106,tx,-97.66299,26.07309,1075,95,121,26,27.4
061012201,tx,-97.54635,26.12848,1824,98,124,26,26.5
061012202,tx,-97.4407,26.15257,1767,93,119,26,28
061012203,tx,-97.49381,26.14156,1964,99,124,25,25.3
061012301,tx,-97.31273,26.15356,3415,80,108,28,35
061012304,tx,-97.21712,26.06266,2044,64,96,32,50
061012305,tx,-97.23525,26.26245,5443,54,89,35,64.8
061012402,tx,-97.47078,26.07697,1911,97,122,25,25.8
061012403,tx,-97.53649,26.06433,1333,98,125,27,27.6
061012404,tx,-97.50029,26.04818,1336,99,124,25,25.3
061012506,tx,-97.56387,26.03743,2211,97,124,27,27.8
061012508,tx,-97.58941,25.98715,2053,95,121,26,27.4
061012509,tx,-97.51611,25.96324,1077,100,125,25,25
061012510,tx,-97.63965,26.05159,2040,95,121,26,27.4
061012511,tx,-97.61316,26.0468,2474,94,121,27,28.7
061012512,tx,-97.54803,25.93443,875,102,127,25,24.5
061012513,tx,-97.55305,25.98003,1997,99,125,26,26.3
061012514,tx,-97.5352,25.9612,1316,100,126,26,26
061012515,tx,-97.53215,25.97418,790,100,126,26,26
061012516,tx,-97.53759,25.94849,1010,100,126,26,26
061012517,tx,-97.52696,25.95754,1872,100,126,26,26
061012607,tx,-97.43308,25.94748,991,92,119,27,29.3
061012608,tx,-97.4566,25.95129,1814,96,122,26,27.1
061012613,tx,-97.497,25.96029,1646,100,125,25,25
061012614,tx,-97.47827,25.96809,776,99,124,25,25.3
061012615,tx,-97.48062,25.97473,895,99,124,25,25.3
061012616,tx,-97.49555,25.97661,1178,100,125,25,25
061012617,tx,-97.50521,25.97349,829,100,125,25,25
061012700,tx,-97.25752,25.98247,3677,73,104,31,42.5
061012800,tx,-97.52415,25.91589,1899,101,127,26,25.7
061012900,tx,-97.51496,25.93931,1244,102,126,24,23.5
061013002,tx,-97.49485,25.94111,871,101,126,25,24.8
061013003,tx,-97.50424,25.93753,375,103,127,24,23.3
061013004,tx,-97.50059,25.9277,978,103,127,24,23.3
061013102,tx,-97.45711,25.93509,1377,98,124,26,26.5
061013104,tx,-97.48167,25.93843,796,101,126,25,24.8
061013106,tx,-97.47442,25.92656,1055,101,126,25,24.8
061013203,tx,-97.4374,25.93366,630,98,124,26,26.5
061013204,tx,-97.43446,25.9229,608,97,123,26,26.8
061013205,tx,-97.44205,25.92277,838,98,124,26,26.5
061013206,tx,-97.42715,25.92474,741,94,120,26,27.7
061013207,tx,-97.41654,25.92884,1078,94,120,26,27.7
061013303,tx,-97.45346,25.92247,905,98,124,26,26.5
061013305,tx,-97.44295,25.89803,1408,100,125,25,25
061013306,tx,-97.45298,25.89524,800,101,126,25,24.8
061013307,tx,-97.46985,25.88709,661,101,126,25,24.8
061013308,tx,-97.44649,25.88616,1009,101,126,25,24.8
061013309,tx,-97.4403,25.8827,805,101,126,25,24.8
061013401,tx,-97.4824,25.91671,837,103,127,24,23.3
061013402,tx,-97.4788,25.91098,745,103,127,24,23.3
061013500,tx,-97.5013,25.91879,785,103,127,24,23.3
061013600,tx,-97.51624,25.92002,767,102,127,25,24.5
061013700,tx,-97.5098,25.91083,1124,103,127,24,23.3
061013801,tx,-97.49326,25.90804,819,103,127,24,23.3
061013802,tx,-97.48577,25.90067,997,103,128,25,24.3
061013901,tx,-97.46649,25.91031,812,98,124,26,26.5
061013902,tx,-97.47499,25.90266,1121,100,125,25,25
061013903,tx,-97.46291,25.90104,1168,99,125,26,26.3
061014001,tx,-97.49758,25.89553,727,103,127,24,23.3
061014002,tx,-97.50539,25.90606,598,103,127,24,23.3
061014101,tx,-97.41952,25.88554,1415,97,123,26,26.8
061014102,tx,-97.39593,25.90103,1276,94,120,26,27.7
061014103,tx,-97.39326,25.87651,1512,95,121,26,27.4
061014201,tx,-97.24467,26.07921,448,73,102,29,39.7
061014202,tx,-97.36588,26.03794,4879,90,117,27,30
061014300,tx,-97.44992,25.91022,860,98,124,26,26.5
061014401,tx,-97.51028,26.01229,2246,99,125,26,26.3
061014402,tx,-97.50136,25.99239,2615,99,124,25,25.3
061014403,tx,-97.43726,25.96356,1306,93,120,27,29
061014404,tx,-97.46612,25.98426,1264,96,122,26,27.1
061014501,tx,-97.48101,25.95318,1071,99,124,25,25.3
061014502,tx,-97.47541,25.95821,1395,98,124,26,26.5
061980001,tx,-97.65454,26.22759,22,96,122,26,27.1
061980100,tx,-97.42369,25.90649,18,95,122,27,28.4
063950101,tx,-94.9176,32.94787,3069,66,90,24,36.4
063950102,tx,-95.05024,33.00074,6000,63,87,24,38.1
063950200,tx,-94.95911,32.99394,2541,65,89,24,36.9
065950100,tx,-101.19723,35.39989,2742,6,17,11,183.3
065950200,tx,-101.46528,35.40607,3186,5,15,10,200
067950101,tx,-94.0935,33.16539,3895,64,88,24,37.5
067950102,tx,-94.21656,33.19486,2520,64,87,23,35.9
067950200,tx,-94.46564,33.18955,4747,64,87,23,35.9
067950300,tx,-94.1564,33.15883,1282,64,88,24,37.5
067950400,tx,-94.17025,33.11648,3656,64,88,24,37.5
067950500,tx,-94.14157,32.99258,3170,64,88,24,37.5
067950601,tx,-94.2675,32.94979,2803,63,87,24,38.1
067950602,tx,-94.40708,33.02084,4495,63,88,25,39.7
067950700,tx,-94.57973,32.9871,5421,66,90,24,36.4
069950100,tx,-102.26051,34.64425,1464,2,7,5,250
069950200,tx,-102.308,34.53739,2141,2,7,5,250
069950300,tx,-102.25871,34.41978,2051,2,7,5,250
071710100,tx,-94.8554,29.85878,5180,77,103,26,33.8
071710201,tx,-94.88206,29.79102,4079,78,105,27,34.6
071710202,tx,-94.83532,29.75753,5427,77,104,27,35.1
071710300,tx,-94.63301,29.83681,2867,77,104,27,35.1
071710401,tx,-94.42233,29.76671,3933,72,99,27,37.5
071710500,tx,-94.58277,29.65574,4508,80,105,25,31.3
071710600,tx,-94.84744,29.62866,2,77,103,26,33.8
073950100,tx,-95.06971,32.01594,4782,59,86,27,45.8
073950201,tx,-95.22985,32.08436,2192,59,87,28,47.5
073950202,tx,-95.36384,32.09705,6472,60,87,27,45
073950301,tx,-95.19902,31.96494,2401,58,86,28,48.3
073950302,tx,-95.35602,31.96719,4352,58,86,28,48.3
073950400,tx,-95.25941,31.98095,1510,59,87,28,47.5
073950500,tx,-95.29229,31.98966,2545,59,87,28,47.5
073950600,tx,-95.23647,31.95699,2767,59,87,28,47.5
073950700,tx,-95.27691,31.94256,2052,58,86,28,48.3
073950801,tx,-95.15895,31.76645,4291,57,85,28,49.1
073950802,tx,-95.26959,31.84944,3596,55,83,28,50.9
073950900,tx,-95.10888,31.8006,2155,52,81,29,55.8
073951000,tx,-95.07772,31.63861,3676,60,87,27,45
073951100,tx,-95.01036,31.51326,1850,57,85,28,49.1
075950100,tx,-100.20757,34.53092,2698,40,62,22,55
075950200,tx,-100.20801,34.4108,3393,37,60,23,62.2
077030200,tx,-98.18528,33.82667,2117,56,76,20,35.7
077030301,tx,-98.22092,33.96311,4690,56,76,20,35.7
077030302,tx,-98.19902,33.64051,4767,55,76,21,38.2
079950100,tx,-102.82844,33.60414,5233,3,9,6,200
081950100,tx,-100.3513,31.9021,2612,37,62,25,67.6
081950200,tx,-100.63954,31.8802,4031,36,60,24,66.7
085030101,tx,-96.43296,33.26649,2327,59,83,24,40.7
085030102,tx,-96.37753,33.31337,3069,57,82,25,43.9
085030201,tx,-96.53738,33.26331,3463,60,84,24,40
085030202,tx,-96.64277,33.34122,4777,59,82,23,39
085030204,tx,-96.568,33.36883,3014,57,81,24,42.1
085030205,tx,-96.57128,33.33133,2042,57,81,24,42.1
085030206,tx,-96.58043,33.29654,1678,59,83,24,40.7
085030207,tx,-96.52929,33.34466,6595,58,82,24,41.4
085030301,tx,-96.70625,33.24017,4317,60,83,23,38.3
085030302,tx,-96.75007,33.24048,2173,58,81,23,39.7
085030303,tx,-96.77914,33.23786,3107,56,80,24,42.9
085030304,tx,-96.81361,33.24218,3629,57,80,23,40.4
085030306,tx,-96.80467,33.3381,6220,56,80,24,42.9
085030307,tx,-96.72455,33.31103,6325,57,80,23,40.4
085030403,tx,-96.81207,33.16246,1886,58,81,23,39.7
085030404,tx,-96.79398,33.14588,2224,58,82,24,41.4
085030405,tx,-96.79702,33.13101,956,58,82,24,41.4
085030406,tx,-96.81363,33.13115,879,58,82,24,41.4
085030407,tx,-96.83406,33.12755,1519,58,81,23,39.7
085030409,tx,-96.81552,33.14213,580,58,82,24,41.4
085030410,tx,-96.82872,33.15525,1643,58,81,23,39.7
085030504,tx,-96.83234,33.10328,855,58,82,24,41.4
085030505,tx,-96.81485,33.10836,638,58,82,24,41.4
085030506,tx,-96.79778,33.10942,1286,58,82,24,41.4
085030507,tx,-96.77983,33.11189,622,58,82,24,41.4
085030509,tx,-96.79206,33.12237,953,58,82,24,41.4
085030510,tx,-96.77716,33.13416,1072,58,82,24,41.4
085030511,tx,-96.75903,33.13889,5091,59,83,24,40.7
085030512,tx,-96.74244,33.12995,1373,59,83,24,40.7
085030515,tx,-96.68921,33.16674,2239,60,84,24,40
085030516,tx,-96.7071,33.16432,2309,60,84,24,40
085030517,tx,-96.72444,33.16338,2695,60,83,23,38.3
085030518,tx,-96.76806,33.16353,3576,59,83,24,40.7
085030519,tx,-96.80712,33.19963,3225,57,80,23,40.4
085030520,tx,-96.79382,33.18213,1893,58,81,23,39.7
085030521,tx,-96.77607,33.18152,1478,58,81,23,39.7
085030524,tx,-96.75029,33.21112,3381,58,81,23,39.7
085030525,tx,-96.72127,33.19437,1886,59,83,24,40.7
085030529,tx,-96.72547,33.18128,1041,59,83,24,40.7
085030531,tx,-96.7054,33.18484,2331,60,84,24,40
085030532,tx,-96.77811,33.11978,844,58,82,24,41.4
085030533,tx,-96.77763,33.12696,1163,58,82,24,41.4
085030534,tx,-96.69008,33.18035,1170,60,84,24,40
085030535,tx,-96.68911,33.19404,1023,60,84,24,40
085030536,tx,-96.75905,33.18178,2070,59,83,24,40.7
085030537,tx,-96.75914,33.19633,2113,58,82,24,41.4
085030538,tx,-96.74152,33.18162,1695,59,83,24,40.7
085030539,tx,-96.74171,33.19637,2018,58,82,24,41.4
085030540,tx,-96.70083,33.15546,524,60,84,24,40
085030541,tx,-96.68902,33.15345,1469,60,84,24,40
085030542,tx,-96.72211,33.13996,2403,60,84,24,40
085030543,tx,-96.69865,33.14485,966,60,84,24,40
085030544,tx,-96.66939,33.17835,1415,61,85,24,39.3
085030545,tx,-96.67659,33.18799,1098,61,85,24,39.3
085030546,tx,-96.72124,33.2097,1652,59,83,24,40.7
085030547,tx,-96.70687,33.21124,1499,60,84,24,40
085030548,tx,-96.68586,33.20828,1714,61,84,23,37.7
085030549,tx,-96.67763,33.16871,945,61,85,24,39.3
085030550,tx,-96.67203,33.15668,1599,61,85,24,39.3
085030604,tx,-96.63848,33.24159,779,60,84,24,40
085030605,tx,-96.6572,33.22459,1991,62,85,23,37.1
085030606,tx,-96.65344,33.16272,1046,61,85,24,39.3
085030607,tx,-96.65369,33.18127,2055,61,85,24,39.3
085030608,tx,-96.64682,33.19343,766,62,85,23,37.1
085030609,tx,-96.65589,33.20723,2406,62,85,23,37.1
085030701,tx,-96.62298,33.22618,1275,63,86,23,36.5
085030702,tx,-96.62489,33.20362,1874,63,86,23,36.5
085030801,tx,-96.63417,33.1725,846,63,86,23,36.5
085030802,tx,-96.62572,33.18899,1573,63,86,23,36.5
085030901,tx,-96.60414,33.21707,886,63,86,23,36.5
085030902,tx,-96.58971,33.17522,97,63,86,23,36.5
085030903,tx,-96.60836,33.16706,1885,62,86,24,38.7
085031003,tx,-96.53254,33.20511,4275,61,85,24,39.3
085031005,tx,-96.48619,33.20504,1372,59,84,25,42.4
085031006,tx,-96.46992,33.13677,1847,59,84,25,42.4
085031007,tx,-96.53114,33.15632,3399,60,84,24,40
085031008,tx,-96.50191,33.08201,1654,59,84,25,42.4
085031101,tx,-96.37454,33.18513,3055,57,82,25,43.9
085031102,tx,-96.38039,33.11193,4101,58,83,25,43.1
085031201,tx,-96.3782,33.04546,4313,59,84,25,42.4
085031202,tx,-96.39304,33.00089,3313,59,84,25,42.4
085031308,tx,-96.52502,33.03636,2441,58,83,25,43.1
085031314,tx,-96.55497,33.07012,2751,58,83,25,43.1
085031318,tx,-96.5542,33.02378,1832,57,83,26,45.6
085031319,tx,-96.55956,33.00979,1492,57,82,25,43.9
085031320,tx,-96.52359,33.01313,2292,57,83,26,45.6
085031321,tx,-96.50025,33.00285,2705,59,84,25,42.4
085031322,tx,-96.55639,32.9928,2555,57,82,25,43.9
085031323,tx,-96.53253,32.99393,1908,57,82,25,43.9
085031324,tx,-96.64772,33.04268,1631,58,83,25,43.1
085031325,tx,-96.64425,33.02387,909,58,83,25,43.1
085031326,tx,-96.60846,33.06002,2093,58,83,25,43.1
085031327,tx,-96.62338,33.02051,1332,57,82,25,43.9
085031328,tx,-96.61801,33.02624,1075,57,82,25,43.9
085031329,tx,-96.60295,33.02794,2043,57,82,25,43.9
085031330,tx,-96.58141,33.04358,1701,57,82,25,43.9
085031331,tx,-96.59128,33.02322,777,57,82,25,43.9
085031332,tx,-96.57923,33.02135,1554,56,82,26,46.4
085031333,tx,-96.62269,33.00589,1250,56,82,26,46.4
085031334,tx,-96.62221,32.993,997,56,82,26,46.4
085031335,tx,-96.60486,32.99703,2081,56,82,26,46.4
085031336,tx,-96.58454,32.99777,1792,56,82,26,46.4
085031408,tx,-96.61041,33.0927,1179,58,83,25,43.1
085031411,tx,-96.63668,33.06895,2085,58,83,25,43.1
085031412,tx,-96.63009,33.14251,2236,61,84,23,37.7
085031413,tx,-96.63892,33.12178,2235,60,84,24,40
085031414,tx,-96.62072,33.1164,1871,60,84,24,40
085031415,tx,-96.70712,33.10783,1336,60,84,24,40
085031416,tx,-96.7185,33.11757,3342,60,84,24,40
085031417,tx,-96.69181,33.12671,1860,60,84,24,40
085031418,tx,-96.66832,33.13707,2858,60,84,24,40
085031419,tx,-96.58939,33.11081,1655,60,84,24,40
085031420,tx,-96.56386,33.1346,2200,60,85,25,41.7
085031421,tx,-96.6649,33.05989,1482,58,83,25,43.1
085031422,tx,-96.66228,33.07858,1240,59,84,25,42.4
085031423,tx,-96.65116,33.07975,983,59,84,25,42.4
085031424,tx,-96.65569,33.08969,943,59,84,25,42.4
085031425,tx,-96.63744,33.093,2000,59,83,24,40.7
085031504,tx,-96.63914,33.10756,2440,59,84,25,42.4
085031507,tx,-96.68626,33.10869,1623,60,84,24,40
085031508,tx,-96.6602,33.11358,1838,60,84,24,40
085031509,tx,-96.72286,33.09297,1495,59,83,24,40.7
085031510,tx,-96.69438,33.09176,2272,59,84,25,42.4
085031511,tx,-96.6736,33.08746,1927,59,84,25,42.4
085031512,tx,-96.65253,33.0968,888,59,84,25,42.4
085031611,tx,-96.70502,33.04873,1351,58,82,24,41.4
085031613,tx,-96.74269,33.04914,2216,58,82,24,41.4
085031621,tx,-96.7807,33.01855,1744,57,82,25,43.9
085031622,tx,-96.72051,33.03399,1976,58,82,24,41.4
085031623,tx,-96.7211,33.02311,763,58,82,24,41.4
085031624,tx,-96.76001,33.02299,616,57,82,25,43.9
085031625,tx,-96.76172,33.03389,1725,58,82,24,41.4
085031626,tx,-96.74233,33.02309,960,58,82,24,41.4
085031627,tx,-96.74355,33.03382,1680,58,82,24,41.4
085031628,tx,-96.72201,33.05286,1320,58,82,24,41.4
085031629,tx,-96.72389,33.04517,1097,58,82,24,41.4
085031630,tx,-96.73004,33.07925,1603,58,82,24,41.4
085031631,tx,-96.71739,33.07755,979,59,84,25,42.4
085031632,tx,-96.70084,33.07702,1178,59,84,25,42.4
085031633,tx,-96.72577,33.06808,1428,58,83,25,43.1
085031634,tx,-96.72508,33.06104,1080,58,82,24,41.4
085031635,tx,-96.70474,33.06298,910,58,83,25,43.1
085031636,tx,-96.76069,33.06417,2420,58,82,24,41.4
085031639,tx,-96.75934,33.10826,1915,59,83,24,40.7
085031641,tx,-96.74178,33.09369,1703,58,82,24,41.4
085031642,tx,-96.74344,33.07876,1632,58,82,24,41.4
085031643,tx,-96.74303,33.06427,827,58,82,24,41.4
085031645,tx,-96.83643,33.05069,728,57,81,24,42.1
085031646,tx,-96.81302,33.05246,1692,57,81,24,42.1
085031647,tx,-96.83637,33.03611,748,57,81,24,42.1
085031649,tx,-96.81803,33.0209,1632,57,82,25,43.9
085031654,tx,-96.78175,33.03828,1368,57,82,25,43.9
085031655,tx,-96.78287,33.0309,1187,57,82,25,43.9
085031657,tx,-96.81065,33.0835,381,58,82,24,41.4
085031659,tx,-96.79692,33.0809,435,58,82,24,41.4
085031660,tx,-96.79615,33.09038,431,58,82,24,41.4
085031661,tx,-96.78491,33.10143,1416,58,82,24,41.4
085031662,tx,-96.77916,33.09217,1563,58,82,24,41.4
085031663,tx,-96.78294,33.08243,1107,58,82,24,41.4
085031664,tx,-96.7816,33.07507,1289,58,82,24,41.4
085031665,tx,-96.74158,33.11783,343,59,83,24,40.7
085031666,tx,-96.74152,33.10708,1188,59,83,24,40.7
085031667,tx,-96.80406,33.03488,819,57,82,25,43.9
085031668,tx,-96.8216,33.03658,1237,57,81,24,42.1
085031669,tx,-96.83481,33.06153,472,57,81,24,42.1
085031670,tx,-96.83264,33.07728,328,58,82,24,41.4
085031671,tx,-96.8216,33.07177,109,58,82,24,41.4
085031672,tx,-96.80713,33.06733,118,58,82,24,41.4
085031673,tx,-96.79363,33.06295,191,57,82,25,43.9
085031674,tx,-96.78085,33.06363,1190,58,82,24,41.4
085031675,tx,-96.78285,33.05357,933,57,82,25,43.9
085031676,tx,-96.7821,33.04638,1196,57,82,25,43.9
085031677,tx,-96.76092,33.0826,1037,58,82,24,41.4
085031678,tx,-96.7611,33.07555,1235,58,82,24,41.4
085031679,tx,-96.75564,33.09385,960,58,82,24,41.4
085031680,tx,-96.76641,33.09282,1188,58,82,24,41.4
085031681,tx,-96.76174,33.04517,955,58,82,24,41.4
085031682,tx,-96.76046,33.05295,936,58,82,24,41.4
085031704,tx,-96.83657,32.9924,890,58,82,24,41.4
085031706,tx,-96.82138,32.99319,906,58,82,24,41.4
085031708,tx,-96.80384,32.99246,1165,57,82,25,43.9
085031709,tx,-96.78249,33.00434,1269,57,81,24,42.1
085031711,tx,-96.83664,33.00182,858,58,82,24,41.4
085031713,tx,-96.82475,33.00223,280,58,82,24,41.4
085031715,tx,-96.80796,33.00765,926,57,82,25,43.9
085031716,tx,-96.80323,33.00205,671,57,82,25,43.9
085031717,tx,-96.79899,33.00619,272,57,81,24,42.1
085031718,tx,-96.78697,32.99203,875,57,81,24,42.1
085031719,tx,-96.77488,32.99435,549,57,81,24,42.1
085031720,tx,-96.77277,32.98894,113,57,81,24,42.1
085031721,tx,-96.83664,33.00829,977,58,82,24,41.4
085031722,tx,-96.83659,33.01337,20,58,82,24,41.4
085031723,tx,-96.8237,33.01113,18,58,82,24,41.4
085031724,tx,-96.81837,33.00487,180,58,82,24,41.4
085031806,tx,-96.73975,33.00049,28,57,82,25,43.9
085031807,tx,-96.74959,33.01163,1857,57,82,25,43.9
085031808,tx,-96.72149,33.01362,1308,57,82,25,43.9
085031809,tx,-96.71925,33.00604,327,57,82,25,43.9
085031810,tx,-96.71913,33.00069,22,57,82,25,43.9
085031811,tx,-96.76186,33.00266,38,57,82,25,43.9
085031812,tx,-96.76202,32.99286,545,57,82,25,43.9
085031813,tx,-96.75079,32.9928,24,57,82,25,43.9
085031814,tx,-96.73608,32.99192,723,57,82,25,43.9
085031815,tx,-96.71881,32.99178,1112,57,82,25,43.9
085031816,tx,-96.69614,32.99119,858,57,82,25,43.9
085031901,tx,-96.67351,33.00784,276,57,82,25,43.9
085031902,tx,-96.69784,33.01594,1274,57,82,25,43.9
085031903,tx,-96.68743,32.99989,77,57,82,25,43.9
085031904,tx,-96.70401,33.00056,38,57,82,25,43.9
085032003,tx,-96.69067,33.02478,1246,58,82,24,41.4
085032008,tx,-96.67405,33.04264,1671,58,83,25,43.1
085032010,tx,-96.65266,33.01569,1071,57,82,25,43.9
085032012,tx,-96.68949,33.03608,954,58,82,24,41.4
085032013,tx,-96.68781,33.05536,1151,58,83,25,43.1
085032014,tx,-96.67244,33.02022,1159,57,82,25,43.9
085032015,tx,-96.67337,33.02765,860,58,83,25,43.1
085032016,tx,-96.6525,33.00321,933,57,82,25,43.9
085032017,tx,-96.6373,32.99357,898,56,82,26,46.4
085032018,tx,-96.67521,32.99079,1168,57,82,25,43.9
085032019,tx,-96.65471,32.99089,1038,57,82,25,43.9
087950300,tx,-100.27007,34.96488,4919,39,59,20,51.3
089750100,tx,-96.33973,29.61437,3713,83,109,26,31.3
089750200,tx,-96.51534,29.45357,4385,78,105,27,34.6
089750300,tx,-96.70305,29.6231,5035,73,100,27,37
089750400,tx,-96.52633,29.80235,4937,79,105,26,32.9
089750500,tx,-96.5465,29.66948,2592,83,108,25,30.1
091310100,tx,-98.12337,29.69782,1904,61,87,26,42.6
091310200,tx,-98.11937,29.71522,1346,61,87,26,42.6
091310301,tx,-98.1516,29.70269,1098,60,86,26,43.3
091310302,tx,-98.13736,29.71559,1628,61,87,26,42.6
091310401,tx,-98.14744,29.68476,1709,60,86,26,43.3
091310404,tx,-98.10868,29.68338,1495,60,86,26,43.3
091310405,tx,-98.13022,29.67683,1250,60,86,26,43.3
091310406,tx,-98.14887,29.6683,1913,59,85,26,44.1
091310501,tx,-98.10219,29.70861,1346,62,87,25,40.3
091310502,tx,-98.08034,29.7065,2566,62,87,25,40.3
091310503,tx,-98.09885,29.72986,2363,61,87,26,42.6
091310603,tx,-98.29347,29.97292,5941,47,73,26,55.3
091310604,tx,-98.27429,29.8822,4061,48,74,26,54.2
091310608,tx,-98.32659,29.85676,3725,44,70,26,59.1
091310609,tx,-98.30512,29.92052,5227,51,77,26,51
091310610,tx,-98.38194,29.9023,3134,50,76,26,52
091310611,tx,-98.16462,29.89935,2726,49,75,26,53.1
091310612,tx,-98.22061,29.89628,2386,51,77,26,51
091310613,tx,-98.24019,29.85705,3762,47,73,26,55.3
091310614,tx,-98.19727,29.83599,1992,51,77,26,51
091310702,tx,-98.45958,29.8503,3636,47,73,26,55.3
091310703,tx,-98.39334,29.80145,5407,47,74,27,57.4
091310705,tx,-98.44369,29.7705,1562,47,74,27,57.4
091310706,tx,-98.53645,29.77271,3345,43,70,27,62.8
091310707,tx,-98.25657,29.73657,2303,53,80,27,50.9
091310708,tx,-98.3456,29.7572,1681,47,74,27,57.4
091310801,tx,-98.32274,29.66898,3600,56,83,27,48.2
091310803,tx,-98.23246,29.67685,2015,58,84,26,44.8
091310804,tx,-98.22197,29.64102,2367,58,84,26,44.8
091310901,tx,-98.2204,29.78001,6743,51,77,26,51
091310903,tx,-98.07534,29.83464,3250,58,83,25,43.1
091310904,tx,-98.04301,29.75752,3633,61,87,26,42.6
091310905,tx,-98.12626,29.79252,1820,57,83,26,45.6
093950101,tx,-98.53564,32.11608,1322,43,68,25,58.1
093950102,tx,-98.60404,32.11171,4361,44,68,24,54.5
093950200,tx,-98.66243,31.90908,4969,43,68,25,58.1
093950300,tx,-98.58634,31.90513,2373,43,68,25,58.1
093950400,tx,-98.36137,31.85992,2597,43,68,25,58.1
095950300,tx,-99.86396,31.3265,6656,39,64,25,64.1
097000100,tx,-97.06757,33.76202,5380,49,72,23,46.9
097000200,tx,-97.3497,33.72609,5250,47,70,23,48.9
097000400,tx,-97.17648,33.65048,1395,49,72,23,46.9
097000500,tx,-97.14285,33.65204,1522,49,72,23,46.9
097000600,tx,-97.12121,33.65288,1909,49,72,23,46.9
097000701,tx,-96.99091,33.51399,3964,54,77,23,42.6
097000702,tx,-97.07102,33.51644,2830,55,78,23,41.8
097000900,tx,-97.29777,33.52071,5209,52,75,23,44.2
097001100,tx,-97.12073,33.60666,2999,50,73,23,46
099010101,tx,-97.63252,31.48254,3421,52,78,26,50
099010102,tx,-97.95879,31.42318,4172,46,72,26,56.5
099010201,tx,-97.72132,31.47829,10,53,79,26,49.1
099010202,tx,-97.67865,31.45315,3246,56,81,25,44.6
099010300,tx,-97.76965,31.43317,1320,56,81,25,44.6
099010400,tx,-97.66309,31.38163,2275,57,82,25,43.9
099010501,tx,-97.82642,31.14524,4,48,74,26,54.2
099010502,tx,-97.80918,31.14412,3,48,74,26,54.2
099010503,tx,-97.78783,31.14203,2,49,75,26,53.1
099010504,tx,-97.84334,31.11548,65,46,72,26,56.5
099010601,tx,-97.8914,31.12802,1258,44,70,26,59.1
099010603,tx,-97.91462,31.14124,2255,44,69,25,56.8
099010604,tx,-97.94462,31.19615,2577,46,72,26,56.5
099010701,tx,-97.92897,31.1292,1857,43,68,25,58.1
099010702,tx,-97.9231,31.11175,1262,43,69,26,60.5
099010802,tx,-97.90708,31.09094,2142,45,71,26,57.8
099010803,tx,-97.88921,31.09969,1153,45,70,25,55.6
099010804,tx,-97.8862,31.1173,1515,45,71,26,57.8
099980000,tx,-97.76616,31.2562,645,52,77,25,48.1
101950100,tx,-100.27874,34.07765,1623,44,65,21,47.7
103950100,tx,-102.51557,31.4285,3346,25,49,24,96
105950100,tx,-101.41215,30.72298,6492,21,45,24,114.3
107950100,tx,-101.16266,33.63814,2552,10,25,15,150
107950200,tx,-101.35574,33.59977,2877,8,22,14,175
107950300,tx,-101.49764,33.58837,2079,7,20,13,185.7
109950300,tx,-104.51737,31.44707,9392,6,17,11,183.3
111950100,tx,-102.60255,36.27866,3504,1,5,4,400
111950300,tx,-102.50355,36.06894,2630,1,6,5,500
113000100,tx,-96.73693,32.81626,1353,60,85,25,41.7
113000201,tx,-96.75716,32.83274,1369,60,84,24,40
113000202,tx,-96.76573,32.83188,1442,59,84,25,42.4
113000300,tx,-96.77612,32.83017,1571,58,83,25,43.1
113000401,tx,-96.82937,32.81132,842,60,84,24,40
113000405,tx,-96.82054,32.81346,169,60,84,24,40
113000407,tx,-96.83111,32.82076,312,59,83,24,40.7
113000408,tx,-96.82507,32.8182,240,59,83,24,40.7
113000409,tx,-96.8403,32.82689,406,59,83,24,40.7
113000410,tx,-96.8624,32.84295,1389,59,83,24,40.7
113000501,tx,-96.81386,32.81124,145,60,84,24,40
113000502,tx,-96.81093,32.80348,330,60,84,24,40
113000503,tx,-96.81556,32.80835,95,60,84,24,40
113000605,tx,-96.80717,32.81048,225,60,84,24,40
113000606,tx,-96.80102,32.81598,699,59,84,25,42.4
113000607,tx,-96.80658,32.82049,547,59,83,24,40.7
113000608,tx,-96.81332,32.81767,333,59,83,24,40.7
113000609,tx,-96.82137,32.83025,554,59,83,24,40.7
113000610,tx,-96.82642,32.82595,150,59,83,24,40.7
113000611,tx,-96.82066,32.82148,126,59,83,24,40.7
113000703,tx,-96.79435,32.8128,423,60,84,24,40
113000704,tx,-96.79714,32.80743,30,60,84,24,40
113000705,tx,-96.79072,32.81985,254,58,83,25,43.1
113000706,tx,-96.78582,32.82655,125,58,83,25,43.1
113000801,tx,-96.78302,32.80558,703,60,84,24,40
113000802,tx,-96.78824,32.81054,262,60,84,24,40
113000901,tx,-96.78412,32.81627,464,60,84,24,40
113000902,tx,-96.77728,32.81044,256,60,84,24,40
113001001,tx,-96.77655,32.82118,629,58,83,25,43.1
113001002,tx,-96.77546,32.81556,788,60,84,24,40
113001101,tx,-96.76599,32.81568,1346,60,84,24,40
113001102,tx,-96.75737,32.81795,835,60,84,24,40
113001202,tx,-96.73524,32.80078,675,61,85,24,39.3
113001203,tx,-96.74408,32.80262,512,61,85,24,39.3
113001204,tx,-96.7484,32.79872,606,61,85,24,39.3
113001301,tx,-96.75278,32.80613,641,61,85,24,39.3
113001302,tx,-96.76285,32.80034,539,61,85,24,39.3
113001400,tx,-96.76174,32.80768,500,61,85,24,39.3
113001502,tx,-96.76917,32.79357,722,60,84,24,40
113001503,tx,-96.77696,32.80291,340,60,84,24,40
113001504,tx,-96.77371,32.80035,456,60,84,24,40
113001601,tx,-96.78969,32.80104,173,60,84,24,40
113001602,tx,-96.78838,32.7947,697,60,84,24,40
113001703,tx,-96.79688,32.79954,359,60,84,24,40
113001705,tx,-96.7972,32.79132,291,60,84,24,40
113001801,tx,-96.80131,32.80415,50,60,84,24,40
113001802,tx,-96.80456,32.79848,153,60,84,24,40
113001901,tx,-96.80752,32.79413,139,60,84,24,40
113001902,tx,-96.81023,32.7901,115,60,84,24,40
113002001,tx,-96.817,32.76176,397,59,83,24,40.7
113002002,tx,-96.81531,32.75344,543,59,83,24,40.7
113002100,tx,-96.80293,32.78423,257,60,84,24,40
113002200,tx,-96.78138,32.78974,655,60,84,24,40
113002400,tx,-96.75718,32.79412,1047,61,85,24,39.3
113002500,tx,-96.74534,32.78548,2415,61,85,24,39.3
113002703,tx,-96.74273,32.77229,2353,61,85,24,39.3
113003102,tx,-96.80389,32.77872,130,60,84,24,40
113003103,tx,-96.79418,32.78096,289,60,84,24,40
113003700,tx,-96.76151,32.76305,1861,61,85,24,39.3
113004201,tx,-96.82942,32.75864,1448,59,83,24,40.7
113004202,tx,-96.84836,32.75315,799,58,82,24,41.4
113004300,tx,-96.83944,32.77249,1950,59,83,24,40.7
113004400,tx,-96.84497,32.76032,1169,58,82,24,41.4
113004500,tx,-96.86581,32.74416,1590,57,81,24,42.1
113004600,tx,-96.84362,32.7469,575,58,82,24,41.4
113004700,tx,-96.83023,32.7463,804,59,83,24,40.7
113004800,tx,-96.81754,32.74369,668,59,83,24,40.7
113005000,tx,-96.83035,32.73843,1070,59,83,24,40.7
113005100,tx,-96.84244,32.73674,824,59,83,24,40.7
113005200,tx,-96.85088,32.74062,1296,58,82,24,41.4
113005300,tx,-96.86025,32.73409,2145,57,81,24,42.1
113005400,tx,-96.81744,32.72731,1926,59,83,24,40.7
113005500,tx,-96.79954,32.72518,1862,60,84,24,40
113005600,tx,-96.82079,32.71247,2105,59,83,24,40.7
113005700,tx,-96.79997,32.69929,2207,61,85,24,39.3
113005901,tx,-96.80825,32.69313,2202,60,84,24,40
113005902,tx,-96.81876,32.69631,1025,59,83,24,40.7
113006001,tx,-96.8357,32.70733,826,59,83,24,40.7
113006002,tx,-96.8306,32.69667,394,59,83,24,40.7
113006100,tx,-96.84864,32.69855,955,58,83,25,43.1
113006200,tx,-96.83332,32.72398,1449,59,83,24,40.7
113006301,tx,-96.84861,32.71307,1650,59,83,24,40.7
113006302,tx,-96.84742,32.72518,1470,59,83,24,40.7
113006401,tx,-96.86361,32.72587,667,57,82,25,43.9
113006402,tx,-96.87343,32.72751,1075,57,82,25,43.9
113006501,tx,-96.88841,32.73007,1406,57,81,24,42.1
113006502,tx,-96.88372,32.72254,1032,57,82,25,43.9
113006701,tx,-96.89179,32.745,789,57,81,24,42.1
113006702,tx,-96.87721,32.74257,721,57,81,24,42.1
113006800,tx,-96.8648,32.75385,734,57,81,24,42.1
113006900,tx,-96.86642,32.76226,439,57,81,24,42.1
113007101,tx,-96.81752,32.84432,546,59,83,24,40.7
113007102,tx,-96.82849,32.84316,1859,59,83,24,40.7
113007203,tx,-96.87641,32.8555,60,59,83,24,40.7
113007204,tx,-96.87305,32.86105,313,59,82,23,39
113007205,tx,-96.86811,32.86328,194,58,82,24,41.4
113007206,tx,-96.86304,32.8608,60,59,82,23,39
113007301,tx,-96.81465,32.85969,941,58,83,25,43.1
113007302,tx,-96.83469,32.85817,1711,59,83,24,40.7
113007601,tx,-96.8295,32.88773,831,58,82,24,41.4
113007604,tx,-96.79535,32.88739,1237,58,83,25,43.1
113007605,tx,-96.81222,32.88742,689,58,82,24,41.4
113007701,tx,-96.79106,32.86942,353,58,83,25,43.1
113007702,tx,-96.79709,32.87398,838,58,83,25,43.1
113007801,tx,-96.77853,32.87284,940,58,83,25,43.1
113007805,tx,-96.75778,32.90201,1099,59,83,24,40.7
113007809,tx,-96.74009,32.85994,705,60,84,24,40
113007810,tx,-96.73913,32.90673,1110,58,83,25,43.1
113007812,tx,-96.74653,32.88949,1222,59,83,24,40.7
113007815,tx,-96.75675,32.87995,112,59,83,24,40.7
113007819,tx,-96.75942,32.86557,57,59,83,24,40.7
113007821,tx,-96.74875,32.87279,33,59,83,24,40.7
113007822,tx,-96.7664,32.87768,104,59,83,24,40.7
113007823,tx,-96.76443,32.89247,272,59,83,24,40.7
113007824,tx,-96.73812,32.87784,738,59,83,24,40.7
113007825,tx,-96.73464,32.89369,967,59,83,24,40.7
113007826,tx,-96.73419,32.87125,71,59,83,24,40.7
113007827,tx,-96.73079,32.88531,28,59,83,24,40.7
113007828,tx,-96.75094,32.91377,31,58,83,25,43.1
113007829,tx,-96.76078,32.91682,790,58,83,25,43.1
113007830,tx,-96.75979,32.86908,15,59,83,24,40.7
113007831,tx,-96.754,32.86569,8,59,83,24,40.7
113007832,tx,-96.75441,32.86862,24,59,83,24,40.7
113007833,tx,-96.74727,32.86658,24,59,83,24,40.7
113007834,tx,-96.72188,32.90108,23,58,83,25,43.1
113007835,tx,-96.72421,32.89734,308,59,83,24,40.7
113007902,tx,-96.74428,32.84804,2036,60,84,24,40
113007903,tx,-96.75639,32.85005,731,60,84,24,40
113007906,tx,-96.77568,32.8603,809,58,83,25,43.1
113007909,tx,-96.76657,32.85347,25,59,83,24,40.7
113007910,tx,-96.76182,32.85703,16,60,84,24,40
113007912,tx,-96.76745,32.86159,37,59,83,24,40.7
113007913,tx,-96.76712,32.84832,53,59,83,24,40.7
113007914,tx,-96.76949,32.84216,91,59,83,24,40.7
113007915,tx,-96.7616,32.86285,5,59,83,24,40.7
113007916,tx,-96.75733,32.86006,5,60,84,24,40
113008000,tx,-96.73517,32.83516,2900,60,84,24,40
113008101,tx,-96.7147,32.8283,116,59,83,24,40.7
113008102,tx,-96.71081,32.81857,2184,59,84,25,42.4
113008200,tx,-96.69711,32.83878,1377,59,83,24,40.7
113008401,tx,-96.7097,32.76926,1515,60,85,25,41.7
113008402,tx,-96.7203,32.77962,1257,60,84,24,40
113008500,tx,-96.69145,32.77062,1387,60,85,25,41.7
113008604,tx,-96.77007,32.71742,577,61,85,24,39.3
113008701,tx,-96.7622,32.69772,1231,62,86,24,38.7
113008703,tx,-96.78259,32.70304,1401,61,85,24,39.3
113008704,tx,-96.78151,32.69522,959,61,85,24,39.3
113008705,tx,-96.77802,32.68579,729,62,86,24,38.7
113008801,tx,-96.79273,32.71892,1001,61,85,24,39.3
113008802,tx,-96.78744,32.71032,2010,61,85,24,39.3
113009001,tx,-96.67709,32.76644,1015,61,86,25,41
113009002,tx,-96.67221,32.75358,996,61,86,25,41
113009101,tx,-96.69436,32.75656,1399,60,85,25,41.7
113009103,tx,-96.7044,32.74068,668,60,85,25,41.7
113009104,tx,-96.69184,32.74554,974,60,85,25,41.7
113009105,tx,-96.69111,32.7383,1005,60,85,25,41.7
113009202,tx,-96.67367,32.72734,1745,62,87,25,40.3
113009203,tx,-96.67373,32.73806,1005,61,86,25,41
113009204,tx,-96.67142,32.74493,932,61,86,25,41
113009301,tx,-96.69306,32.72868,1431,62,86,24,38.7
113009303,tx,-96.71935,32.72322,1518,62,86,24,38.7
113009304,tx,-96.69964,32.71723,1023,62,87,25,40.3
113009401,tx,-96.85203,32.87183,1333,58,82,24,41.4
113009402,tx,-96.84316,32.87126,1283,58,82,24,41.4
113009500,tx,-96.84736,32.88774,1019,58,82,24,41.4
113009603,tx,-96.82784,32.91742,1523,59,83,24,40.7
113009604,tx,-96.81071,32.9184,1053,59,83,24,40.7
113009605,tx,-96.86749,32.91224,615,59,82,23,39
113009607,tx,-96.8641,32.90261,1349,59,82,23,39
113009608,tx,-96.84627,32.91597,1218,59,83,24,40.7
113009609,tx,-96.84729,32.90238,1203,58,82,24,41.4
113009610,tx,-96.88563,32.90278,128,59,82,23,39
113009611,tx,-96.87652,32.90216,1173,59,82,23,39
113009701,tx,-96.87716,32.88794,1288,58,82,24,41.4
113009702,tx,-96.86263,32.88856,1245,58,82,24,41.4
113009802,tx,-96.86017,32.87176,1061,58,82,24,41.4
113009803,tx,-96.87519,32.87597,542,58,82,24,41.4
113009804,tx,-96.87014,32.87112,79,58,82,24,41.4
113009900,tx,-96.90549,32.88016,1943,59,82,23,39
113010001,tx,-96.85732,32.82292,852,59,83,24,40.7
113010002,tx,-96.81331,32.77278,75,59,83,24,40.7
113010003,tx,-96.86724,32.81077,2563,60,84,24,40
113010101,tx,-96.84881,32.78783,2060,60,84,24,40
113010102,tx,-96.83454,32.78304,1153,60,84,24,40
113010500,tx,-96.88624,32.77694,1579,59,83,24,40.7
113010601,tx,-96.89838,32.7877,2520,59,83,24,40.7
113010602,tx,-96.91526,32.77227,1404,57,81,24,42.1
113010701,tx,-96.90038,32.75721,1123,57,81,24,42.1
113010704,tx,-96.90872,32.73231,928,57,81,24,42.1
113010804,tx,-96.86276,32.71324,537,57,82,25,43.9
113010805,tx,-96.8794,32.71152,1273,57,82,25,43.9
113010806,tx,-96.86771,32.69794,1298,57,82,25,43.9
113010807,tx,-96.88816,32.69959,780,57,82,25,43.9
113010808,tx,-96.90698,32.7172,560,57,81,24,42.1
113010809,tx,-96.89652,32.71384,1019,57,81,24,42.1
113010903,tx,-96.88684,32.67644,607,59,83,24,40.7
113010904,tx,-96.87215,32.67574,340,59,83,24,40.7
113010905,tx,-96.8722,32.65609,6,59,83,24,40.7
113010906,tx,-96.86246,32.65915,1062,59,83,24,40.7
113011002,tx,-96.83223,32.68196,1320,60,84,24,40
113011003,tx,-96.84704,32.68,1644,60,84,24,40
113011004,tx,-96.85319,32.68614,374,59,83,24,40.7
113011101,tx,-96.84839,32.65835,1637,60,84,24,40
113011103,tx,-96.83114,32.66829,1293,60,84,24,40
113011104,tx,-96.83527,32.65202,1146,60,84,24,40
113011105,tx,-96.82697,32.65273,762,60,84,24,40
113011201,tx,-96.81449,32.65233,1165,60,85,25,41.7
113011202,tx,-96.81464,32.67338,1075,60,84,24,40
113011300,tx,-96.79556,32.66634,2121,62,86,24,38.7
113011401,tx,-96.76976,32.67603,1879,62,86,24,38.7
113011500,tx,-96.73061,32.7454,1571,61,85,24,39.3
113011601,tx,-96.70195,32.70044,1185,62,87,25,40.3
113011603,tx,-96.67314,32.69583,1030,63,87,24,38.1
113011604,tx,-96.65234,32.68851,1287,63,87,24,38.1
113011701,tx,-96.66209,32.71196,1765,62,87,25,40.3
113011702,tx,-96.64088,32.70521,1918,62,87,25,40.3
113011801,tx,-96.63983,32.72685,1449,62,87,25,40.3
113011802,tx,-96.65664,32.72652,1135,62,87,25,40.3
113011901,tx,-96.65535,32.74128,1394,61,86,25,41
113011902,tx,-96.63981,32.74146,1650,62,86,24,38.7
113012000,tx,-96.65747,32.75639,1427,61,86,25,41
113012101,tx,-96.65223,32.7662,483,61,86,25,41
113012102,tx,-96.66431,32.77089,1093,61,86,25,41
113012206,tx,-96.70832,32.78684,1694,60,84,24,40
113012207,tx,-96.6845,32.78599,1537,60,84,24,40
113012208,tx,-96.72213,32.7998,65,60,84,24,40
113012209,tx,-96.70393,32.8127,810,59,84,25,42.4
113012210,tx,-96.6916,32.81106,458,60,84,24,40
113012211,tx,-96.68904,32.80222,431,60,84,24,40
113012212,tx,-96.7052,32.79757,877,60,84,24,40
113012213,tx,-96.70445,32.80438,989,60,84,24,40
113012301,tx,-96.67474,32.81745,1265,60,85,25,41.7
113012302,tx,-96.6755,32.80786,1048,61,85,24,39.3
113012400,tx,-96.68481,32.82823,2151,59,84,25,42.4
113012501,tx,-96.66292,32.82829,1183,60,84,24,40
113012502,tx,-96.66995,32.83095,1356,60,84,24,40
113012601,tx,-96.66017,32.85476,1138,60,84,24,40
113012603,tx,-96.65768,32.84087,677,60,84,24,40
113012604,tx,-96.647,32.84599,458,60,84,24,40
113012701,tx,-96.6724,32.85219,1653,60,84,24,40
113012702,tx,-96.67615,32.8398,1043,60,84,24,40
113012801,tx,-96.68784,32.86134,1143,58,83,25,43.1
113012802,tx,-96.68831,32.85205,1900,59,84,25,42.4
113012900,tx,-96.71243,32.85045,2021,59,83,24,40.7
113013005,tx,-96.70499,32.87459,1581,58,83,25,43.1
113013007,tx,-96.69393,32.86964,1025,58,83,25,43.1
113013008,tx,-96.72361,32.88595,980,58,83,25,43.1
113013009,tx,-96.71274,32.88728,952,58,83,25,43.1
113013010,tx,-96.68023,32.86881,289,58,83,25,43.1
113013011,tx,-96.69244,32.87819,146,58,83,25,43.1
113013012,tx,-96.7138,32.87157,848,58,83,25,43.1
113013013,tx,-96.72515,32.86909,1385,59,83,24,40.7
113013101,tx,-96.77902,32.90271,971,59,83,24,40.7
113013102,tx,-96.78232,32.88749,783,58,83,25,43.1
113013104,tx,-96.77388,32.8835,139,58,83,25,43.1
113013106,tx,-96.77513,32.89365,291,58,83,25,43.1
113013107,tx,-96.77223,32.89164,24,58,83,25,43.1
113013201,tx,-96.79508,32.91737,1214,59,83,24,40.7
113013202,tx,-96.77667,32.91733,639,59,83,24,40.7
113013300,tx,-96.7958,32.9024,838,59,83,24,40.7
113013400,tx,-96.81138,32.90212,820,58,83,25,43.1
113013500,tx,-96.82853,32.90239,930,58,82,24,41.4
113013605,tx,-96.77718,32.9702,1956,59,83,24,40.7
113013606,tx,-96.79535,32.95614,1327,59,83,24,40.7
113013607,tx,-96.7778,32.95631,1129,59,83,24,40.7
113013608,tx,-96.79486,32.93762,1154,59,83,24,40.7
113013609,tx,-96.77722,32.94518,685,59,83,24,40.7
113013610,tx,-96.77771,32.93229,1263,59,83,24,40.7
113013611,tx,-96.81539,32.97872,1170,58,82,24,41.4
113013615,tx,-96.80828,32.93282,212,59,83,24,40.7
113013617,tx,-96.7961,32.98185,965,58,82,24,41.4
113013618,tx,-96.77669,32.9825,768,58,82,24,41.4
113013619,tx,-96.79409,32.97031,1876,59,83,24,40.7
113013620,tx,-96.81563,32.96171,314,58,82,24,41.4
113013621,tx,-96.80759,32.96101,115,59,83,24,40.7
113013622,tx,-96.81108,32.94961,305,58,82,24,41.4
113013624,tx,-96.81881,32.94708,23,58,82,24,41.4
113013625,tx,-96.82037,32.94322,15,58,82,24,41.4
113013626,tx,-96.81738,32.93527,75,59,83,24,40.7
113013627,tx,-96.8269,32.97448,53,58,82,24,41.4
113013628,tx,-96.82374,32.94927,268,58,82,24,41.4
113013629,tx,-96.81096,32.94115,6,58,82,24,41.4
113013630,tx,-96.80671,32.94448,10,59,82,23,39
113013631,tx,-96.80575,32.94022,3,59,83,24,40.7
113013715,tx,-96.87638,32.94998,654,58,82,24,41.4
113013716,tx,-96.90718,32.96872,1693,59,83,24,40.7
113013717,tx,-96.90176,32.95905,544,59,83,24,40.7
113013718,tx,-96.89173,32.96019,506,59,83,24,40.7
113013719,tx,-96.91353,32.98269,1052,59,83,24,40.7
113013720,tx,-96.88678,32.98095,1537,58,82,24,41.4
113013721,tx,-96.86914,32.97693,2353,58,82,24,41.4
113013722,tx,-96.85269,32.97995,590,58,82,24,41.4
113013725,tx,-96.84637,32.96264,275,58,82,24,41.4
113013726,tx,-96.84899,32.94535,799,58,82,24,41.4
113013727,tx,-96.83832,32.96679,1213,58,82,24,41.4
113013728,tx,-96.88192,32.94254,933,58,82,24,41.4
113013729,tx,-96.89581,32.94757,1587,59,83,24,40.7
113013804,tx,-96.86126,32.92064,1116,59,82,23,39
113013805,tx,-96.85173,32.9367,25,59,82,23,39
113013806,tx,-96.83695,32.93594,588,59,83,24,40.7
113013807,tx,-96.86542,32.92973,1062,59,82,23,39
113013808,tx,-96.86363,32.94342,1107,58,82,24,41.4
113013901,tx,-96.89604,32.93153,1035,59,83,24,40.7
113013902,tx,-96.8817,32.93151,1515,59,82,23,39
113014001,tx,-96.88661,32.91732,1333,59,82,23,39
113014002,tx,-96.92219,32.94035,1354,60,83,23,38.3
113014119,tx,-96.98581,32.95972,1637,59,82,23,39
113014120,tx,-96.96697,32.9608,1938,59,83,24,40.7
113014121,tx,-96.94765,32.95448,775,59,83,24,40.7
113014123,tx,-96.95511,32.97845,2041,59,82,23,39
113014124,tx,-96.99011,32.91853,2143,59,83,24,40.7
113014126,tx,-97.00941,32.95395,2373,59,82,23,39
113014128,tx,-96.95661,32.934,892,59,83,24,40.7
113014130,tx,-96.9447,32.92211,1354,59,83,24,40.7
113014132,tx,-96.94806,32.94376,446,59,83,24,40.7
113014134,tx,-96.98296,32.98306,1231,59,82,23,39
113014135,tx,-96.98339,32.97332,1099,59,82,23,39
113014138,tx,-96.93432,32.89871,677,59,83,24,40.7
113014139,tx,-97.00213,32.85859,139,59,82,23,39
113014140,tx,-97.00018,32.86216,227,59,82,23,39
113014141,tx,-96.94877,32.93685,257,59,83,24,40.7
113014142,tx,-96.94861,32.93106,148,59,83,24,40.7
113014143,tx,-96.94946,32.90211,1111,59,82,23,39
113014144,tx,-96.94481,32.88754,565,59,82,23,39
113014145,tx,-96.99415,32.85875,9,59,82,23,39
113014146,tx,-96.99415,32.86307,64,59,82,23,39
113014147,tx,-97.01451,32.8549,187,59,82,23,39
113014148,tx,-97.01539,32.84519,544,59,82,23,39
113014149,tx,-96.95949,32.92445,208,59,83,24,40.7
113014150,tx,-96.97419,32.92203,609,59,83,24,40.7
113014151,tx,-96.97854,32.902,461,59,83,24,40.7
113014152,tx,-96.96356,32.90091,33,59,82,23,39
113014153,tx,-96.99789,32.84613,1145,59,82,23,39
113014154,tx,-97.00525,32.84836,861,59,82,23,39
113014155,tx,-96.95922,32.94171,480,59,82,23,39
113014156,tx,-96.96463,32.93993,1277,59,82,23,39
113014157,tx,-96.97994,32.93882,164,59,82,23,39
113014158,tx,-96.98211,32.8714,91,59,82,23,39
113014159,tx,-96.98587,32.89715,1112,59,83,24,40.7
113014160,tx,-96.99786,32.87499,717,59,82,23,39
113014161,tx,-97.01173,32.862,71,59,82,23,39
113014203,tx,-96.94558,32.84515,1062,59,82,23,39
113014204,tx,-96.92362,32.84618,307,59,82,23,39
113014205,tx,-96.94004,32.85653,764,59,82,23,39
113014207,tx,-96.94109,32.87449,101,59,82,23,39
113014208,tx,-96.93587,32.86425,50,59,82,23,39
113014209,tx,-96.92894,32.86425,227,59,83,24,40.7
113014306,tx,-96.98459,32.84386,1584,59,82,23,39
113014308,tx,-96.955,32.84361,411,59,82,23,39
113014309,tx,-96.98954,32.85696,122,59,82,23,39
113014310,tx,-96.98174,32.8588,975,59,82,23,39
113014313,tx,-96.95448,32.87353,622,59,82,23,39
113014314,tx,-96.96729,32.86553,602,59,82,23,39
113014315,tx,-96.96703,32.84028,630,59,82,23,39
113014316,tx,-96.97057,32.84845,1256,59,82,23,39
113014317,tx,-96.95286,32.85766,102,59,82,23,39
113014318,tx,-96.96017,32.85253,885,59,82,23,39
113014319,tx,-96.96844,32.8831,19,59,82,23,39
113014320,tx,-96.96925,32.87925,119,59,82,23,39
113014405,tx,-96.98548,32.83166,770,59,82,23,39
113014406,tx,-96.98473,32.82159,1044,59,82,23,39
113014407,tx,-97.00069,32.83087,449,59,82,23,39
113014408,tx,-97.00301,32.8226,782,59,82,23,39
113014409,tx,-97.02558,32.82693,86,58,81,23,39.7
113014410,tx,-97.01353,32.82618,530,59,82,23,39
113014501,tx,-96.96783,32.83158,1038,59,82,23,39
113014502,tx,-96.95706,32.82213,1001,59,82,23,39
113014601,tx,-96.95183,32.83322,592,59,82,23,39
113014602,tx,-96.93908,32.82635,815,59,82,23,39
113014603,tx,-96.94647,32.82232,509,59,82,23,39
113014701,tx,-96.92592,32.83357,605,59,82,23,39
113014704,tx,-96.92725,32.82293,1068,59,82,23,39
113014903,tx,-96.94105,32.81165,1203,59,83,24,40.7
113015001,tx,-96.93443,32.80478,1077,59,83,24,40.7
113015002,tx,-96.93822,32.78802,909,59,83,24,40.7
113015101,tx,-96.94903,32.79268,1161,59,83,24,40.7
113015102,tx,-96.95319,32.80493,526,59,83,24,40.7
113015202,tx,-96.97072,32.82054,694,59,82,23,39
113015205,tx,-96.96802,32.81233,749,59,83,24,40.7
113015206,tx,-96.9685,32.80522,1059,59,83,24,40.7
113015207,tx,-96.96603,32.79393,1311,59,83,24,40.7
113015208,tx,-96.97257,32.78894,889,59,83,24,40.7
113015303,tx,-97.02213,32.8063,377,59,82,23,39
113015304,tx,-96.99694,32.78304,715,59,82,23,39
113015305,tx,-96.98549,32.81008,1146,59,83,24,40.7
113015306,tx,-96.9858,32.79129,1578,59,83,24,40.7
113015403,tx,-97.02424,32.7554,548,58,81,23,39.7
113015404,tx,-97.02771,32.74732,1236,58,81,23,39.7
113015405,tx,-97.01781,32.77187,700,58,82,24,41.4
113015406,tx,-97.02933,32.76898,946,58,82,24,41.4
113015500,tx,-97.00675,32.75198,1147,59,82,23,39
113015600,tx,-96.98496,32.75433,1485,59,82,23,39
113015700,tx,-96.96708,32.7568,976,59,83,24,40.7
113015900,tx,-96.9698,32.73341,653,59,83,24,40.7
113016001,tx,-97.00951,32.73688,1336,60,83,23,38.3
113016002,tx,-97.00021,32.73662,719,59,83,24,40.7
113016100,tx,-97.02513,32.72551,1348,59,82,23,39
113016201,tx,-97.00386,32.72506,1131,61,85,24,39.3
113016203,tx,-97.00891,32.71149,32,61,85,24,39.3
113016204,tx,-97.00344,32.71594,1335,61,85,24,39.3
113016301,tx,-96.979,32.71723,2176,61,85,24,39.3
113016302,tx,-96.99004,32.71548,515,61,85,24,39.3
113016406,tx,-97.00984,32.70339,1224,61,85,24,39.3
113016407,tx,-96.99578,32.7041,1628,61,85,24,39.3
113016409,tx,-96.98735,32.68203,1333,63,86,23,36.5
113016410,tx,-97.02642,32.66653,1530,62,85,23,37.1
113016412,tx,-96.99432,32.66237,3081,63,86,23,36.5
113016414,tx,-97.01069,32.6713,227,63,86,23,36.5
113016415,tx,-97.00576,32.65031,1539,63,86,23,36.5
113016416,tx,-97.02246,32.61614,1140,65,88,23,35.4
113016417,tx,-97.02501,32.65119,1985,63,86,23,36.5
113016418,tx,-97.03044,32.693,1274,61,84,23,37.7
113016419,tx,-97.01831,32.69062,1770,61,85,24,39.3
113016420,tx,-97.0092,32.69178,971,62,85,23,37.1
113016421,tx,-96.98624,32.6968,1345,61,85,24,39.3
113016511,tx,-96.94918,32.62627,1449,62,85,23,37.1
113016513,tx,-96.93354,32.63529,2051,62,85,23,37.1
113016516,tx,-96.89995,32.65436,1398,60,84,24,40
113016517,tx,-96.9003,32.63994,1508,62,86,24,38.7
113016518,tx,-96.91731,32.65484,1392,60,84,24,40
113016519,tx,-96.93444,32.65486,900,60,84,24,40
113016521,tx,-96.95299,32.68226,1455,60,84,24,40
113016522,tx,-96.98331,32.6027,1592,62,86,24,38.7
113016524,tx,-96.98009,32.5724,1970,62,86,24,38.7
113016525,tx,-97.01669,32.5647,1513,62,86,24,38.7
113016526,tx,-96.94792,32.64035,1192,62,85,23,37.1
113016527,tx,-96.97567,32.63946,1435,61,85,24,39.3
113016528,tx,-96.95596,32.65535,1467,60,84,24,40
113016529,tx,-96.96114,32.61985,1094,62,85,23,37.1
113016530,tx,-96.9369,32.61202,1378,62,86,24,38.7
113016531,tx,-96.91471,32.63983,1166,62,86,24,38.7
113016532,tx,-96.92019,32.62583,959,62,86,24,38.7
113016533,tx,-96.92464,32.7012,930,59,83,24,40.7
113016534,tx,-96.9013,32.68952,748,60,83,23,38.3
113016535,tx,-96.91713,32.66909,974,60,84,24,40
113016536,tx,-96.89995,32.6691,1077,60,84,24,40
113016607,tx,-96.88633,32.65307,41,60,84,24,40
113016610,tx,-96.8321,32.61131,1250,62,86,24,38.7
113016615,tx,-96.93341,32.57534,1390,62,86,24,38.7
113016616,tx,-96.94947,32.5597,2183,62,86,24,38.7
113016617,tx,-96.88776,32.61196,1829,62,86,24,38.7
113016618,tx,-96.86545,32.60214,1625,61,85,24,39.3
113016619,tx,-96.84917,32.61181,823,62,86,24,38.7
113016620,tx,-96.83976,32.59702,2211,62,86,24,38.7
113016621,tx,-96.83986,32.56865,1945,62,86,24,38.7
113016622,tx,-96.83932,32.55476,1294,62,86,24,38.7
113016623,tx,-96.88252,32.56138,2895,62,86,24,38.7
113016624,tx,-96.91681,32.56874,1137,62,86,24,38.7
113016626,tx,-96.94223,32.58418,1334,62,86,24,38.7
113016627,tx,-96.83093,32.5824,763,62,86,24,38.7
113016628,tx,-96.84831,32.58253,1386,62,86,24,38.7
113016629,tx,-96.93078,32.5976,880,62,86,24,38.7
113016630,tx,-96.91633,32.60318,1664,62,86,24,38.7
113016631,tx,-96.89972,32.58983,1783,62,86,24,38.7
113016632,tx,-96.86556,32.58252,1187,61,85,24,39.3
113016633,tx,-96.88265,32.58979,2184,61,85,24,39.3
113016634,tx,-96.84527,32.63147,1260,62,86,24,38.7
113016635,tx,-96.87279,32.64297,67,61,85,24,39.3
113016636,tx,-96.89913,32.62638,983,62,86,24,38.7
113016637,tx,-96.88721,32.63156,1090,62,86,24,38.7
113016638,tx,-96.87609,32.6294,596,62,86,24,38.7
113016704,tx,-96.77589,32.6172,1596,63,87,24,38.1
113016706,tx,-96.7733,32.60796,747,64,88,24,37.5
113016707,tx,-96.79508,32.6103,1282,64,87,23,35.9
113016708,tx,-96.79503,32.62439,2175,63,87,24,38.1
113016709,tx,-96.77198,32.63368,2076,63,87,24,38.1
113016710,tx,-96.76417,32.65784,1632,63,86,23,36.5
113016711,tx,-96.781,32.65612,923,62,86,24,38.7
113016802,tx,-96.78113,32.56728,2397,64,88,24,37.5
113016803,tx,-96.76399,32.59609,2206,65,88,23,35.4
113016805,tx,-96.81431,32.59778,689,63,87,24,38.1
113016806,tx,-96.79115,32.59801,2044,64,88,24,37.5
113016902,tx,-96.70326,32.64516,1551,65,88,23,35.4
113016903,tx,-96.66113,32.58476,2716,65,89,24,36.9
113017005,tx,-96.60025,32.65362,1162,63,88,25,39.7
113017006,tx,-96.55802,32.6066,2212,63,87,24,38.1
113017007,tx,-96.5607,32.66869,962,63,88,25,39.7
113017008,tx,-96.53864,32.67826,2759,64,88,24,37.5
113017009,tx,-96.56877,32.68996,163,63,88,25,39.7
113017010,tx,-96.58403,32.67975,1388,63,88,25,39.7
113017101,tx,-96.60363,32.69303,1748,63,88,25,39.7
113017102,tx,-96.6432,32.6585,2644,63,88,25,39.7
113017201,tx,-96.62473,32.725,1530,63,87,24,38.1
113017203,tx,-96.6077,32.73376,804,63,87,24,38.1
113017204,tx,-96.61373,32.70955,1093,62,87,25,40.3
113017307,tx,-96.55746,32.75699,1401,65,89,24,36.9
113017308,tx,-96.56288,32.74394,1348,65,89,24,36.9
113017309,tx,-96.53928,32.73476,1057,65,89,24,36.9
113017310,tx,-96.54775,32.73478,1170,65,89,24,36.9
113017311,tx,-96.57817,32.76129,1308,65,89,24,36.9
113017312,tx,-96.57434,32.7517,1337,65,89,24,36.9
113017313,tx,-96.53447,32.72637,1184,64,89,25,39.1
113017314,tx,-96.57539,32.72524,2479,64,88,24,37.5
113017315,tx,-96.59545,32.71165,2056,63,88,25,39.7
113017400,tx,-96.59117,32.75552,1955,65,89,24,36.9
113017500,tx,-96.60856,32.75871,1649,63,88,25,39.7
113017602,tx,-96.6407,32.77089,1381,63,87,24,38.1
113017604,tx,-96.61753,32.74119,926,63,87,24,38.1
113017605,tx,-96.64428,32.75463,1157,61,86,25,41
113017606,tx,-96.62902,32.75711,1758,63,87,24,38.1
113017703,tx,-96.61713,32.78586,1158,63,87,24,38.1
113017704,tx,-96.60976,32.77555,1570,63,87,24,38.1
113017705,tx,-96.60152,32.78663,456,64,88,24,37.5
113017706,tx,-96.5878,32.77487,1777,65,89,24,36.9
113017805,tx,-96.64943,32.78596,1513,62,86,24,38.7
113017806,tx,-96.65923,32.80135,1221,61,85,24,39.3
113017808,tx,-96.60658,32.82999,1533,61,86,25,41
113017811,tx,-96.60688,32.81949,1467,62,86,24,38.7
113017812,tx,-96.62181,32.81679,763,62,86,24,38.7
113017814,tx,-96.60344,32.80254,1546,63,87,24,38.1
113017815,tx,-96.63334,32.80195,630,63,87,24,38.1
113017816,tx,-96.64452,32.79577,743,62,86,24,38.7
113017817,tx,-96.62059,32.80624,81,63,87,24,38.1
113017818,tx,-96.61765,32.79846,978,63,87,24,38.1
113017819,tx,-96.63241,32.81649,47,62,86,24,38.7
113017820,tx,-96.64383,32.81018,1042,62,86,24,38.7
113017900,tx,-96.65463,32.81761,1616,60,85,25,41.7
113018001,tx,-96.64464,32.83357,1990,60,85,25,41.7
113018002,tx,-96.63696,32.82525,1003,61,85,24,39.3
113018105,tx,-96.62085,32.91966,1831,60,84,24,40
113018110,tx,-96.60284,32.88074,1905,61,85,24,39.3
113018111,tx,-96.61831,32.86775,1747,61,85,24,39.3
113018120,tx,-96.59416,32.93383,1698,60,85,25,41.7
113018121,tx,-96.603,32.91854,1791,60,84,24,40
113018126,tx,-96.62958,32.8594,2315,61,85,24,39.3
113018127,tx,-96.63933,32.85293,865,61,85,24,39.3
113018128,tx,-96.60602,32.85434,1422,61,86,25,41
113018129,tx,-96.61219,32.84411,1219,61,86,25,41
113018130,tx,-96.62585,32.83631,646,61,85,24,39.3
113018132,tx,-96.57814,32.83856,1908,63,87,24,38.1
113018133,tx,-96.56358,32.90042,1786,62,86,24,38.7
113018134,tx,-96.52645,32.90241,2018,61,86,25,41
113018135,tx,-96.53132,32.88209,1594,62,86,24,38.7
113018137,tx,-96.558,32.86315,1136,62,87,25,40.3
113018138,tx,-96.58205,32.85105,702,63,87,24,38.1
113018140,tx,-96.55977,32.91909,1957,61,85,24,39.3
113018141,tx,-96.53482,32.86024,320,63,87,24,38.1
113018142,tx,-96.54286,32.84306,1302,63,87,24,38.1
113018143,tx,-96.54544,32.94953,2274,59,84,25,42.4
113018144,tx,-96.52365,32.93838,1479,60,85,25,41.7
113018145,tx,-96.5573,32.88103,1522,62,86,24,38.7
113018146,tx,-96.57828,32.885,1321,62,86,24,38.7
113018147,tx,-96.58466,32.86767,1272,62,86,24,38.7
113018148,tx,-96.5967,32.85919,1135,62,86,24,38.7
113018149,tx,-96.52631,32.91954,1255,61,85,24,39.3
113018150,tx,-96.5374,32.9228,1374,61,85,24,39.3
113018151,tx,-96.60184,32.95398,1070,58,83,25,43.1
113018152,tx,-96.61485,32.94226,1707,59,84,25,42.4
113018153,tx,-96.59115,32.96434,1850,57,83,26,45.6
113018154,tx,-96.57378,32.9786,1935,57,83,26,45.6
113018155,tx,-96.55146,32.96922,1821,58,83,25,43.1
113018156,tx,-96.58175,32.91422,1612,61,85,24,39.3
113018157,tx,-96.57691,32.93622,1235,61,85,24,39.3
113018158,tx,-96.55118,32.77881,1575,65,89,24,36.9
113018159,tx,-96.55632,32.81362,2187,65,88,23,35.4
113018203,tx,-96.6063,32.9022,1943,60,85,25,41.7
113018204,tx,-96.62571,32.90184,1427,60,85,25,41.7
113018205,tx,-96.61564,32.8889,878,61,85,24,39.3
113018206,tx,-96.62684,32.88442,1328,61,85,24,39.3
113018300,tx,-96.64304,32.88604,2098,60,84,24,40
113018401,tx,-96.65644,32.87113,1248,59,83,24,40.7
113018402,tx,-96.64043,32.87175,1335,60,84,24,40
113018403,tx,-96.65075,32.86113,61,59,83,24,40.7
113018501,tx,-96.6711,32.88922,1624,59,83,24,40.7
113018505,tx,-96.71386,32.90671,38,58,82,24,41.4
113018506,tx,-96.69624,32.89603,617,58,83,25,43.1
113018507,tx,-96.72413,32.90743,14,58,83,25,43.1
113018508,tx,-96.71924,32.90443,78,58,82,24,41.4
113018600,tx,-96.65719,32.90167,1426,58,83,25,43.1
113018700,tx,-96.63986,32.90168,1655,60,84,24,40
113018801,tx,-96.63704,32.92476,1648,59,84,25,42.4
113018802,tx,-96.6406,32.91288,721,59,84,25,42.4
113018900,tx,-96.65732,32.92025,1750,58,83,25,43.1
113019013,tx,-96.67428,32.91286,146,58,83,25,43.1
113019016,tx,-96.74218,32.91951,467,58,83,25,43.1
113019018,tx,-96.71136,32.92529,873,58,82,24,41.4
113019019,tx,-96.71023,32.91416,825,58,82,24,41.4
113019020,tx,-96.674,32.93809,1451,58,83,25,43.1
113019023,tx,-96.69126,32.95295,1491,58,82,24,41.4
113019024,tx,-96.69129,32.93821,1324,58,82,24,41.4
113019025,tx,-96.6297,32.94631,1727,58,83,25,43.1
113019026,tx,-96.63925,32.9379,1904,59,84,25,42.4
113019027,tx,-96.64833,32.95706,1109,57,83,26,45.6
113019028,tx,-96.67488,32.95622,1091,57,82,25,43.9
113019029,tx,-96.66637,32.94818,2167,57,82,25,43.9
113019031,tx,-96.67518,32.97382,2391,57,82,25,43.9
113019032,tx,-96.69177,32.92035,978,58,82,24,41.4
113019033,tx,-96.69169,32.9129,1037,58,82,24,41.4
113019034,tx,-96.72709,32.92032,430,58,83,25,43.1
113019035,tx,-96.72585,32.91262,349,58,83,25,43.1
113019036,tx,-96.69195,32.97768,1134,58,82,24,41.4
113019037,tx,-96.69007,32.96581,1237,58,82,24,41.4
113019039,tx,-96.70742,32.94652,1987,58,82,24,41.4
113019040,tx,-96.7389,32.93225,1013,58,83,25,43.1
113019041,tx,-96.72713,32.92883,934,58,83,25,43.1
113019042,tx,-96.653,32.97481,1655,57,82,25,43.9
113019044,tx,-96.69163,32.92756,1116,58,82,24,41.4
113019045,tx,-96.70297,32.92396,822,58,82,24,41.4
113019046,tx,-96.67416,32.92,1036,58,83,25,43.1
113019047,tx,-96.67419,32.92735,965,58,83,25,43.1
113019048,tx,-96.65692,32.93454,841,58,83,25,43.1
113019049,tx,-96.65656,32.94184,971,58,83,25,43.1
113019050,tx,-96.63159,32.96995,1140,58,83,25,43.1
113019051,tx,-96.61217,32.97187,2174,57,83,26,45.6
113019052,tx,-96.70696,32.9802,59,58,82,24,41.4
113019053,tx,-96.71088,32.96737,174,58,82,24,41.4
113019101,tx,-96.73393,32.94816,427,58,82,24,41.4
113019102,tx,-96.72256,32.94891,1789,58,82,24,41.4
113019202,tx,-96.74816,32.94592,1193,58,82,24,41.4
113019203,tx,-96.7438,32.95694,1503,58,82,24,41.4
113019205,tx,-96.76249,32.97411,1863,58,82,24,41.4
113019208,tx,-96.76525,32.93216,680,59,83,24,40.7
113019210,tx,-96.72854,32.98112,1632,58,82,24,41.4
113019211,tx,-96.73206,32.9696,1640,58,82,24,41.4
113019212,tx,-96.75982,32.93445,12,58,83,25,43.1
113019213,tx,-96.75474,32.93654,43,58,83,25,43.1
113019214,tx,-96.76308,32.94343,359,58,82,24,41.4
113019215,tx,-96.76265,32.95474,1145,58,82,24,41.4
113019216,tx,-96.7498,32.97037,1540,58,82,24,41.4
113019301,tx,-96.78185,32.85635,958,58,83,25,43.1
113019302,tx,-96.78047,32.84464,870,58,83,25,43.1
113019400,tx,-96.79134,32.8475,1288,58,83,25,43.1
113019501,tx,-96.7994,32.85802,2231,58,83,25,43.1
113019502,tx,-96.80632,32.84461,1380,59,83,24,40.7
113019600,tx,-96.78764,32.83143,724,58,83,25,43.1
113019700,tx,-96.79679,32.83283,777,58,83,25,43.1
113019800,tx,-96.81001,32.82949,1616,59,83,24,40.7
113019900,tx,-96.8886,32.73811,1044,57,81,24,42.1
113020000,tx,-97.01154,32.9805,1667,59,82,23,39
113020100,tx,-96.90781,32.8228,1086,59,82,23,39
113020200,tx,-96.72953,32.68591,2366,63,87,24,38.1
113020300,tx,-96.76637,32.77425,1294,61,85,24,39.3
113020401,tx,-96.77876,32.78205,635,60,84,24,40
113020402,tx,-96.79386,32.7692,1315,61,84,23,37.7
113020500,tx,-96.86505,32.78277,921,59,83,24,40.7
113020600,tx,-96.8216,32.87272,999,58,82,24,41.4
113020700,tx,-96.87155,32.96238,2004,58,82,24,41.4
113020800,tx,-96.75185,32.75544,3515,62,85,23,37.1
113020900,tx,-96.77257,32.75144,1612,61,85,24,39.3
113021000,tx,-96.80426,32.74452,3027,60,84,24,40
113021100,tx,-96.774,32.73062,2165,61,85,24,39.3
113021200,tx,-96.94046,32.74727,1695,58,82,24,41.4
113980000,tx,-97.01731,32.89198,143,59,82,23,39
113980100,tx,-96.84927,32.84548,80,59,83,24,40.7
113980200,tx,-96.75071,32.9823,6,58,82,24,41.4
115950401,tx,-101.94223,32.76608,28,11,29,18,163.6
115950402,tx,-101.96892,32.72699,48,12,29,17,141.7
115950500,tx,-101.95999,32.72814,2,12,29,17,141.7
115950600,tx,-101.94696,32.7427,1255,11,28,17,154.5
117950300,tx,-102.40141,34.83788,1999,2,8,6,300
117950400,tx,-102.40272,34.8258,1965,2,8,6,300
117950500,tx,-102.39981,34.81327,1780,2,8,6,300
117950600,tx,-102.60591,34.96671,4470,1,7,6,600
119950100,tx,-95.67261,33.38842,4382,56,82,26,46.4
119950200,tx,-95.66638,33.34906,1734,56,81,25,44.6
121020109,tx,-96.85856,33.19969,3459,58,82,24,41.4
121020110,tx,-96.87739,33.1846,1780,58,82,24,41.4
121020111,tx,-96.87268,33.17251,1263,58,82,24,41.4
121020112,tx,-96.8884,33.17256,1083,58,82,24,41.4
121020115,tx,-96.98178,33.15613,4148,57,81,24,42.1
121020116,tx,-96.97862,33.27922,2827,57,80,23,40.4
121020117,tx,-96.99498,33.33127,1336,58,81,23,39.7
121020118,tx,-97.02029,33.39438,2700,59,82,23,39
121020119,tx,-96.92031,33.17791,1452,58,82,24,41.4
121020120,tx,-96.90409,33.17477,1929,58,82,24,41.4
121020121,tx,-97.0077,33.25415,3100,57,81,24,42.1
121020122,tx,-96.9537,33.23525,1465,57,81,24,42.1
121020123,tx,-96.91996,33.26383,3441,58,81,23,39.7
121020124,tx,-96.90304,33.2409,1947,58,81,23,39.7
121020125,tx,-96.91362,33.22583,2859,58,81,23,39.7
121020126,tx,-96.93845,33.1662,1260,58,81,23,39.7
121020127,tx,-96.93166,33.1547,1723,58,81,23,39.7
121020128,tx,-96.86648,33.23661,4408,58,81,23,39.7
121020129,tx,-96.89341,33.34352,3016,58,81,23,39.7
121020130,tx,-96.9627,33.19968,1871,58,81,23,39.7
121020131,tx,-97.00483,33.20866,3070,57,81,24,42.1
121020132,tx,-96.89343,33.18559,1624,58,82,24,41.4
121020133,tx,-96.89873,33.19336,2320,58,81,23,39.7
121020134,tx,-96.91011,33.19975,2376,58,81,23,39.7
121020135,tx,-96.91509,33.21271,1639,58,81,23,39.7
121020136,tx,-96.94315,33.19512,1639,57,81,24,42.1
121020137,tx,-96.93549,33.21282,1502,57,81,24,42.1
121020203,tx,-97.14694,33.34884,2957,58,81,23,39.7
121020204,tx,-97.2375,33.39134,3037,57,80,23,40.4
121020205,tx,-97.07585,33.31683,1210,58,81,23,39.7
121020206,tx,-97.33074,33.26993,1849,56,79,23,41.1
121020207,tx,-97.21353,33.32398,1713,58,80,22,37.9
121020208,tx,-97.28581,33.31844,1658,57,79,22,38.6
121020305,tx,-97.14981,33.0093,3306,58,81,23,39.7
121020310,tx,-97.23409,33.17523,3621,57,80,23,40.4
121020311,tx,-97.21959,32.99992,884,57,81,24,42.1
121020312,tx,-97.26184,33.00585,2627,58,81,23,39.7
121020313,tx,-97.33879,33.15688,3243,58,81,23,39.7
121020314,tx,-97.26239,33.11166,5947,58,81,23,39.7
121020315,tx,-97.16348,33.07394,1954,58,81,23,39.7
121020316,tx,-97.16236,33.12616,1819,57,80,23,40.4
121020317,tx,-97.21217,33.08823,2804,58,81,23,39.7
121020318,tx,-97.18271,33.14784,2318,57,80,23,40.4
121020319,tx,-97.3323,33.05941,2639,59,82,23,39
121020320,tx,-97.34228,33.01513,4423,59,82,23,39
121020321,tx,-97.18264,33.0294,2343,58,81,23,39.7
121020322,tx,-97.23058,33.03555,3643,58,81,23,39.7
121020402,tx,-97.15852,33.24216,2420,57,80,23,40.4
121020403,tx,-97.15267,33.22458,1719,56,80,24,42.9
121020404,tx,-97.15449,33.29025,1769,57,80,23,40.4
121020405,tx,-97.20349,33.25579,2142,57,80,23,40.4
121020504,tx,-97.11853,33.27642,1177,57,80,23,40.4
121020505,tx,-97.1075,33.24232,3005,57,80,23,40.4
121020506,tx,-97.07194,33.25734,845,57,81,24,42.1
121020507,tx,-97.12373,33.24954,1059,57,80,23,40.4
121020508,tx,-97.12706,33.23953,562,57,80,23,40.4
121020601,tx,-97.12075,33.22748,758,56,79,23,41.1
121020603,tx,-97.11516,33.22218,1141,56,79,23,41.1
121020604,tx,-97.10262,33.22215,1260,56,80,24,42.9
121020605,tx,-97.09009,33.22345,882,56,80,24,42.9
121020700,tx,-97.15079,33.21693,694,56,80,24,42.9
121020800,tx,-97.17823,33.19758,1174,57,80,23,40.4
121020900,tx,-97.15676,33.20548,389,56,80,24,42.9
121021000,tx,-97.14685,33.20558,895,56,80,24,42.9
121021100,tx,-97.13488,33.21042,653,56,79,23,41.1
121021202,tx,-97.11813,33.20373,1522,56,79,23,41.1
121021203,tx,-97.10178,33.20392,173,56,80,24,42.9
121021204,tx,-97.09208,33.19063,240,56,80,24,42.9
121021301,tx,-97.1291,33.19835,195,56,79,23,41.1
121021304,tx,-97.13195,33.17284,1978,56,80,24,42.9
121021305,tx,-97.11753,33.18439,1107,56,80,24,42.9
121021306,tx,-97.10306,33.17671,927,56,80,24,42.9
121021307,tx,-97.09969,33.16531,1211,56,80,24,42.9
121021410,tx,-97.06018,33.1182,2223,57,81,24,42.1
121021411,tx,-96.99964,33.10871,2957,58,81,23,39.7
121021412,tx,-97.03461,33.16011,2727,57,81,24,42.1
121021413,tx,-97.03876,33.1382,1175,57,81,24,42.1
121021414,tx,-97.05005,33.21213,859,57,80,23,40.4
121021415,tx,-97.06941,33.18543,2706,56,80,24,42.9
121021416,tx,-97.10035,33.14547,1414,56,80,24,42.9
121021417,tx,-97.09113,33.14632,977,57,80,23,40.4
121021418,tx,-97.08055,33.15813,1596,56,80,24,42.9
121021419,tx,-97.06498,33.14546,1497,57,80,23,40.4
121021420,tx,-97.08178,33.13613,1165,57,80,23,40.4
121021421,tx,-97.06166,33.13493,1152,57,81,24,42.1
121021422,tx,-97.12324,33.15444,1913,56,80,24,42.9
121021423,tx,-97.11681,33.14034,1061,57,81,24,42.1
121021502,tx,-96.99314,33.0695,870,58,81,23,39.7
121021505,tx,-97.03108,33.07415,2313,58,81,23,39.7
121021512,tx,-97.10179,33.11629,1877,57,81,24,42.1
121021513,tx,-97.04275,33.09236,1519,58,81,23,39.7
121021514,tx,-97.06072,33.08199,1526,57,81,24,42.1
121021516,tx,-96.91159,33.09363,2734,58,82,24,41.4
121021517,tx,-96.93567,33.06823,659,58,82,24,41.4
121021518,tx,-96.90156,33.07964,1175,58,82,24,41.4
121021520,tx,-96.88119,33.09075,1273,58,82,24,41.4
121021521,tx,-96.88694,33.09409,1625,58,82,24,41.4
121021522,tx,-96.88026,33.11472,1055,58,82,24,41.4
121021526,tx,-96.85256,33.1648,2257,58,82,24,41.4
121021528,tx,-96.8694,33.15895,828,58,82,24,41.4
121021529,tx,-96.88057,33.16058,1313,58,82,24,41.4
121021530,tx,-96.87967,33.07635,1115,58,82,24,41.4
121021531,tx,-96.86968,33.09052,1675,58,82,24,41.4
121021532,tx,-96.8607,33.08784,981,58,82,24,41.4
121021533,tx,-96.86223,33.10701,2222,58,82,24,41.4
121021534,tx,-96.92885,33.1068,2800,58,82,24,41.4
121021535,tx,-96.90599,33.13649,2497,58,82,24,41.4
121021536,tx,-96.90632,33.15362,2390,58,82,24,41.4
121021537,tx,-96.94291,33.12971,2140,58,82,24,41.4
121021538,tx,-96.8571,33.14247,1992,58,82,24,41.4
121021539,tx,-96.87601,33.14533,2761,58,82,24,41.4
121021540,tx,-96.88135,33.13157,1909,58,82,24,41.4
121021611,tx,-96.8992,32.99381,1551,59,82,23,39
121021612,tx,-96.90438,33.00536,1089,59,83,24,40.7
121021613,tx,-96.89238,33.00514,780,58,82,24,41.4
121021614,tx,-96.88014,33.00517,1097,57,81,24,42.1
121021615,tx,-96.87943,32.99542,1636,57,81,24,42.1
121021616,tx,-96.86388,33.00645,934,57,81,24,42.1
121021618,tx,-96.99841,33.04713,2095,58,81,23,39.7
121021619,tx,-96.97065,33.02685,350,58,82,24,41.4
121021620,tx,-96.95463,33.00457,100,59,82,23,39
121021621,tx,-96.92218,32.99613,1431,59,83,24,40.7
121021622,tx,-96.92678,33.00746,1880,59,83,24,40.7
121021626,tx,-96.84887,33.07207,978,58,82,24,41.4
121021630,tx,-96.90796,33.02146,1368,59,82,23,39
121021631,tx,-96.8953,33.01757,1953,59,82,23,39
121021632,tx,-96.85629,33.01837,1303,57,81,24,42.1
121021633,tx,-96.87803,33.01815,1680,57,81,24,42.1
121021634,tx,-96.85308,33.00669,31,57,81,24,42.1
121021635,tx,-96.84797,33.00233,362,58,82,24,41.4
121021637,tx,-96.86069,32.99416,874,57,81,24,42.1
121021638,tx,-96.86979,32.99459,620,57,81,24,42.1
121021639,tx,-96.87604,33.02895,1371,57,82,25,43.9
121021640,tx,-96.87184,33.03225,658,57,82,25,43.9
121021641,tx,-96.84948,32.99505,34,58,82,24,41.4
121021642,tx,-96.84953,32.99028,200,57,81,24,42.1
121021643,tx,-96.89505,33.03055,1278,58,82,24,41.4
121021644,tx,-96.89683,33.03793,689,58,82,24,41.4
121021645,tx,-96.94579,33.04514,196,59,82,23,39
121021646,tx,-96.93837,33.02598,868,59,82,23,39
121021647,tx,-96.85058,33.05636,30,57,82,25,43.9
121021648,tx,-96.84961,33.04116,1131,57,82,25,43.9
121021649,tx,-96.9362,33.01339,613,59,82,23,39
121021650,tx,-96.9238,33.03189,1170,59,82,23,39
121021651,tx,-96.86858,33.04111,2495,57,82,25,43.9
121021652,tx,-96.90837,33.04014,1496,59,82,23,39
121021653,tx,-96.88063,33.05954,759,57,82,25,43.9
121021654,tx,-96.90343,33.05327,1751,59,82,23,39
121021655,tx,-96.86442,33.06447,298,57,82,25,43.9
121021715,tx,-97.03456,33.06173,1580,57,81,24,42.1
121021716,tx,-97.01885,33.05252,1192,58,81,23,39.7
121021717,tx,-97.03611,33.04978,1828,57,81,24,42.1
121021719,tx,-97.09173,33.08571,1810,57,81,24,42.1
121021720,tx,-97.05334,33.06608,1068,57,81,24,42.1
121021721,tx,-97.05278,33.05555,1320,57,81,24,42.1
121021722,tx,-97.05456,33.04355,1299,57,81,24,42.1
121021723,tx,-97.0323,33.02384,547,58,81,23,39.7
121021724,tx,-97.04999,33.02798,1485,58,81,23,39.7
121021725,tx,-97.06501,33.02591,1340,58,81,23,39.7
121021726,tx,-97.05701,33.01635,1077,58,81,23,39.7
121021727,tx,-97.04888,33.00156,1947,58,81,23,39.7
121021728,tx,-97.01457,32.99856,80,58,82,24,41.4
121021729,tx,-97.0381,33.0146,1146,58,81,23,39.7
121021730,tx,-97.02559,33.01582,1324,58,81,23,39.7
121021731,tx,-97.01277,33.01231,1301,58,82,24,41.4
121021732,tx,-96.99877,33.01351,563,58,82,24,41.4
121021733,tx,-96.99871,33.00721,520,58,82,24,41.4
121021734,tx,-96.99029,33.01181,136,58,82,24,41.4
121021735,tx,-96.98296,33.0077,234,58,82,24,41.4
121021736,tx,-96.98796,33.00051,93,58,82,24,41.4
121021737,tx,-96.99191,32.99319,1050,58,82,24,41.4
121021738,tx,-96.96572,32.99597,769,59,82,23,39
121021739,tx,-96.98751,33.01939,106,58,82,24,41.4
121021740,tx,-97.00138,33.02236,972,58,82,24,41.4
121021741,tx,-97.01667,33.02338,447,58,81,23,39.7
121021742,tx,-97.03407,33.03332,1885,57,81,24,42.1
121021743,tx,-97.02791,33.0387,812,57,81,24,42.1
121021744,tx,-97.01191,33.0397,920,58,81,23,39.7
121021745,tx,-97.00642,33.0315,1526,58,81,23,39.7
121021746,tx,-97.10652,33.06126,1774,57,81,24,42.1
121021748,tx,-97.08068,33.04509,1597,57,81,24,42.1
121021749,tx,-97.1022,33.05512,1113,57,81,24,42.1
121021750,tx,-97.10894,33.02621,1880,58,81,23,39.7
121021751,tx,-97.09833,33.02804,1402,58,81,23,39.7
121021752,tx,-97.08439,33.02444,1611,58,81,23,39.7
121021754,tx,-97.12938,33.101,1448,57,80,23,40.4
121021755,tx,-97.1161,33.09508,3279,57,80,23,40.4
121021756,tx,-97.07292,32.99747,996,58,81,23,39.7
121021757,tx,-97.09258,33.00644,1271,58,81,23,39.7
121021758,tx,-97.07034,33.06425,1129,57,81,24,42.1
121021759,tx,-97.0665,33.04464,648,57,81,24,42.1
121021800,tx,-96.84842,33.09821,1357,58,82,24,41.4
121021900,tx,-96.8522,33.1291,2071,58,82,24,41.4
123970100,tx,-97.18078,29.22894,4080,76,102,26,34.2
123970201,tx,-97.29302,29.1419,352,84,108,24,28.6
123970202,tx,-97.40435,29.16526,3457,82,107,25,30.5
123970300,tx,-97.17636,29.09217,3353,85,110,25,29.4
123970400,tx,-97.37015,28.9638,4458,80,106,26,32.5
123970500,tx,-97.59196,29.00936,3387,74,99,25,33.8
125950300,tx,-100.77886,33.61661,1682,23,44,21,91.3
127950201,tx,-99.86265,28.52204,2647,95,115,20,21.1
127950202,tx,-99.97706,28.47279,2718,94,115,21,22.3
127950400,tx,-99.65065,28.398,10319,98,119,21,21.4
129950200,tx,-100.8932,34.93428,1073,16,33,17,106.3
129950300,tx,-100.81354,34.96559,4847,19,36,17,89.5
131950100,tx,-98.34471,27.88507,3703,90,114,24,26.7
131950200,tx,-98.6333,27.9045,2586,89,112,23,25.8
131950500,tx,-98.5125,27.523,4295,93,117,24,25.8
133950100,tx,-98.59637,32.43159,3126,40,65,25,62.5
133950201,tx,-98.80966,32.45505,1316,39,63,24,61.5
133950202,tx,-98.78852,32.36217,3926,41,65,24,58.5
133950301,tx,-98.97912,32.39347,2575,39,64,25,64.1
133950302,tx,-99.01069,32.39035,2065,40,64,24,60
133950400,tx,-98.99067,32.1701,2257,35,59,24,68.6
133950500,tx,-98.72213,32.25957,2958,41,65,24,58.5
135000100,tx,-102.41676,31.92954,1718,12,31,19,158.3
135000300,tx,-102.38354,31.90596,747,12,31,19,158.3
135000400,tx,-102.35824,31.88095,1600,13,33,20,153.8
135000500,tx,-102.37899,31.89188,1568,13,33,20,153.8
135000600,tx,-102.37456,31.87683,2083,13,33,20,153.8
135000700,tx,-102.39092,31.87354,1367,14,33,19,135.7
135000800,tx,-102.40694,31.88783,2335,14,33,19,135.7
135001000,tx,-102.40321,31.85588,1545,16,36,20,125
135001100,tx,-102.40017,31.83745,2039,16,37,21,131.3
135001300,tx,-102.38634,31.85855,1853,15,35,20,133.3
135001500,tx,-102.36833,31.85898,2079,14,34,20,142.9
135001600,tx,-102.35473,31.86402,2362,14,33,19,135.7
135001700,tx,-102.33621,31.86882,2134,13,33,20,153.8
135001800,tx,-102.34706,31.84232,1770,15,36,21,140
135001900,tx,-102.361,31.83638,2532,15,36,21,140
135002000,tx,-102.38569,31.82596,1479,15,36,21,140
135002200,tx,-102.61754,31.85064,4821,17,38,21,123.5
135002300,tx,-102.3243,31.86082,1032,14,34,20,142.9
135002400,tx,-102.33272,31.88626,1522,13,33,20,153.8
135002501,tx,-102.38336,31.93468,3197,12,30,18,150
135002502,tx,-102.36443,31.90192,2253,13,32,19,146.2
135002503,tx,-102.33991,31.90625,1092,13,32,19,146.2
135002701,tx,-102.47199,31.8694,3923,16,36,20,125
135002702,tx,-102.54091,31.86353,3229,17,38,21,123.5
135002801,tx,-102.52047,31.80315,3213,18,39,21,116.7
135002803,tx,-102.43274,31.83733,2777,17,37,20,117.6
135002804,tx,-102.46851,31.81903,2002,17,38,21,123.5
135002900,tx,-102.30791,31.88632,1067,13,33,20,153.8
135003001,tx,-102.41574,32.02158,919,13,32,19,146.2
135003002,tx,-102.33837,31.97627,1842,12,31,19,158.3
135003003,tx,-102.32178,31.76099,2217,17,38,21,123.5
135003004,tx,-102.29619,31.89302,1967,13,33,20,153.8
135003100,tx,-102.37876,31.84561,1636,15,36,21,140
137950300,tx,-100.30474,29.98263,8000,22,46,24,109.1
139060103,tx,-96.72206,32.5234,2132,63,88,25,39.7
139060104,tx,-96.63324,32.52519,1679,63,88,25,39.7
139060105,tx,-96.58981,32.47844,2129,61,86,25,41
139060106,tx,-96.70371,32.46724,1592,62,87,25,40.3
139060206,tx,-96.80853,32.52786,2481,62,87,25,40.3
139060207,tx,-96.77796,32.52082,3004,62,87,25,40.3
139060209,tx,-96.86582,32.48351,2445,60,85,25,41.7
139060211,tx,-96.9057,32.42706,1731,60,85,25,41.7
139060212,tx,-96.82819,32.43984,2825,61,86,25,41
139060215,tx,-96.83871,32.51046,1557,62,86,24,38.7
139060216,tx,-96.87201,32.5393,3829,62,86,24,38.7
139060217,tx,-96.76852,32.41418,3282,61,86,25,41
139060218,tx,-96.7743,32.47956,1022,62,87,25,40.3
139060219,tx,-96.80599,32.4724,1933,61,86,25,41
139060220,tx,-96.95865,32.49223,1274,60,85,25,41.7
139060221,tx,-96.91639,32.50998,2938,60,85,25,41.7
139060300,tx,-96.8291,32.39774,1810,61,86,25,41
139060400,tx,-96.8296,32.3647,2447,61,87,26,42.6
139060500,tx,-96.86035,32.38754,1091,61,86,25,41
139060601,tx,-96.8441,32.41243,1346,61,86,25,41
139060602,tx,-96.85893,32.40907,1273,60,86,26,43.3
139060702,tx,-96.95891,32.50462,2382,60,85,25,41.7
139060704,tx,-97.02846,32.52283,2345,61,85,24,39.3
139060801,tx,-96.96854,32.4411,4262,59,84,25,42.4
139060802,tx,-97.03843,32.43418,3086,59,84,25,42.4
139060803,tx,-97.05892,32.47964,830,60,85,25,41.7
139060900,tx,-96.99917,32.33474,3471,60,85,25,41.7
139061000,tx,-96.92961,32.17476,2819,60,85,25,41.7
139061100,tx,-96.83357,32.3024,2256,60,85,25,41.7
139061200,tx,-96.7381,32.22065,1382,59,85,26,44.1
139061300,tx,-96.69086,32.32673,1745,59,85,26,44.1
139061401,tx,-96.6648,32.33131,851,58,84,26,44.8
139061402,tx,-96.65486,32.34707,2236,58,84,26,44.8
139061500,tx,-96.62917,32.30662,1891,58,85,27,46.6
139061600,tx,-96.61683,32.34168,2807,58,84,26,44.8
139061700,tx,-96.53276,32.35979,3053,60,86,26,43.3
141000106,tx,-106.43042,31.92055,2171,8,27,19,237.5
141000107,tx,-106.41471,31.92068,1890,9,28,19,211.1
141000108,tx,-106.40136,31.91962,730,9,28,19,211.1
141000109,tx,-106.41559,31.90994,1281,9,28,19,211.1
141000110,tx,-106.41567,31.90257,805,9,28,19,211.1
141000111,tx,-106.43738,31.90637,711,8,26,18,225
141000112,tx,-106.42894,31.90591,1472,9,28,19,211.1
141000113,tx,-106.41912,31.89164,1305,9,28,19,211.1
141000114,tx,-106.43303,31.88443,1062,9,27,18,200
141000204,tx,-106.40048,31.88969,1674,9,28,19,211.1
141000205,tx,-106.41234,31.88647,866,9,28,19,211.1
141000206,tx,-106.41536,31.8743,1570,9,28,19,211.1
141000207,tx,-106.39652,31.90373,1314,9,28,19,211.1
141000208,tx,-106.386,31.91806,1322,9,28,19,211.1
141000301,tx,-106.42962,31.85736,1367,9,28,19,211.1
141000302,tx,-106.41754,31.86187,1576,9,28,19,211.1
141000401,tx,-106.47072,31.84973,2449,9,28,19,211.1
141000403,tx,-106.44533,31.86055,1108,9,27,18,200
141000404,tx,-106.43653,31.86362,487,8,27,19,237.5
141000600,tx,-106.44851,31.83227,1393,9,28,19,211.1
141000800,tx,-106.45172,31.81677,1367,11,31,20,181.8
141000901,tx,-106.45184,31.80891,1552,12,33,21,175
141000902,tx,-106.47932,31.81673,575,12,33,21,175
141001001,tx,-106.46195,31.79969,1070,12,33,21,175
141001002,tx,-106.45056,31.80049,1160,12,33,21,175
141001107,tx,-106.54407,31.8565,2320,6,22,16,266.7
141001109,tx,-106.52567,31.84813,1943,6,22,16,266.7
141001110,tx,-106.51753,31.83448,1390,4,18,14,350
141001111,tx,-106.50142,31.82796,961,6,20,14,233.3
141001112,tx,-106.54909,31.84752,1553,6,22,16,266.7
141001114,tx,-106.5329,31.81823,885,6,23,17,283.3
141001115,tx,-106.51909,31.80752,449,10,30,20,200
141001116,tx,-106.55988,31.83275,326,7,24,17,242.9
141001117,tx,-106.54444,31.82638,1725,6,22,16,266.7
141001118,tx,-106.5351,31.83538,600,6,22,16,266.7
141001119,tx,-106.54742,31.84044,1080,6,22,16,266.7
141001202,tx,-106.56761,31.85109,1544,11,31,20,181.8
141001204,tx,-106.56949,31.83587,1672,11,31,20,181.8
141001301,tx,-106.59491,31.85275,1295,11,32,21,190.9
141001302,tx,-106.58359,31.8276,2872,11,32,21,190.9
141001400,tx,-106.52259,31.79058,439,11,31,20,181.8
141001501,tx,-106.49595,31.79421,2089,10,30,20,200
141001502,tx,-106.49968,31.77612,1005,11,31,20,181.8
141001600,tx,-106.49763,31.76384,1033,13,35,22,169.2
141001700,tx,-106.48743,31.75955,549,13,35,22,169.2
141001800,tx,-106.49356,31.75407,299,13,35,22,169.2
141001900,tx,-106.48078,31.75247,413,13,35,22,169.2
141002000,tx,-106.47141,31.75781,415,13,35,22,169.2
141002100,tx,-106.4748,31.76551,584,13,35,22,169.2
141002201,tx,-106.48169,31.77957,941,11,32,21,190.9
141002202,tx,-106.48414,31.77044,1142,13,35,22,169.2
141002300,tx,-106.46771,31.78459,1710,12,33,21,175
141002400,tx,-106.45497,31.78979,1102,12,33,21,175
141002500,tx,-106.44036,31.79194,2128,12,33,21,175
141002600,tx,-106.45007,31.78102,1243,12,33,21,175
141002800,tx,-106.46042,31.77087,1140,14,36,22,157.1
141002900,tx,-106.44774,31.77046,502,13,36,23,176.9
141003000,tx,-106.43689,31.76538,1200,14,37,23,164.3
141003100,tx,-106.42648,31.76264,876,16,39,23,143.8
141003200,tx,-106.42219,31.77451,1155,13,35,22,169.2
141003300,tx,-106.42783,31.78466,1851,11,31,20,181.8
141003402,tx,-106.39643,31.78897,1584,11,31,20,181.8
141003403,tx,-106.3862,31.78313,1274,11,31,20,181.8
141003404,tx,-106.36879,31.7817,2067,11,31,20,181.8
141003501,tx,-106.38653,31.76259,1234,17,40,23,135.3
141003502,tx,-106.3591,31.73447,1148,19,43,24,126.3
141003601,tx,-106.41736,31.76288,1152,16,39,23,143.8
141003602,tx,-106.40727,31.75646,661,16,39,23,143.8
141003701,tx,-106.39526,31.74887,1206,16,40,24,150
141003702,tx,-106.38325,31.74096,1213,18,42,24,133.3
141003801,tx,-106.37116,31.72552,1634,20,46,26,130
141003803,tx,-106.35986,31.71529,1083,21,46,25,119
141003804,tx,-106.35035,31.71254,907,21,46,25,119
141003901,tx,-106.33576,31.70244,1119,21,47,26,123.8
141003902,tx,-106.32517,31.68606,1035,20,45,25,125
141003904,tx,-106.34523,31.69833,713,21,47,26,123.8
141003905,tx,-106.33756,31.68554,776,20,44,24,120
141004004,tx,-106.31079,31.69427,1583,20,45,25,125
141004005,tx,-106.31777,31.66914,2033,19,43,24,126.3
141004006,tx,-106.2899,31.6814,1038,18,41,23,127.8
141004007,tx,-106.30311,31.69858,840,19,43,24,126.3
141004008,tx,-106.2989,31.70572,1112,19,44,25,131.6
141004103,tx,-106.32133,31.72248,1836,21,47,26,123.8
141004104,tx,-106.33451,31.71423,1998,21,47,26,123.8
141004105,tx,-106.3486,31.74136,846,18,42,24,133.3
141004106,tx,-106.34005,31.7387,1440,17,41,24,141.2
141004107,tx,-106.33002,31.73697,509,18,42,24,133.3
141004201,tx,-106.35814,31.74766,1760,18,42,24,133.3
141004202,tx,-106.36486,31.7593,1393,18,42,24,133.3
141004303,tx,-106.35103,31.77795,1964,12,33,21,175
141004307,tx,-106.31035,31.76107,1736,16,39,23,143.8
141004309,tx,-106.31075,31.7398,1687,16,39,23,143.8
141004310,tx,-106.34437,31.79303,1331,11,31,20,181.8
141004311,tx,-106.34511,31.78622,1430,11,31,20,181.8
141004312,tx,-106.33492,31.75807,1489,17,40,23,135.3
141004313,tx,-106.32451,31.75641,859,17,40,23,135.3
141004314,tx,-106.29722,31.76038,1564,14,37,23,164.3
141004316,tx,-106.29635,31.7411,1638,14,37,23,164.3
141004317,tx,-106.35981,31.76773,286,18,42,24,133.3
141004318,tx,-106.34773,31.76382,1466,17,41,24,141.2
141004319,tx,-106.28308,31.761,1750,14,37,23,164.3
141004320,tx,-106.28499,31.7521,1047,14,37,23,164.3
141010101,tx,-106.25472,31.9146,246,8,27,19,237.5
141010102,tx,-106.41906,31.81665,5,10,30,20,200
141010103,tx,-106.42367,31.80169,15,11,32,21,190.9
141010203,tx,-106.60157,31.98749,1158,9,30,21,233.3
141010210,tx,-106.43371,31.95682,1853,8,27,19,237.5
141010211,tx,-106.47109,31.93758,1026,8,25,17,212.5
141010212,tx,-106.41979,31.96992,2340,9,28,19,211.1
141010213,tx,-106.53357,31.88816,2732,2,13,11,550
141010214,tx,-106.51613,31.86626,2155,3,13,10,333.3
141010217,tx,-106.55333,31.87062,1674,2,13,11,550
141010218,tx,-106.61822,31.89679,1909,13,35,22,169.2
141010220,tx,-106.53947,31.94902,2764,7,24,17,242.9
141010222,tx,-106.61583,31.95121,860,12,35,23,191.7
141010223,tx,-106.39115,31.94641,1316,9,28,19,211.1
141010224,tx,-106.36968,31.9794,2024,9,29,20,222.2
141010225,tx,-106.56908,31.87072,1634,8,28,20,250
141010226,tx,-106.56952,31.89302,1407,8,27,19,237.5
141010227,tx,-106.5855,31.87231,1086,9,28,19,211.1
141010228,tx,-106.59106,31.89532,1285,8,27,19,237.5
141010229,tx,-106.61747,31.86567,2692,13,35,22,169.2
141010230,tx,-106.59635,31.8694,826,9,29,20,222.2
141010231,tx,-106.59285,31.95054,1281,8,27,19,237.5
141010232,tx,-106.59214,31.91716,1387,7,25,18,257.1
141010303,tx,-106.32795,31.79087,995,11,32,21,190.9
141010307,tx,-106.33005,31.77691,1657,13,34,21,161.5
141010311,tx,-106.3122,31.79567,2113,11,32,21,190.9
141010312,tx,-106.31276,31.78711,1390,11,32,21,190.9
141010316,tx,-106.3171,31.77694,1252,13,35,22,169.2
141010317,tx,-106.30785,31.77673,1258,13,34,21,161.5
141010322,tx,-106.29363,31.79723,1727,11,32,21,190.9
141010323,tx,-106.29357,31.78692,1442,11,32,21,190.9
141010326,tx,-106.29359,31.77229,1547,14,36,22,157.1
141010327,tx,-106.29448,31.77957,1212,11,32,21,190.9
141010328,tx,-106.27615,31.77171,1127,13,35,22,169.2
141010329,tx,-106.25835,31.77528,1599,11,32,21,190.9
141010333,tx,-106.16548,31.66879,3314,9,28,19,211.1
141010334,tx,-106.18124,31.62859,4902,9,28,19,211.1
141010335,tx,-106.07222,31.64253,21493,7,24,17,242.9
141010336,tx,-106.27446,31.74788,1847,14,37,23,164.3
141010337,tx,-106.27698,31.73498,1856,16,39,23,143.8
141010338,tx,-106.2859,31.72021,2205,18,43,25,138.9
141010344,tx,-106.07526,31.75846,50428,7,23,16,228.6
141010346,tx,-106.26348,31.66766,2002,16,38,22,137.5
141010347,tx,-106.22877,31.62592,2458,12,32,20,166.7
141010348,tx,-106.27182,31.7847,1421,11,32,21,190.9
141010349,tx,-106.28042,31.78681,1081,11,32,21,190.9
141010350,tx,-106.27671,31.795,1331,11,32,21,190.9
141010351,tx,-106.27611,31.80181,1278,11,32,21,190.9
141010352,tx,-106.26142,31.78505,1704,10,30,20,200
141010353,tx,-106.244,31.79186,1578,10,30,20,200
141010354,tx,-106.2356,31.80518,1688,10,30,20,200
141010355,tx,-106.25964,31.79989,1550,10,30,20,200
141010356,tx,-106.18893,31.67778,1136,10,30,20,200
141010357,tx,-106.20979,31.66623,2161,10,30,20,200
141010358,tx,-106.24126,31.82853,2681,9,28,19,211.1
141010359,tx,-106.18356,31.85571,1669,8,26,18,225
141010360,tx,-106.20717,31.69167,1341,11,30,19,172.7
141010361,tx,-106.19657,31.68776,1283,10,30,20,200
141010362,tx,-106.24479,31.68183,2715,13,35,22,169.2
141010363,tx,-106.22516,31.68995,1569,13,34,21,161.5
141010364,tx,-106.06446,31.90608,9980,4,17,13,325
141010365,tx,-106.17628,31.80842,1418,9,27,18,200
141010366,tx,-106.24343,31.74994,2447,12,33,21,175
141010367,tx,-106.22684,31.7906,2441,10,29,19,190
141010368,tx,-106.23338,31.77573,3778,11,31,20,181.8
141010369,tx,-106.19232,31.76509,18979,10,29,19,190
141010370,tx,-106.24693,31.71527,6050,13,34,21,161.5
141010371,tx,-106.17139,31.69796,3877,10,29,19,190
141010372,tx,-106.18991,31.71743,3873,10,29,19,190
141010401,tx,-106.29728,31.64194,2281,15,38,23,153.3
141010404,tx,-106.24041,31.60345,2111,11,32,21,190.9
141010406,tx,-106.27736,31.57896,1218,12,33,21,175
141010408,tx,-106.26953,31.64255,1363,14,36,22,157.1
141010409,tx,-106.28514,31.66079,1738,17,41,24,141.2
141010410,tx,-106.26937,31.61156,1563,13,35,22,169.2
141010411,tx,-106.29158,31.61209,1096,13,35,22,169.2
141010412,tx,-106.26209,31.58541,1378,11,31,20,181.8
141010413,tx,-106.26441,31.59678,468,12,32,20,166.7
141010501,tx,-106.21525,31.53294,2710,10,29,19,190
141010502,tx,-106.06918,31.53089,2716,7,24,17,242.9
141010504,tx,-106.05796,31.42449,1398,7,24,17,242.9
141010505,tx,-106.15785,31.46959,1457,8,25,17,212.5
141010506,tx,-106.10417,31.48008,1143,7,24,17,242.9
141010601,tx,-106.45059,31.82267,27,9,28,19,211.1
141010602,tx,-106.43881,31.84132,31,9,28,19,211.1
141980000,tx,-106.36236,31.81402,228,10,30,20,200
143950100,tx,-98.21696,32.41596,4394,47,71,24,51.1
143950201,tx,-98.11503,32.25273,2303,37,61,24,64.9
143950203,tx,-98.26314,32.16866,2394,36,60,24,66.7
143950204,tx,-98.37252,32.30501,1758,36,60,24,66.7
143950301,tx,-98.42665,32.17296,1615,37,61,24,64.9
143950302,tx,-98.30899,32.04371,2351,37,61,24,64.9
143950401,tx,-98.22937,32.20368,714,35,59,24,68.6
143950402,tx,-98.24061,32.21219,1196,34,58,24,70.6
143950501,tx,-98.19422,32.24353,1302,34,59,25,73.5
143950502,tx,-98.21322,32.22279,1439,35,59,24,68.6
143950600,tx,-98.18588,32.21413,1685,35,59,24,68.6
143950700,tx,-98.06131,32.07775,2010,44,69,25,56.8
145000200,tx,-97.11147,31.29871,2753,60,87,27,45
145000300,tx,-96.89274,31.31645,1967,60,88,28,46.7
145000400,tx,-96.89267,31.28731,2650,61,89,28,45.9
145000500,tx,-97.07183,31.19133,2522,60,87,27,45
145000700,tx,-96.98093,31.10384,2907,64,91,27,42.2
145000800,tx,-96.81198,31.31307,4741,61,89,28,45.9
147950100,tx,-95.91283,33.62191,3254,55,80,25,45.5
147950300,tx,-96.32305,33.60094,2504,52,77,25,48.1
147950401,tx,-96.20819,33.58255,1147,52,77,25,48.1
147950402,tx,-96.19239,33.6161,3466,52,77,25,48.1
147950500,tx,-96.01777,33.51849,3530,54,79,25,46.3
147950600,tx,-96.20509,33.51939,2325,53,78,25,47.2
147950701,tx,-96.17821,33.41905,3278,55,80,25,45.5
147950702,tx,-96.33761,33.43169,2545,54,79,25,46.3
147950800,tx,-96.07848,33.75284,4105,54,79,25,46.3
149970100,tx,-96.75279,30.06845,2660,70,97,27,38.6
149970200,tx,-96.8952,29.98252,2681,72,98,26,36.1
149970301,tx,-96.89735,29.91848,754,72,97,25,34.7
149970302,tx,-96.86564,29.91047,2137,72,98,26,36.1
149970400,tx,-96.97933,29.89015,3016,70,96,26,37.1
149970500,tx,-97.11683,29.76193,4069,65,92,27,41.5
149970601,tx,-96.82361,29.77311,995,70,96,26,37.1
149970602,tx,-96.91195,29.70521,2788,69,96,27,39.1
149970700,tx,-96.67888,29.92304,2154,72,98,26,36.1
151950300,tx,-100.40201,32.64791,3264,34,58,24,70.6
151950400,tx,-100.40237,32.86441,3193,39,63,24,61.5
153950500,tx,-101.30597,34.18119,6028,6,17,11,183.3
153950600,tx,-101.29994,33.94161,6674,7,20,13,185.7
155950100,tx,-99.77798,33.97462,4706,56,76,20,35.7
157670101,tx,-95.45228,29.58858,2216,71,100,29,40.8
157670102,tx,-95.46389,29.58454,1242,71,100,29,40.8
157670201,tx,-95.47668,29.58628,639,73,102,29,39.7
157670202,tx,-95.47612,29.5982,2167,72,101,29,40.3
157670300,tx,-95.48788,29.59509,1477,73,102,29,39.7
157670400,tx,-95.50081,29.60822,1791,73,102,29,39.7
157670500,tx,-95.52014,29.61215,2066,74,102,28,37.8
157670602,tx,-95.49901,29.5894,794,73,102,29,39.7
157670603,tx,-95.51609,29.58619,1891,74,102,28,37.8
157670604,tx,-95.5143,29.5965,1560,74,102,28,37.8
157670700,tx,-95.46578,29.56419,5049,71,100,29,40.8
157670801,tx,-95.44875,29.51735,1819,71,101,30,42.3
157670802,tx,-95.46723,29.51853,1880,72,101,29,40.3
157670803,tx,-95.46774,29.53059,1775,72,102,30,41.7
157670804,tx,-95.49272,29.52916,1518,74,103,29,39.2
157670902,tx,-95.48424,29.54777,3878,73,102,29,39.7
157670903,tx,-95.51841,29.54717,3761,75,103,28,37.3
157670904,tx,-95.54075,29.55501,2507,76,104,28,36.8
157671001,tx,-95.55197,29.57233,2668,75,103,28,37.3
157671002,tx,-95.53251,29.5733,2671,75,103,28,37.3
157671101,tx,-95.5332,29.58854,986,74,103,29,39.2
157671102,tx,-95.55246,29.59356,2478,75,103,28,37.3
157671200,tx,-95.53582,29.60467,2251,74,102,28,37.8
157671300,tx,-95.55277,29.61106,1211,74,102,28,37.8
157671401,tx,-95.57432,29.61931,577,73,102,29,39.7
157671402,tx,-95.57414,29.61065,1009,74,102,28,37.8
157671501,tx,-95.57294,29.59435,2994,76,104,28,36.8
157671502,tx,-95.57084,29.57718,907,76,104,28,36.8
157671601,tx,-95.60451,29.59858,1976,76,104,28,36.8
157671602,tx,-95.58752,29.59223,1389,76,104,28,36.8
157671700,tx,-95.59505,29.61348,2461,74,102,28,37.8
157671800,tx,-95.55837,29.62983,1825,73,102,29,39.7
157671900,tx,-95.58737,29.65186,1682,72,101,29,40.3
157672002,tx,-95.58928,29.64125,922,73,102,29,39.7
157672003,tx,-95.60752,29.63861,1260,73,101,28,38.4
157672004,tx,-95.61015,29.65948,1832,72,101,29,40.3
157672100,tx,-95.62327,29.61361,2381,73,102,29,39.7
157672201,tx,-95.64474,29.63186,804,73,101,28,38.4
157672202,tx,-95.6298,29.62673,1338,73,102,29,39.7
157672303,tx,-95.64348,29.65608,736,72,101,29,40.3
157672304,tx,-95.62958,29.65652,1503,72,101,29,40.3
157672305,tx,-95.63482,29.64647,1613,73,101,28,38.4
157672306,tx,-95.62687,29.6395,1565,73,102,29,39.7
157672401,tx,-95.63942,29.67682,834,72,101,29,40.3
157672402,tx,-95.62865,29.66901,2179,72,101,29,40.3
157672500,tx,-95.65437,29.68572,2550,72,100,28,38.9
157672602,tx,-95.67488,29.68531,1992,71,100,29,40.8
157672603,tx,-95.68211,29.70141,899,72,100,28,38.9
157672604,tx,-95.67439,29.69397,2432,72,100,28,38.9
157672701,tx,-95.66872,29.67428,1883,71,100,29,40.8
157672702,tx,-95.66924,29.64293,2287,72,101,29,40.3
157672703,tx,-95.66028,29.6618,2792,71,100,29,40.8
157672801,tx,-95.66874,29.63001,1488,72,101,29,40.3
157672802,tx,-95.66552,29.61674,459,73,102,29,39.7
157672901,tx,-95.69281,29.64328,6244,72,101,29,40.3
157672902,tx,-95.75581,29.69361,3031,73,101,28,38.4
157672903,tx,-95.73591,29.67391,4888,72,101,29,40.3
157672904,tx,-95.69924,29.67391,2950,72,100,28,38.9
157672905,tx,-95.69433,29.69711,2630,72,100,28,38.9
157672906,tx,-95.73047,29.69747,2169,72,101,29,40.3
157672907,tx,-95.71406,29.6922,3905,72,101,29,40.3
157673004,tx,-95.75519,29.74358,1080,73,102,29,39.7
157673005,tx,-95.76691,29.74403,1765,73,102,29,39.7
157673006,tx,-95.73572,29.72486,1623,73,101,28,38.4
157673007,tx,-95.71603,29.71107,893,73,101,28,38.4
157673008,tx,-95.76069,29.72571,1468,73,101,28,38.4
157673009,tx,-95.75556,29.71115,1938,73,101,28,38.4
157673010,tx,-95.76882,29.70972,1321,73,101,28,38.4
157673103,tx,-95.80696,29.76339,1758,74,102,28,37.8
157673104,tx,-95.78795,29.70942,2093,73,101,28,38.4
157673105,tx,-95.80111,29.71909,1530,73,101,28,38.4
157673106,tx,-95.78147,29.72792,2241,73,101,28,38.4
157673107,tx,-95.78592,29.7525,2624,73,102,29,39.7
157673108,tx,-95.8338,29.75822,6496,74,102,28,37.8
157673109,tx,-95.82126,29.70166,3596,73,101,28,38.4
157673110,tx,-95.82786,29.71093,2171,73,101,28,38.4
157673111,tx,-95.83429,29.72506,3731,73,102,29,39.7
157673112,tx,-95.81386,29.73221,3241,73,102,29,39.7
157673113,tx,-95.79599,29.73716,2378,73,102,29,39.7
157673201,tx,-95.86281,29.76201,4906,74,103,29,39.2
157673202,tx,-95.93601,29.71319,13098,75,103,28,37.3
157673300,tx,-95.90108,29.64755,5028,76,104,28,36.8
157673401,tx,-95.78338,29.60534,3961,74,102,28,37.8
157673402,tx,-95.82489,29.66921,3496,74,102,28,37.8
157673403,tx,-95.79236,29.69179,3727,73,101,28,38.4
157673404,tx,-95.77814,29.65516,5054,73,101,28,38.4
157673501,tx,-95.72547,29.6447,3610,73,101,28,38.4
157673502,tx,-95.73628,29.63151,1351,73,101,28,38.4
157673600,tx,-95.72872,29.61082,2921,73,101,28,38.4
157673700,tx,-95.70465,29.61961,54,73,101,28,38.4
157673801,tx,-95.7166,29.58585,1258,75,103,28,37.3
157673802,tx,-95.68896,29.59323,1600,75,103,28,37.3
157673902,tx,-95.64792,29.59435,3865,75,103,28,37.3
157673903,tx,-95.66858,29.58409,1128,75,103,28,37.3
157673904,tx,-95.66994,29.59808,1978,75,103,28,37.3
157674001,tx,-95.62348,29.58036,1162,76,104,28,36.8
157674002,tx,-95.61824,29.58932,1735,76,104,28,36.8
157674100,tx,-95.59959,29.57917,2839,76,104,28,36.8
157674200,tx,-95.62147,29.5715,2224,76,104,28,36.8
157674301,tx,-95.58646,29.56473,1499,76,104,28,36.8
157674302,tx,-95.57256,29.56248,2864,77,104,27,35.1
157674401,tx,-95.63276,29.5641,2802,78,105,27,34.6
157674402,tx,-95.61254,29.54396,2132,78,106,28,35.9
157674403,tx,-95.58962,29.53998,1433,77,105,28,36.4
157674404,tx,-95.57451,29.52726,2702,77,105,28,36.4
157674503,tx,-95.54136,29.50817,2021,76,104,28,36.8
157674504,tx,-95.52994,29.48664,4149,75,104,29,38.7
157674505,tx,-95.5034,29.49258,2682,74,103,29,39.2
157674506,tx,-95.48945,29.46849,4333,71,100,29,40.8
157674507,tx,-95.5484,29.53121,4328,76,104,28,36.8
157674508,tx,-95.50727,29.51934,1432,75,104,29,38.7
157674601,tx,-95.68058,29.55639,1572,77,105,28,36.4
157674602,tx,-95.62779,29.53071,3275,78,105,27,34.6
157674603,tx,-95.69127,29.54352,2278,76,104,28,36.8
157674604,tx,-95.71572,29.54856,2008,76,104,28,36.8
157674701,tx,-95.68199,29.57174,1607,75,103,28,37.3
157674702,tx,-95.73248,29.5676,5915,75,104,29,38.7
157674800,tx,-95.77178,29.56655,1218,75,103,28,37.3
157674900,tx,-95.7721,29.59464,1833,74,103,29,39.2
157675000,tx,-95.79344,29.56627,1766,74,103,29,39.2
157675101,tx,-95.76696,29.54941,2290,75,103,28,37.3
157675102,tx,-95.78794,29.54968,1382,75,103,28,37.3
157675200,tx,-95.79569,29.54317,2034,75,103,28,37.3
157675300,tx,-95.82418,29.54557,2593,74,103,29,39.2
157675401,tx,-95.86011,29.49568,4039,74,102,28,37.8
157675402,tx,-95.8872,29.54677,1733,73,102,29,39.7
157675501,tx,-95.78765,29.49289,3325,75,103,28,37.3
157675502,tx,-95.73682,29.52786,6311,76,104,28,36.8
157675503,tx,-95.64459,29.46052,3212,77,105,28,36.4
157675600,tx,-95.71023,29.37797,5078,73,103,30,41.1
157675701,tx,-95.8615,29.36076,3200,72,101,29,40.3
157675702,tx,-95.84957,29.39824,2268,72,102,30,41.7
157675800,tx,-95.97253,29.52922,4466,74,103,29,39.2
159950101,tx,-95.2226,33.1025,7403,59,84,25,42.4
159950102,tx,-95.21531,33.2733,2392,57,82,25,43.9
159950200,tx,-95.21675,33.17017,1232,54,80,26,48.1
159950300,tx,-95.22107,33.00753,3271,59,85,26,44.1
161000101,tx,-96.18605,31.82468,4193,64,91,27,42.2
161000102,tx,-96.07226,31.81265,2678,65,93,28,43.1
161000200,tx,-96.15396,31.73068,821,64,92,28,43.8
161000300,tx,-96.17205,31.72395,973,64,92,28,43.8
161000400,tx,-96.34538,31.81474,2904,63,90,27,42.9
161000600,tx,-96.23539,31.59602,6129,63,91,28,44.4
161000700,tx,-96.28291,31.62511,2313,62,90,28,45.2
161000900,tx,-95.95081,31.6475,3279,67,94,27,40.3
163950101,tx,-98.94044,29.00466,2539,80,104,24,30
163950102,tx,-98.95991,28.78634,1942,84,107,23,27.4
163950201,tx,-99.26983,28.89628,865,86,109,23,26.7
163950202,tx,-99.21715,29.02094,1761,84,107,23,27.4
163950301,tx,-99.29428,28.73095,1072,86,109,23,26.7
163950302,tx,-99.12048,28.67952,938,86,109,23,26.7
165950100,tx,-102.45557,32.85819,3067,7,20,13,185.7
165950201,tx,-102.47089,32.65749,3089,9,25,16,177.8
165950202,tx,-102.8816,32.71725,4256,8,23,15,187.5
165950300,tx,-102.65171,32.71876,2677,10,26,16,160
167720100,tx,-95.2098,29.54299,2336,54,86,32,59.3
167720200,tx,-95.18231,29.51419,1967,51,84,33,64.7
167720301,tx,-95.20028,29.5208,911,52,85,33,63.5
167720302,tx,-95.21611,29.49849,2772,52,85,33,63.5
167720400,tx,-95.19569,29.48369,3409,52,84,32,61.5
167720501,tx,-95.1405,29.4996,1643,49,82,33,67.3
167720504,tx,-95.1709,29.47822,900,49,82,33,67.3
167720505,tx,-95.16258,29.475,1478,50,83,33,66
167720506,tx,-95.14608,29.48737,1860,49,82,33,67.3
167720507,tx,-95.1406,29.47541,1678,50,83,33,66
167720508,tx,-95.13076,29.49106,965,50,83,33,66
167720509,tx,-95.11828,29.49612,885,50,83,33,66
167720510,tx,-95.11805,29.48983,1110,50,83,33,66
167720511,tx,-95.11257,29.47657,1101,50,83,33,66
167720512,tx,-95.12266,29.47872,1010,50,83,33,66
167720601,tx,-95.09446,29.43958,1236,61,92,31,50.8
167720602,tx,-95.09041,29.45384,1397,60,92,32,53.3
167720603,tx,-95.10242,29.44482,1438,55,87,32,58.2
167720604,tx,-95.10306,29.46431,1553,53,85,32,60.4
167720605,tx,-95.16487,29.45,953,54,87,33,61.1
167720701,tx,-95.08746,29.49871,1429,61,92,31,50.8
167720702,tx,-95.10372,29.49976,1201,53,85,32,60.4
167720703,tx,-95.09004,29.48062,1041,61,92,31,50.8
167720800,tx,-95.07323,29.46821,1952,61,92,31,50.8
167720900,tx,-95.05967,29.45533,2086,67,97,30,44.8
167721000,tx,-95.00505,29.46181,1330,76,104,28,36.8
167721101,tx,-95.05363,29.47981,764,73,102,29,39.7
167721102,tx,-95.0377,29.47348,1246,74,103,29,39.2
167721103,tx,-95.01244,29.48242,1187,74,103,29,39.2
167721203,tx,-95.06773,29.49791,428,62,92,30,48.4
167721204,tx,-95.06903,29.51154,744,61,92,31,50.8
167721205,tx,-95.0544,29.52023,1683,70,99,29,41.4
167721206,tx,-95.05188,29.50828,1669,71,100,29,40.8
167721207,tx,-95.03781,29.51833,1336,72,101,29,40.3
167721208,tx,-95.02275,29.52677,540,68,98,30,44.1
167721209,tx,-95.05244,29.4951,1079,69,98,29,42
167721210,tx,-95.01926,29.51359,1911,74,102,28,37.8
167721211,tx,-95.01505,29.50066,1382,73,101,28,38.4
167721301,tx,-95.08645,29.51503,1603,61,92,31,50.8
167721302,tx,-95.08095,29.53046,964,61,93,32,52.5
167721401,tx,-95.06177,29.53028,976,63,95,32,50.8
167721402,tx,-95.02839,29.53654,97,66,97,31,47
167721403,tx,-95.04642,29.5357,1378,66,97,31,47
167721501,tx,-95.06881,29.54495,946,61,93,32,52.5
167721502,tx,-95.05139,29.55036,1335,66,97,31,47
167721503,tx,-95.03179,29.5458,1227,66,97,31,47
167721600,tx,-95.00703,29.52732,1036,72,99,27,37.5
167721701,tx,-94.98519,29.50869,1473,75,102,27,36
167721702,tx,-94.99424,29.5057,795,75,102,27,36
167721703,tx,-94.97408,29.49313,1663,73,100,27,37
167721800,tx,-94.94474,29.48537,4678,64,93,29,45.3
167721901,tx,-95.03607,29.42473,1538,79,106,27,34.2
167721902,tx,-94.97825,29.42987,2731,77,102,25,32.5
167722001,tx,-94.91142,29.42131,2424,66,95,29,43.9
167722002,tx,-94.93101,29.40132,1128,67,95,28,41.8
167722100,tx,-94.90889,29.40243,2588,64,93,29,45.3
167722200,tx,-94.90147,29.3901,1451,64,92,28,43.8
167722300,tx,-94.92406,29.39012,2635,66,94,28,42.4
167722600,tx,-94.96501,29.38822,878,74,100,26,35.1
167722700,tx,-94.98958,29.38696,2423,80,104,24,30
167722800,tx,-94.96464,29.36577,1122,73,99,26,35.6
167722900,tx,-94.98012,29.36329,1150,78,103,25,32.1
167723000,tx,-94.98668,29.37383,1875,79,104,25,31.6
167723100,tx,-95.01337,29.39182,887,80,105,25,31.3
167723200,tx,-95.02485,29.37205,2900,81,106,25,30.9
167723300,tx,-95.06883,29.40148,4978,76,103,27,35.5
167723401,tx,-95.17317,29.41652,946,56,89,33,58.9
167723402,tx,-95.12204,29.41601,1056,59,91,32,54.2
167723403,tx,-95.11033,29.39122,1611,72,100,28,38.9
167723501,tx,-95.07797,29.35852,1267,80,106,26,32.5
167723503,tx,-95.15648,29.37625,1273,66,96,30,45.5
167723504,tx,-95.11688,29.36885,1294,71,100,29,40.8
167723505,tx,-95.11161,29.33177,1365,85,109,24,28.2
167723600,tx,-95.03407,29.2896,4047,75,101,26,34.7
167723700,tx,-94.98394,29.34353,1756,69,96,27,39.1
167723800,tx,-94.94313,29.33151,3951,61,90,29,47.5
167723900,tx,-94.57653,29.48579,14829,56,85,29,51.8
167724000,tx,-94.82736,29.32513,720,54,84,30,55.6
167724101,tx,-94.75624,29.32589,1034,53,84,31,58.5
167724200,tx,-94.77226,29.31973,603,53,84,31,58.5
167724300,tx,-94.78036,29.3077,1325,52,83,31,59.6
167724400,tx,-94.78439,29.29901,1534,52,83,31,59.6
167724500,tx,-94.79452,29.30375,648,52,83,31,59.6
167724600,tx,-94.80807,29.29765,611,53,83,30,56.6
167724700,tx,-94.79981,29.2946,966,52,83,31,59.6
167724800,tx,-94.79279,29.29206,680,52,83,31,59.6
167724900,tx,-94.8014,29.28692,779,52,83,31,59.6
167725000,tx,-94.80819,29.28312,869,53,83,30,56.6
167725100,tx,-94.80958,29.29077,788,53,84,31,58.5
167725200,tx,-94.82164,29.29049,653,54,84,30,55.6
167725300,tx,-94.82692,29.28617,917,54,84,30,55.6
167725400,tx,-94.82086,29.28192,1435,54,84,30,55.6
167725500,tx,-94.81909,29.27541,586,53,84,31,58.5
167725600,tx,-94.83225,29.26753,435,52,82,30,57.7
167725700,tx,-94.8431,29.26502,1040,52,82,30,57.7
167725800,tx,-94.85872,29.28282,1617,54,84,30,55.6
167725900,tx,-94.86283,29.26408,851,52,82,30,57.7
167726000,tx,-94.92347,29.26284,2337,52,83,31,59.6
167726101,tx,-94.97387,29.22128,4004,52,82,30,57.7
167726102,tx,-95.04787,29.16201,4786,59,87,28,47.5
167726200,tx,-94.91229,29.3593,2402,69,96,27,39.1
167990000,tx,-94.72695,29.31744,18,52,82,30,57.7
167990100,tx,-94.76236,29.46596,106,64,92,28,43.8
169950101,tx,-101.34782,33.19787,1062,17,37,20,117.6
169950102,tx,-101.29729,33.17946,3729,17,36,19,111.8
169980000,tx,-101.37386,33.2003,5,17,37,20,117.6
171950100,tx,-98.71788,30.31548,6525,27,52,25,92.6
171950200,tx,-99.1681,30.31445,6497,16,37,21,131.3
171950301,tx,-98.98929,30.3665,2767,22,46,24,109.1
171950302,tx,-98.90756,30.41982,4100,23,47,24,104.3
171950401,tx,-98.83932,30.29668,1886,27,52,25,92.6
171950402,tx,-98.82337,30.25259,2168,29,55,26,89.7
171950500,tx,-98.95502,30.21289,3659,24,48,24,100
173950100,tx,-101.5208,31.86946,1916,14,35,21,150
175960100,tx,-97.3121,28.76987,4588,84,111,27,32.1
175960200,tx,-97.47421,28.61005,4692,82,109,27,32.9
177000100,tx,-97.37965,29.65005,3774,64,90,26,40.6
177000200,tx,-97.40734,29.52183,4781,65,91,26,40
177000300,tx,-97.4404,29.51122,1534,66,92,26,39.4
177000400,tx,-97.4569,29.51025,1094,66,92,26,39.4
177000500,tx,-97.71427,29.39057,3245,67,93,26,38.8
177000600,tx,-97.52077,29.31383,3734,70,96,26,37.1
179950100,tx,-100.81064,35.39929,4569,9,22,13,144.4
179950300,tx,-100.95352,35.56248,2272,6,16,10,166.7
179950400,tx,-100.97971,35.55655,2224,6,16,10,166.7
179950500,tx,-100.95668,35.54503,1432,6,16,10,166.7
179950600,tx,-100.94178,35.53687,2022,5,16,11,220
179950700,tx,-100.97879,35.53296,1748,6,16,10,166.7
179950800,tx,-100.96865,35.52413,1762,5,16,11,220
181000101,tx,-96.4473,33.67536,3095,51,75,24,47.1
181000102,tx,-96.45113,33.57915,2249,51,76,25,49
181000200,tx,-96.48374,33.77022,1526,47,72,25,53.2
181000302,tx,-96.66573,33.78052,3689,43,68,25,58.1
181000304,tx,-96.87386,33.80376,5560,48,72,24,50
181000305,tx,-96.76775,33.80751,1788,45,69,24,53.3
181000306,tx,-96.65782,33.86459,2820,45,70,25,55.6
181000400,tx,-96.57871,33.76973,1461,45,70,25,55.6
181000501,tx,-96.53795,33.77143,2009,46,71,25,54.3
181000502,tx,-96.54265,33.75325,1019,46,71,25,54.3
181000600,tx,-96.5157,33.71283,2112,48,73,25,52.1
181000700,tx,-96.54609,33.73723,2231,47,72,25,53.2
181000800,tx,-96.58296,33.74407,2944,45,70,25,55.6
181000901,tx,-96.6129,33.72611,2156,44,69,25,56.8
181000903,tx,-96.5963,33.68215,1212,45,69,24,53.3
181000904,tx,-96.62785,33.68432,1587,44,68,24,54.5
181001101,tx,-96.71025,33.66757,3063,44,68,24,54.5
181001103,tx,-96.9036,33.66139,2467,49,72,23,46.9
181001104,tx,-96.86802,33.65259,2107,48,72,24,50
181001200,tx,-96.62748,33.65145,2312,45,70,25,55.6
181001300,tx,-96.63087,33.63713,1311,46,71,25,54.3
181001400,tx,-96.5703,33.66656,2297,47,71,24,51.1
181001500,tx,-96.58488,33.61993,2652,48,72,24,50
181001700,tx,-96.62481,33.61208,1895,47,71,24,51.1
181001801,tx,-96.57376,33.54453,3499,49,74,25,51
181001802,tx,-96.46055,33.4679,3298,53,77,24,45.3
181001803,tx,-96.58803,33.44401,4115,54,78,24,44.4
181001901,tx,-96.72748,33.50442,4715,50,74,24,48
181001902,tx,-96.8695,33.51616,3562,54,77,23,42.6
181002000,tx,-96.60567,33.63655,2062,46,71,25,54.3
183000201,tx,-94.71092,32.51977,1357,63,89,26,41.3
183000202,tx,-94.71933,32.55644,1235,64,90,26,40.6
183000300,tx,-94.73023,32.52404,2127,64,90,26,40.6
183000401,tx,-94.75155,32.55516,1220,65,90,25,38.5
183000402,tx,-94.74576,32.52028,985,64,90,26,40.6
183000501,tx,-94.76667,32.52436,2082,64,90,26,40.6
183000502,tx,-94.76431,32.50845,1636,64,90,26,40.6
183000601,tx,-94.78218,32.53849,1886,65,90,25,38.5
183000602,tx,-94.77734,32.55089,1353,65,90,25,38.5
183000700,tx,-94.79714,32.52964,2078,65,90,25,38.5
183000800,tx,-94.81481,32.52313,2270,64,90,26,40.6
183000900,tx,-94.78562,32.49273,1704,64,90,26,40.6
183001000,tx,-94.72914,32.50672,1346,64,89,25,39.1
183001100,tx,-94.72192,32.49421,2069,63,89,26,41.3
183001200,tx,-94.71847,32.4783,1664,63,89,26,41.3
183001300,tx,-94.73664,32.47759,1793,63,89,26,41.3
183001400,tx,-94.74386,32.44951,2250,63,89,26,41.3
183001500,tx,-94.71512,32.46233,2240,63,89,26,41.3
183010100,tx,-94.76404,32.60383,3585,64,89,25,39.1
183010201,tx,-94.92058,32.50234,2736,63,89,26,41.3
183010202,tx,-94.89372,32.546,1825,63,89,26,41.3
183010301,tx,-94.82059,32.55083,1982,63,89,26,41.3
183010302,tx,-94.83639,32.50357,2218,63,89,26,41.3
183010401,tx,-94.875,32.42315,1854,60,87,27,45
183010402,tx,-94.93945,32.44005,2752,60,87,27,45
183010501,tx,-94.64211,32.38463,1386,59,85,26,44.1
183010502,tx,-94.75298,32.40181,1712,60,86,26,43.3
183010600,tx,-94.8331,32.39488,2634,59,86,27,45.8
183010700,tx,-94.88109,32.39085,2634,60,86,26,43.3
183980000,tx,-94.71029,32.38242,57,58,85,27,46.6
185180101,tx,-96.04835,30.31498,3417,72,98,26,36.1
185180102,tx,-95.89165,30.29662,6072,72,99,27,37.5
185180201,tx,-96.08275,30.39436,1828,72,98,26,36.1
185180202,tx,-95.93049,30.40918,4965,71,97,26,36.6
185180302,tx,-95.90306,30.68653,3630,70,97,27,38.6
185180303,tx,-96.09902,30.56717,2600,70,97,27,38.6
185180304,tx,-96.02928,30.66494,2864,69,96,27,39.1
185180400,tx,-96.08305,30.28244,34,74,100,26,35.1
187210100,tx,-97.95386,29.58781,1764,64,89,25,39.1
187210200,tx,-97.97568,29.58511,2024,64,89,25,39.1
187210300,tx,-97.97674,29.56499,2093,64,89,25,39.1
187210400,tx,-97.94486,29.56911,1670,64,89,25,39.1
187210505,tx,-97.8993,29.81278,1861,63,88,25,39.7
187210506,tx,-97.8479,29.71811,2605,63,89,26,41.3
187210508,tx,-97.98936,29.70723,1638,62,88,26,41.9
187210509,tx,-98.03214,29.67701,2359,62,88,26,41.9
187210510,tx,-98.05937,29.65775,1551,62,88,26,41.9
187210511,tx,-97.91515,29.64372,1467,63,88,25,39.7
187210512,tx,-97.98918,29.61121,1300,63,88,25,39.7
187210513,tx,-98.02,29.59416,890,63,89,26,41.3
187210603,tx,-98.13523,29.57814,1226,63,88,25,39.7
187210606,tx,-98.06581,29.6099,2016,63,88,25,39.7
187210608,tx,-98.09418,29.63979,3019,62,88,26,41.9
187210609,tx,-98.09893,29.6728,1144,61,87,26,42.6
187210610,tx,-98.10887,29.66513,1774,60,86,26,43.3
187210611,tx,-98.12322,29.65473,2019,60,86,26,43.3
187210612,tx,-98.17005,29.61184,3122,62,87,25,40.3
187210613,tx,-98.22504,29.61472,1858,58,84,26,44.8
187210614,tx,-98.21113,29.62299,1247,57,83,26,45.6
187210705,tx,-98.26108,29.55686,929,63,89,26,41.3
187210706,tx,-98.27752,29.56013,1849,62,88,26,41.9
187210707,tx,-98.29469,29.58031,2590,62,88,26,41.9
187210709,tx,-98.2813,29.59227,1952,62,88,26,41.9
187210710,tx,-98.27014,29.5765,1507,62,88,26,41.9
187210711,tx,-98.26747,29.59907,1240,61,87,26,42.6
187210712,tx,-98.25284,29.58691,1651,61,87,26,42.6
187210713,tx,-98.24547,29.60717,3480,59,85,26,44.1
187210715,tx,-98.25145,29.57114,950,61,87,26,42.6
187210716,tx,-98.25185,29.57824,1161,61,87,26,42.6
187210717,tx,-98.239,29.56429,1061,62,88,26,41.9
187210718,tx,-98.2232,29.57894,2454,62,88,26,41.9
187210803,tx,-98.04039,29.44152,3261,66,91,25,37.9
187210804,tx,-98.12309,29.53034,2938,64,90,26,40.6
187210805,tx,-97.9868,29.51578,1883,63,89,26,41.3
187210806,tx,-97.96927,29.54348,1263,64,90,26,40.6
187210902,tx,-97.89288,29.56097,2556,64,90,26,40.6
187210903,tx,-97.75517,29.60856,1468,65,90,25,38.5
187210904,tx,-97.92549,29.44033,918,61,87,26,42.6
187210905,tx,-97.83319,29.47708,2041,62,88,26,41.9
189950100,tx,-101.69086,34.19966,2733,5,15,10,200
189950200,tx,-101.71724,34.21174,1576,5,15,10,200
189950300,tx,-101.74709,34.19389,2696,5,15,10,200
189950400,tx,-101.72819,34.18586,1571,5,15,10,200
189950500,tx,-101.71241,34.17708,1484,5,15,10,200
189950600,tx,-101.79027,34.1985,2564,4,14,10,250
189950700,tx,-101.934,34.07326,2222,4,13,9,225
189950800,tx,-101.65386,33.93032,1298,5,16,11,220
189950900,tx,-101.91181,33.91061,1950,5,14,9,180
191950500,tx,-100.68113,34.53078,5350,35,57,22,62.9
193950100,tx,-98.02256,31.86593,2684,47,72,25,53.2
193950200,tx,-98.1439,31.64402,3407,40,66,26,65
193950300,tx,-98.11346,31.7091,2413,40,65,25,62.5
195950100,tx,-101.41428,36.33223,1861,10,24,14,140
195950300,tx,-101.24361,36.17575,2737,14,29,15,107.1
197950100,tx,-99.74572,34.29029,5777,49,70,21,42.9
199030100,tx,-94.56447,30.34195,5196,76,101,25,32.9
199030200,tx,-94.4074,30.1574,4818,74,101,27,36.5
199030301,tx,-94.36789,30.43533,4706,77,102,25,32.5
199030302,tx,-94.33455,30.27617,3535,75,101,26,34.7
199030400,tx,-94.31692,30.38271,1602,77,102,25,32.5
199030501,tx,-94.21224,30.29648,1785,75,101,26,34.7
199030503,tx,-94.21268,30.20818,1685,74,100,26,35.1
199030504,tx,-94.20468,30.2569,1968,75,100,25,33.3
199030600,tx,-94.14914,30.21392,1987,73,99,26,35.6
199030700,tx,-94.14391,30.31188,2215,76,101,25,32.9
199030800,tx,-94.21167,30.35145,2893,76,101,25,32.9
199030900,tx,-94.1944,30.39631,2015,76,102,26,34.2
199031000,tx,-94.17631,30.4561,2216,77,102,25,32.5
201100001,tx,-95.36217,29.755,574,64,93,29,45.3
201210400,tx,-95.3622,29.78644,1446,62,92,30,48.4
201210500,tx,-95.36039,29.79525,1850,62,92,30,48.4
201210600,tx,-95.36536,29.80704,2136,62,92,30,48.4
201210700,tx,-95.35352,29.80673,1088,62,92,30,48.4
201210800,tx,-95.34509,29.79438,1588,67,96,29,43.3
201210900,tx,-95.33124,29.80416,886,67,96,29,43.3
201211000,tx,-95.33215,29.79709,966,67,96,29,43.3
201211101,tx,-95.33594,29.78706,1442,67,96,29,43.3
201211102,tx,-95.32752,29.78707,1117,67,96,29,43.3
201211200,tx,-95.32037,29.79817,1130,67,96,29,43.3
201211301,tx,-95.3335,29.77642,1099,68,96,28,41.2
201211302,tx,-95.3231,29.77816,1414,68,96,28,41.2
201211400,tx,-95.32818,29.76586,2730,68,97,29,42.6
201211501,tx,-95.29295,29.76386,1444,71,100,29,40.8
201211502,tx,-95.30318,29.77059,1041,70,99,29,41.4
201211600,tx,-95.31159,29.78092,1067,68,97,29,42.6
201211700,tx,-95.30464,29.80023,1631,68,97,29,42.6
201211900,tx,-95.29951,29.78382,1593,71,100,29,40.8
201212300,tx,-95.35496,29.7752,2273,64,93,29,45.3
201212400,tx,-95.28462,29.78751,1484,71,100,29,40.8
201212500,tx,-95.27957,29.75428,2115,71,100,29,40.8
201220100,tx,-95.34346,29.81516,936,66,95,29,43.9
201220200,tx,-95.36494,29.81656,952,62,91,29,46.8
201220300,tx,-95.36566,29.82424,1240,61,91,30,49.2
201220400,tx,-95.366,29.83303,1368,61,91,30,49.2
201220500,tx,-95.38146,29.83621,919,61,91,30,49.2
201220600,tx,-95.36688,29.84181,928,61,91,30,49.2
201220701,tx,-95.3507,29.84131,798,63,93,30,47.6
201220702,tx,-95.34851,29.82746,1031,64,94,30,46.9
201220800,tx,-95.3387,29.83085,841,65,94,29,44.6
201220900,tx,-95.33764,29.84884,758,65,94,29,44.6
201221000,tx,-95.34467,29.8597,1273,65,94,29,44.6
201221100,tx,-95.35623,29.85987,1240,63,92,29,46
201221200,tx,-95.37403,29.8646,1910,64,93,29,45.3
201221301,tx,-95.37826,29.85246,1391,61,91,30,49.2
201221302,tx,-95.36624,29.85232,962,61,91,30,49.2
201221400,tx,-95.39157,29.85344,1143,62,92,30,48.4
201221501,tx,-95.39296,29.86432,1059,64,93,29,45.3
201221502,tx,-95.40217,29.86722,154,64,93,29,45.3
201221601,tx,-95.40551,29.89265,816,64,93,29,45.3
201221602,tx,-95.39999,29.87898,1841,64,93,29,45.3
201221701,tx,-95.37707,29.87692,1103,64,93,29,45.3
201221702,tx,-95.3817,29.88798,612,64,93,29,45.3
201221800,tx,-95.3611,29.88244,1077,64,93,29,45.3
201221900,tx,-95.3491,29.88187,1481,64,94,30,46.9
201222000,tx,-95.33712,29.86839,743,64,94,30,46.9
201222100,tx,-95.33485,29.87953,1635,64,94,30,46.9
201222200,tx,-95.32366,29.89401,1046,65,94,29,44.6
201222300,tx,-95.3489,29.89624,1143,65,95,30,46.2
201222401,tx,-95.39466,29.90058,1305,67,96,29,43.3
201222402,tx,-95.38846,29.90914,1497,70,99,29,41.4
201222501,tx,-95.40584,29.92831,365,71,99,28,39.4
201222502,tx,-95.38791,29.92388,1142,70,99,29,41.4
201222504,tx,-95.40484,29.92308,25,71,99,28,39.4
201222505,tx,-95.40399,29.92009,828,71,99,28,39.4
201222601,tx,-95.39035,29.93508,51,70,99,29,41.4
201222602,tx,-95.40602,29.93649,69,71,99,28,39.4
201222701,tx,-95.3038,29.93499,300,71,99,28,39.4
201222702,tx,-95.34156,29.93512,452,70,99,29,41.4
201222800,tx,-95.36626,29.91812,1077,70,99,29,41.4
201222900,tx,-95.34482,29.91438,2668,70,99,29,41.4
201223001,tx,-95.31912,29.91233,809,70,99,29,41.4
201223002,tx,-95.3277,29.90677,585,70,99,29,41.4
201223100,tx,-95.32322,29.92528,990,70,99,29,41.4
201230100,tx,-95.33002,29.81406,648,67,96,29,43.3
201230200,tx,-95.30565,29.81955,2587,68,97,29,42.6
201230300,tx,-95.31272,29.83473,1308,66,95,29,43.9
201230400,tx,-95.3252,29.83059,1808,65,94,29,44.6
201230500,tx,-95.32872,29.84855,1593,65,94,29,44.6
201230600,tx,-95.30927,29.84487,1476,68,96,28,41.2
201230700,tx,-95.30993,29.85301,1023,66,95,29,43.9
201230800,tx,-95.29372,29.83983,1290,71,99,28,39.4
201230900,tx,-95.28098,29.81787,3841,71,99,28,39.4
201231000,tx,-95.27707,29.84022,2415,71,99,28,39.4
201231100,tx,-95.25256,29.82896,2155,73,101,28,38.4
201231200,tx,-95.24618,29.86525,2033,74,102,28,37.8
201231300,tx,-95.27166,29.8577,2131,71,99,28,39.4
201231400,tx,-95.28579,29.86483,1462,70,99,29,41.4
201231500,tx,-95.29655,29.85984,976,70,99,29,41.4
201231600,tx,-95.30748,29.86174,1250,68,97,29,42.6
201231700,tx,-95.31986,29.87612,1639,64,94,30,46.9
201231800,tx,-95.30647,29.87711,1198,68,97,29,42.6
201231900,tx,-95.27895,29.88244,2453,70,99,29,41.4
201232000,tx,-95.27038,29.9043,1409,71,100,29,40.8
201232100,tx,-95.30628,29.90532,1436,70,99,29,41.4
201232201,tx,-95.29018,29.92959,1471,71,100,29,40.8
201232202,tx,-95.27341,29.9246,1890,72,100,28,38.9
201232203,tx,-95.23599,29.92453,1335,74,102,28,37.8
201232303,tx,-95.21767,29.90282,2007,76,103,27,35.5
201232304,tx,-95.22231,29.85871,2179,74,102,28,37.8
201232305,tx,-95.20016,29.867,3567,75,103,28,37.3
201232306,tx,-95.20139,29.84446,1252,73,102,29,39.7
201232402,tx,-95.18798,29.81184,910,70,100,30,42.9
201232403,tx,-95.20219,29.81127,1115,70,100,30,42.9
201232404,tx,-95.19285,29.83326,1469,73,102,29,39.7
201232405,tx,-95.19586,29.81966,1766,71,100,29,40.8
201232500,tx,-95.24581,29.80558,1537,73,101,28,38.4
201232600,tx,-95.24943,29.78318,1147,73,101,28,38.4
201232701,tx,-95.22783,29.78865,918,72,101,29,40.3
201232703,tx,-95.22173,29.77326,119,70,99,29,41.4
201232704,tx,-95.21152,29.78711,699,70,99,29,41.4
201232801,tx,-95.19881,29.78775,365,70,100,30,42.9
201232802,tx,-95.2083,29.78464,489,70,100,30,42.9
201232901,tx,-95.19964,29.8002,685,70,100,30,42.9
201232902,tx,-95.1872,29.80039,635,70,100,30,42.9
201233001,tx,-95.18256,29.79715,649,67,97,30,44.8
201233002,tx,-95.17018,29.80172,1275,67,97,30,44.8
201233003,tx,-95.17075,29.79367,836,67,97,30,44.8
201233101,tx,-95.17933,29.78753,1044,67,97,30,44.8
201233103,tx,-95.17627,29.77646,1190,66,97,31,47
201233104,tx,-95.16627,29.7766,685,66,97,31,47
201233105,tx,-95.16246,29.78173,859,67,97,30,44.8
201233200,tx,-95.19214,29.77969,2115,70,100,30,42.9
201233300,tx,-95.1997,29.75494,1537,68,98,30,44.1
201233400,tx,-95.24644,29.77073,819,70,100,30,42.9
201233501,tx,-95.23327,29.76423,1131,70,100,30,42.9
201233502,tx,-95.24588,29.76255,1014,70,100,30,42.9
201233600,tx,-95.2595,29.75093,1970,70,100,30,42.9
201233701,tx,-95.24746,29.73569,1733,70,100,30,42.9
201233702,tx,-95.23789,29.74739,812,70,100,30,42.9
201233703,tx,-95.22239,29.74276,877,69,99,30,43.5
201240101,tx,-95.3917,29.94279,89,73,101,28,38.4
201240102,tx,-95.41032,29.94763,249,74,102,28,37.8
201240400,tx,-95.38081,29.98686,2709,75,102,27,36
201240503,tx,-95.38895,29.94972,5,74,102,28,37.8
201240504,tx,-95.39357,29.94781,181,74,102,28,37.8
201240505,tx,-95.39442,29.95205,13,74,102,28,37.8
201240506,tx,-95.39078,29.9596,408,74,102,28,37.8
201240600,tx,-95.40822,29.95838,157,74,102,28,37.8
201240703,tx,-95.41269,30.00076,1238,74,102,28,37.8
201240704,tx,-95.42183,30.01295,1156,74,102,28,37.8
201240705,tx,-95.40979,30.01472,1667,74,102,28,37.8
201240706,tx,-95.39892,29.97966,2856,74,102,28,37.8
201240707,tx,-95.41501,29.98129,2002,74,102,28,37.8
201240802,tx,-95.36552,30.02526,2858,76,103,27,35.5
201240803,tx,-95.41532,30.03092,523,75,102,27,36
201240804,tx,-95.42532,30.02741,32,75,102,27,36
201240903,tx,-95.2962,30.02329,2112,75,102,27,36
201240904,tx,-95.28089,30.01638,2759,75,102,27,36
201240905,tx,-95.31738,30.01171,999,76,103,27,35.5
201240906,tx,-95.31781,30.02399,2703,76,103,27,35.5
201241001,tx,-95.34556,30.03602,1537,76,104,28,36.8
201241002,tx,-95.33924,30.05449,1520,76,103,27,35.5
201241101,tx,-95.38912,30.06246,1636,76,103,27,35.5
201241103,tx,-95.37947,30.04771,1464,76,103,27,35.5
201241104,tx,-95.36492,30.05557,3420,76,103,27,35.5
201241105,tx,-95.36528,30.04392,1608,76,103,27,35.5
201241201,tx,-95.3917,30.04197,985,75,102,27,36
201241202,tx,-95.40066,30.05016,1671,75,102,27,36
201241301,tx,-95.42493,30.08491,2431,75,102,27,36
201241302,tx,-95.41898,30.05381,2643,75,102,27,36
201241400,tx,-95.40076,30.08411,3365,75,102,27,36
201241501,tx,-95.29171,29.98293,1719,74,102,28,37.8
201241502,tx,-95.2984,29.94665,361,73,101,28,38.4
201241503,tx,-95.33504,29.95362,1544,74,102,28,37.8
201250101,tx,-95.27715,29.961,1597,73,101,28,38.4
201250102,tx,-95.24723,29.97097,1533,74,102,28,37.8
201250201,tx,-95.2575,29.94778,2064,74,102,28,37.8
201250202,tx,-95.27231,29.94546,541,73,101,28,38.4
201250303,tx,-95.24295,29.94141,889,74,102,28,37.8
201250304,tx,-95.2303,29.95461,2881,75,103,28,37.3
201250305,tx,-95.2101,29.97581,1852,76,103,27,35.5
201250306,tx,-95.20943,29.96749,1378,76,103,27,35.5
201250403,tx,-95.14016,29.99992,1264,77,104,27,35.1
201250404,tx,-95.15171,29.98957,1824,77,104,27,35.1
201250405,tx,-95.1693,29.98881,2461,77,104,27,35.1
201250406,tx,-95.18668,29.98497,1684,76,103,27,35.5
201250407,tx,-95.19065,29.97075,3402,77,104,27,35.1
201250408,tx,-95.19473,29.95551,4732,77,104,27,35.1
201250500,tx,-95.19617,29.99312,2545,74,102,28,37.8
201250601,tx,-95.26422,29.99309,836,74,101,27,36.5
201250602,tx,-95.23591,29.98921,1723,73,101,28,38.4
201250701,tx,-95.22293,30.01236,3621,74,102,28,37.8
201250702,tx,-95.1784,30.00326,1797,76,103,27,35.5
201250801,tx,-95.15036,30.01143,1487,77,104,27,35.1
201250802,tx,-95.16339,30.02162,1645,77,104,27,35.1
201250901,tx,-95.16827,30.04239,984,75,103,28,37.3
201250902,tx,-95.14359,30.04542,2152,75,103,28,37.3
201251000,tx,-95.19597,30.03516,916,74,102,28,37.8
201251100,tx,-95.23549,30.03504,3428,74,101,27,36.5
201251200,tx,-95.22273,30.05765,2161,74,101,27,36.5
201251300,tx,-95.1998,30.0561,2667,74,101,27,36.5
201251401,tx,-95.19124,30.08088,1019,75,102,27,36
201251402,tx,-95.20131,30.07321,2104,75,102,27,36
201251501,tx,-95.16025,30.09934,3090,76,102,26,34.2
201251503,tx,-95.18506,30.07363,819,75,102,27,36
201251504,tx,-95.17529,30.06587,1967,75,102,27,36
201251505,tx,-95.17198,30.05681,1433,75,103,28,37.3
201251600,tx,-95.11344,30.10136,4311,77,103,26,33.8
201251701,tx,-95.10807,30.03432,2347,78,104,26,33.3
201251702,tx,-95.07657,30.02308,2363,80,105,25,31.3
201251800,tx,-95.03295,29.96263,1135,80,105,25,31.3
201251902,tx,-95.09619,29.90811,3358,76,103,27,35.5
201251903,tx,-95.10552,29.96509,2486,80,105,25,31.3
201251904,tx,-95.10584,29.9354,2730,77,104,27,35.1
201252001,tx,-95.18586,29.94025,2154,78,105,27,34.6
201252002,tx,-95.17907,29.89141,2012,76,104,28,36.8
201252003,tx,-95.15502,29.9468,4242,78,105,27,34.6
201252100,tx,-95.13592,29.8857,1593,71,100,29,40.8
201252201,tx,-95.16396,29.82657,838,70,99,29,41.4
201252202,tx,-95.14833,29.83917,2362,69,98,29,42
201252303,tx,-95.14683,29.79368,1437,67,97,30,44.8
201252304,tx,-95.15848,29.79815,929,67,97,30,44.8
201252305,tx,-95.14974,29.80586,2279,67,97,30,44.8
201252306,tx,-95.13321,29.80367,2514,64,94,30,46.9
201252400,tx,-95.14286,29.78184,2151,65,96,31,47.7
201252500,tx,-95.12521,29.76255,1853,64,94,30,46.9
201252601,tx,-95.11596,29.79112,807,64,94,30,46.9
201252602,tx,-95.10343,29.83102,2069,65,95,30,46.2
201252700,tx,-95.0272,29.91566,2203,74,101,27,36.5
201252800,tx,-95.0332,29.862,4396,69,98,29,42
201252901,tx,-95.07162,29.81209,1271,66,96,30,45.5
201252902,tx,-95.04653,29.81404,2503,69,98,29,42
201253000,tx,-95.01942,29.82263,1896,70,98,28,40
201253101,tx,-94.99118,29.81177,1993,72,100,28,38.9
201253102,tx,-94.96067,29.82772,2574,71,99,28,39.4
201253201,tx,-94.93439,29.79484,2658,77,104,27,35.1
201253202,tx,-94.99136,29.7916,1400,73,100,27,37
201253300,tx,-95.05229,29.7637,2091,66,96,30,45.5
201253501,tx,-94.98968,29.77535,1190,72,100,28,38.9
201253502,tx,-95.01521,29.77908,886,72,100,28,38.9
201253601,tx,-94.99336,29.76603,1196,71,99,28,39.4
201253602,tx,-94.98805,29.75565,269,71,99,28,39.4
201253700,tx,-94.97088,29.76358,1249,75,102,27,36
201253800,tx,-94.94824,29.76636,2442,76,103,27,35.5
201253900,tx,-94.93471,29.75093,1109,76,103,27,35.5
201254000,tx,-94.94275,29.73495,934,74,101,27,36.5
201254100,tx,-94.95588,29.74636,1767,76,102,26,34.2
201254200,tx,-94.9645,29.72872,1130,70,99,29,41.4
201254300,tx,-94.97335,29.74223,1791,75,102,27,36
201254400,tx,-94.97582,29.72617,1411,66,95,29,43.9
201254600,tx,-94.99991,29.717,1335,63,93,30,47.6
201254700,tx,-94.9597,29.69988,1260,69,98,29,42
201254800,tx,-95.01311,29.74686,1489,66,95,29,43.9
201310101,tx,-95.34349,29.75204,1680,68,97,29,42.6
201310102,tx,-95.34307,29.75919,824,68,97,29,42.6
201310200,tx,-95.35113,29.74347,1690,65,94,29,44.6
201310300,tx,-95.33597,29.73646,1596,68,97,29,42.6
201310400,tx,-95.32952,29.751,1216,68,97,29,42.6
201310500,tx,-95.31642,29.74739,1438,68,97,29,42.6
201310600,tx,-95.32482,29.73254,1624,67,96,29,43.3
201310700,tx,-95.31607,29.7211,1024,66,96,30,45.5
201310800,tx,-95.31074,29.73024,610,67,96,29,43.3
201310900,tx,-95.30133,29.73579,1573,70,99,29,41.4
201311001,tx,-95.30383,29.74598,1002,71,100,29,40.8
201311002,tx,-95.29501,29.74466,1383,71,100,29,40.8
201311100,tx,-95.28518,29.7332,2052,70,99,29,41.4
201311200,tx,-95.29903,29.7193,1184,68,98,30,44.1
201311300,tx,-95.29457,29.70973,1508,68,98,30,44.1
201311400,tx,-95.27498,29.71929,810,68,98,30,44.1
201311501,tx,-95.28683,29.70524,705,68,98,30,44.1
201311502,tx,-95.27956,29.70996,908,68,98,30,44.1
201311600,tx,-95.28617,29.70111,20,68,98,30,44.1
201311701,tx,-95.31282,29.69921,654,67,97,30,44.8
201311702,tx,-95.29905,29.70106,153,68,98,30,44.1
201311800,tx,-95.3211,29.70594,1003,66,96,30,45.5
201311900,tx,-95.32544,29.71692,842,66,96,30,45.5
201312000,tx,-95.34423,29.71714,638,65,95,30,46.2
201312200,tx,-95.34976,29.73211,1207,65,95,30,46.2
201312300,tx,-95.36037,29.73773,1676,64,93,29,45.3
201312400,tx,-95.36101,29.7299,1276,64,93,29,45.3
201312501,tx,-95.36996,29.7431,1143,64,93,29,45.3
201312502,tx,-95.37643,29.73616,611,64,93,29,45.3
201312601,tx,-95.3846,29.72179,154,64,94,30,46.9
201312602,tx,-95.38305,29.7258,709,64,94,30,46.9
201312603,tx,-95.37845,29.72678,945,64,94,30,46.9
201312700,tx,-95.36821,29.72676,919,64,94,30,46.9
201312800,tx,-95.35794,29.72196,328,64,94,30,46.9
201312901,tx,-95.35789,29.71388,190,64,94,30,46.9
201312902,tx,-95.36522,29.71477,718,64,94,30,46.9
201313000,tx,-95.37345,29.71907,929,64,94,30,46.9
201313101,tx,-95.37981,29.70718,303,64,94,30,46.9
201313102,tx,-95.39229,29.71168,312,63,93,30,47.6
201313201,tx,-95.35057,29.70641,619,65,95,30,46.2
201313202,tx,-95.36857,29.70717,950,64,94,30,46.9
201313300,tx,-95.33595,29.70448,1168,66,96,30,45.5
201313400,tx,-95.33819,29.69419,1049,66,96,30,45.5
201313500,tx,-95.34789,29.68871,1278,65,94,29,44.6
201313600,tx,-95.35757,29.69165,2031,64,94,30,46.9
201313700,tx,-95.36655,29.69754,1114,64,94,30,46.9
201313801,tx,-95.36953,29.68873,827,64,94,30,46.9
201313802,tx,-95.37475,29.68751,780,64,94,30,46.9
201313901,tx,-95.38318,29.69453,498,64,94,30,46.9
201313902,tx,-95.3863,29.6832,26,64,94,30,46.9
201314001,tx,-95.39239,29.69893,237,63,93,30,47.6
201314003,tx,-95.39781,29.69193,45,64,94,30,46.9
201314004,tx,-95.39762,29.6872,3,65,95,30,46.2
201314005,tx,-95.39702,29.68366,321,65,95,30,46.2
201314301,tx,-95.4158,29.68003,13,65,95,30,46.2
201314302,tx,-95.41822,29.68474,69,64,94,30,46.9
201314401,tx,-95.40345,29.69704,25,62,92,30,48.4
201314402,tx,-95.40819,29.68819,41,63,93,30,47.6
201320100,tx,-95.28127,29.69467,438,68,97,29,42.6
201320201,tx,-95.26767,29.70103,476,68,98,30,44.1
201320202,tx,-95.27082,29.68953,651,67,97,30,44.8
201320500,tx,-95.24531,29.69876,1391,67,97,30,44.8
201320601,tx,-95.26222,29.68406,600,66,96,30,45.5
201320602,tx,-95.25846,29.678,994,66,96,30,45.5
201320700,tx,-95.25065,29.67048,921,66,96,30,45.5
201320800,tx,-95.241,29.65981,2072,66,96,30,45.5
201320901,tx,-95.24376,29.64777,637,65,95,30,46.2
201320902,tx,-95.23123,29.64877,1119,65,95,30,46.2
201321001,tx,-95.22863,29.63335,442,65,95,30,46.2
201321002,tx,-95.2257,29.64003,1584,65,95,30,46.2
201321101,tx,-95.20585,29.61656,780,67,97,30,44.8
201321102,tx,-95.21312,29.62748,1443,66,97,31,47
201321200,tx,-95.20139,29.6366,280,67,97,30,44.8
201321301,tx,-95.21907,29.64943,68,67,97,30,44.8
201321302,tx,-95.21172,29.64471,448,67,97,30,44.8
201321401,tx,-95.2267,29.66552,1529,66,96,30,45.5
201321402,tx,-95.21977,29.65664,1206,66,97,31,47
201321500,tx,-95.21188,29.66505,328,67,97,30,44.8
201321600,tx,-95.21963,29.67721,1879,66,97,31,47
201321700,tx,-95.23557,29.67798,1061,66,96,30,45.5
201321800,tx,-95.23873,29.68788,1071,66,96,30,45.5
201321900,tx,-95.22486,29.69577,1779,67,97,30,44.8
201322000,tx,-95.21812,29.70116,92,67,97,30,44.8
201322100,tx,-95.21042,29.69004,1305,67,97,30,44.8
201322200,tx,-95.21287,29.70441,539,67,97,30,44.8
201322600,tx,-95.15777,29.69906,1554,64,95,31,48.4
201322701,tx,-95.16625,29.69505,753,65,95,30,46.2
201322702,tx,-95.16681,29.70603,1168,65,96,31,47.7
201322800,tx,-95.18107,29.70613,1898,65,96,31,47.7
201322900,tx,-95.19431,29.70347,1162,67,97,30,44.8
201323000,tx,-95.19199,29.6949,524,67,97,30,44.8
201323100,tx,-95.16937,29.68844,582,64,95,31,48.4
201323200,tx,-95.18292,29.68691,1553,65,96,31,47.7
201323300,tx,-95.20113,29.68716,658,67,97,30,44.8
201323400,tx,-95.19956,29.67661,1537,67,97,30,44.8
201323500,tx,-95.20179,29.66343,619,67,97,30,44.8
201323601,tx,-95.19412,29.65175,645,67,97,30,44.8
201323602,tx,-95.18675,29.64003,1763,66,96,30,45.5
201323701,tx,-95.17877,29.65775,755,64,95,31,48.4
201323702,tx,-95.17662,29.64532,680,60,91,31,51.7
201323801,tx,-95.18919,29.67438,1276,67,97,30,44.8
201323802,tx,-95.1791,29.67324,1019,64,95,31,48.4
201323900,tx,-95.1642,29.67352,761,63,94,31,49.2
201324000,tx,-95.17201,29.64186,2176,62,93,31,50
201324101,tx,-95.20999,29.71008,1866,67,97,30,44.8
201324102,tx,-95.18004,29.72785,166,66,97,31,47
201324200,tx,-95.24548,29.71585,807,67,98,31,46.3
201330101,tx,-95.42588,29.63474,1567,66,96,30,45.5
201330102,tx,-95.41651,29.63477,896,66,96,30,45.5
201330200,tx,-95.45469,29.63907,1261,70,99,29,41.4
201330301,tx,-95.47217,29.63613,2215,71,100,29,40.8
201330302,tx,-95.47656,29.61578,2259,71,100,29,40.8
201330303,tx,-95.49761,29.62664,1127,72,101,29,40.3
201330400,tx,-95.45551,29.61669,1680,70,99,29,41.4
201330500,tx,-95.43061,29.62371,1662,68,97,29,42.6
201330600,tx,-95.43297,29.61307,2481,68,98,30,44.1
201330700,tx,-95.44216,29.59821,2267,71,100,29,40.8
201330801,tx,-95.32865,29.60715,2061,62,92,30,48.4
201330802,tx,-95.38708,29.59539,3739,64,94,30,46.9
201330901,tx,-95.39981,29.62142,3013,66,96,30,45.5
201330902,tx,-95.4048,29.60635,708,67,97,30,44.8
201331100,tx,-95.36912,29.67496,2408,64,94,30,46.9
201331200,tx,-95.37052,29.66352,1989,64,94,30,46.9
201331300,tx,-95.37917,29.6462,2428,64,94,30,46.9
201331400,tx,-95.36238,29.65261,186,64,94,30,46.9
201331501,tx,-95.35971,29.6342,1706,63,93,30,47.6
201331502,tx,-95.37206,29.62499,2174,63,93,30,47.6
201331602,tx,-95.32289,29.62928,1526,61,92,31,50.8
201331603,tx,-95.34995,29.62677,1694,62,92,30,48.4
201331604,tx,-95.34405,29.63202,659,61,92,31,50.8
201331700,tx,-95.33245,29.64342,1741,62,92,30,48.4
201331800,tx,-95.34546,29.65268,1674,63,93,30,47.6
201331900,tx,-95.34669,29.66267,1477,64,94,30,46.9
201332000,tx,-95.34681,29.67244,1800,64,94,30,46.9
201332100,tx,-95.34439,29.68038,1117,64,94,30,46.9
201332200,tx,-95.32992,29.68057,1848,64,94,30,46.9
201332300,tx,-95.32336,29.66656,1062,64,94,30,46.9
201332400,tx,-95.32874,29.65811,1621,63,94,31,49.2
201332500,tx,-95.3077,29.66484,1339,64,95,31,48.4
201332600,tx,-95.30685,29.67501,1877,65,95,30,46.2
201332700,tx,-95.3138,29.68507,1627,64,94,30,46.9
201332800,tx,-95.30745,29.69159,901,66,96,30,45.5
201332900,tx,-95.29047,29.69042,1160,66,96,30,45.5
201333000,tx,-95.2849,29.68157,1009,65,96,31,47.7
201333100,tx,-95.27858,29.6756,586,65,96,31,47.7
201333201,tx,-95.26995,29.6694,683,65,96,31,47.7
201333203,tx,-95.26306,29.65979,598,65,96,31,47.7
201333204,tx,-95.27455,29.65968,6,65,96,31,47.7
201333205,tx,-95.275,29.66304,33,65,96,31,47.7
201333301,tx,-95.24062,29.63215,368,64,95,31,48.4
201333302,tx,-95.25689,29.63968,1408,64,95,31,48.4
201333501,tx,-95.28128,29.66325,487,65,96,31,47.7
201333502,tx,-95.28479,29.66701,472,65,96,31,47.7
201333600,tx,-95.29987,29.65942,1146,65,95,30,46.2
201333700,tx,-95.29311,29.63562,1450,62,93,31,50
201333801,tx,-95.28992,29.61247,823,62,93,31,50
201333802,tx,-95.27395,29.61195,1988,62,93,31,50
201333903,tx,-95.23451,29.62037,852,64,95,31,48.4
201333904,tx,-95.24529,29.61551,1139,63,94,31,49.2
201333905,tx,-95.25803,29.61918,1336,64,95,31,48.4
201333906,tx,-95.25805,29.60567,1491,62,93,31,50
201334001,tx,-95.22625,29.61554,468,65,95,30,46.2
201334002,tx,-95.21432,29.60841,172,65,96,31,47.7
201334003,tx,-95.23047,29.60549,1605,62,93,31,50
201334101,tx,-95.40444,29.6578,2054,66,96,30,45.5
201334102,tx,-95.42511,29.6492,2703,68,98,30,44.1
201340101,tx,-95.17155,29.58442,104,55,87,32,58.2
201340102,tx,-95.18996,29.60197,1328,61,92,31,50.8
201340201,tx,-95.16687,29.60961,48,60,91,31,51.7
201340202,tx,-95.14101,29.61242,3091,54,86,32,59.3
201340203,tx,-95.10069,29.60827,1474,55,87,32,58.2
201340301,tx,-95.12648,29.59149,1590,51,84,33,64.7
201340302,tx,-95.11284,29.596,2530,51,84,33,64.7
201340400,tx,-95.11254,29.57976,587,51,84,33,64.7
201340501,tx,-95.12069,29.56941,1180,50,83,33,66
201340502,tx,-95.12031,29.56088,270,49,82,33,67.3
201340600,tx,-95.13125,29.57586,999,51,84,33,64.7
201340701,tx,-95.13053,29.55841,1282,49,82,33,67.3
201340702,tx,-95.14061,29.56919,940,52,85,33,63.5
201340800,tx,-95.14382,29.58149,2136,53,85,32,60.4
201340900,tx,-95.15534,29.56633,467,50,83,33,66
201341001,tx,-95.13649,29.55201,329,49,82,33,67.3
201341002,tx,-95.14451,29.55034,718,49,82,33,67.3
201341101,tx,-95.12971,29.53874,477,49,82,33,67.3
201341102,tx,-95.11782,29.54675,158,49,82,33,67.3
201341201,tx,-95.11099,29.52686,830,49,82,33,67.3
201341203,tx,-95.09694,29.54231,559,60,92,32,53.3
201341204,tx,-95.08278,29.54618,943,61,93,32,52.5
201341302,tx,-95.10741,29.55316,210,49,82,33,67.3
201341303,tx,-95.10873,29.56514,925,50,83,33,66
201341304,tx,-95.08809,29.56937,195,57,89,32,56.1
201341400,tx,-95.06342,29.5883,2136,58,91,33,56.9
201341501,tx,-95.04069,29.57743,1926,60,91,31,51.7
201341502,tx,-95.03603,29.56193,1090,62,94,32,51.6
201341600,tx,-95.0147,29.59238,3340,61,91,30,49.2
201341700,tx,-95.01177,29.6231,1402,58,88,30,51.7
201341800,tx,-95.02554,29.63117,950,60,92,32,53.3
201342001,tx,-95.129,29.64107,2499,57,88,31,54.4
201342002,tx,-95.15278,29.63894,1095,60,91,31,51.7
201342100,tx,-95.1421,29.65698,1507,62,93,31,50
201342200,tx,-95.14647,29.67192,1240,62,93,31,50
201342300,tx,-95.13123,29.67371,1323,60,91,31,51.7
201342400,tx,-95.14846,29.69477,976,63,94,31,49.2
201342500,tx,-95.13361,29.69674,2334,62,93,31,50
201342700,tx,-95.11857,29.69531,1740,62,93,31,50
201342801,tx,-95.10297,29.68475,1659,59,91,32,54.2
201342802,tx,-95.1007,29.69724,1495,62,93,31,50
201342900,tx,-95.10525,29.67175,2603,60,91,31,51.7
201343000,tx,-95.10716,29.65755,2056,59,91,32,54.2
201343100,tx,-95.07933,29.65827,1520,59,91,32,54.2
201343200,tx,-95.05536,29.65812,1953,58,90,32,55.2
201343301,tx,-95.0652,29.68478,1805,59,91,32,54.2
201343302,tx,-95.06681,29.66985,1795,58,90,32,55.2
201343601,tx,-95.06735,29.71684,571,61,92,31,50.8
201343602,tx,-95.00712,29.66472,2025,58,89,31,53.4
201343700,tx,-95.06055,29.63773,2631,58,90,32,55.2
201350101,tx,-95.20796,29.56966,1492,60,92,32,53.3
201350102,tx,-95.23146,29.56458,1997,58,90,32,55.2
201350103,tx,-95.24626,29.57324,2766,61,92,31,50.8
201350104,tx,-95.25877,29.592,1081,62,92,30,48.4
201350201,tx,-95.2257,29.59474,1065,61,92,31,50.8
201350202,tx,-95.23838,29.5954,1591,62,92,30,48.4
201350300,tx,-95.22486,29.58288,2083,61,92,31,50.8
201350400,tx,-95.21006,29.59582,1575,61,92,31,50.8
201350500,tx,-95.1958,29.58221,2080,61,92,31,50.8
201350601,tx,-95.17263,29.55459,1543,50,83,33,66
201350603,tx,-95.17155,29.53458,1544,50,83,33,66
201350604,tx,-95.18437,29.54148,1035,52,85,33,63.5
201350700,tx,-95.18699,29.53397,932,53,86,33,62.3
201350801,tx,-95.17445,29.5246,1417,49,82,33,67.3
201350803,tx,-95.14804,29.53053,699,49,83,34,69.4
201350804,tx,-95.14795,29.51344,1589,49,81,32,65.3
201410101,tx,-95.38216,29.7549,755,64,93,29,45.3
201410102,tx,-95.37919,29.75855,464,64,93,29,45.3
201410201,tx,-95.39227,29.75991,186,64,93,29,45.3
201410202,tx,-95.39187,29.75501,1151,63,92,29,46
201410300,tx,-95.40371,29.75674,526,62,91,29,46.8
201410401,tx,-95.40639,29.74751,1618,62,91,29,46.8
201410402,tx,-95.39872,29.7475,1143,62,91,29,46.8
201410501,tx,-95.39236,29.7491,894,62,92,30,48.4
201410502,tx,-95.38508,29.7491,1039,64,93,29,45.3
201410601,tx,-95.37777,29.74453,172,64,93,29,45.3
201410602,tx,-95.37789,29.74938,291,64,93,29,45.3
201410703,tx,-95.39371,29.74139,589,62,92,30,48.4
201410704,tx,-95.38543,29.74224,564,64,93,29,45.3
201410705,tx,-95.39408,29.7366,361,62,92,30,48.4
201410706,tx,-95.38501,29.7362,268,64,93,29,45.3
201410801,tx,-95.40499,29.73646,681,62,91,29,46.8
201410802,tx,-95.40503,29.74068,490,62,91,29,46.8
201410900,tx,-95.39934,29.73295,865,62,92,30,48.4
201411001,tx,-95.42437,29.74028,163,62,91,29,46.8
201411002,tx,-95.4147,29.7405,317,62,91,29,46.8
201411003,tx,-95.41469,29.73469,511,62,91,29,46.8
201411100,tx,-95.41407,29.75039,1088,62,91,29,46.8
201411200,tx,-95.43117,29.75309,661,62,92,30,48.4
201411301,tx,-95.45236,29.7522,343,62,92,30,48.4
201411302,tx,-95.45305,29.74398,191,62,92,30,48.4
201411400,tx,-95.43308,29.74464,988,62,92,30,48.4
201411503,tx,-95.42407,29.73459,504,62,92,30,48.4
201411504,tx,-95.43295,29.73539,210,62,92,30,48.4
201411505,tx,-95.44474,29.73557,563,62,92,30,48.4
201411506,tx,-95.43946,29.73307,25,65,94,29,44.6
201411507,tx,-95.4385,29.73817,162,62,92,30,48.4
201411600,tx,-95.45374,29.73548,1072,63,92,29,46
201411700,tx,-95.45435,29.72549,39,65,95,30,46.2
201411801,tx,-95.43802,29.72643,695,65,95,30,46.2
201411802,tx,-95.41877,29.72819,525,62,92,30,48.4
201411901,tx,-95.40185,29.72891,830,62,92,30,48.4
201411902,tx,-95.39296,29.7266,445,63,93,30,47.6
201412000,tx,-95.41071,29.72154,1340,62,92,30,48.4
201412201,tx,-95.40825,29.70925,765,62,92,30,48.4
201412202,tx,-95.41295,29.70539,1058,62,92,30,48.4
201412300,tx,-95.42418,29.71575,2594,62,92,30,48.4
201412400,tx,-95.43527,29.71619,1675,64,94,30,46.9
201412500,tx,-95.43671,29.70894,567,65,95,30,46.2
201412600,tx,-95.44451,29.71483,1410,65,95,30,46.2
201412700,tx,-95.45367,29.7135,1328,65,95,30,46.2
201412800,tx,-95.45318,29.69791,1790,66,95,29,43.9
201412901,tx,-95.45423,29.68635,35,68,97,29,42.6
201412902,tx,-95.44616,29.68366,659,68,97,29,42.6
201413000,tx,-95.44238,29.69729,1026,66,95,29,43.9
201413100,tx,-95.43234,29.69856,1165,63,93,30,47.6
201413203,tx,-95.42524,29.70348,65,62,92,30,48.4
201413204,tx,-95.42426,29.69839,46,62,92,30,48.4
201413205,tx,-95.42057,29.70316,148,62,92,30,48.4
201413206,tx,-95.41925,29.69883,107,62,92,30,48.4
201413301,tx,-95.42192,29.69086,821,64,94,30,46.9
201413302,tx,-95.43299,29.68529,1323,66,96,30,45.5
201420100,tx,-95.43574,29.67342,505,68,97,29,42.6
201420200,tx,-95.44344,29.66799,958,68,97,29,42.6
201420300,tx,-95.45419,29.67155,1092,68,97,29,42.6
201420400,tx,-95.4559,29.65751,1517,68,97,29,42.6
201420500,tx,-95.47282,29.64991,281,71,100,29,40.8
201420600,tx,-95.47013,29.6611,719,69,98,29,42
201420700,tx,-95.46948,29.67202,1276,69,98,29,42
201420800,tx,-95.46846,29.68438,1033,69,98,29,42
201420900,tx,-95.47016,29.69717,2380,66,95,29,43.9
201421000,tx,-95.46543,29.71324,1189,65,95,30,46.2
201421101,tx,-95.47008,29.72228,172,66,95,29,43.9
201421103,tx,-95.48064,29.71829,25,67,97,30,44.8
201421104,tx,-95.48053,29.723,36,67,97,30,44.8
201421203,tx,-95.4871,29.72398,7,67,97,30,44.8
201421204,tx,-95.48952,29.72145,10,67,97,30,44.8
201421205,tx,-95.49372,29.7181,32,67,97,30,44.8
201421206,tx,-95.4869,29.71822,12,67,97,30,44.8
201421301,tx,-95.49501,29.70871,27,67,97,30,44.8
201421302,tx,-95.50267,29.70921,126,67,97,30,44.8
201421401,tx,-95.49251,29.71444,22,67,97,30,44.8
201421402,tx,-95.48686,29.71459,6,67,97,30,44.8
201421403,tx,-95.4889,29.70912,269,67,97,30,44.8
201421501,tx,-95.47586,29.71085,301,66,95,29,43.9
201421502,tx,-95.48056,29.71284,98,67,97,30,44.8
201421601,tx,-95.49003,29.70094,117,67,97,30,44.8
201421602,tx,-95.48042,29.70212,372,67,96,29,43.3
201421700,tx,-95.48833,29.68654,1201,70,99,29,41.4
201421801,tx,-95.4801,29.67879,20,70,99,29,41.4
201421802,tx,-95.48086,29.68566,684,70,99,29,41.4
201421900,tx,-95.48485,29.67151,1192,70,99,29,41.4
201422000,tx,-95.48466,29.662,1050,70,99,29,41.4
201422100,tx,-95.48708,29.64827,1752,72,100,28,38.9
201422200,tx,-95.50133,29.63873,328,72,101,29,40.3
201422302,tx,-95.49713,29.64903,731,71,100,29,40.8
201422303,tx,-95.5058,29.64777,187,72,100,28,38.9
201422304,tx,-95.50364,29.65109,725,71,100,29,40.8
201422403,tx,-95.4967,29.66177,683,70,99,29,41.4
201422404,tx,-95.49706,29.65497,244,70,99,29,41.4
201422405,tx,-95.50703,29.65949,14,70,99,29,41.4
201422406,tx,-95.50406,29.662,467,70,99,29,41.4
201422501,tx,-95.50102,29.67479,318,70,99,29,41.4
201422502,tx,-95.49971,29.66949,543,70,99,29,41.4
201422601,tx,-95.50303,29.6813,734,70,99,29,41.4
201422602,tx,-95.49773,29.68707,999,70,99,29,41.4
201422701,tx,-95.49997,29.69738,1163,68,97,29,42.6
201422702,tx,-95.50937,29.69899,1125,67,97,30,44.8
201422800,tx,-95.51779,29.69003,631,72,100,28,38.9
201422900,tx,-95.53015,29.68243,815,72,101,29,40.3
201423001,tx,-95.51124,29.67923,88,70,99,29,41.4
201423002,tx,-95.51987,29.67748,231,71,99,28,39.4
201423100,tx,-95.54414,29.66925,247,72,101,29,40.3
201423201,tx,-95.54412,29.66094,992,72,101,29,40.3
201423203,tx,-95.53218,29.66088,520,72,101,29,40.3
201423204,tx,-95.53202,29.66907,92,72,101,29,40.3
201423301,tx,-95.51746,29.66961,923,71,100,29,40.8
201423303,tx,-95.51088,29.66014,128,70,99,29,41.4
201423304,tx,-95.52035,29.66075,928,72,100,28,38.9
201423401,tx,-95.51716,29.65,1464,72,101,29,40.3
201423402,tx,-95.52965,29.64855,1170,73,102,29,39.7
201423500,tx,-95.54118,29.65094,776,73,101,28,38.4
201423600,tx,-95.5195,29.63675,2239,73,101,28,38.4
201430101,tx,-95.46387,29.78025,365,62,92,30,48.4
201430102,tx,-95.46952,29.7743,491,63,93,30,47.6
201430200,tx,-95.48475,29.77598,220,66,95,29,43.9
201430300,tx,-95.49869,29.77152,1576,65,95,30,46.2
201430400,tx,-95.51553,29.7586,1199,67,96,29,43.3
201430500,tx,-95.51917,29.77985,660,68,97,29,42.6
201430600,tx,-95.53176,29.76475,1342,69,98,29,42
201430700,tx,-95.53882,29.77708,892,69,98,29,42
201430800,tx,-95.55294,29.77607,1355,69,98,29,42
201430900,tx,-95.54282,29.75833,2080,69,98,29,42
201431001,tx,-95.54815,29.74227,1051,69,98,29,42
201431002,tx,-95.55053,29.75314,1206,69,98,29,42
201431101,tx,-95.53566,29.74416,441,69,98,29,42
201431102,tx,-95.52834,29.74146,150,69,98,29,42
201431203,tx,-95.50881,29.74153,51,65,95,30,46.2
201431204,tx,-95.50377,29.74519,483,65,95,30,46.2
201431205,tx,-95.51848,29.73931,7,69,98,29,42
201431206,tx,-95.51477,29.74088,52,67,96,29,43.3
201431302,tx,-95.49051,29.74364,1418,65,95,30,46.2
201431303,tx,-95.49886,29.74055,23,65,95,30,46.2
201431304,tx,-95.49804,29.74605,30,65,95,30,46.2
201431401,tx,-95.48399,29.74447,187,65,95,30,46.2
201431403,tx,-95.47841,29.74423,151,65,95,30,46.2
201431404,tx,-95.48105,29.74361,101,65,95,30,46.2
201431503,tx,-95.49815,29.7529,165,65,95,30,46.2
201431504,tx,-95.49051,29.75381,864,65,95,30,46.2
201431505,tx,-95.48425,29.75461,220,65,95,30,46.2
201431506,tx,-95.47991,29.75627,279,65,95,30,46.2
201431600,tx,-95.4838,29.76453,1188,64,94,30,46.9
201431701,tx,-95.46208,29.76156,596,62,92,30,48.4
201431702,tx,-95.47048,29.75675,1032,62,92,30,48.4
201431801,tx,-95.47228,29.74446,543,63,93,30,47.6
201431803,tx,-95.4654,29.74586,96,62,92,30,48.4
201431804,tx,-95.45985,29.74843,96,62,92,30,48.4
201431901,tx,-95.46462,29.72958,99,65,95,30,46.2
201431902,tx,-95.46413,29.73648,68,62,92,30,48.4
201432003,tx,-95.487,29.7347,85,66,95,29,43.9
201432004,tx,-95.47622,29.73468,1295,65,94,29,44.6
201432005,tx,-95.49265,29.7347,121,66,95,29,43.9
201432006,tx,-95.49828,29.73457,101,67,96,29,43.3
201432101,tx,-95.51743,29.73335,290,68,97,29,42.6
201432102,tx,-95.508,29.73375,385,67,96,29,43.3
201432200,tx,-95.5301,29.73296,1050,70,99,29,41.4
201432301,tx,-95.54133,29.73246,22,70,99,29,41.4
201432302,tx,-95.5463,29.73083,7,71,100,29,40.8
201432303,tx,-95.55178,29.73301,117,70,99,29,41.4
201432401,tx,-95.54327,29.72318,35,71,100,29,40.8
201432402,tx,-95.55197,29.72384,59,71,100,29,40.8
201432501,tx,-95.534,29.72438,419,71,100,29,40.8
201432502,tx,-95.52484,29.72491,221,71,100,29,40.8
201432600,tx,-95.51064,29.72593,690,68,97,29,42.6
201432703,tx,-95.47235,29.72883,321,66,95,29,43.9
201432704,tx,-95.48224,29.72889,320,67,97,30,44.8
201432705,tx,-95.49628,29.7254,39,67,97,30,44.8
201432706,tx,-95.4938,29.72917,145,67,97,30,44.8
201432803,tx,-95.51691,29.71531,14,70,99,29,41.4
201432804,tx,-95.50676,29.71833,401,68,97,29,42.6
201432805,tx,-95.51694,29.70681,84,70,99,29,41.4
201432806,tx,-95.51247,29.71106,32,68,97,29,42.6
201432901,tx,-95.52794,29.71632,382,71,100,29,40.8
201432903,tx,-95.53674,29.70999,148,71,100,29,40.8
201432904,tx,-95.5293,29.70968,223,71,100,29,40.8
201433003,tx,-95.55138,29.70835,76,71,100,29,40.8
201433004,tx,-95.5432,29.71684,34,71,100,29,40.8
201433005,tx,-95.55208,29.71505,35,71,100,29,40.8
201433006,tx,-95.54159,29.71138,4,71,100,29,40.8
201433007,tx,-95.54241,29.70768,16,71,100,29,40.8
201433100,tx,-95.55463,29.69702,142,71,100,29,40.8
201433201,tx,-95.54838,29.69839,1093,71,100,29,40.8
201433202,tx,-95.54125,29.6968,873,71,100,29,40.8
201433300,tx,-95.52962,29.69844,1653,71,100,29,40.8
201433400,tx,-95.54125,29.68608,372,72,101,29,40.3
201433503,tx,-95.55446,29.68738,15,72,101,29,40.3
201433504,tx,-95.54719,29.6793,44,72,101,29,40.3
201433505,tx,-95.55314,29.68326,120,72,101,29,40.3
201433506,tx,-95.55417,29.67948,31,72,101,29,40.3
201433507,tx,-95.55719,29.67925,117,72,101,29,40.3
201433601,tx,-95.55575,29.66715,30,72,101,29,40.3
201433602,tx,-95.55251,29.67297,50,72,101,29,40.3
201440101,tx,-95.55959,29.65062,281,73,101,28,38.4
201440102,tx,-95.54009,29.63938,1350,73,102,29,39.7
201450100,tx,-95.56693,29.77724,367,70,99,29,41.4
201450200,tx,-95.57958,29.77926,1590,70,99,29,41.4
201450301,tx,-95.59435,29.77517,667,70,99,29,41.4
201450302,tx,-95.60073,29.77904,814,71,99,28,39.4
201450401,tx,-95.60978,29.77332,408,72,100,28,38.9
201450402,tx,-95.61432,29.78068,262,72,100,28,38.9
201450500,tx,-95.63478,29.77836,1280,72,100,28,38.9
201450600,tx,-95.61501,29.76925,1085,72,100,28,38.9
201450700,tx,-95.58338,29.76685,2292,70,99,29,41.4
201450801,tx,-95.56872,29.76018,207,70,99,29,41.4
201450803,tx,-95.56834,29.75309,750,70,99,29,41.4
201450804,tx,-95.56079,29.75259,64,70,99,29,41.4
201450900,tx,-95.56494,29.74212,871,70,99,29,41.4
201451003,tx,-95.58641,29.74406,15,70,99,29,41.4
201451004,tx,-95.58489,29.73876,22,70,99,29,41.4
201451005,tx,-95.57411,29.73991,39,70,99,29,41.4
201451006,tx,-95.57861,29.74315,764,70,99,29,41.4
201451100,tx,-95.58083,29.75638,1015,70,99,29,41.4
201451200,tx,-95.59587,29.75581,1160,71,100,29,40.8
201451301,tx,-95.59873,29.74072,988,71,100,29,40.8
201451302,tx,-95.59653,29.74815,1194,71,100,29,40.8
201451401,tx,-95.61237,29.75037,787,72,100,28,38.9
201451404,tx,-95.62192,29.75054,156,72,100,28,38.9
201451405,tx,-95.62117,29.74123,385,72,100,28,38.9
201451406,tx,-95.61119,29.7418,298,72,100,28,38.9
201451407,tx,-95.61635,29.73921,76,72,100,28,38.9
201451501,tx,-95.62236,29.76017,102,72,100,28,38.9
201451502,tx,-95.61435,29.76008,503,72,100,28,38.9
201451603,tx,-95.63312,29.75943,687,72,100,28,38.9
201451604,tx,-95.63391,29.76704,1330,72,100,28,38.9
201451605,tx,-95.62705,29.74741,208,72,100,28,38.9
201451606,tx,-95.6364,29.7452,1905,72,100,28,38.9
201451700,tx,-95.63152,29.73243,785,71,100,29,40.8
201451800,tx,-95.63125,29.72026,1412,71,100,29,40.8
201451902,tx,-95.5987,29.72252,1061,71,100,29,40.8
201451903,tx,-95.60956,29.71662,218,71,100,29,40.8
201451904,tx,-95.61212,29.72385,1130,71,100,29,40.8
201452001,tx,-95.61307,29.73236,793,71,100,29,40.8
201452002,tx,-95.59928,29.73309,107,71,100,29,40.8
201452101,tx,-95.58348,29.72503,1468,71,100,29,40.8
201452102,tx,-95.57831,29.73473,4,70,99,29,41.4
201452103,tx,-95.57545,29.73155,70,71,100,29,40.8
201452202,tx,-95.56473,29.72271,170,71,100,29,40.8
201452203,tx,-95.56198,29.73171,77,71,100,29,40.8
201452204,tx,-95.56838,29.73302,24,71,100,29,40.8
201452300,tx,-95.56434,29.71094,709,71,100,29,40.8
201452401,tx,-95.57958,29.71394,1176,71,100,29,40.8
201452402,tx,-95.57948,29.70764,808,71,100,29,40.8
201452501,tx,-95.59613,29.70933,340,71,100,29,40.8
201452502,tx,-95.60957,29.70866,1234,71,100,29,40.8
201452601,tx,-95.63915,29.7077,30,71,100,29,40.8
201452602,tx,-95.62419,29.70816,1002,71,100,29,40.8
201452701,tx,-95.619,29.69631,1373,71,100,29,40.8
201452702,tx,-95.6287,29.69606,1010,71,100,29,40.8
201452703,tx,-95.63911,29.69703,769,71,100,29,40.8
201452801,tx,-95.60949,29.69614,1820,71,100,29,40.8
201452802,tx,-95.6002,29.69629,1109,71,100,29,40.8
201452900,tx,-95.59185,29.69631,1084,71,100,29,40.8
201453001,tx,-95.57306,29.6961,502,71,100,29,40.8
201453002,tx,-95.5813,29.69613,1423,71,100,29,40.8
201453100,tx,-95.56419,29.69671,409,71,100,29,40.8
201453201,tx,-95.56294,29.68745,18,72,101,29,40.3
201453202,tx,-95.56501,29.68019,544,72,101,29,40.3
201453300,tx,-95.56513,29.6642,197,72,101,29,40.3
201453401,tx,-95.57632,29.65448,699,72,101,29,40.3
201453403,tx,-95.58513,29.66976,410,72,101,29,40.3
201453404,tx,-95.57898,29.66451,938,72,101,29,40.3
201453405,tx,-95.57357,29.66694,405,72,101,29,40.3
201453501,tx,-95.58997,29.66403,1373,72,101,29,40.3
201453502,tx,-95.59824,29.67115,1023,72,101,29,40.3
201453601,tx,-95.59158,29.68223,456,72,101,29,40.3
201453603,tx,-95.57659,29.68378,862,72,101,29,40.3
201453604,tx,-95.5813,29.67926,1023,72,101,29,40.3
201453701,tx,-95.60942,29.68275,1249,72,101,29,40.3
201453702,tx,-95.59965,29.68328,998,72,101,29,40.3
201453800,tx,-95.60878,29.67109,894,72,101,29,40.3
201453901,tx,-95.62866,29.68534,1545,72,101,29,40.3
201453902,tx,-95.62237,29.67844,1018,72,101,29,40.3
201454000,tx,-95.65107,29.69599,1530,72,100,28,38.9
201454100,tx,-95.65382,29.7054,842,72,100,28,38.9
201454200,tx,-95.66947,29.70518,1217,72,100,28,38.9
201454302,tx,-95.67015,29.71492,2236,72,100,28,38.9
201454303,tx,-95.65195,29.71447,827,72,100,28,38.9
201454304,tx,-95.6571,29.7239,464,72,100,28,38.9
201454305,tx,-95.64899,29.72691,635,72,100,28,38.9
201454400,tx,-95.67227,29.7493,162,72,101,29,40.3
201454502,tx,-95.71581,29.74162,885,73,101,28,38.4
201454503,tx,-95.70906,29.77166,958,73,101,28,38.4
201454504,tx,-95.69824,29.76254,1428,73,101,28,38.4
201454505,tx,-95.70371,29.78056,1016,73,102,29,39.7
201454600,tx,-95.7357,29.78047,923,74,102,28,37.8
201454700,tx,-95.72601,29.76632,2301,73,101,28,38.4
201454801,tx,-95.74207,29.77142,841,73,102,29,39.7
201454802,tx,-95.7442,29.76374,1320,73,102,29,39.7
201454901,tx,-95.72969,29.75322,920,73,102,29,39.7
201454902,tx,-95.74106,29.74932,2192,73,102,29,39.7
201455000,tx,-95.75813,29.75433,737,73,102,29,39.7
201455102,tx,-95.77124,29.76625,1162,73,102,29,39.7
201455103,tx,-95.759,29.76293,1400,73,102,29,39.7
201455104,tx,-95.76032,29.77129,951,73,102,29,39.7
201455200,tx,-95.76504,29.77997,1672,74,102,28,37.8
201455300,tx,-95.79023,29.77683,1101,74,102,28,37.8
201510100,tx,-95.37143,29.76993,1493,63,93,30,47.6
201510201,tx,-95.38502,29.76491,346,64,93,29,45.3
201510202,tx,-95.38658,29.77162,1369,63,92,29,46
201510301,tx,-95.37665,29.78239,943,62,92,30,48.4
201510302,tx,-95.38248,29.7869,1107,62,92,30,48.4
201510400,tx,-95.3926,29.78375,1399,62,92,30,48.4
201510500,tx,-95.40349,29.78383,1753,62,92,30,48.4
201510601,tx,-95.40349,29.77359,1332,62,91,29,46.8
201510602,tx,-95.41756,29.77432,1890,62,91,29,46.8
201510701,tx,-95.40407,29.76377,319,62,91,29,46.8
201510702,tx,-95.4037,29.76822,1117,62,91,29,46.8
201510801,tx,-95.41672,29.7667,2008,62,91,29,46.8
201510802,tx,-95.44068,29.76799,886,62,91,29,46.8
201510803,tx,-95.41834,29.76159,610,62,91,29,46.8
201510901,tx,-95.42084,29.78088,2884,62,92,30,48.4
201510902,tx,-95.43445,29.78535,1675,62,92,30,48.4
201511001,tx,-95.44217,29.79907,1201,62,92,30,48.4
201511003,tx,-95.43397,29.79544,747,62,92,30,48.4
201511004,tx,-95.42586,29.79473,558,62,92,30,48.4
201511100,tx,-95.42665,29.80843,1722,62,92,30,48.4
201511201,tx,-95.41751,29.79591,1241,62,92,30,48.4
201511202,tx,-95.41729,29.80421,2023,62,92,30,48.4
201511301,tx,-95.40545,29.79726,1973,62,92,30,48.4
201511302,tx,-95.39352,29.7974,1575,62,92,30,48.4
201511400,tx,-95.38312,29.79579,1424,62,92,30,48.4
201511501,tx,-95.40582,29.80832,1331,62,92,30,48.4
201511502,tx,-95.39037,29.80869,2419,62,92,30,48.4
201511600,tx,-95.37704,29.80301,1642,62,92,30,48.4
201520100,tx,-95.46044,29.79228,1197,62,92,30,48.4
201520200,tx,-95.47656,29.78936,1175,64,94,30,46.9
201520301,tx,-95.47194,29.79869,518,62,92,30,48.4
201520302,tx,-95.48026,29.79873,699,66,95,29,43.9
201520400,tx,-95.47727,29.80837,786,65,95,30,46.2
201520501,tx,-95.47132,29.81489,1281,66,95,29,43.9
201520502,tx,-95.4961,29.83493,687,67,96,29,43.3
201520601,tx,-95.49268,29.8168,414,66,95,29,43.9
201520603,tx,-95.48703,29.8068,92,66,95,29,43.9
201520604,tx,-95.49503,29.80692,756,66,95,29,43.9
201520700,tx,-95.49673,29.79932,1597,66,95,29,43.9
201521000,tx,-95.51764,29.79436,435,67,97,30,44.8
201521100,tx,-95.5197,29.80177,247,68,97,29,42.6
201521201,tx,-95.50371,29.80701,325,66,95,29,43.9
201521202,tx,-95.51461,29.80689,1068,66,95,29,43.9
201521300,tx,-95.51394,29.81596,2083,67,96,29,43.3
201521401,tx,-95.50242,29.82926,122,67,96,29,43.3
201521402,tx,-95.50347,29.82448,648,67,96,29,43.3
201521501,tx,-95.52281,29.82501,337,67,96,29,43.3
201521502,tx,-95.51596,29.82771,1070,67,96,29,43.3
201521600,tx,-95.53129,29.84247,1770,67,96,29,43.3
201521701,tx,-95.53124,29.85748,486,68,96,28,41.2
201521702,tx,-95.50681,29.84524,320,67,96,29,43.3
201521800,tx,-95.55479,29.85024,2059,68,96,28,41.2
201521900,tx,-95.55442,29.82239,2197,68,97,29,42.6
201522001,tx,-95.53941,29.82809,932,67,96,29,43.3
201522002,tx,-95.53077,29.82633,637,67,96,29,43.3
201522101,tx,-95.54105,29.81766,578,68,97,29,42.6
201522102,tx,-95.53149,29.81578,825,68,97,29,42.6
201522201,tx,-95.5333,29.80588,883,68,97,29,42.6
201522202,tx,-95.53789,29.80045,643,68,97,29,42.6
201522301,tx,-95.5269,29.79025,753,68,97,29,42.6
201522302,tx,-95.53807,29.7895,470,68,97,29,42.6
201522401,tx,-95.54933,29.79858,1387,68,97,29,42.6
201522402,tx,-95.55871,29.79869,963,69,98,29,42
201522500,tx,-95.50119,29.78995,1968,66,95,29,43.9
201530101,tx,-95.451,29.81502,391,62,92,30,48.4
201530102,tx,-95.45429,29.81092,291,62,92,30,48.4
201530200,tx,-95.42428,29.81581,1723,62,92,30,48.4
201530300,tx,-95.38879,29.81753,2155,62,92,30,48.4
201530400,tx,-95.38798,29.82612,1152,62,91,29,46.8
201530501,tx,-95.39236,29.83915,516,62,92,30,48.4
201530502,tx,-95.39757,29.83576,742,62,92,30,48.4
201530600,tx,-95.40521,29.83133,1517,62,92,30,48.4
201530701,tx,-95.40882,29.86307,230,64,93,29,45.3
201530702,tx,-95.40398,29.85163,932,62,92,30,48.4
201530800,tx,-95.42023,29.85345,3154,63,93,30,47.6
201530900,tx,-95.42015,29.83597,1604,62,92,30,48.4
201531000,tx,-95.41999,29.82518,2017,62,92,30,48.4
201531100,tx,-95.43774,29.82488,1363,63,92,29,46
201531200,tx,-95.45195,29.82686,1286,63,92,29,46
201531300,tx,-95.46394,29.82308,614,63,92,29,46
201531400,tx,-95.471,29.8302,702,64,94,30,46.9
201531500,tx,-95.47641,29.83691,1271,65,94,29,44.6
201531600,tx,-95.45424,29.83779,1649,63,92,29,46
201531700,tx,-95.43576,29.83578,1494,63,92,29,46
201531800,tx,-95.43634,29.85346,1790,64,93,29,45.3
201531900,tx,-95.45323,29.85313,2390,64,93,29,45.3
201532003,tx,-95.47241,29.85975,253,65,94,29,44.6
201532004,tx,-95.4668,29.84979,726,63,92,29,46
201532101,tx,-95.478,29.84404,720,66,95,29,43.9
201532102,tx,-95.48245,29.84695,162,67,95,28,41.8
201532200,tx,-95.48223,29.85664,349,67,96,29,43.3
201532301,tx,-95.51335,29.85923,244,67,96,29,43.3
201532302,tx,-95.49638,29.85513,1022,67,96,29,43.3
201532400,tx,-95.50322,29.87145,2412,68,97,29,42.6
201532502,tx,-95.50027,29.88602,1489,68,97,29,42.6
201532503,tx,-95.5178,29.89041,1658,68,97,29,42.6
201532504,tx,-95.51219,29.88484,1422,68,97,29,42.6
201532600,tx,-95.48629,29.89185,1644,68,97,29,42.6
201532700,tx,-95.48068,29.87639,1498,68,96,28,41.2
201532800,tx,-95.47147,29.87275,722,66,95,29,43.9
201532900,tx,-95.47318,29.8926,1236,67,95,28,41.8
201533000,tx,-95.46173,29.88932,373,66,95,29,43.9
201533100,tx,-95.4557,29.8762,2696,66,95,29,43.9
201533200,tx,-95.44959,29.86688,1585,66,95,29,43.9
201533301,tx,-95.4191,29.87214,1166,64,93,29,45.3
201533302,tx,-95.42491,29.87931,1457,64,93,29,45.3
201533401,tx,-95.43301,29.89149,1607,65,94,29,44.6
201533402,tx,-95.44309,29.885,2638,66,95,29,43.9
201533500,tx,-95.41849,29.89279,1368,64,93,29,45.3
201533600,tx,-95.42511,29.90854,1139,71,99,28,39.4
201533701,tx,-95.43096,29.92861,830,71,99,28,39.4
201533702,tx,-95.43844,29.91875,904,71,99,28,39.4
201533802,tx,-95.46735,29.92791,1928,71,99,28,39.4
201533803,tx,-95.45141,29.90344,1883,71,99,28,39.4
201533804,tx,-95.45916,29.91276,1487,71,99,28,39.4
201533902,tx,-95.50116,29.93039,391,70,98,28,40
201533903,tx,-95.48614,29.92187,1339,70,98,28,40
201533904,tx,-95.48978,29.93331,1353,70,98,28,40
201534001,tx,-95.48427,29.90672,858,70,99,29,41.4
201534002,tx,-95.50266,29.9146,1496,70,98,28,40
201534003,tx,-95.51244,29.93016,726,70,98,28,40
201534101,tx,-95.53277,29.91836,1103,70,98,28,40
201534102,tx,-95.51599,29.90993,1911,70,98,28,40
201534201,tx,-95.54802,29.91223,794,70,99,29,41.4
201534203,tx,-95.53714,29.87259,528,68,97,29,42.6
201534204,tx,-95.53635,29.8848,1246,68,97,29,42.6
201534205,tx,-95.53781,29.89426,1745,68,97,29,42.6
201540101,tx,-95.58731,29.84648,2836,70,98,28,40
201540102,tx,-95.58269,29.86812,1827,70,98,28,40
201540200,tx,-95.56977,29.82229,555,69,98,29,42
201540502,tx,-95.63088,29.84697,1948,71,99,28,39.4
201540503,tx,-95.64033,29.85985,44,71,100,29,40.8
201540504,tx,-95.64308,29.84646,485,71,100,29,40.8
201540601,tx,-95.63243,29.8622,1406,70,99,29,41.4
201540602,tx,-95.63442,29.87273,1868,70,99,29,41.4
201540700,tx,-95.61511,29.85714,2241,70,99,29,41.4
201540800,tx,-95.60383,29.89162,2236,70,99,29,41.4
201540901,tx,-95.62444,29.88972,1023,70,99,29,41.4
201540903,tx,-95.62554,29.90593,353,71,99,28,39.4
201540904,tx,-95.63512,29.88861,1323,70,99,29,41.4
201541004,tx,-95.64109,29.91826,1874,71,100,29,40.8
201541005,tx,-95.63127,29.91151,568,71,100,29,40.8
201541006,tx,-95.67912,29.92796,1705,72,100,28,38.9
201541007,tx,-95.67438,29.9229,2261,72,100,28,38.9
201541008,tx,-95.65935,29.93138,1340,72,100,28,38.9
201541009,tx,-95.65923,29.91234,1785,72,100,28,38.9
201541100,tx,-95.65149,29.90101,2405,71,100,29,40.8
201541203,tx,-95.64908,29.88885,1081,71,100,29,40.8
201541204,tx,-95.65989,29.88401,1691,71,100,29,40.8
201541205,tx,-95.6624,29.89414,1149,71,100,29,40.8
201541206,tx,-95.67669,29.88644,1362,71,100,29,40.8
201541207,tx,-95.67627,29.8996,1594,71,100,29,40.8
201541301,tx,-95.6576,29.87265,1736,71,100,29,40.8
201541302,tx,-95.67614,29.87236,2093,71,100,29,40.8
201541401,tx,-95.65069,29.85741,1235,71,100,29,40.8
201541402,tx,-95.65741,29.85376,1032,72,100,28,38.9
201541403,tx,-95.66515,29.85481,722,72,100,28,38.9
201541404,tx,-95.65777,29.86366,1390,71,100,29,40.8
201541500,tx,-95.67798,29.85616,1795,71,100,29,40.8
201541603,tx,-95.6545,29.84302,1969,72,100,28,38.9
201541604,tx,-95.68057,29.8391,3572,72,101,29,40.3
201541701,tx,-95.66566,29.82323,1690,72,101,29,40.3
201541702,tx,-95.66669,29.78797,161,72,101,29,40.3
201541703,tx,-95.66581,29.80239,430,73,102,29,39.7
201541801,tx,-95.71202,29.7957,825,73,102,29,39.7
201541802,tx,-95.70019,29.79158,352,73,102,29,39.7
201541901,tx,-95.69589,29.80757,649,73,102,29,39.7
201541902,tx,-95.69464,29.8228,1707,73,101,28,38.4
201542001,tx,-95.71226,29.81929,1548,73,101,28,38.4
201542002,tx,-95.71098,29.82732,937,72,101,29,40.3
201542003,tx,-95.71146,29.8116,1232,73,102,29,39.7
201542004,tx,-95.71251,29.80449,1040,73,102,29,39.7
201542103,tx,-95.69552,29.8564,3302,72,101,29,40.3
201542104,tx,-95.7106,29.83711,2258,72,101,29,40.3
201542105,tx,-95.71152,29.85286,2703,72,101,29,40.3
201542106,tx,-95.71317,29.87205,2674,72,101,29,40.3
201542107,tx,-95.68786,29.87224,1293,72,101,29,40.3
201542108,tx,-95.69795,29.87237,1069,72,101,29,40.3
201542201,tx,-95.72616,29.87026,2200,73,101,28,38.4
201542202,tx,-95.75068,29.84971,3380,73,102,29,39.7
201542203,tx,-95.73729,29.86236,3688,73,102,29,39.7
201542302,tx,-95.74161,29.81074,2057,74,102,28,37.8
201542303,tx,-95.72772,29.81119,1112,74,102,28,37.8
201542304,tx,-95.7257,29.82277,1575,73,102,29,39.7
201542305,tx,-95.73957,29.82496,1892,74,102,28,37.8
201542401,tx,-95.72453,29.79539,814,74,102,28,37.8
201542402,tx,-95.73886,29.79279,1627,74,102,28,37.8
201542500,tx,-95.76429,29.79361,862,74,102,28,37.8
201542600,tx,-95.7892,29.79379,1927,74,102,28,37.8
201542700,tx,-95.81435,29.79318,1773,74,103,29,39.2
201542800,tx,-95.82205,29.8175,2515,74,103,29,39.2
201542901,tx,-95.76187,29.81473,3486,74,102,28,37.8
201542902,tx,-95.80411,29.84434,11578,75,103,28,37.3
201543004,tx,-95.74601,29.95584,5578,73,101,28,38.4
201543005,tx,-95.77856,29.93091,3432,73,101,28,38.4
201543006,tx,-95.70662,29.90982,5966,72,101,29,40.3
201543007,tx,-95.70314,29.94726,7323,72,100,28,38.9
201543008,tx,-95.69019,29.88781,1998,72,101,29,40.3
201543009,tx,-95.70041,29.8876,1197,72,101,29,40.3
201543010,tx,-95.71585,29.88454,1561,72,101,29,40.3
201543011,tx,-95.70872,29.88863,1473,72,101,29,40.3
201543100,tx,-95.85221,29.96404,1476,75,102,27,36
201543201,tx,-95.57166,29.79785,2043,70,99,29,41.4
201543202,tx,-95.6123,29.81013,1052,70,99,29,41.4
201550101,tx,-95.42402,29.95167,58,74,102,28,37.8
201550102,tx,-95.4298,29.94281,116,73,101,28,38.4
201550201,tx,-95.42316,29.96177,110,74,102,28,37.8
201550202,tx,-95.4315,29.95686,223,74,102,28,37.8
201550303,tx,-95.42703,29.9764,64,74,102,28,37.8
201550304,tx,-95.43622,30.01421,108,74,101,27,36.5
201550305,tx,-95.43603,30.0049,917,73,101,28,38.4
201550306,tx,-95.44007,29.991,1130,73,101,28,38.4
201550307,tx,-95.45173,30.00374,166,73,101,28,38.4
201550308,tx,-95.42843,29.98945,98,74,102,28,37.8
201550403,tx,-95.43375,29.97019,145,73,101,28,38.4
201550404,tx,-95.45557,29.96986,1965,73,101,28,38.4
201550405,tx,-95.47154,29.99395,862,73,101,28,38.4
201550406,tx,-95.45182,29.98641,510,73,101,28,38.4
201550407,tx,-95.45923,29.97949,1501,73,101,28,38.4
201550500,tx,-95.44546,29.95252,1544,73,101,28,38.4
201550601,tx,-95.45855,29.95726,1881,73,101,28,38.4
201550602,tx,-95.45944,29.94413,854,72,100,28,38.9
201550603,tx,-95.47007,29.95766,1233,73,101,28,38.4
201550700,tx,-95.49712,29.94245,1414,71,99,28,39.4
201550800,tx,-95.47594,29.95059,831,72,100,28,38.9
201550901,tx,-95.48886,29.95392,1518,71,100,29,40.8
201550902,tx,-95.48954,29.96077,1157,71,100,29,40.8
201551000,tx,-95.49177,29.96973,863,71,100,29,40.8
201551101,tx,-95.48771,29.98713,492,72,100,28,38.9
201551102,tx,-95.48018,29.97406,1764,72,100,28,38.9
201551201,tx,-95.49882,29.97674,822,71,100,29,40.8
201551202,tx,-95.50483,29.97137,875,71,100,29,40.8
201551300,tx,-95.50713,29.95179,1216,71,100,29,40.8
201551400,tx,-95.52292,29.9627,1699,71,99,28,39.4
201551501,tx,-95.55653,29.94678,959,71,99,28,39.4
201551502,tx,-95.54209,29.94001,1172,70,99,29,41.4
201551601,tx,-95.55655,29.92978,1101,71,99,28,39.4
201551602,tx,-95.57561,29.92961,1152,71,99,28,39.4
201551702,tx,-95.56162,29.90153,1339,70,98,28,40
201551703,tx,-95.56261,29.91602,2040,71,99,28,39.4
201551704,tx,-95.57704,29.90242,1187,71,99,28,39.4
201551705,tx,-95.57718,29.91771,1630,71,99,28,39.4
201551800,tx,-95.56378,29.8867,1975,69,98,29,42
201551901,tx,-95.58607,29.90347,22,71,99,28,39.4
201551902,tx,-95.59058,29.90017,64,70,98,28,40
201552002,tx,-95.60883,29.91323,429,71,100,29,40.8
201552003,tx,-95.59347,29.92115,1328,71,99,28,39.4
201552004,tx,-95.59497,29.90954,982,71,99,28,39.4
201552101,tx,-95.61857,29.9229,896,71,100,29,40.8
201552102,tx,-95.61335,29.93793,2053,71,99,28,39.4
201552103,tx,-95.6248,29.93824,997,72,99,27,37.5
201552200,tx,-95.64758,29.94601,2248,72,100,28,38.9
201552301,tx,-95.61856,29.95616,1537,72,99,27,37.5
201552303,tx,-95.58889,29.95971,335,72,99,27,37.5
201552304,tx,-95.5987,29.96232,916,72,99,27,37.5
201552401,tx,-95.59694,29.93191,1082,71,99,28,39.4
201552402,tx,-95.59652,29.94486,1101,71,99,28,39.4
201552501,tx,-95.57652,29.94473,1070,72,99,27,37.5
201552502,tx,-95.57117,29.9554,2300,72,99,27,37.5
201552602,tx,-95.57711,29.97524,1791,72,99,27,37.5
201552603,tx,-95.55666,29.96168,216,71,99,28,39.4
201552604,tx,-95.5737,29.9639,913,72,99,27,37.5
201552701,tx,-95.54807,29.97031,539,71,99,28,39.4
201552702,tx,-95.55748,29.9813,1073,71,99,28,39.4
201552801,tx,-95.53566,29.98617,1860,72,99,27,37.5
201552802,tx,-95.52941,29.97674,1109,71,99,28,39.4
201552901,tx,-95.5087,29.99388,1034,72,100,28,38.9
201552902,tx,-95.5177,29.99348,1416,72,100,28,38.9
201553001,tx,-95.49635,30.0016,2070,72,100,28,38.9
201553002,tx,-95.47924,30.0114,1572,72,100,28,38.9
201553101,tx,-95.4664,30.02257,845,73,101,28,38.4
201553102,tx,-95.45953,30.01519,1139,73,101,28,38.4
201553201,tx,-95.45089,30.0239,754,73,101,28,38.4
201553202,tx,-95.44552,30.03144,502,74,101,27,36.5
201553300,tx,-95.43474,30.02653,64,74,101,27,36.5
201553401,tx,-95.44377,30.04116,1730,74,101,27,36.5
201553403,tx,-95.46346,30.05767,2607,73,101,28,38.4
201553404,tx,-95.46236,30.04602,1200,74,101,27,36.5
201553405,tx,-95.44681,30.0542,1668,74,101,27,36.5
201553500,tx,-95.4753,30.03644,2268,73,101,28,38.4
201553601,tx,-95.49735,30.02685,1588,73,100,27,37
201553602,tx,-95.48618,30.02718,290,73,100,27,37
201553700,tx,-95.51006,30.01756,1403,72,100,28,38.9
201553801,tx,-95.50551,30.04192,1240,73,100,27,37
201553803,tx,-95.51932,30.03731,1494,72,100,28,38.9
201553804,tx,-95.52833,30.0337,1431,72,99,27,37.5
201553901,tx,-95.54001,30.03087,1921,72,99,27,37.5
201554001,tx,-95.52583,30.00991,867,72,100,28,38.9
201554002,tx,-95.54381,29.99972,1667,72,100,28,38.9
201554103,tx,-95.55422,30.01173,2236,72,100,28,38.9
201554104,tx,-95.56016,30.02224,1284,72,99,27,37.5
201554201,tx,-95.5651,30.00125,1198,72,100,28,38.9
201554202,tx,-95.57474,30.00382,1077,72,100,28,38.9
201554301,tx,-95.59385,29.98903,2815,72,99,27,37.5
201554302,tx,-95.61163,29.97514,1473,72,99,27,37.5
201554404,tx,-95.6401,29.97482,1893,72,100,28,38.9
201554405,tx,-95.7079,29.98618,2545,72,100,28,38.9
201554406,tx,-95.71276,30.00656,2047,73,100,27,37
201554407,tx,-95.68702,29.98378,2432,72,100,28,38.9
201554408,tx,-95.6776,29.99848,3184,72,100,28,38.9
201554409,tx,-95.67045,29.97117,2098,71,100,29,40.8
201554410,tx,-95.65149,29.96227,1363,71,100,29,40.8
201554501,tx,-95.66331,30.01161,2717,72,100,28,38.9
201554502,tx,-95.63323,29.99099,2306,72,99,27,37.5
201554600,tx,-95.6188,30.00229,1760,72,99,27,37.5
201554701,tx,-95.58838,30.00296,614,72,100,28,38.9
201554702,tx,-95.60236,30.00345,2008,72,99,27,37.5
201554803,tx,-95.57715,30.09147,2938,71,99,28,39.4
201554804,tx,-95.55554,30.05412,1953,72,99,27,37.5
201554805,tx,-95.58204,30.03091,2610,72,99,27,37.5
201554806,tx,-95.60438,30.05932,807,72,99,27,37.5
201554807,tx,-95.59653,30.03625,2408,72,99,27,37.5
201554808,tx,-95.57527,30.03771,1125,72,99,27,37.5
201554809,tx,-95.57153,30.05502,2890,72,99,27,37.5
201554902,tx,-95.51999,30.09779,3447,73,100,27,37
201554904,tx,-95.52117,30.07004,1274,72,100,28,38.9
201554905,tx,-95.52331,30.06083,2804,72,100,28,38.9
201554906,tx,-95.5012,30.05344,1414,73,100,27,37
201554907,tx,-95.53292,30.0781,1252,72,99,27,37.5
201554908,tx,-95.54629,30.08817,2226,72,99,27,37.5
201555001,tx,-95.46487,30.06708,828,74,101,27,36.5
201555002,tx,-95.48753,30.06337,1970,73,100,27,37
201555101,tx,-95.48233,30.07736,1838,73,101,28,38.4
201555102,tx,-95.45323,30.07689,1762,74,101,27,36.5
201555200,tx,-95.47198,30.09568,3857,73,101,28,38.4
201555301,tx,-95.51385,30.12195,1532,73,101,28,38.4
201555303,tx,-95.57063,30.13404,5734,73,100,27,37
201555304,tx,-95.53965,30.12685,2749,73,100,27,37
201555305,tx,-95.52936,30.14767,4086,74,101,27,36.5
201555401,tx,-95.6062,30.10645,2033,72,99,27,37.5
201555403,tx,-95.63008,30.10877,1718,72,99,27,37.5
201555404,tx,-95.61588,30.08032,1379,71,99,28,39.4
201555501,tx,-95.66242,30.07781,2703,72,100,28,38.9
201555503,tx,-95.65507,30.03837,5304,72,99,27,37.5
201555504,tx,-95.62428,30.02657,2109,72,99,27,37.5
201555505,tx,-95.61745,30.0173,3790,72,99,27,37.5
201555600,tx,-95.73229,30.05878,3902,74,100,26,35.1
201555701,tx,-95.74034,30.01061,3780,73,101,28,38.4
201555703,tx,-95.74832,30.0009,2064,73,101,28,38.4
201555704,tx,-95.76687,30.01272,2614,73,101,28,38.4
201556000,tx,-95.85847,30.07379,5081,74,101,27,36.5
201556100,tx,-95.54437,30.02163,1304,72,100,28,38.9
201980000,tx,-95.27734,29.64632,132,63,93,30,47.6
201980100,tx,-95.3388,29.98823,251,76,103,27,35.5
201980200,tx,-95.35166,29.76707,144,65,94,29,44.6
201980300,tx,-95.40273,29.71723,1,62,92,30,48.4
201980400,tx,-95.34458,29.72228,67,66,96,30,45.5
201980700,tx,-95.36522,29.7621,241,64,93,29,45.3
203020103,tx,-94.23575,32.42908,3983,62,87,25,40.3
203020104,tx,-94.22625,32.60349,3460,62,87,25,40.3
203020105,tx,-94.10457,32.62978,2132,64,88,24,37.5
203020106,tx,-94.07431,32.46182,2493,62,87,25,40.3
203020201,tx,-94.61791,32.67537,3709,64,89,25,39.1
203020202,tx,-94.41024,32.64801,2956,61,86,25,41
203020301,tx,-94.31791,32.52919,1841,59,84,25,42.4
203020302,tx,-94.35108,32.59691,2313,59,84,25,42.4
203020401,tx,-94.40741,32.56742,2697,59,84,25,42.4
203020402,tx,-94.41981,32.51429,3019,59,84,25,42.4
203020501,tx,-94.35085,32.53434,2307,59,84,25,42.4
203020502,tx,-94.36683,32.49401,2751,60,85,25,41.7
203020603,tx,-94.59168,32.4835,2743,62,87,25,40.3
203020604,tx,-94.49816,32.43197,3392,62,88,26,41.9
203020605,tx,-94.5655,32.55163,3262,61,87,26,42.6
203020606,tx,-94.67671,32.55259,2570,63,89,26,41.3
205950200,tx,-102.60286,35.84003,5330,1,7,6,600
207950300,tx,-99.62497,33.11954,4139,50,73,23,46
207950400,tx,-99.80645,33.22067,4237,50,72,22,44
209010100,tx,-97.94598,29.88015,823,62,88,26,41.9
209010200,tx,-97.94581,29.89024,334,62,88,26,41.9
209010302,tx,-97.91501,29.87016,831,62,88,26,41.9
209010305,tx,-97.90106,29.88708,414,62,88,26,41.9
209010306,tx,-97.87914,29.91557,343,60,86,26,43.3
209010307,tx,-97.92431,29.88845,103,62,88,26,41.9
209010308,tx,-97.91906,29.89494,128,62,88,26,41.9
209010309,tx,-97.89988,29.92122,233,61,87,26,42.6
209010401,tx,-97.92705,29.85676,891,62,88,26,41.9
209010402,tx,-97.96149,29.81486,2567,62,88,26,41.9
209010500,tx,-97.9752,29.84424,1421,62,88,26,41.9
209010601,tx,-97.95963,29.88452,1167,62,88,26,41.9
209010602,tx,-98.01386,29.85806,2560,62,87,25,40.3
209010603,tx,-98.0538,29.90432,1821,58,84,26,44.8
209010702,tx,-97.94665,29.96481,1095,59,84,25,42.4
209010703,tx,-97.94416,29.89971,1026,62,88,26,41.9
209010704,tx,-97.9915,29.94007,625,59,85,26,44.1
209010806,tx,-98.04985,30.15293,2305,53,78,25,47.2
209010807,tx,-98.16737,30.1422,2155,48,74,26,54.2
209010809,tx,-98.03725,30.22266,3834,51,77,26,51
209010810,tx,-98.13627,29.9748,2035,50,75,25,50
209010811,tx,-98.20741,30.04636,2076,50,75,25,50
209010812,tx,-98.05448,30.02125,3648,53,78,25,47.2
209010813,tx,-98.15274,30.03667,3051,51,77,26,51
209010814,tx,-98.11291,30.02312,1806,53,78,25,47.2
209010815,tx,-97.95324,30.18467,799,57,82,25,43.9
209010816,tx,-97.98379,30.17378,3705,54,79,25,46.3
209010817,tx,-98.15353,30.23037,2490,48,74,26,54.2
209010818,tx,-98.13858,30.29259,1192,49,75,26,53.1
209010905,tx,-97.95522,30.00883,4709,59,85,26,44.1
209010909,tx,-97.87946,30.017,2804,60,86,26,43.3
209010911,tx,-97.8575,30.11266,1329,61,86,25,41
209010912,tx,-97.9277,30.13253,3728,58,83,25,43.1
209010913,tx,-97.84826,30.06442,2428,61,86,25,41
209010914,tx,-97.94625,30.07587,1400,59,84,25,42.4
209010915,tx,-97.86353,30.07935,2766,60,86,26,43.3
209010916,tx,-97.82014,29.97319,2943,61,86,25,41
209010917,tx,-97.85404,29.94593,1973,59,85,26,44.1
209010918,tx,-97.84942,29.97291,1813,60,86,26,43.3
209010919,tx,-97.82414,30.0218,2438,61,87,26,42.6
209010920,tx,-97.74733,30.02417,978,63,88,25,39.7
209010921,tx,-97.78604,29.99784,1699,61,87,26,42.6
209010922,tx,-97.82131,30.05002,4349,61,87,26,42.6
209010923,tx,-97.78926,30.05958,3024,61,87,26,42.6
209010924,tx,-97.86258,29.99318,1407,60,86,26,43.3
209010925,tx,-97.8649,30.00814,1450,60,86,26,43.3
211950300,tx,-100.27047,35.83757,1114,17,33,16,94.1
213950101,tx,-95.48987,32.32618,2049,55,84,29,52.7
213950102,tx,-95.50072,32.24308,5376,58,86,28,48.3
213950201,tx,-95.57271,32.27075,1658,59,87,28,47.5
213950202,tx,-95.63183,32.29221,3082,61,88,27,44.3
213950301,tx,-95.7788,32.29351,2967,64,90,26,40.6
213950302,tx,-95.77797,32.10919,2017,64,91,27,42.2
213950303,tx,-95.76044,32.20422,3147,65,92,27,41.5
213950400,tx,-95.8865,32.19669,4223,63,90,27,42.9
213950500,tx,-96.00537,32.31638,2770,62,89,27,43.5
213950601,tx,-96.12394,32.31476,4832,61,88,27,44.3
213950603,tx,-96.15733,32.3185,2496,61,88,27,44.3
213950604,tx,-96.13278,32.34384,3861,61,88,27,44.3
213950700,tx,-96.28471,32.31977,4761,61,88,27,44.3
213950801,tx,-96.16898,32.28385,4080,61,88,27,44.3
213950802,tx,-96.15362,32.22128,5795,62,89,27,43.5
213950902,tx,-96.05065,32.10184,2984,65,91,26,40
213950903,tx,-96.06317,32.22822,5677,64,90,26,40.6
213950904,tx,-96.09998,32.26184,7826,63,89,26,41.3
213950905,tx,-96.10357,32.29539,4685,62,88,26,41.9
213951000,tx,-96.03251,32.15352,1772,65,91,26,40
213951101,tx,-95.9474,32.09388,1529,63,90,27,42.9
213951102,tx,-96.00714,32.23617,6513,64,90,26,40.6
213951201,tx,-95.88071,32.18666,1569,62,89,27,43.5
213951202,tx,-95.87714,32.2107,1853,62,89,27,43.5
213951300,tx,-95.84052,32.19865,3765,63,90,27,42.9
213951401,tx,-95.54054,32.15249,3517,61,89,28,45.9
213951402,tx,-95.64796,32.1249,3250,62,90,28,45.2
213951403,tx,-95.50989,32.15957,4214,61,89,28,45.9
215020103,tx,-98.34592,26.20782,594,103,126,23,22.3
215020104,tx,-98.33979,26.21143,291,102,126,24,23.5
215020105,tx,-98.33098,26.20841,696,102,126,24,23.5
215020106,tx,-98.36857,26.21193,672,105,128,23,21.9
215020107,tx,-98.35686,26.20856,1381,105,128,23,21.9
215020108,tx,-98.34817,26.16994,1637,103,127,24,23.3
215020205,tx,-98.33682,26.22138,1672,102,126,24,23.5
215020206,tx,-98.38611,26.229,1534,106,129,23,21.7
215020207,tx,-98.38402,26.24397,924,106,129,23,21.7
215020208,tx,-98.35933,26.2261,1404,105,128,23,21.9
215020209,tx,-98.35789,26.24003,1064,104,128,24,23.1
215020210,tx,-98.33163,26.23328,1730,102,126,24,23.5
215020211,tx,-98.33853,26.23981,1277,103,126,23,22.3
215020303,tx,-98.28616,26.2336,1497,100,124,24,24
215020304,tx,-98.2932,26.2165,989,101,125,24,23.8
215020305,tx,-98.2853,26.22149,1408,101,125,24,23.8
215020306,tx,-98.30996,26.21975,1436,101,125,24,23.8
215020307,tx,-98.31236,26.23266,1880,102,126,24,23.5
215020403,tx,-98.31904,26.20695,1776,102,126,24,23.5
215020405,tx,-98.31001,26.19225,1094,101,125,24,23.8
215020406,tx,-98.31194,26.17108,2406,101,125,24,23.8
215020407,tx,-98.28714,26.20315,794,101,125,24,23.8
215020408,tx,-98.29914,26.20444,1244,101,125,24,23.8
215020409,tx,-98.30714,26.20536,1181,101,125,24,23.8
215020505,tx,-98.25294,26.20326,632,98,123,25,25.5
215020506,tx,-98.26602,26.20058,685,99,124,25,25.3
215020507,tx,-98.24969,26.16282,910,100,125,25,25
215020508,tx,-98.26057,26.16278,863,100,125,25,25
215020509,tx,-98.2682,26.16065,624,100,125,25,25
215020510,tx,-98.27442,26.15732,955,101,125,24,23.8
215020511,tx,-98.27608,26.18685,1052,101,125,24,23.8
215020512,tx,-98.258,26.18938,696,100,124,24,24
215020513,tx,-98.24948,26.17981,895,100,125,25,25
215020600,tx,-98.24309,26.19868,881,98,123,25,25.5
215020724,tx,-98.26506,26.21464,1565,99,124,25,25.3
215020725,tx,-98.24696,26.22585,1231,98,123,25,25.5
215020727,tx,-98.26143,26.25782,1384,99,123,24,24.2
215020728,tx,-98.24715,26.23722,542,99,123,24,24.2
215020729,tx,-98.24166,26.2128,870,98,123,25,25.5
215020730,tx,-98.24873,26.21209,506,98,123,25,25.5
215020731,tx,-98.25367,26.23122,405,98,123,25,25.5
215020732,tx,-98.26437,26.22786,1550,99,124,25,25.3
215020733,tx,-98.24174,26.25481,985,99,123,24,24.2
215020734,tx,-98.24958,26.25663,1035,99,123,24,24.2
215020735,tx,-98.26378,26.24347,902,99,123,24,24.2
215020736,tx,-98.24778,26.24392,557,99,123,24,24.2
215020804,tx,-98.23033,26.24737,910,99,123,24,24.2
215020805,tx,-98.23456,26.22401,868,98,123,25,25.5
215020806,tx,-98.23241,26.23485,944,98,123,25,25.5
215020807,tx,-98.22736,26.26536,784,99,123,24,24.2
215020808,tx,-98.22878,26.25808,797,99,123,24,24.2
215020905,tx,-98.20592,26.24329,915,99,124,25,25.3
215020906,tx,-98.21629,26.2478,965,99,124,25,25.3
215020907,tx,-98.20766,26.22331,688,99,124,25,25.3
215020908,tx,-98.21933,26.22074,703,99,123,24,24.2
215020909,tx,-98.22145,26.23061,726,99,124,25,25.3
215020910,tx,-98.20875,26.23395,620,99,124,25,25.3
215021001,tx,-98.21084,26.2094,474,99,123,24,24.2
215021002,tx,-98.22063,26.20566,582,99,123,24,24.2
215021003,tx,-98.22984,26.21426,753,98,123,25,25.5
215021100,tx,-98.23505,26.20067,1456,98,123,25,25.5
215021201,tx,-98.21939,26.195,1139,99,124,25,25.3
215021203,tx,-98.22423,26.16004,1634,101,125,24,23.8
215021204,tx,-98.21823,26.18314,571,100,125,25,25
215021306,tx,-98.17836,26.0952,1770,100,124,24,24
215021307,tx,-98.20741,26.11746,1524,100,124,24,24
215021308,tx,-98.26644,26.10283,886,100,124,24,24
215021309,tx,-98.23277,26.08677,1156,100,124,24,24
215021310,tx,-98.23047,26.10466,1082,100,124,24,24
215021311,tx,-98.26566,26.12835,2065,100,124,24,24
215021312,tx,-98.20434,26.13538,1522,100,124,24,24
215021313,tx,-98.16595,26.13389,893,100,124,24,24
215021314,tx,-98.2056,26.12822,1241,100,124,24,24
215021315,tx,-98.18725,26.12573,1166,100,124,24,24
215021401,tx,-98.18987,26.19418,1449,100,124,24,24
215021405,tx,-98.17989,26.1738,352,100,125,25,25
215021406,tx,-98.17608,26.18195,791,100,125,25,25
215021407,tx,-98.19466,26.18322,1163,101,125,24,23.8
215021408,tx,-98.20079,26.16301,1614,101,125,24,23.8
215021409,tx,-98.1823,26.15872,1222,100,125,25,25
215021500,tx,-98.18066,26.19666,1324,99,124,25,25.3
215021600,tx,-98.18046,26.2016,1198,100,124,24,24
215021703,tx,-98.19144,26.21306,1292,99,124,25,25.3
215021704,tx,-98.1879,26.23466,1927,99,124,25,25.3
215021705,tx,-98.17184,26.21271,1896,100,125,25,25
215021706,tx,-98.16829,26.23931,1004,100,125,25,25
215021707,tx,-98.17192,26.22636,523,100,125,25,25
215021803,tx,-98.1467,26.20098,1670,100,125,25,25
215021804,tx,-98.1538,26.19363,1337,100,125,25,25
215021807,tx,-98.15604,26.21499,1289,100,125,25,25
215021808,tx,-98.13977,26.21381,1494,100,125,25,25
215021809,tx,-98.14084,26.23638,1543,100,125,25,25
215021810,tx,-98.14765,26.22746,1304,100,125,25,25
215021903,tx,-98.10777,26.185,1557,101,125,24,23.8
215021904,tx,-98.10909,26.19551,1864,100,125,25,25
215021905,tx,-98.09732,26.21337,1270,100,125,25,25
215021906,tx,-98.1123,26.2257,1754,100,125,25,25
215022005,tx,-98.15943,26.18394,1477,100,125,25,25
215022006,tx,-98.14689,26.17626,2110,101,125,24,23.8
215022007,tx,-98.15248,26.1563,852,100,125,25,25
215022008,tx,-98.12435,26.17802,1079,101,126,25,24.8
215022009,tx,-98.12555,26.16273,1181,101,126,25,24.8
215022010,tx,-98.09859,26.17045,1660,101,125,24,23.8
215022011,tx,-98.11254,26.14757,1116,101,125,24,23.8
215022105,tx,-98.05444,26.16372,1190,101,126,25,24.8
215022107,tx,-98.06798,26.17873,1048,101,126,25,24.8
215022108,tx,-98.04772,26.17536,477,101,126,25,24.8
215022109,tx,-98.06206,26.19342,1315,101,126,25,24.8
215022110,tx,-98.04703,26.21838,932,101,126,25,24.8
215022111,tx,-98.06842,26.21904,1789,100,125,25,25
215022112,tx,-98.07295,26.13199,1109,100,125,25,25
215022113,tx,-98.07596,26.16531,1373,101,125,24,23.8
215022203,tx,-98.03327,26.16033,1479,101,126,25,24.8
215022204,tx,-98.03366,26.12576,2486,100,125,25,25
215022205,tx,-98.02731,26.18094,1323,101,126,25,24.8
215022206,tx,-98.02583,26.21644,793,101,126,25,24.8
215022301,tx,-98.00484,26.15226,1878,100,125,25,25
215022302,tx,-98.00139,26.13186,2253,100,125,25,25
215022401,tx,-98.00082,26.17182,1816,100,126,26,26
215022402,tx,-98.00421,26.20381,2286,101,126,25,24.8
215022502,tx,-97.97282,26.17131,1734,100,125,25,25
215022503,tx,-97.97569,26.22103,1087,100,126,26,26
215022504,tx,-97.97528,26.19926,1041,101,126,25,24.8
215022600,tx,-97.98664,26.16438,1012,100,126,26,26
215022703,tx,-97.98571,26.15051,576,100,125,25,25
215022704,tx,-97.97064,26.14819,829,99,125,26,26.3
215022705,tx,-97.97339,26.1257,1498,99,124,25,25.3
215022706,tx,-97.98205,26.13376,651,99,124,25,25.3
215022801,tx,-97.90658,26.09596,2015,97,122,25,25.8
215022802,tx,-98.05651,26.0854,2300,98,123,25,25.5
215022900,tx,-97.9385,26.13943,2256,98,123,25,25.5
215023000,tx,-97.89167,26.142,1887,97,123,26,26.8
215023103,tx,-97.95086,26.19282,2162,99,125,26,26.3
215023104,tx,-97.92701,26.19134,1802,99,125,26,26.3
215023105,tx,-97.89012,26.16567,2012,98,124,26,26.5
215023106,tx,-97.88466,26.20376,1125,98,124,26,26.5
215023516,tx,-98.16808,26.36463,1846,103,127,24,23.3
215023517,tx,-98.20049,26.4091,1713,104,128,24,23.1
215023518,tx,-98.20509,26.32457,2689,102,126,24,23.5
215023519,tx,-98.23172,26.33121,1116,103,127,24,23.3
215023520,tx,-98.05858,26.30829,1264,101,126,25,24.8
215023521,tx,-98.09884,26.31222,1636,101,126,25,24.8
215023522,tx,-98.22268,26.29329,1450,101,125,24,23.8
215023523,tx,-98.07611,26.36475,2551,103,127,24,23.3
215023524,tx,-98.11305,26.34587,2609,102,126,24,23.5
215023525,tx,-98.05502,26.33792,1405,101,126,25,24.8
215023526,tx,-98.1119,26.24989,1294,101,125,24,23.8
215023527,tx,-98.06875,26.24583,2024,101,125,24,23.8
215023528,tx,-98.07624,26.28738,1683,101,126,25,24.8
215023529,tx,-98.07818,26.27033,2959,101,126,25,24.8
215023530,tx,-98.09809,26.40518,2634,103,127,24,23.3
215023531,tx,-98.24632,26.26823,857,99,123,24,24.2
215023532,tx,-98.24011,26.27115,798,99,124,25,25.3
215023533,tx,-98.24019,26.2831,1089,101,125,24,23.8
215023534,tx,-98.239,26.30054,1704,101,125,24,23.8
215023535,tx,-98.21318,26.25943,1018,99,124,25,25.3
215023536,tx,-98.21678,26.27488,1214,100,124,24,24
215023601,tx,-98.15263,26.30665,1131,101,125,24,23.8
215023602,tx,-98.13505,26.31693,2582,102,126,24,23.5
215023700,tx,-98.13996,26.29437,1533,101,125,24,23.8
215023803,tx,-98.14134,26.25854,2563,101,125,24,23.8
215023804,tx,-98.16303,26.25854,1044,100,125,25,25
215023805,tx,-98.15804,26.28387,1061,101,125,24,23.8
215023806,tx,-98.13499,26.28094,2124,101,125,24,23.8
215023903,tx,-98.17168,26.29525,1400,101,125,24,23.8
215023905,tx,-98.19084,26.28475,2333,101,125,24,23.8
215023906,tx,-98.18906,26.26403,3319,100,124,24,24
215023907,tx,-98.18357,26.29701,626,101,125,24,23.8
215023908,tx,-98.20047,26.29945,1791,101,125,24,23.8
215024001,tx,-98.16901,26.30949,819,101,125,24,23.8
215024002,tx,-98.185,26.31193,667,102,126,24,23.5
215024003,tx,-98.16595,26.32752,981,102,126,24,23.5
215024004,tx,-98.18184,26.32979,1648,102,126,24,23.5
215024107,tx,-98.36566,26.26931,1286,106,129,23,21.7
215024108,tx,-98.39318,26.28111,2173,106,129,23,21.7
215024109,tx,-98.32674,26.26897,2430,103,126,23,22.3
215024115,tx,-98.27483,26.26891,1997,100,124,24,24
215024116,tx,-98.29583,26.24789,1257,100,125,25,25
215024117,tx,-98.30413,26.27108,1003,101,125,24,23.8
215024118,tx,-98.34431,26.27128,1436,103,127,24,23.3
215024119,tx,-98.35108,26.25532,1232,104,127,23,22.1
215024120,tx,-98.28516,26.41476,1224,104,127,23,22.1
215024121,tx,-98.35514,26.40908,1660,104,127,23,22.1
215024122,tx,-98.37937,26.34239,1418,105,128,23,21.9
215024123,tx,-98.34409,26.33395,892,104,127,23,22.1
215024124,tx,-98.3263,26.30348,1287,103,126,23,22.3
215024125,tx,-98.34718,26.30903,871,103,127,24,23.3
215024126,tx,-98.36078,26.30822,1248,105,129,24,22.9
215024127,tx,-98.39057,26.31201,1495,105,128,23,21.9
215024128,tx,-98.29253,26.29153,2479,102,126,24,23.5
215024129,tx,-98.27309,26.30103,1172,101,125,24,23.8
215024130,tx,-98.3123,26.34394,702,104,127,23,22.1
215024131,tx,-98.2719,26.33951,493,104,127,23,22.1
215024132,tx,-98.28289,26.32297,1083,103,127,24,23.3
215024204,tx,-98.42664,26.20818,1738,106,129,23,21.7
215024206,tx,-98.53698,26.26096,2248,106,130,24,22.6
215024207,tx,-98.41307,26.24481,1664,107,131,24,22.4
215024208,tx,-98.44543,26.26062,1949,107,131,24,22.4
215024209,tx,-98.42228,26.23278,1272,107,130,23,21.5
215024210,tx,-98.4715,26.23995,2019,107,130,23,21.5
215024211,tx,-98.45552,26.30408,2110,106,129,23,21.7
215024212,tx,-98.45798,26.38799,2605,105,128,23,21.9
215024301,tx,-98.1884,26.61643,1989,105,129,24,22.9
215024302,tx,-97.98022,26.42195,1975,102,126,24,23.5
215024403,tx,-97.99333,26.30064,1994,100,125,25,25
215024404,tx,-98.00799,26.33297,1968,100,125,25,25
215024405,tx,-98.01424,26.2693,1859,101,126,25,24.8
215024406,tx,-97.99236,26.24984,1654,101,126,25,24.8
215024501,tx,-97.95984,26.25948,1425,100,125,25,25
215024502,tx,-97.96231,26.3233,1624,99,125,26,26.3
215024600,tx,-97.90961,26.31289,3325,99,125,26,26.3
215980000,tx,-98.23948,26.17773,9,100,125,25,25
217960100,tx,-97.16409,32.17268,3425,58,83,25,43.1
217960200,tx,-97.37719,32.10591,10194,60,84,24,40
217960400,tx,-97.36458,31.98046,2041,60,85,25,41.7
217960501,tx,-97.26512,31.89655,3653,61,85,24,39.3
217960502,tx,-97.34339,31.90939,2239,62,86,24,38.7
217960600,tx,-97.32127,31.94907,725,61,85,24,39.3
217960700,tx,-97.16745,31.9546,2620,59,84,25,42.4
217960800,tx,-97.10999,32.01862,1448,56,82,26,46.4
217960900,tx,-97.13023,32.0086,1231,57,83,26,45.6
217961000,tx,-97.11255,31.99981,1305,57,82,25,43.9
217961100,tx,-97.0116,32.00915,3946,58,84,26,44.8
217961400,tx,-96.88275,31.85029,4693,58,85,27,46.6
219950100,tx,-102.18227,33.77155,1185,4,14,10,250
219950200,tx,-102.38108,33.6583,3744,4,13,9,225
219950300,tx,-102.3417,33.58694,1851,4,14,10,250
219950400,tx,-102.39452,33.58799,2689,4,14,10,250
219950500,tx,-102.37093,33.56562,2015,4,14,10,250
219950600,tx,-102.18613,33.466,1358,5,15,10,200
219950700,tx,-102.45193,33.44532,1245,4,13,9,225
221160100,tx,-97.79354,32.45742,2525,58,81,23,39.7
221160204,tx,-97.65521,32.43892,3119,60,83,23,38.3
221160206,tx,-97.75864,32.43276,3166,58,81,23,39.7
221160210,tx,-97.66054,32.34754,3365,62,85,23,37.1
221160211,tx,-97.76441,32.408,4495,58,82,24,41.4
221160212,tx,-97.73411,32.36548,4669,60,83,23,38.3
221160213,tx,-97.69054,32.42905,2172,60,83,23,38.3
221160214,tx,-97.72168,32.42434,2292,60,83,23,38.3
221160215,tx,-97.82979,32.48756,3215,57,81,24,42.1
221160216,tx,-97.80532,32.52351,2927,57,80,23,40.4
221160217,tx,-97.69784,32.52024,2641,55,79,24,43.6
221160218,tx,-97.7581,32.47864,2779,56,80,24,42.9
221160302,tx,-97.9489,32.47641,4540,53,77,24,45.3
221160303,tx,-97.87811,32.33938,5501,54,78,24,44.4
223950100,tx,-95.4912,33.28837,2864,55,81,26,47.3
223950200,tx,-95.78368,33.11053,3349,56,82,26,46.4
223950301,tx,-95.61608,33.19323,1867,55,81,26,47.3
223950302,tx,-95.56764,33.10796,2040,55,81,26,47.3
223950401,tx,-95.60478,33.12111,1680,54,81,27,50
223950402,tx,-95.61912,33.14067,1882,54,81,27,50
223950500,tx,-95.57494,33.14717,1173,55,81,26,47.3
223950600,tx,-95.57642,33.12241,2242,55,81,26,47.3
223950700,tx,-95.39175,33.08192,3748,56,82,26,46.4
223950800,tx,-95.59649,33.01395,2106,57,83,26,45.6
225950101,tx,-95.59922,31.47511,2794,65,92,27,41.5
225950102,tx,-95.30887,31.50421,2568,64,91,27,42.2
225950200,tx,-95.64076,31.24462,1691,67,94,27,40.3
225950300,tx,-95.45948,31.3247,1617,66,92,26,39.4
225950400,tx,-95.45663,31.3075,1776,66,93,27,40.9
225950500,tx,-95.37854,31.30807,4658,67,93,26,38.8
225950600,tx,-95.13103,31.36516,2191,66,92,26,39.4
225950700,tx,-95.52149,31.10266,3566,68,94,26,38.2
227950100,tx,-101.49088,32.40819,3054,17,38,21,123.5
227950200,tx,-101.25734,32.34172,1998,20,42,22,110
227950300,tx,-101.48799,32.26545,1465,16,37,21,131.3
227950400,tx,-101.49432,32.24091,1949,16,37,21,131.3
227950500,tx,-101.47132,32.2472,2216,16,38,22,137.5
227950600,tx,-101.43639,32.25458,2139,16,38,22,137.5
227950700,tx,-101.45625,32.24463,1443,17,38,21,123.5
227950801,tx,-101.48468,32.2128,1769,15,35,20,133.3
227950802,tx,-101.51967,32.21128,1113,15,35,20,133.3
227950900,tx,-101.45,32.16795,3177,16,36,20,125
229950300,tx,-105.38646,31.45614,6484,5,16,11,220
231960100,tx,-95.93977,33.30778,2093,58,83,25,43.1
231960200,tx,-96.06198,33.34061,1888,56,81,25,44.6
231960300,tx,-96.21261,33.28096,3524,57,82,25,43.9
231960400,tx,-96.09658,33.20486,3765,60,85,25,41.7
231960500,tx,-95.88598,33.24249,1961,58,83,25,43.1
231960600,tx,-95.90547,33.23896,1104,58,83,25,43.1
231960700,tx,-95.93543,33.07975,6524,58,84,26,44.8
231960800,tx,-96.13891,33.15408,2061,61,86,25,41
231960900,tx,-96.12391,33.13176,2030,61,86,25,41
231961000,tx,-96.08487,33.13415,2052,61,86,25,41
231961101,tx,-96.08547,33.02929,2437,61,86,25,41
231961102,tx,-96.03321,33.06225,2121,60,86,26,43.3
231961200,tx,-96.08825,33.10982,2241,61,86,25,41
231961300,tx,-96.15165,33.06633,3458,62,87,25,40.3
231961401,tx,-96.2295,33.02097,3742,62,87,25,40.3
231961402,tx,-96.2571,33.11219,2802,61,86,25,41
231961501,tx,-96.22568,32.8755,1830,58,84,26,44.8
231961502,tx,-96.23214,32.94812,3295,59,85,26,44.1
231961503,tx,-96.09895,32.9462,2789,59,85,26,44.1
231961600,tx,-96.06378,32.8921,7052,59,85,26,44.1
231961700,tx,-96.04765,32.85051,2822,59,85,26,44.1
233950200,tx,-101.38827,35.90711,3528,8,21,13,162.5
233950501,tx,-101.59092,35.63497,2964,5,16,11,220
233950502,tx,-101.27011,35.7192,3681,7,18,11,157.1
233950600,tx,-101.40139,35.68645,2152,7,19,12,171.4
233950700,tx,-101.38318,35.67332,1137,8,20,12,150
233950800,tx,-101.40587,35.66591,958,7,18,11,157.1
233950900,tx,-101.39524,35.65053,2081,7,19,12,171.4
233951000,tx,-101.41532,35.67649,2143,5,16,11,220
235950100,tx,-100.98242,31.30393,3524,25,49,24,96
237950100,tx,-98.15559,33.30701,4056,55,77,22,40
237950300,tx,-98.16225,33.21284,2067,53,75,22,41.5
237950500,tx,-98.20066,33.11163,4096,55,78,23,41.8
239950100,tx,-96.45039,28.88704,14537,70,100,30,42.9
239950200,tx,-96.71274,29.08632,3591,78,105,27,34.6
239950300,tx,-96.63629,28.87301,3317,77,104,27,35.1
241950101,tx,-93.98109,31.05789,7121,67,92,25,37.3
241950102,tx,-94.14911,31.00274,3159,70,95,25,35.7
241950200,tx,-94.00589,30.93092,2152,69,95,26,37.7
241950300,tx,-93.99573,30.90366,1520,69,95,26,37.7
241950400,tx,-94.02372,30.87189,3714,69,95,26,37.7
241950500,tx,-93.99825,30.71007,4346,75,101,26,34.7
241950600,tx,-93.89769,30.65907,1564,77,103,26,33.8
241950701,tx,-93.99101,30.32232,2685,74,100,26,35.1
241950702,tx,-93.99837,30.48669,3231,81,106,25,30.9
241950800,tx,-93.96466,30.43332,1525,79,105,26,32.9
243950100,tx,-104.14002,30.71548,5913,1,4,3,300
245000101,tx,-94.19747,30.15837,2754,71,99,28,39.4
245000102,tx,-94.17269,30.165,983,71,98,27,38
245000103,tx,-94.13073,30.14606,1386,69,96,27,39.1
245000200,tx,-94.15701,30.13601,1994,70,97,27,38.6
245000304,tx,-94.18584,30.07169,2326,70,97,27,38.6
245000306,tx,-94.16117,30.08649,1416,69,96,27,39.1
245000307,tx,-94.19222,30.1223,906,71,98,27,38
245000309,tx,-94.20069,30.0861,822,71,98,27,38
245000310,tx,-94.18035,30.08305,1600,69,97,28,40.6
245000311,tx,-94.15913,30.09858,1384,69,96,27,39.1
245000312,tx,-94.17966,30.10354,1696,70,97,27,38.6
245000313,tx,-94.1599,30.12169,433,70,97,27,38.6
245000314,tx,-94.15801,30.10987,1166,69,97,28,40.6
245000400,tx,-94.14086,30.09976,1642,68,96,28,41.2
245000500,tx,-94.13198,30.10884,946,68,95,27,39.7
245000600,tx,-94.12358,30.11705,2872,68,95,27,39.7
245000700,tx,-94.09488,30.11445,2377,68,95,27,39.7
245000900,tx,-94.11413,30.10233,1143,67,95,28,41.8
245001100,tx,-94.12502,30.0906,1103,67,95,28,41.8
245001200,tx,-94.1235,30.07707,1629,67,95,28,41.8
245001301,tx,-94.14674,30.06925,2432,68,96,28,41.2
245001302,tx,-94.17853,30.05856,1464,69,97,28,40.6
245001303,tx,-94.16462,30.02317,1969,68,96,28,41.2
245001700,tx,-94.08627,30.0696,2251,65,93,28,43.1
245001900,tx,-94.09708,30.06428,1287,65,93,28,43.1
245002000,tx,-94.10523,30.06364,940,66,94,28,42.4
245002100,tx,-94.12213,30.06173,1660,66,94,28,42.4
245002200,tx,-94.12918,30.0392,1835,66,94,28,42.4
245002300,tx,-94.10586,30.04431,2271,65,94,29,44.6
245002400,tx,-94.0941,30.05336,1300,64,93,29,45.3
245002500,tx,-94.0903,30.04061,1400,64,93,29,45.3
245002600,tx,-94.07497,30.03911,1743,64,93,29,45.3
245005100,tx,-93.88303,29.88929,1594,68,96,28,41.2
245005400,tx,-93.92307,29.88819,1042,67,95,28,41.8
245005500,tx,-93.91509,29.89664,1191,67,95,28,41.8
245005600,tx,-93.90566,29.90531,1397,67,96,29,43.3
245005900,tx,-93.95251,29.87263,567,68,96,28,41.2
245006100,tx,-93.94026,29.87651,1977,68,96,28,41.2
245006300,tx,-93.93202,29.89455,942,67,95,28,41.8
245006400,tx,-93.92418,29.90341,924,67,96,29,43.3
245006500,tx,-93.91546,29.9143,1341,67,96,29,43.3
245006600,tx,-93.8864,29.95358,1429,67,96,29,43.3
245006700,tx,-93.93483,29.90787,1227,67,96,29,43.3
245006800,tx,-93.94648,29.91604,796,67,96,29,43.3
245006900,tx,-93.99001,29.90796,3414,67,96,29,43.3
245007002,tx,-93.95567,29.93853,1078,67,96,29,43.3
245007003,tx,-93.9781,29.95323,631,67,96,29,43.3
245007004,tx,-93.97874,29.94429,620,67,96,29,43.3
245007100,tx,-94.03079,29.91078,2543,67,96,29,43.3
245010100,tx,-93.89841,29.91404,1186,67,96,29,43.3
245010200,tx,-93.92445,29.92117,717,67,96,29,43.3
245010300,tx,-93.93627,29.92154,1318,67,96,29,43.3
245010400,tx,-93.93221,29.94455,1208,67,96,29,43.3
245010500,tx,-93.91646,29.93415,1732,67,96,29,43.3
245010600,tx,-93.9046,29.94643,2576,67,96,29,43.3
245010700,tx,-93.92005,29.95625,1569,67,96,29,43.3
245010800,tx,-93.94511,29.9882,2686,66,95,29,43.9
245010901,tx,-93.97182,29.97459,1354,67,96,29,43.3
245010902,tx,-93.9478,29.96298,1940,67,96,29,43.3
245011001,tx,-93.99363,29.95849,2075,67,96,29,43.3
245011002,tx,-93.98181,29.97401,1578,67,96,29,43.3
245011101,tx,-94.00592,29.96816,1947,67,96,29,43.3
245011102,tx,-93.99202,29.98137,1244,67,96,29,43.3
245011204,tx,-94.03119,29.97144,2142,66,95,29,43.9
245011205,tx,-94.03752,30.02443,1551,65,94,29,44.6
245011303,tx,-94.17742,29.87836,2248,68,97,29,42.6
245011304,tx,-94.13476,29.95932,2761,68,97,29,42.6
245011401,tx,-94.33602,30.06718,2656,73,100,27,37
245011402,tx,-94.26876,30.02138,3530,71,98,27,38
245011500,tx,-94.37744,29.94766,2114,72,100,28,38.9
245011600,tx,-94.13888,29.74003,4003,68,96,28,41.2
245011700,tx,-94.10251,30.08513,1828,67,94,27,40.3
245011800,tx,-93.9337,29.88384,1532,67,96,29,43.3
245980000,tx,-94.01887,29.95098,47,66,96,30,45.5
245980200,tx,-94.04596,29.98967,34,65,95,30,46.2
245980300,tx,-94.07973,29.96705,1,65,95,30,46.2
247950200,tx,-98.67074,27.33493,1180,95,118,23,24.2
247950400,tx,-98.69781,27.03786,2901,96,119,23,24
249950101,tx,-98.09499,27.95612,3158,84,109,25,29.8
249950102,tx,-97.89498,27.9736,3689,81,108,27,33.3
249950201,tx,-98.05394,27.76287,3413,93,117,24,25.8
249950202,tx,-98.15369,27.60112,2476,93,117,24,25.8
249950301,tx,-98.05423,27.73437,985,94,118,24,25.5
249950302,tx,-98.05622,27.75795,893,94,118,24,25.5
249950303,tx,-98.05342,27.77215,763,94,118,24,25.5
249950400,tx,-98.07626,27.76862,1703,94,118,24,25.5
249950500,tx,-98.09165,27.73168,3104,94,118,24,25.5
249950600,tx,-98.07134,27.73844,2190,94,118,24,25.5
249950700,tx,-98.14496,27.36337,3173,101,124,23,22.8
251130100,tx,-97.55016,32.41866,3710,60,83,23,38.3
251130205,tx,-97.33546,32.54877,1326,58,82,24,41.4
251130210,tx,-97.34166,32.44004,2585,60,84,24,40
251130211,tx,-97.3319,32.47781,3010,59,83,24,40.7
251130212,tx,-97.46421,32.52187,2294,57,81,24,42.1
251130213,tx,-97.45953,32.45823,2297,60,84,24,40
251130214,tx,-97.39917,32.47664,2653,59,83,24,40.7
251130215,tx,-97.39027,32.5291,2735,57,81,24,42.1
251130216,tx,-97.35767,32.54716,1468,57,82,25,43.9
251130217,tx,-97.35061,32.53805,1197,57,82,25,43.9
251130218,tx,-97.34153,32.53784,1247,58,82,24,41.4
251130219,tx,-97.31224,32.49898,1064,58,82,24,41.4
251130220,tx,-97.29964,32.52993,2406,58,82,24,41.4
251130221,tx,-97.32849,32.5196,1043,58,82,24,41.4
251130222,tx,-97.32378,32.53239,1319,58,82,24,41.4
251130302,tx,-97.42999,32.38992,2182,65,88,23,35.4
251130303,tx,-97.3227,32.37686,1611,63,86,23,36.5
251130304,tx,-97.35661,32.39656,2207,63,86,23,36.5
251130405,tx,-97.22616,32.53114,2925,59,83,24,40.7
251130406,tx,-97.24808,32.49627,2738,59,83,24,40.7
251130411,tx,-97.17063,32.4841,1763,60,84,24,40
251130412,tx,-97.12133,32.47164,2238,61,85,24,39.3
251130413,tx,-97.117,32.38966,1517,61,85,24,39.3
251130414,tx,-97.2534,32.36581,1489,61,85,24,39.3
251130415,tx,-97.2658,32.41638,2500,61,85,24,39.3
251130416,tx,-97.21388,32.45507,1635,60,84,24,40
251130417,tx,-97.18118,32.39651,2052,60,84,24,40
251130418,tx,-97.10135,32.54116,1379,62,86,24,38.7
251130419,tx,-97.14538,32.52496,1623,61,85,24,39.3
251130501,tx,-97.17266,32.30891,2582,61,85,24,39.3
251130502,tx,-97.27161,32.26127,2453,61,85,24,39.3
251130602,tx,-97.52651,32.26321,1783,65,88,23,35.4
251130603,tx,-97.35099,32.2895,2332,64,87,23,35.9
251130604,tx,-97.46635,32.21864,4397,65,87,22,33.8
251130700,tx,-97.40419,32.3585,1696,66,89,23,34.8
251130800,tx,-97.39011,32.36498,1723,65,88,23,35.4
251130900,tx,-97.37394,32.36287,1602,65,88,23,35.4
251131000,tx,-97.39997,32.33093,1941,66,89,23,34.8
251131100,tx,-97.40347,32.34327,2121,66,89,23,34.8
253020101,tx,-99.70365,32.58226,1913,35,60,25,71.4
253020102,tx,-99.62555,32.55004,14,32,57,25,78.1
253020200,tx,-99.89374,32.75173,2015,42,66,24,57.1
253020300,tx,-100.06982,32.84045,3736,45,68,23,51.1
253020400,tx,-99.79067,32.90649,3946,54,76,22,40.7
253020500,tx,-99.87441,32.69424,5519,41,65,24,58.5
255970100,tx,-97.88226,29.02386,2852,76,100,24,31.6
255970200,tx,-97.96529,28.84904,3157,76,100,24,31.6
255970301,tx,-97.80572,28.75002,1073,79,103,24,30.4
255970302,tx,-97.88877,28.80488,2406,78,103,25,32.1
255970400,tx,-97.70509,28.87681,1587,78,103,25,32.1
257050204,tx,-96.40252,32.76034,2407,59,85,26,44.1
257050207,tx,-96.47981,32.80145,2761,63,87,24,38.1
257050208,tx,-96.49943,32.75579,1769,62,87,25,40.3
257050209,tx,-96.43794,32.76813,3915,61,86,25,41
257050210,tx,-96.43159,32.79589,1036,60,85,25,41.7
257050211,tx,-96.44753,32.67146,3506,61,87,26,42.6
257050212,tx,-96.39716,32.70199,1760,60,86,26,43.3
257050213,tx,-96.42688,32.72489,2423,61,86,25,41
257050214,tx,-96.46238,32.74264,1118,61,86,25,41
257050215,tx,-96.48705,32.68807,2438,62,87,25,40.3
257050300,tx,-96.31091,32.75094,1410,58,84,26,44.8
257050401,tx,-96.25791,32.74864,1353,58,84,26,44.8
257050402,tx,-96.28023,32.77167,1776,58,84,26,44.8
257050500,tx,-96.29166,32.72322,2939,59,85,26,44.1
257050601,tx,-96.25682,32.80209,2555,58,84,26,44.8
257050602,tx,-96.1493,32.73669,3096,57,84,27,47.4
257050701,tx,-96.34176,32.65472,3020,60,86,26,43.3
257050703,tx,-96.1671,32.56388,1661,61,87,26,42.6
257050704,tx,-96.1771,32.63846,3318,60,86,26,43.3
257050801,tx,-96.39321,32.57381,1810,60,86,26,43.3
257050802,tx,-96.46431,32.54961,3878,61,87,26,42.6
257051000,tx,-96.29154,32.59715,820,60,86,26,43.3
257051100,tx,-96.30594,32.57563,2112,60,86,26,43.3
257051201,tx,-96.19972,32.49041,2408,61,87,26,42.6
257051202,tx,-96.35432,32.46596,3304,60,86,26,43.3
257051301,tx,-96.16409,32.40399,4272,61,88,27,44.3
257051302,tx,-96.32766,32.3814,2042,61,87,26,42.6
259970101,tx,-98.84274,29.93991,1854,28,53,25,89.3
259970102,tx,-98.67674,30.0253,5063,33,59,26,78.8
259970301,tx,-98.75931,29.88811,2619,30,56,26,86.7
259970302,tx,-98.8278,29.80791,3213,25,50,25,100
259970403,tx,-98.60882,29.85762,4268,39,66,27,69.2
259970404,tx,-98.70226,29.87674,2027,34,60,26,76.5
259970405,tx,-98.72114,29.74765,1035,33,59,26,78.8
259970406,tx,-98.6445,29.78273,3248,37,63,26,70.3
259970500,tx,-98.72611,29.78956,2500,32,59,27,84.4
261950100,tx,-97.66311,26.92703,452,96,122,26,27.1
263950100,tx,-100.77757,33.18142,3029,29,52,23,79.3
265960101,tx,-99.13802,30.10782,1734,17,38,21,123.5
265960102,tx,-99.01677,30.05985,2521,20,43,23,115
265960200,tx,-99.16871,30.07305,1832,20,43,23,115
265960301,tx,-99.4595,29.99303,4368,15,36,21,140
265960303,tx,-99.22397,30.08297,1870,18,41,23,127.8
265960304,tx,-99.50989,30.17733,4920,16,38,22,137.5
265960401,tx,-99.16283,29.99876,918,20,43,23,115
265960403,tx,-99.17846,30.02159,1835,20,43,23,115
265960404,tx,-99.19203,30.04915,1155,19,41,22,115.8
265960500,tx,-99.14124,30.06592,2772,21,44,23,109.5
265960601,tx,-99.12935,30.03066,1760,21,44,23,109.5
265960602,tx,-99.12162,30.0435,1257,20,43,23,115
265960700,tx,-99.15745,29.94017,3717,22,45,23,104.5
265960800,tx,-98.99912,29.908,3605,24,48,24,100
267950100,tx,-99.74866,30.48678,7503,24,49,25,104.2
267950200,tx,-99.77229,30.4892,1400,29,54,25,86.2
269950100,tx,-100.25585,33.61648,1791,44,66,22,50
271950100,tx,-100.41795,29.35021,10248,61,87,26,42.6
273020101,tx,-97.56041,27.42461,3303,88,114,26,29.5
273020102,tx,-97.95159,27.42688,2029,93,118,25,26.9
273020200,tx,-97.85184,27.52588,2596,92,117,25,27.2
273020301,tx,-97.87336,27.53294,661,92,118,26,28.3
273020302,tx,-97.88344,27.5235,1081,92,117,25,27.2
273020401,tx,-97.86403,27.48485,959,91,117,26,28.6
273020402,tx,-97.88172,27.50785,1304,92,117,25,27.2
273020501,tx,-97.8412,27.48444,1026,91,116,25,27.5
273020502,tx,-97.84823,27.51092,1532,91,117,26,28.6
275950100,tx,-99.77764,33.63749,3425,54,74,20,37
275950200,tx,-99.59871,33.48254,2465,57,78,21,36.8
277000101,tx,-95.50144,33.80928,3002,58,82,24,41.4
277000102,tx,-95.71394,33.77325,4286,58,82,24,41.4
277000200,tx,-95.65224,33.54196,4469,57,81,24,42.1
277000301,tx,-95.3751,33.53462,3009,53,79,26,49.1
277000302,tx,-95.37735,33.75226,2646,53,78,25,47.2
277000401,tx,-95.52394,33.66737,1357,55,79,24,43.6
277000402,tx,-95.48343,33.69659,3175,53,77,24,45.3
277000500,tx,-95.53929,33.69835,2785,56,80,24,42.9
277000600,tx,-95.56456,33.69328,1882,57,81,24,42.1
277000700,tx,-95.60191,33.66251,1829,57,81,24,42.1
277000800,tx,-95.5597,33.6298,2244,56,80,24,42.9
277000900,tx,-95.47418,33.6277,2237,53,77,24,45.3
277001000,tx,-95.53566,33.65244,1608,56,79,23,41.1
279950100,tx,-102.19033,34.17492,2833,2,7,5,250
279950200,tx,-102.40937,34.23586,1644,2,8,6,300
279950300,tx,-102.49928,34.02931,2818,3,9,6,200
279950500,tx,-102.23746,33.9792,3207,3,11,8,266.7
279950600,tx,-102.24563,33.87147,2272,3,11,8,266.7
281950100,tx,-98.27783,31.2438,3836,39,65,26,66.7
281950302,tx,-98.21703,31.10524,2411,44,69,25,56.8
281950303,tx,-97.93878,31.06853,1769,46,72,26,56.5
281950304,tx,-97.98725,31.09736,2021,45,71,26,57.8
281950400,tx,-98.16178,31.06912,2944,43,69,26,60.5
281950500,tx,-98.186,31.04739,2661,42,67,25,59.5
283950301,tx,-99.22946,28.42426,1987,95,116,21,22.1
283950302,tx,-99.09936,28.34488,10156,94,116,22,23.4
285000100,tx,-96.79015,29.3848,5008,76,103,27,35.5
285000200,tx,-96.99768,29.46509,2956,72,99,27,37.5
285000300,tx,-97.07228,29.56681,2656,66,93,27,40.9
285000400,tx,-97.14605,29.42582,3033,70,97,27,38.6
285000500,tx,-96.99068,29.25072,3569,78,104,26,33.3
285000600,tx,-97.13805,29.29508,1498,75,102,27,36
287000100,tx,-97.07432,30.42862,4044,61,88,27,44.3
287000200,tx,-96.9019,30.31734,3576,64,91,27,42.2
287000300,tx,-96.92532,30.16746,2859,67,93,26,38.8
287000400,tx,-96.92864,30.18234,3254,66,92,26,39.4
291700100,tx,-95.12008,30.33459,2770,69,96,27,39.1
291700200,tx,-95.06173,30.35832,1237,69,96,27,39.1
291700301,tx,-95.09134,30.28555,2309,71,98,27,38
291700302,tx,-95.0579,30.20151,17102,77,103,26,33.8
291700303,tx,-95.07493,30.32967,1323,69,96,27,39.1
291700400,tx,-94.92672,30.25175,6993,79,104,25,31.6
291700500,tx,-94.89741,30.3748,8921,76,102,26,34.2
291700600,tx,-94.75306,30.3709,8758,76,101,25,32.9
291700700,tx,-94.77013,30.19138,2491,80,105,25,31.3
291700801,tx,-94.9003,30.14424,2518,86,110,24,27.9
291700802,tx,-94.86447,30.08381,2971,88,111,23,26.1
291700900,tx,-94.98306,30.10062,1950,86,109,23,26.7
291701000,tx,-94.95607,29.97488,3979,82,106,24,29.3
291701100,tx,-94.844,29.96093,5138,78,104,26,33.3
291701200,tx,-94.76971,30.00409,4305,83,108,25,30.1
291701300,tx,-94.6061,30.11237,3669,82,106,24,29.3
291701400,tx,-94.60937,29.97822,5789,85,109,24,28.2
293970100,tx,-96.7411,31.6912,2530,60,87,27,45
293970200,tx,-96.51253,31.68843,2544,64,91,27,42.2
293970300,tx,-96.5029,31.69115,1125,66,92,26,39.4
293970400,tx,-96.48483,31.66852,1207,66,92,26,39.4
293970500,tx,-96.46652,31.68096,1194,65,92,27,41.5
293970600,tx,-96.62937,31.53618,3458,62,89,27,43.5
293970700,tx,-96.37327,31.51311,2312,64,91,27,42.2
293970800,tx,-96.53511,31.37553,4698,62,90,28,45.2
295950200,tx,-100.41288,36.36673,1954,14,29,15,107.1
295950300,tx,-100.2146,36.24045,3301,17,32,15,88.2
297950100,tx,-98.17432,28.52709,4411,95,118,23,24.2
297950200,tx,-98.11153,28.33504,1241,97,119,22,22.7
297950300,tx,-98.11636,28.22132,4527,90,114,24,26.7
297950400,tx,-97.90342,28.17607,4987,81,107,26,32.1
299970100,tx,-98.71173,30.82738,5891,53,78,25,47.2
299970200,tx,-98.67572,30.75023,2601,64,88,24,37.5
299970300,tx,-98.69845,30.61347,5070,51,76,25,49
299970401,tx,-98.42258,30.5499,4940,53,78,25,47.2
299970402,tx,-98.37244,30.52761,5042,49,74,25,51
299970501,tx,-98.43202,30.66971,3491,55,80,25,45.5
299970502,tx,-98.46943,30.66197,4638,61,85,24,39.3
299970600,tx,-98.43756,30.75306,2295,51,76,25,49
301950100,tx,-103.5799,31.84919,1734,31,54,23,74.2
303000100,tx,-101.83381,33.63128,1590,6,19,13,216.7
303000201,tx,-101.87566,33.6287,1023,6,18,12,200
303000202,tx,-101.86394,33.59719,776,6,18,12,200
303000301,tx,-101.87905,33.59508,587,6,18,12,200
303000303,tx,-101.89729,33.61317,135,6,18,12,200
303000304,tx,-101.88025,33.60435,1863,6,18,12,200
303000402,tx,-101.93117,33.58397,1315,6,17,11,183.3
303000403,tx,-101.91377,33.58504,1429,6,17,11,183.3
303000406,tx,-101.9658,33.58501,672,5,16,11,220
303000407,tx,-101.95273,33.58498,993,5,16,11,220
303000408,tx,-101.94267,33.58687,751,5,16,11,220
303000409,tx,-101.92259,33.61412,1877,6,18,12,200
303000410,tx,-101.92642,33.60254,494,5,17,12,240
303000411,tx,-101.91885,33.59719,1016,6,17,11,183.3
303000501,tx,-101.8943,33.59114,126,6,17,11,183.3
303000502,tx,-101.8763,33.586,1,6,18,12,200
303000603,tx,-101.8663,33.58841,281,6,18,12,200
303000605,tx,-101.8586,33.58843,92,6,18,12,200
303000607,tx,-101.86292,33.58112,826,6,18,12,200
303000700,tx,-101.84673,33.59079,1427,6,19,13,216.7
303000901,tx,-101.8314,33.60501,504,6,19,13,216.7
303000902,tx,-101.80663,33.60455,1498,6,19,13,216.7
303001000,tx,-101.8078,33.58792,2881,6,19,13,216.7
303001200,tx,-101.80571,33.56442,1397,6,19,13,216.7
303001300,tx,-101.84578,33.57053,1509,6,19,13,216.7
303001401,tx,-101.86671,33.57053,954,6,18,12,200
303001402,tx,-101.85917,33.57054,910,6,18,12,200
303001501,tx,-101.87909,33.57418,896,6,18,12,200
303001502,tx,-101.8791,33.5669,1081,6,18,12,200
303001601,tx,-101.91355,33.57067,821,6,17,11,183.3
303001602,tx,-101.89626,33.57037,1472,6,17,11,183.3
303001708,tx,-101.92843,33.54323,73,5,17,12,240
303001709,tx,-101.92907,33.55423,1001,5,17,12,240
303001710,tx,-101.93767,33.56525,545,5,16,11,220
303001711,tx,-101.93048,33.57011,1017,6,17,11,183.3
303001712,tx,-101.92966,33.53269,715,5,17,12,240
303001713,tx,-101.93286,33.52544,1173,5,16,11,220
303001714,tx,-101.95919,33.57051,1034,5,16,11,220
303001715,tx,-101.94759,33.54942,688,5,16,11,220
303001716,tx,-101.95928,33.52925,1140,5,16,11,220
303001717,tx,-101.94394,33.52679,938,5,16,11,220
303001804,tx,-101.91444,33.52628,1280,5,17,12,240
303001805,tx,-101.9181,33.55828,872,5,17,12,240
303001806,tx,-101.91149,33.55482,1301,5,17,12,240
303001807,tx,-101.91336,33.54476,779,5,17,12,240
303001808,tx,-101.91382,33.53706,950,5,17,12,240
303001904,tx,-101.89679,33.52479,636,5,17,12,240
303001905,tx,-101.89675,33.55989,859,5,17,12,240
303001906,tx,-101.89621,33.55265,965,5,17,12,240
303001907,tx,-101.89742,33.54366,1078,5,17,12,240
303001908,tx,-101.89588,33.53455,1138,5,17,12,240
303002001,tx,-101.88346,33.556,847,6,18,12,200
303002002,tx,-101.87476,33.55599,1000,6,18,12,200
303002102,tx,-101.87907,33.52454,1027,6,17,11,183.3
303002103,tx,-101.88341,33.53904,808,6,18,12,200
303002104,tx,-101.87473,33.53906,1209,6,18,12,200
303002203,tx,-101.86606,33.53904,952,6,18,12,200
303002205,tx,-101.86608,33.52457,616,6,17,11,183.3
303002206,tx,-101.85292,33.52455,1169,6,17,11,183.3
303002207,tx,-101.85725,33.5407,851,6,18,12,200
303002208,tx,-101.85098,33.53398,576,6,18,12,200
303002301,tx,-101.8661,33.55602,731,6,18,12,200
303002302,tx,-101.85858,33.55601,794,6,18,12,200
303002401,tx,-101.84978,33.55285,1096,6,18,12,200
303002402,tx,-101.84068,33.55217,1334,6,18,12,200
303002500,tx,-101.81718,33.53791,2050,6,18,12,200
303010101,tx,-101.65051,33.71536,1357,6,19,13,216.7
303010102,tx,-101.6857,33.65731,1097,7,20,13,185.7
303010201,tx,-101.87058,33.69115,1014,6,18,12,200
303010202,tx,-101.82865,33.78223,832,5,15,10,200
303010203,tx,-101.7826,33.68219,857,6,19,13,216.7
303010204,tx,-101.7561,33.58052,1045,7,20,13,185.7
303010301,tx,-101.99478,33.73028,2152,5,16,11,220
303010302,tx,-101.99261,33.69594,1145,5,16,11,220
303010402,tx,-102.00045,33.57771,913,5,16,11,220
303010404,tx,-102.00753,33.5069,1446,5,16,11,220
303010409,tx,-101.93543,33.51568,664,5,16,11,220
303010410,tx,-101.92665,33.51246,1032,5,16,11,220
303010411,tx,-101.93512,33.5085,609,5,16,11,220
303010412,tx,-101.98238,33.51611,782,5,16,11,220
303010413,tx,-101.96776,33.51118,979,5,16,11,220
303010414,tx,-101.96147,33.515,855,5,16,11,220
303010415,tx,-101.94835,33.51243,1488,5,16,11,220
303010416,tx,-102.04212,33.60779,681,5,16,11,220
303010417,tx,-101.95803,33.61667,1629,5,17,12,240
303010418,tx,-102.05454,33.53231,783,5,15,10,200
303010419,tx,-101.99529,33.54381,2334,5,16,11,220
303010420,tx,-102.023,33.48513,469,5,16,11,220
303010421,tx,-101.96062,33.48964,1808,5,16,11,220
303010422,tx,-101.95195,33.44073,1126,5,16,11,220
303010423,tx,-102.02446,33.4304,738,5,16,11,220
303010502,tx,-101.91352,33.5123,1192,5,16,11,220
303010504,tx,-101.89632,33.51246,1687,5,17,12,240
303010505,tx,-101.87903,33.5125,1703,5,17,12,240
303010506,tx,-101.85743,33.5126,1729,5,17,12,240
303010509,tx,-101.9221,33.49777,2578,5,16,11,220
303010510,tx,-101.8962,33.49784,1273,5,17,12,240
303010511,tx,-101.86628,33.49804,2153,5,17,12,240
303010512,tx,-101.88323,33.46885,3149,5,17,12,240
303010513,tx,-101.79273,33.47384,1193,6,18,12,200
303010514,tx,-101.8781,33.41802,1379,5,16,11,220
303010601,tx,-101.65478,33.43894,1715,7,20,13,185.7
303010602,tx,-101.63522,33.43003,1409,7,21,14,200
303010700,tx,-101.65495,33.48945,2801,7,21,14,200
303980000,tx,-101.82193,33.66211,9,6,19,13,216.7
305950400,tx,-101.81562,33.28083,2539,6,18,12,200
305950500,tx,-101.78308,33.16264,1744,6,20,14,233.3
305950600,tx,-101.81766,33.0625,1990,8,23,15,187.5
307950300,tx,-99.34134,31.12201,3615,37,63,26,70.3
307950400,tx,-99.31554,31.05233,2282,36,61,25,69.4
307950500,tx,-99.36549,31.28233,3393,38,63,25,65.8
309000100,tx,-97.1335,31.55425,909,62,88,26,41.9
309000200,tx,-97.10047,31.54341,406,62,88,26,41.9
309000300,tx,-97.11525,31.54987,62,62,88,26,41.9
309000401,tx,-97.12996,31.54493,599,62,88,26,41.9
309000402,tx,-97.12301,31.54053,435,62,88,26,41.9
309000598,tx,-97.14109,31.53221,2318,62,87,25,40.3
309000700,tx,-97.15083,31.54501,1302,61,86,25,41
309000800,tx,-97.16245,31.5424,1038,61,86,25,41
309000900,tx,-97.17236,31.55761,1845,61,86,25,41
309001000,tx,-97.15743,31.55619,960,61,86,25,41
309001100,tx,-97.16868,31.56855,2256,61,87,26,42.6
309001200,tx,-97.14747,31.56159,1146,61,86,25,41
309001300,tx,-97.15554,31.57609,1200,62,87,25,40.3
309001401,tx,-97.1351,31.57414,1096,62,88,26,41.9
309001402,tx,-97.12788,31.59602,1733,62,88,26,41.9
309001500,tx,-97.11626,31.56567,2289,62,88,26,41.9
309001600,tx,-97.10307,31.59927,2741,62,88,26,41.9
309001700,tx,-97.07128,31.61187,2466,62,88,26,41.9
309001800,tx,-97.06298,31.55946,895,63,88,25,39.7
309001900,tx,-97.09634,31.52793,1225,62,88,26,41.9
309002000,tx,-97.11119,31.48458,1924,60,87,27,45
309002100,tx,-97.12486,31.51366,1302,61,87,26,42.6
309002302,tx,-97.17962,31.52213,883,59,84,25,42.4
309002498,tx,-97.17296,31.53462,1927,60,86,26,43.3
309002501,tx,-97.21207,31.52916,1553,58,84,26,44.8
309002503,tx,-97.21771,31.5135,2240,58,83,25,43.1
309002504,tx,-97.24344,31.4998,1786,56,82,26,46.4
309002600,tx,-97.20578,31.54737,2506,58,84,26,44.8
309002700,tx,-97.18154,31.54611,1541,60,86,26,43.3
309002800,tx,-97.19687,31.56497,1486,59,85,26,44.1
309002900,tx,-97.26833,31.5499,2238,60,85,25,41.7
309003000,tx,-97.1874,31.58554,1013,61,87,26,42.6
309003200,tx,-97.09875,31.64379,2084,62,88,26,41.9
309003300,tx,-97.07661,31.63938,927,62,88,26,41.9
309003401,tx,-97.0643,31.69376,996,62,88,26,41.9
309003402,tx,-97.13714,31.66718,2868,62,88,26,41.9
309003500,tx,-96.97959,31.65462,2871,60,87,27,45
309003601,tx,-96.87343,31.55009,2249,59,87,28,47.5
309003602,tx,-96.96903,31.49744,1907,60,87,27,45
309003701,tx,-97.07313,31.43675,1925,61,88,27,44.3
309003703,tx,-97.14678,31.44059,2660,60,86,26,43.3
309003708,tx,-97.22557,31.44953,3345,57,83,26,45.6
309003709,tx,-97.17506,31.47883,2281,59,85,26,44.1
309003710,tx,-97.19558,31.43869,2035,58,84,26,44.8
309003711,tx,-97.20188,31.48956,1657,58,83,25,43.1
309003712,tx,-97.24706,31.4767,1154,57,83,26,45.6
309003801,tx,-97.2278,31.38861,3458,57,83,26,45.6
309003802,tx,-97.3228,31.33275,4046,55,81,26,47.3
309003901,tx,-97.34303,31.44361,1860,57,83,26,45.6
309003902,tx,-97.41126,31.4308,3236,58,83,25,43.1
309004000,tx,-97.44224,31.56223,3736,57,82,25,43.9
309004102,tx,-97.31471,31.67477,2931,61,86,25,41
309004104,tx,-97.20063,31.63463,2220,62,88,26,41.9
309004105,tx,-97.2584,31.61326,2317,62,87,25,40.3
309004201,tx,-97.05529,31.7973,2392,60,86,26,43.3
309004202,tx,-97.18046,31.74501,2573,62,87,25,40.3
309004300,tx,-97.1581,31.51295,2650,60,85,25,41.7
309980000,tx,-97.22504,31.6017,23,61,86,25,41
311950100,tx,-98.56784,28.35269,3211,95,117,22,23.2
313000100,tx,-95.7427,31.01826,1783,74,99,25,33.8
313000200,tx,-95.88454,30.95964,2430,75,101,26,34.7
313000300,tx,-96.08969,30.9391,2912,72,98,26,36.1
313000400,tx,-95.90291,30.95187,2561,75,101,26,34.7
315950100,tx,-94.19067,32.80066,3132,64,88,24,37.5
315950200,tx,-94.48257,32.80191,3428,64,89,25,39.1
315950300,tx,-94.60147,32.7871,8508,65,90,25,38.5
315950400,tx,-94.34439,32.76375,2413,63,87,24,38.1
317950100,tx,-101.98284,32.32935,2180,15,36,21,140
317950200,tx,-101.79083,32.18774,2521,16,37,21,131.3
319950100,tx,-99.23498,30.74785,1537,30,56,26,86.7
319950200,tx,-99.22608,30.71757,4889,32,57,25,78.1
321730100,tx,-95.99743,29.06158,1248,66,96,30,45.5
321730202,tx,-95.8202,29.00167,1220,68,98,30,44.1
321730203,tx,-95.90443,29.10155,2173,67,97,30,44.8
321730204,tx,-95.95581,28.99098,1831,65,95,30,46.2
321730301,tx,-95.95358,28.97568,1709,64,94,30,46.9
321730302,tx,-95.9613,28.95587,961,64,94,30,46.9
321730303,tx,-95.8633,28.93107,870,74,102,28,37.8
321730400,tx,-95.98723,28.92318,1816,65,95,30,46.2
321730502,tx,-95.94896,28.71044,4340,91,114,23,25.3
321730503,tx,-95.67626,28.83986,8214,109,125,16,14.7
321730600,tx,-96.18543,28.66251,4668,62,95,33,53.2
321730700,tx,-96.15187,28.91526,6744,68,98,30,44.1
323950204,tx,-100.49656,28.68202,1802,93,112,19,20.4
323950206,tx,-100.4432,28.6633,2153,92,112,20,21.7
323950207,tx,-100.24247,28.46769,3045,93,112,19,20.4
323950208,tx,-100.46686,28.69689,1311,92,111,19,20.7
323950209,tx,-100.47509,28.66853,1582,93,112,19,20.4
323950301,tx,-100.48665,28.72978,1270,91,111,20,22
323950302,tx,-100.48242,28.71816,933,91,111,20,22
323950400,tx,-100.49195,28.71326,1247,91,111,20,22
323950500,tx,-100.50216,28.72516,2218,91,111,20,22
323950601,tx,-100.49462,28.70083,1009,91,111,20,22
323950602,tx,-100.48198,28.69671,1629,91,111,20,22
323950701,tx,-100.26795,28.86575,3194,90,110,20,22.2
323950702,tx,-100.52075,28.95473,3292,89,109,20,22.5
325000101,tx,-98.89364,29.31886,3858,65,91,26,40
325000103,tx,-98.86585,29.41511,4365,61,88,27,44.3
325000104,tx,-98.86578,29.55372,3226,46,73,27,58.7
325000200,tx,-99.31166,29.35061,2861,58,85,27,46.6
325000301,tx,-99.02763,29.47709,3363,56,83,27,48.2
325000302,tx,-99.16522,29.49875,2812,58,84,26,44.8
325000401,tx,-98.83814,29.15063,3388,70,96,26,37.1
325000402,tx,-98.91917,29.24271,3439,67,94,27,40.3
325000500,tx,-99.11599,29.23092,3598,69,94,25,36.2
325000801,tx,-98.99168,29.14487,1906,76,100,24,31.6
325000802,tx,-98.90767,29.16158,2219,75,100,25,33.3
327950300,tx,-99.82064,30.88978,5060,28,53,25,89.3
329000100,tx,-102.07145,32.03433,2174,19,41,22,115.8
329000200,tx,-102.09675,32.02801,1721,18,40,22,122.2
329000302,tx,-102.13088,32.01081,1545,16,38,22,137.5
329000303,tx,-102.11435,32.01469,1659,16,38,22,137.5
329000304,tx,-102.13542,32.02486,1192,16,38,22,137.5
329000305,tx,-102.1189,32.02898,1477,17,38,21,123.5
329000401,tx,-102.14361,31.99253,1219,15,35,20,133.3
329000402,tx,-102.12634,31.99677,1515,16,38,22,137.5
329000500,tx,-102.10418,32.00067,1823,17,39,22,129.4
329000600,tx,-102.08894,32.00973,1584,19,41,22,115.8
329001100,tx,-102.09909,31.98937,2281,18,39,21,116.7
329001200,tx,-102.12649,31.98458,2104,16,37,21,131.3
329001300,tx,-102.13297,31.97383,2363,16,37,21,131.3
329001400,tx,-102.07866,31.98098,2195,18,41,23,127.8
329001500,tx,-102.05627,31.99097,2861,19,42,23,121.1
329001700,tx,-102.06094,32.01337,1744,19,41,22,115.8
329010105,tx,-102.14977,32.019,675,14,34,20,142.9
329010106,tx,-102.14789,32.00684,1243,14,34,20,142.9
329010107,tx,-102.13407,32.03954,1241,17,38,21,123.5
329010108,tx,-102.10006,32.04722,1054,18,39,21,116.7
329010115,tx,-102.15758,32.02276,511,14,35,21,150
329010116,tx,-102.15837,32.04106,1632,15,36,21,140
329010117,tx,-102.08584,31.9538,1154,18,40,22,122.2
329010118,tx,-102.11903,31.93553,936,16,37,21,131.3
329010119,tx,-102.15173,31.7802,2489,16,37,21,131.3
329010120,tx,-102.17637,32.01043,2499,14,34,20,142.9
329010121,tx,-102.1934,32.05984,2232,16,37,21,131.3
329010122,tx,-102.04888,32.03208,547,20,43,23,115
329010123,tx,-102.01078,32.06424,4350,19,41,22,115.8
329010124,tx,-101.90725,31.80498,1646,18,40,22,122.2
329010125,tx,-102.25727,31.91885,2505,13,33,20,153.8
329010126,tx,-102.21846,31.98019,3705,14,34,20,142.9
329010127,tx,-102.05055,31.9546,1137,19,41,22,115.8
329010128,tx,-101.97786,32.01494,1818,19,42,23,121.1
329010129,tx,-101.85387,32.00471,2132,18,40,22,122.2
329010200,tx,-102.07423,32.00684,1752,19,41,22,115.8
329980000,tx,-102.20814,31.94036,132,14,34,20,142.9
331950100,tx,-96.94307,30.94014,3009,66,93,27,40.9
331950300,tx,-97.0928,30.70912,3620,62,88,26,41.9
331950401,tx,-96.91958,30.83695,1683,66,93,27,40.9
331950402,tx,-97.02558,30.83056,2544,65,92,27,41.5
331950500,tx,-96.7943,30.73933,2926,65,92,27,41.5
331950700,tx,-97.00601,30.65674,3399,62,89,27,43.5
331950800,tx,-97.13927,30.59492,2193,61,88,27,44.3
333950100,tx,-98.59953,31.54185,4509,35,61,26,74.3
333950200,tx,-98.5864,31.39139,3506,30,56,26,86.7
335950200,tx,-100.85776,32.41562,3943,27,51,24,88.9
335950400,tx,-100.93343,32.28518,3637,25,48,23,92
337950100,tx,-97.56807,33.76181,5020,50,72,22,44
337950200,tx,-97.79025,33.82015,2167,53,74,21,39.6
337950300,tx,-97.72918,33.78675,1508,51,73,22,43.1
337950401,tx,-97.91618,33.57324,3298,51,73,22,43.1
337950402,tx,-97.75927,33.52119,2371,50,73,23,46
337950501,tx,-97.85392,33.56832,1717,47,70,23,48.9
337950502,tx,-97.83,33.55041,1021,47,70,23,48.9
337950600,tx,-97.63282,33.57871,2228,49,72,23,46.9
339690101,tx,-95.78104,30.12174,2244,75,101,26,34.7
339690102,tx,-95.73028,30.11931,2852,75,101,26,34.7
339690203,tx,-95.78542,30.18548,2079,75,101,26,34.7
339690204,tx,-95.76011,30.18563,1866,75,101,26,34.7
339690205,tx,-95.73498,30.16453,1581,76,102,26,34.2
339690206,tx,-95.70346,30.16348,1481,76,102,26,34.2
339690207,tx,-95.67821,30.12992,2457,75,101,26,34.7
339690300,tx,-95.7304,30.21436,2792,75,101,26,34.7
339690403,tx,-95.66724,30.24309,1604,77,102,25,32.5
339690404,tx,-95.5914,30.23353,1963,77,102,25,32.5
339690405,tx,-95.65959,30.17563,2225,75,101,26,34.7
339690406,tx,-95.61188,30.2154,1993,77,102,25,32.5
339690407,tx,-95.61707,30.19707,1595,77,102,25,32.5
339690408,tx,-95.62296,30.16283,1971,76,102,26,34.2
339690501,tx,-95.55707,30.24078,1716,77,102,25,32.5
339690502,tx,-95.52174,30.25123,2278,78,103,25,32.1
339690503,tx,-95.48862,30.24403,2430,78,103,25,32.1
339690603,tx,-95.57312,30.16449,2182,76,102,26,34.2
339690604,tx,-95.58591,30.17938,2616,76,102,26,34.2
339690605,tx,-95.54861,30.19111,1494,76,102,26,34.2
339690606,tx,-95.57198,30.19726,1915,77,102,25,32.5
339690607,tx,-95.53945,30.20673,1538,77,102,25,32.5
339690608,tx,-95.55043,30.21709,1994,77,102,25,32.5
339690609,tx,-95.52291,30.21318,2083,77,102,25,32.5
339690610,tx,-95.49722,30.21945,2487,77,103,26,33.8
339690701,tx,-95.46904,30.21472,1996,77,103,26,33.8
339690702,tx,-95.46505,30.18592,1928,75,102,27,36
339690800,tx,-95.49255,30.19702,1459,77,103,26,33.8
339690900,tx,-95.51591,30.19639,1559,77,102,25,32.5
339691000,tx,-95.51263,30.18593,1630,76,102,26,34.2
339691100,tx,-95.51533,30.1775,1683,76,102,26,34.2
339691201,tx,-95.48778,30.17489,1172,75,102,27,36
339691202,tx,-95.49024,30.16487,1470,75,102,27,36
339691301,tx,-95.52099,30.16574,1821,76,102,26,34.2
339691302,tx,-95.49638,30.15159,1765,75,102,27,36
339691401,tx,-95.49331,30.13216,1545,73,101,28,38.4
339691402,tx,-95.47489,30.11742,956,74,101,27,36.5
339691403,tx,-95.45157,30.11798,729,74,102,28,37.8
339691500,tx,-95.47387,30.14017,1208,74,101,27,36.5
339691601,tx,-95.45937,30.14923,1516,75,102,27,36
339691602,tx,-95.45447,30.1353,1308,74,102,28,37.8
339691700,tx,-95.46453,30.16533,1000,75,102,27,36
339691801,tx,-95.43807,30.13859,1335,75,102,27,36
339691802,tx,-95.4391,30.1751,1700,75,102,27,36
339691900,tx,-95.42399,30.12855,2199,75,102,27,36
339692003,tx,-95.40763,30.1639,2270,75,102,27,36
339692004,tx,-95.41611,30.14752,1811,75,102,27,36
339692005,tx,-95.40033,30.13512,1542,75,102,27,36
339692006,tx,-95.39024,30.12323,2481,75,102,27,36
339692007,tx,-95.4062,30.10889,2290,75,102,27,36
339692008,tx,-95.37129,30.14066,4391,74,102,28,37.8
339692009,tx,-95.38087,30.09514,4621,75,102,27,36
339692010,tx,-95.32242,30.08179,3468,76,103,27,35.5
339692101,tx,-95.43177,30.22481,2845,77,103,26,33.8
339692102,tx,-95.44585,30.21744,1612,77,103,26,33.8
339692103,tx,-95.41486,30.19271,2393,77,103,26,33.8
339692201,tx,-95.33313,30.22217,2267,75,102,27,36
339692202,tx,-95.37331,30.22092,3280,76,102,26,34.2
339692301,tx,-95.31248,30.13883,1675,74,102,28,37.8
339692302,tx,-95.29526,30.10771,1999,75,102,27,36
339692303,tx,-95.26821,30.07254,1312,75,102,27,36
339692304,tx,-95.26078,30.09096,3367,75,102,27,36
339692401,tx,-95.22154,30.0875,1540,75,102,27,36
339692402,tx,-95.23583,30.06411,2791,75,102,27,36
339692501,tx,-95.18526,30.12944,2732,76,102,26,34.2
339692502,tx,-95.21167,30.10377,1173,75,102,27,36
339692601,tx,-95.27862,30.20466,1713,74,101,27,36.5
339692603,tx,-95.27931,30.1706,2011,74,101,27,36.5
339692604,tx,-95.2629,30.12763,3245,74,102,28,37.8
339692605,tx,-95.23613,30.14051,1335,75,102,27,36
339692701,tx,-95.27466,30.22576,1560,74,101,27,36.5
339692702,tx,-95.21964,30.21717,2371,74,101,27,36.5
339692802,tx,-95.14858,30.16695,7770,76,102,26,34.2
339692803,tx,-95.14172,30.22336,2985,74,100,26,35.1
339692804,tx,-95.17027,30.18938,2915,75,101,26,34.7
339692900,tx,-95.18587,30.28675,2533,70,98,28,40
339693001,tx,-95.27128,30.2961,2629,72,99,27,37.5
339693002,tx,-95.34894,30.29867,2963,75,101,26,34.7
339693102,tx,-95.41667,30.2978,2654,77,102,25,32.5
339693103,tx,-95.44778,30.30633,1448,78,103,25,32.1
339693104,tx,-95.4332,30.311,754,77,102,25,32.5
339693201,tx,-95.42891,30.27073,1401,78,103,25,32.1
339693202,tx,-95.43892,30.25274,2320,78,103,25,32.1
339693301,tx,-95.49863,30.2979,1161,79,103,24,30.4
339693302,tx,-95.47529,30.29966,400,78,103,25,32.1
339693303,tx,-95.46947,30.28554,710,78,103,25,32.1
339693304,tx,-95.47545,30.26794,922,78,103,25,32.1
339693401,tx,-95.46132,30.30288,688,78,103,25,32.1
339693402,tx,-95.45902,30.28857,111,78,103,25,32.1
339693501,tx,-95.47148,30.33055,418,76,101,25,32.9
339693502,tx,-95.4608,30.33057,710,76,101,25,32.9
339693503,tx,-95.4651,30.31796,891,76,102,26,34.2
339693600,tx,-95.48667,30.31907,795,77,102,25,32.5
339693701,tx,-95.54396,30.36626,1843,76,101,25,32.9
339693702,tx,-95.50262,30.35522,2148,76,102,26,34.2
339693703,tx,-95.51763,30.33631,1950,78,103,25,32.1
339693800,tx,-95.47289,30.36286,1239,75,101,26,34.7
339693901,tx,-95.42757,30.35464,1414,75,101,26,34.7
339693902,tx,-95.42658,30.32859,1482,75,101,26,34.7
339693903,tx,-95.45003,30.32263,912,76,102,26,34.2
339693904,tx,-95.44678,30.33401,17,76,101,25,32.9
339694001,tx,-95.3707,30.36975,2702,73,99,26,35.6
339694002,tx,-95.28306,30.36165,3341,72,98,26,36.1
339694103,tx,-95.43899,30.40092,1363,73,99,26,35.6
339694104,tx,-95.42054,30.42137,2338,73,99,26,35.6
339694105,tx,-95.47705,30.41692,2138,73,99,26,35.6
339694106,tx,-95.46058,30.4565,3062,73,99,26,35.6
339694107,tx,-95.39553,30.46204,1710,71,97,26,36.6
339694203,tx,-95.52813,30.43331,925,73,99,26,35.6
339694204,tx,-95.54938,30.45225,3546,73,98,25,34.2
339694205,tx,-95.53999,30.48735,889,72,98,26,36.1
339694206,tx,-95.56513,30.41226,2219,73,99,26,35.6
339694207,tx,-95.56087,30.38603,980,75,100,25,33.3
339694208,tx,-95.50424,30.38164,2037,75,101,26,34.7
339694209,tx,-95.51939,30.40554,1292,74,100,26,35.1
339694210,tx,-95.58369,30.42441,1205,73,99,26,35.6
339694303,tx,-95.67028,30.40251,2210,72,98,26,36.1
339694304,tx,-95.62738,30.42433,3087,73,99,26,35.6
339694305,tx,-95.60555,30.39771,2036,74,100,26,35.1
339694306,tx,-95.62523,30.39294,2785,74,99,25,33.8
339694307,tx,-95.57895,30.36278,1325,76,101,25,32.9
339694308,tx,-95.64027,30.38497,1568,73,99,26,35.6
339694309,tx,-95.61208,30.373,1771,74,99,25,33.8
339694401,tx,-95.55724,30.33069,1616,78,103,25,32.1
339694402,tx,-95.61334,30.33642,2708,75,101,26,34.7
339694403,tx,-95.646,30.36294,2516,73,99,26,35.6
339694501,tx,-95.67602,30.32053,945,73,99,26,35.6
339694502,tx,-95.62145,30.27696,2198,77,102,25,32.5
339694503,tx,-95.55159,30.29121,5333,79,104,25,31.6
339694601,tx,-95.76618,30.4069,1476,71,97,26,36.6
339694602,tx,-95.72957,30.34161,1056,73,99,26,35.6
339694603,tx,-95.76184,30.28387,2326,74,100,26,35.1
339694700,tx,-95.72107,30.50483,3542,72,98,26,36.1
341950100,tx,-101.73347,35.92308,1335,7,19,12,171.4
341950201,tx,-102.00839,36.04024,1002,5,15,10,200
341950202,tx,-101.95225,35.80389,3284,4,13,9,225
341950301,tx,-101.97278,35.87919,1522,3,12,9,300
341950302,tx,-101.95997,35.8685,1635,3,12,9,300
341950400,tx,-101.96903,35.85383,1979,4,14,10,250
343950100,tx,-94.73829,33.20877,3628,65,88,23,35.4
343950200,tx,-94.72631,33.0049,4502,68,91,23,33.8
343950300,tx,-94.72484,33.03021,1468,66,90,24,36.4
345950100,tx,-100.77983,34.07409,1788,24,45,21,87.5
347950100,tx,-94.52802,31.79313,1863,65,90,25,38.5
347950200,tx,-94.8355,31.73553,4774,63,90,27,42.9
347950303,tx,-94.70667,31.6551,1676,66,92,26,39.4
347950304,tx,-94.74496,31.5405,2473,64,90,26,40.6
347950305,tx,-94.69284,31.56096,1205,66,91,25,37.9
347950306,tx,-94.57485,31.50812,1923,67,92,25,37.3
347950401,tx,-94.54802,31.6535,2480,67,92,25,37.3
347950402,tx,-94.6018,31.73253,1981,66,91,25,37.9
347950501,tx,-94.64841,31.64924,651,67,93,26,38.8
347950502,tx,-94.62971,31.64072,1763,67,92,25,37.3
347950600,tx,-94.64972,31.62433,556,67,93,26,38.8
347950700,tx,-94.67,31.63231,1865,67,92,25,37.3
347950800,tx,-94.66888,31.58994,1558,66,91,25,37.9
347950900,tx,-94.64289,31.58904,1609,66,91,25,37.9
347951001,tx,-94.65069,31.61013,848,67,92,25,37.3
347951002,tx,-94.6153,31.60983,1017,66,92,26,39.4
347951100,tx,-94.41204,31.48445,4817,67,92,25,37.3
349970100,tx,-96.40494,32.23104,3759,60,87,27,45
349970200,tx,-96.49463,32.15152,3752,58,85,27,46.6
349970301,tx,-96.60086,32.13739,2738,58,85,27,46.6
349970302,tx,-96.58978,32.06816,1982,58,85,27,46.6
349970400,tx,-96.74431,32.04328,4626,59,85,26,44.1
349970500,tx,-96.47996,32.10234,1547,57,84,27,47.4
349970600,tx,-96.20595,32.10322,4330,62,89,27,43.5
349970701,tx,-96.33167,31.99773,7950,60,87,27,45
349970800,tx,-96.47095,32.0924,995,57,84,27,47.4
349970901,tx,-96.4964,32.0124,2010,58,86,28,48.3
349970902,tx,-96.4742,32.08004,1617,57,84,27,47.4
349971000,tx,-96.57532,31.89139,5086,60,87,27,45
351950100,tx,-93.70481,31.06322,4638,64,89,25,39.1
351950201,tx,-93.77666,30.90249,2895,67,93,26,38.8
351950202,tx,-93.70189,30.78105,2878,70,96,26,37.1
351950300,tx,-93.79586,30.55222,2526,77,103,26,33.8
351950400,tx,-93.81919,30.32649,3065,61,90,29,47.5
353950100,tx,-100.31136,32.44829,1980,25,49,24,96
353950200,tx,-100.39679,32.48296,1821,26,50,24,92.3
353950300,tx,-100.42124,32.46852,1846,26,49,23,88.5
353950400,tx,-100.39324,32.46302,2894,26,49,23,88.5
353950500,tx,-100.43239,32.26129,4099,20,43,23,115
355000500,tx,-97.41896,27.80196,620,64,95,31,48.4
355000601,tx,-97.43419,27.79216,1567,67,98,31,46.3
355000602,tx,-97.43358,27.80527,806,67,97,30,44.8
355000700,tx,-97.46307,27.80466,1638,70,100,30,42.9
355000800,tx,-97.49886,27.76403,1984,72,102,30,41.7
355000900,tx,-97.42793,27.78195,1859,65,96,31,47.7
355001000,tx,-97.41379,27.78281,1155,64,95,31,48.4
355001100,tx,-97.41351,27.79193,805,64,95,31,48.4
355001201,tx,-97.39827,27.78415,501,64,95,31,48.4
355001202,tx,-97.40169,27.78006,848,64,95,31,48.4
355001300,tx,-97.41043,27.77315,1386,66,97,31,47
355001400,tx,-97.39497,27.76712,1908,66,97,31,47
355001500,tx,-97.41585,27.76341,956,67,97,30,44.8
355001601,tx,-97.43059,27.77294,1919,67,97,30,44.8
355001602,tx,-97.42412,27.7626,1515,67,97,30,44.8
355001702,tx,-97.46237,27.73802,677,73,102,29,39.7
355001703,tx,-97.44857,27.75174,1349,70,100,30,42.9
355001704,tx,-97.44111,27.75636,818,70,100,30,42.9
355001801,tx,-97.42951,27.74702,2010,67,98,31,46.3
355001802,tx,-97.44137,27.72796,909,73,103,30,41.1
355001903,tx,-97.41833,27.73574,1188,67,97,30,44.8
355001904,tx,-97.41374,27.74287,1468,67,97,30,44.8
355001905,tx,-97.42305,27.72732,909,69,100,31,44.9
355001906,tx,-97.42996,27.71638,1518,70,100,30,42.9
355002001,tx,-97.40523,27.7576,1305,67,97,30,44.8
355002002,tx,-97.40929,27.7497,1217,67,97,30,44.8
355002101,tx,-97.39044,27.75042,839,64,96,32,50
355002102,tx,-97.38253,27.75567,1407,63,95,32,50.8
355002200,tx,-97.39685,27.74124,1841,66,97,31,47
355002301,tx,-97.4028,27.72989,1530,69,99,30,43.5
355002303,tx,-97.40872,27.7204,1092,70,100,30,42.9
355002304,tx,-97.41561,27.70943,1019,70,100,30,42.9
355002400,tx,-97.38423,27.72245,2494,67,98,31,46.3
355002500,tx,-97.37756,27.73774,1523,64,96,32,50
355002601,tx,-97.36614,27.73218,514,66,97,31,47
355002602,tx,-97.36759,27.71376,805,67,98,31,46.3
355002603,tx,-97.36921,27.72382,1100,67,98,31,46.3
355002703,tx,-97.35207,27.70762,1708,67,99,32,47.8
355002705,tx,-97.34942,27.7204,1827,67,99,32,47.8
355002706,tx,-97.32585,27.71276,6,67,99,32,47.8
355002707,tx,-97.34154,27.69561,266,67,99,32,47.8
355002708,tx,-97.32479,27.69889,505,70,100,30,42.9
355002900,tx,-97.2705,27.68959,169,72,102,30,41.7
355003002,tx,-97.29523,27.6625,2221,73,102,29,39.7
355003003,tx,-97.30505,27.68404,369,72,102,30,41.7
355003004,tx,-97.25745,27.66437,1364,72,102,30,41.7
355003101,tx,-97.27503,27.62777,2525,75,103,28,37.3
355003102,tx,-97.32054,27.64236,2362,75,103,28,37.3
355003202,tx,-97.33477,27.67415,3191,72,102,30,41.7
355003204,tx,-97.35735,27.6815,1384,71,101,30,42.3
355003205,tx,-97.35264,27.69698,275,67,98,31,46.3
355003206,tx,-97.35425,27.69179,973,69,99,30,43.5
355003303,tx,-97.38006,27.70651,686,67,98,31,46.3
355003304,tx,-97.38699,27.69547,962,68,99,31,45.6
355003305,tx,-97.36816,27.70006,587,67,98,31,46.3
355003306,tx,-97.37202,27.68736,846,70,101,31,44.3
355003401,tx,-97.39437,27.71348,1041,69,99,30,43.5
355003402,tx,-97.4013,27.70247,1688,70,100,30,42.9
355003500,tx,-97.52148,27.80316,1264,77,106,29,37.7
355003601,tx,-97.60067,27.84292,1779,84,111,27,32.1
355003602,tx,-97.58316,27.82971,1995,83,110,27,32.5
355003603,tx,-97.56054,27.81316,2227,80,108,28,35
355003700,tx,-97.61679,27.86741,1341,85,111,26,30.6
355005103,tx,-97.08272,27.81776,3363,58,89,31,53.4
355005104,tx,-97.05951,27.83366,1264,70,98,28,40
355005404,tx,-97.35334,27.65709,1906,71,101,30,42.3
355005406,tx,-97.4704,27.64658,3151,78,106,28,35.9
355005407,tx,-97.41551,27.69067,1232,72,102,30,41.7
355005408,tx,-97.40633,27.68779,1235,73,103,30,41.1
355005409,tx,-97.41569,27.67714,1439,74,103,29,39.2
355005410,tx,-97.39698,27.67953,1133,73,103,30,41.1
355005411,tx,-97.39297,27.6859,674,73,103,30,41.1
355005412,tx,-97.40277,27.6689,1615,74,103,29,39.2
355005413,tx,-97.37872,27.67906,450,71,101,30,42.3
355005414,tx,-97.37085,27.6646,1341,71,101,30,42.3
355005415,tx,-97.38448,27.66949,1879,71,101,30,42.3
355005416,tx,-97.39334,27.65299,1421,73,102,29,39.7
355005417,tx,-97.36949,27.64334,3040,75,103,28,37.3
355005603,tx,-97.67288,27.81179,1426,87,112,25,28.7
355005604,tx,-97.65582,27.80956,1430,87,112,25,28.7
355005605,tx,-97.67784,27.78351,2228,87,112,25,28.7
355005606,tx,-97.64942,27.78593,521,87,112,25,28.7
355005801,tx,-97.66796,27.87258,2730,86,111,25,29.1
355005803,tx,-97.83133,27.8716,2981,86,112,26,30.2
355005804,tx,-97.67923,27.82933,1611,86,111,25,29.1
355005900,tx,-97.8252,27.70701,2305,87,112,25,28.7
355006000,tx,-97.6653,27.64257,2111,85,111,26,30.6
355006100,tx,-97.8039,27.58318,1851,88,115,27,30.7
355006201,tx,-97.22991,27.58957,1871,81,105,24,29.6
355006202,tx,-97.2507,27.59075,3103,81,105,24,29.6
355006203,tx,-97.22837,27.61004,1163,80,104,24,30
355006204,tx,-97.24009,27.61723,2330,80,104,24,30
355006205,tx,-97.22132,27.78297,2925,66,96,30,45.5
355006300,tx,-97.45099,27.84422,1354,69,99,30,43.5
355006400,tx,-97.39828,27.79812,1305,64,95,31,48.4
355980000,tx,-97.50599,27.77329,50,78,106,28,35.9
357950100,tx,-100.81575,36.27716,2505,11,25,14,127.3
357950300,tx,-100.80357,36.4001,1858,9,22,13,144.4
357950400,tx,-100.81894,36.38476,2033,9,22,13,144.4
359950100,tx,-102.60287,35.40503,3206,1,7,6,600
361020200,tx,-93.72554,30.10799,2604,59,89,30,50.8
361020300,tx,-93.76745,30.06065,1801,60,90,30,50
361020500,tx,-93.75738,30.07756,1802,60,90,30,50
361020700,tx,-93.84214,30.10958,2361,58,88,30,51.7
361020800,tx,-93.77486,30.11034,897,57,87,30,52.6
361020900,tx,-93.7532,30.10915,1799,58,88,30,51.7
361021000,tx,-93.7257,30.14857,1190,57,87,30,52.6
361021100,tx,-93.73847,30.21099,1069,58,87,29,50
361021200,tx,-93.81815,30.20239,2931,58,88,30,51.7
361021300,tx,-93.77974,30.14181,2344,57,87,30,52.6
361021400,tx,-93.87262,30.156,2214,58,88,30,51.7
361021501,tx,-93.91239,30.21939,1103,61,90,29,47.5
361021503,tx,-93.97194,30.20046,1674,65,93,28,43.1
361021504,tx,-94.00338,30.17375,1810,65,93,28,43.1
361021600,tx,-94.06946,30.19278,2416,68,96,28,41.2
361021700,tx,-94.04781,30.13214,1410,66,93,27,40.9
361021800,tx,-93.94802,30.14907,1619,62,90,28,45.2
361021901,tx,-93.95032,30.10422,1446,62,90,28,45.2
361021902,tx,-93.99726,30.11693,1874,63,91,28,44.4
361022000,tx,-94.03156,30.0898,2020,64,92,28,43.8
361022200,tx,-93.93632,30.06007,2225,61,90,29,47.5
361022301,tx,-93.84767,30.05353,2222,62,92,30,48.4
361022302,tx,-93.90027,30.01783,1687,63,93,30,47.6
361022400,tx,-93.81875,29.98673,2673,64,93,29,45.3
363000100,tx,-98.30644,32.92709,4529,54,77,23,42.6
363000200,tx,-98.46286,32.67411,6349,52,76,24,46.2
363000300,tx,-98.23642,32.67104,4439,56,79,23,41.1
363000401,tx,-98.12382,32.85683,1510,61,83,22,36.1
363000402,tx,-98.1319,32.73058,2143,62,84,22,35.5
363000500,tx,-98.11771,32.8189,908,63,84,21,33.3
363000600,tx,-98.08742,32.82184,1769,63,85,22,34.9
363000700,tx,-98.07876,32.7991,1279,63,85,22,34.9
363000800,tx,-98.10314,32.80155,1681,63,85,22,34.9
363000900,tx,-98.12137,32.79806,1277,63,85,22,34.9
365950100,tx,-94.14919,32.21642,3873,64,89,25,39.1
365950200,tx,-94.46196,32.25322,2409,63,88,25,39.7
365950300,tx,-94.34223,32.16073,2747,65,89,24,36.9
365950401,tx,-94.33492,32.13527,1137,65,90,25,38.5
365950402,tx,-94.34304,32.1665,2302,65,90,25,38.5
365950500,tx,-94.50238,32.04604,2560,64,89,25,39.1
365950600,tx,-94.25934,32.03585,1825,66,91,25,37.9
367140101,tx,-97.75573,32.75382,1421,50,74,24,48
367140102,tx,-97.78578,32.77229,2016,49,73,24,49
367140201,tx,-97.80054,32.74323,1596,49,72,23,46.9
367140202,tx,-97.78079,32.74145,1428,49,72,23,46.9
367140300,tx,-97.8251,32.7541,2602,48,72,24,50
367140403,tx,-97.67232,32.97315,3699,55,77,22,40
367140408,tx,-97.59322,32.89091,2329,57,81,24,42.1
367140409,tx,-97.63747,32.91358,1511,55,78,23,41.8
367140410,tx,-97.75379,32.9422,2016,51,74,23,45.1
367140411,tx,-97.71811,32.87029,2724,52,75,23,44.2
367140412,tx,-97.58542,32.92969,1720,59,82,23,39
367140413,tx,-97.57564,32.9684,1650,59,81,22,37.3
367140414,tx,-97.5849,32.84711,1516,58,81,23,39.7
367140415,tx,-97.68103,32.84337,1916,53,76,23,43.4
367140416,tx,-97.61836,32.80715,2224,55,79,24,43.6
367140502,tx,-97.97068,32.88247,3555,54,77,23,42.6
367140503,tx,-97.80976,32.85109,2335,49,73,24,49
367140504,tx,-97.86367,32.93741,2345,52,75,23,44.2
367140601,tx,-97.96092,32.72707,4946,55,78,23,41.8
367140603,tx,-97.92257,32.62102,7062,55,78,23,41.8
367140604,tx,-97.75357,32.61388,2984,53,77,24,45.3
367140707,tx,-97.62986,32.71243,1898,54,78,24,44.4
367140708,tx,-97.72637,32.72789,1935,49,73,24,49
367140709,tx,-97.64796,32.68566,2385,53,77,24,45.3
367140710,tx,-97.66059,32.63887,1917,52,76,24,46.2
367140711,tx,-97.70355,32.7688,2763,52,76,24,46.2
367140712,tx,-97.69768,32.74478,1243,52,76,24,46.2
367140713,tx,-97.57157,32.67564,2826,54,78,24,44.4
367140714,tx,-97.63257,32.75872,2689,53,77,24,45.3
369950200,tx,-102.74754,34.65361,2702,1,5,4,400
369950300,tx,-102.80959,34.44648,3554,2,7,5,250
371950100,tx,-102.52463,31.0256,3613,31,55,24,77.4
371950300,tx,-102.87716,30.89046,2043,13,32,19,146.2
371950400,tx,-102.89819,30.89148,2230,14,33,19,135.7
371950500,tx,-102.80276,30.68322,6231,12,28,16,133.3
371980000,tx,-102.86425,30.89967,21,13,32,19,146.2
373210103,tx,-94.92583,30.65359,1408,72,97,25,34.7
373210104,tx,-94.66811,30.58414,4860,75,99,24,32
373210105,tx,-94.81372,30.64632,3208,72,96,24,33.3
373210106,tx,-94.86842,30.57131,3917,74,99,25,33.8
373210203,tx,-95.01727,30.71814,5282,72,96,24,33.3
373210204,tx,-94.98671,30.64592,4766,72,97,25,34.7
373210205,tx,-95.09921,30.71891,6329,71,96,25,35.2
373210206,tx,-95.08175,30.77917,8013,71,96,25,35.2
373210301,tx,-95.12532,30.8483,5381,71,96,25,35.2
373210302,tx,-94.96635,30.83223,5152,71,95,24,33.8
373210401,tx,-94.72723,31.00861,3864,70,96,26,37.1
373210402,tx,-94.91339,30.99022,1805,70,96,26,37.1
373210500,tx,-94.74505,30.78947,4445,71,96,25,35.2
375010100,tx,-101.91009,35.18586,472,2,10,8,400
375010200,tx,-101.89293,35.18706,907,2,10,8,400
375010300,tx,-101.87436,35.18794,330,2,10,8,400
375010400,tx,-101.85743,35.18902,1386,2,10,8,400
375010600,tx,-101.82416,35.18737,913,3,10,7,233.3
375010700,tx,-101.80517,35.18842,1282,2,10,8,400
375011000,tx,-101.80596,35.20104,981,2,9,7,350
375011500,tx,-101.85673,35.20208,1856,2,9,7,350
375011600,tx,-101.88089,35.19644,1387,2,9,7,350
375011700,tx,-101.93104,35.19528,906,2,9,7,350
375011800,tx,-101.89396,35.20117,1513,2,9,7,350
375011900,tx,-101.87596,35.20668,1303,2,9,7,350
375012000,tx,-101.85971,35.21509,1109,2,9,7,350
375012200,tx,-101.8126,35.21611,1635,2,9,7,350
375012600,tx,-101.78583,35.23039,1055,2,9,7,350
375012800,tx,-101.82079,35.22874,1642,2,9,7,350
375013000,tx,-101.85678,35.23669,1371,2,9,7,350
375013200,tx,-101.89261,35.21345,607,2,9,7,350
375013300,tx,-101.91688,35.23381,2544,2,10,8,400
375013400,tx,-101.86531,35.28177,1807,3,11,8,266.7
375013900,tx,-101.82259,35.2438,1354,2,9,7,350
375014100,tx,-101.77322,35.25275,1458,2,9,7,350
375014300,tx,-101.90934,35.42646,6077,3,12,9,300
375014401,tx,-101.68591,35.22452,1206,3,10,7,233.3
375014500,tx,-101.77886,35.19426,2616,2,9,7,350
375014701,tx,-101.83933,35.19815,768,2,9,7,350
375014702,tx,-101.84131,35.18842,893,3,10,7,233.3
375014800,tx,-101.84153,35.22433,2015,2,9,7,350
375014900,tx,-101.76663,35.21704,2096,2,9,7,350
375015000,tx,-101.8038,35.23727,2223,2,9,7,350
375015100,tx,-101.81854,35.29449,1437,3,10,7,233.3
375015200,tx,-101.83396,35.25361,1346,2,9,7,350
375015300,tx,-101.87583,35.22295,2181,2,9,7,350
375015400,tx,-101.83001,35.20483,2007,2,9,7,350
375980000,tx,-101.70224,35.21874,38,2,10,8,400
377950100,tx,-104.29156,30.17583,5111,6,12,6,100
377950200,tx,-104.13113,29.62249,7153,69,90,21,30.4
379950101,tx,-95.72711,32.92221,4477,57,83,26,45.6
379950102,tx,-95.72572,32.80973,2155,58,84,26,44.8
379950200,tx,-95.8752,32.88674,4632,58,84,26,44.8
381020100,tx,-101.91127,35.17973,837,2,10,8,400
381020200,tx,-101.89317,35.17965,762,2,10,8,400
381020300,tx,-101.87505,35.18058,616,2,10,8,400
381020400,tx,-101.85851,35.17836,856,2,10,8,400
381020500,tx,-101.84357,35.17452,1623,3,10,7,233.3
381020600,tx,-101.78668,35.18078,1410,2,10,8,400
381020800,tx,-101.85571,35.15737,2609,2,10,8,400
381020900,tx,-101.85758,35.16947,1218,2,10,8,400
381021000,tx,-101.87327,35.15494,993,2,10,8,400
381021101,tx,-101.8756,35.17151,1641,2,10,8,400
381021102,tx,-101.87992,35.15926,109,2,10,8,400
381021200,tx,-101.89308,35.16898,1869,2,10,8,400
381021300,tx,-101.89313,35.15421,1743,3,10,7,233.3
381021500,tx,-101.89278,35.13192,2126,3,10,7,233.3
381021602,tx,-101.91122,35.16907,1501,2,10,8,400
381021603,tx,-101.92918,35.17978,799,2,10,8,400
381021604,tx,-101.92917,35.16915,1606,2,10,8,400
381021605,tx,-101.91111,35.15419,851,3,10,7,233.3
381021606,tx,-101.91098,35.13929,1973,3,11,8,266.7
381021609,tx,-101.92904,35.1456,2114,3,10,7,233.3
381021610,tx,-101.91084,35.12431,893,3,11,8,266.7
381021611,tx,-101.94427,35.14598,2766,3,10,7,233.3
381021702,tx,-101.70301,35.07762,3775,3,12,9,300
381021705,tx,-101.90006,35.0787,1299,4,13,9,225
381021706,tx,-101.87434,35.06071,1685,4,13,9,225
381021707,tx,-101.92954,35.06272,2368,4,14,10,250
381021708,tx,-102.05314,35.10143,2995,3,11,8,266.7
381021802,tx,-101.90856,34.98044,1392,5,15,10,200
381021803,tx,-101.92738,34.9846,1012,5,15,10,200
381021804,tx,-101.93835,34.97365,1441,5,15,10,200
381021900,tx,-101.90314,34.88516,5175,4,12,8,200
381022001,tx,-101.86854,35.13503,3027,3,10,7,233.3
381022002,tx,-101.77801,35.15057,3352,3,10,7,233.3
383950100,tx,-101.52301,31.36619,3206,17,40,23,135.3
385950100,tx,-99.82217,29.83174,6584,23,46,23,100
387950100,tx,-94.85002,33.57331,2842,60,84,24,40
387950501,tx,-95.07811,33.57466,1844,53,79,26,49.1
387950502,tx,-95.05689,33.62557,2849,53,79,26,49.1
387950600,tx,-95.15588,33.45891,2575,57,82,25,43.9
387950700,tx,-95.17672,33.77793,2441,54,78,24,44.4
389950200,tx,-103.49698,31.42744,1959,43,66,23,53.5
389950300,tx,-103.50434,31.41926,1074,43,66,23,53.5
389950400,tx,-103.50371,31.40492,1934,43,66,23,53.5
389950600,tx,-103.69355,31.32301,7692,29,51,22,75.9
391950200,tx,-97.2439,28.41172,2426,74,103,29,39.2
391950400,tx,-97.13462,28.29498,4787,75,103,28,37.3
393950100,tx,-100.81344,35.83849,1190,11,25,14,127.3
395960100,tx,-96.65829,31.12819,2201,64,92,28,43.8
395960200,tx,-96.66015,30.99895,1905,66,93,27,40.9
395960300,tx,-96.40466,31.12633,4597,65,92,27,41.5
395960400,tx,-96.49214,30.8662,2860,67,94,27,40.3
395960501,tx,-96.64292,30.882,2289,69,95,26,37.7
395960502,tx,-96.5792,30.91505,1343,67,94,27,40.3
397040101,tx,-96.48096,32.93972,2712,57,83,26,45.6
397040103,tx,-96.47872,32.96667,1575,58,83,25,43.1
397040104,tx,-96.50649,32.95342,1136,58,84,26,44.8
397040201,tx,-96.43183,32.95247,989,57,83,26,45.6
397040202,tx,-96.45371,32.94915,2246,57,83,26,45.6
397040203,tx,-96.45134,32.9739,796,57,83,26,45.6
397040301,tx,-96.5045,32.90246,1916,59,84,25,42.4
397040303,tx,-96.47651,32.91212,1739,57,83,26,45.6
397040304,tx,-96.45895,32.90802,235,57,82,25,43.9
397040305,tx,-96.4375,32.92207,1557,57,82,25,43.9
397040403,tx,-96.38731,32.9751,1200,59,84,25,42.4
397040404,tx,-96.39429,32.93463,1020,58,84,26,44.8
397040405,tx,-96.35102,32.965,1384,59,84,25,42.4
397040406,tx,-96.38791,32.94533,1399,58,84,26,44.8
397040407,tx,-96.40151,32.95374,1483,58,83,25,43.1
397040408,tx,-96.39069,32.91613,1345,59,84,25,42.4
397040409,tx,-96.35554,32.92623,1738,59,84,25,42.4
397040410,tx,-96.33953,32.9552,1131,59,84,25,42.4
397040411,tx,-96.31444,32.95364,1104,59,84,25,42.4
397040412,tx,-96.31867,32.91614,713,59,84,25,42.4
397040503,tx,-96.44819,32.88665,2634,58,83,25,43.1
397040507,tx,-96.46517,32.86247,2017,58,84,26,44.8
397040508,tx,-96.41766,32.83654,1575,59,84,25,42.4
397040509,tx,-96.35405,32.83726,1280,58,84,26,44.8
397040510,tx,-96.49374,32.87229,1793,59,85,26,44.1
397040511,tx,-96.49598,32.83273,1567,61,86,25,41
397040512,tx,-96.42934,32.89592,1708,57,83,26,45.6
397040513,tx,-96.38942,32.8836,1702,58,84,26,44.8
397040514,tx,-96.32552,32.86235,1306,58,84,26,44.8
399950100,tx,-99.99099,31.96861,1836,33,58,25,75.8
399950200,tx,-99.96676,31.95577,1181,37,62,25,67.6
399950500,tx,-100.05909,31.65524,1732,42,66,24,57.1
399950600,tx,-99.89905,31.7639,3786,41,66,25,61
401950101,tx,-94.55507,32.32967,1968,60,86,26,43.3
401950102,tx,-94.65579,32.30386,1523,58,84,26,44.8
401950200,tx,-94.79445,32.3251,1563,58,84,26,44.8
401950300,tx,-94.8734,32.34736,3277,58,85,27,46.6
401950400,tx,-94.91714,32.2687,2708,57,84,27,47.4
401950501,tx,-94.77451,32.14991,3310,58,85,27,46.6
401950502,tx,-94.83623,32.22152,1663,58,85,27,46.6
401950600,tx,-94.657,32.10816,2510,60,86,26,43.3
401950700,tx,-94.79229,32.17592,1887,60,86,26,43.3
401950800,tx,-94.82015,32.15553,2288,60,86,26,43.3
401950900,tx,-94.7993,32.13917,1928,59,85,26,44.1
401951000,tx,-94.9459,32.12468,1505,58,85,27,46.6
401951100,tx,-94.8555,31.9447,3047,61,87,26,42.6
401951200,tx,-94.61152,31.90751,3103,62,89,27,43.5
403950100,tx,-93.86101,31.48991,5483,64,89,25,39.1
403950200,tx,-93.97682,31.29011,3140,67,91,24,35.8
403950300,tx,-93.77702,31.27801,7617,63,88,25,39.7
405950100,tx,-94.17178,31.51472,3676,66,90,24,36.4
405950200,tx,-94.12146,31.53217,1629,66,90,24,36.4
405950300,tx,-94.16689,31.26881,4170,69,93,24,34.8
407200103,tx,-94.95731,30.52233,2633,73,99,26,35.6
407200104,tx,-94.99891,30.45445,4912,71,97,26,36.6
407200105,tx,-95.11565,30.45147,2953,68,95,27,39.7
407200106,tx,-95.25527,30.42893,2455,69,96,27,39.1
407200107,tx,-95.26996,30.56357,2367,68,94,26,38.2
407200201,tx,-95.14641,30.58078,4397,69,95,26,37.7
407200202,tx,-95.05706,30.61825,3929,71,96,25,35.2
407200301,tx,-95.20377,30.71338,6807,70,95,25,35.7
407200302,tx,-95.28178,30.79598,9669,68,95,27,39.7
409010201,tx,-97.15678,27.89471,2598,62,95,33,53.2
409010202,tx,-97.16775,27.91475,2792,63,96,33,52.4
409010301,tx,-97.20392,27.901,1849,63,95,32,50.8
409010302,tx,-97.19911,27.8512,2506,63,95,32,50.8
409010500,tx,-97.28992,27.93466,981,64,97,33,51.6
409010601,tx,-97.34262,27.88402,2170,58,91,33,56.9
409010602,tx,-97.33391,27.90037,1009,59,92,33,55.9
409010603,tx,-97.30293,27.88534,1153,58,92,34,58.6
409010604,tx,-97.32827,27.8696,1283,58,91,33,56.9
409010700,tx,-97.35469,27.99205,3157,66,98,32,48.5
409010800,tx,-97.38496,27.98424,2028,73,104,31,42.5
409010900,tx,-97.5819,28.02172,3935,80,107,27,33.8
409011000,tx,-97.49215,28.02635,2988,78,105,27,34.6
409011100,tx,-97.58592,27.94498,1168,84,110,26,31
409011200,tx,-97.76385,28.04887,2708,79,106,27,34.2
409011300,tx,-97.82042,28.08536,2441,77,105,28,36.4
411950100,tx,-98.70651,31.2015,2023,48,72,24,50
411950200,tx,-98.81865,31.15473,6971,41,66,25,61
413950300,tx,-100.53855,30.89745,4295,16,38,22,137.5
415950100,tx,-100.83978,32.85021,4262,23,46,23,100
415950200,tx,-101.07808,32.72353,1928,22,44,22,100
415950300,tx,-100.93677,32.70029,2907,23,46,23,100
415950600,tx,-100.80598,32.61835,3817,23,46,23,100
417950300,tx,-99.35407,32.73597,5224,46,69,23,50
419950100,tx,-94.1098,31.92143,3993,67,91,24,35.8
419950200,tx,-94.39088,31.86342,3120,65,90,25,38.5
419950300,tx,-94.17113,31.82823,2999,68,92,24,35.3
419950401,tx,-94.17352,31.77701,1819,68,92,24,35.3
419950402,tx,-94.17722,31.80729,1195,68,92,24,35.3
419950500,tx,-94.22108,31.69605,2239,67,91,24,35.8
419950600,tx,-93.94916,31.70689,3487,66,90,24,36.4
421950200,tx,-101.89347,36.27767,3651,3,12,9,300
423000100,tx,-95.33319,32.36021,2425,55,83,28,50.9
423000201,tx,-95.31553,32.37711,1626,55,83,28,50.9
423000202,tx,-95.30943,32.36488,1243,55,83,28,50.9
423000300,tx,-95.28941,32.37725,2080,56,84,28,50
423000400,tx,-95.31935,32.3521,1245,55,84,29,52.7
423000500,tx,-95.30238,32.35092,1195,56,84,28,50
423000600,tx,-95.27921,32.35709,1041,56,84,28,50
423000700,tx,-95.32951,32.32551,2171,56,84,28,50
423000800,tx,-95.30515,32.33603,2262,56,84,28,50
423000900,tx,-95.28016,32.33944,1469,56,84,28,50
423001000,tx,-95.31285,32.31666,2383,56,84,28,50
423001101,tx,-95.29287,32.3201,1649,56,85,29,51.8
423001102,tx,-95.28915,32.30865,1130,57,85,28,49.1
423001200,tx,-95.27573,32.32472,1424,56,84,28,50
423001300,tx,-95.25918,32.32984,886,56,84,28,50
423001404,tx,-95.40037,32.56326,3773,58,85,27,46.6
423001405,tx,-95.54672,32.55848,3548,59,86,27,45.8
423001406,tx,-95.48085,32.45513,3692,55,83,28,50.9
423001407,tx,-95.36711,32.49924,2695,57,84,27,47.4
423001408,tx,-95.4372,32.44674,1532,55,83,28,50.9
423001501,tx,-95.07223,32.50154,1747,60,87,27,45
423001502,tx,-95.2166,32.50359,2900,58,85,27,46.6
423001602,tx,-95.39855,32.30474,2682,54,83,29,53.7
423001605,tx,-95.33765,32.43578,1713,55,83,28,50.9
423001606,tx,-95.39874,32.40522,2119,53,81,28,52.8
423001607,tx,-95.41219,32.34483,2188,53,82,29,54.7
423001608,tx,-95.35458,32.37629,1087,54,82,28,51.9
423001701,tx,-95.21683,32.41515,2352,57,85,28,49.1
423001702,tx,-95.27681,32.44364,1900,56,84,28,50
423001803,tx,-95.25197,32.30842,1682,57,85,28,49.1
423001804,tx,-95.09884,32.39686,3265,58,85,27,46.6
423001805,tx,-95.0593,32.326,2362,57,85,28,49.1
423001806,tx,-95.20236,32.33328,2429,57,85,28,49.1
423001807,tx,-95.21343,32.30766,1341,57,85,28,49.1
423001906,tx,-95.36997,32.2363,3179,56,84,28,50
423001909,tx,-95.31413,32.29666,988,57,85,28,49.1
423001910,tx,-95.311,32.28413,304,56,85,29,51.8
423001911,tx,-95.32282,32.28575,764,56,85,29,51.8
423001912,tx,-95.44286,32.15648,2478,59,87,28,47.5
423001913,tx,-95.44688,32.22232,8725,57,86,29,50.9
423001914,tx,-95.29799,32.16821,2191,57,85,28,49.1
423001915,tx,-95.37443,32.16802,4094,57,85,28,49.1
423001916,tx,-95.33285,32.25851,2502,56,84,28,50
423001917,tx,-95.3484,32.27829,1487,56,84,28,50
423002003,tx,-95.27202,32.30242,658,57,85,28,49.1
423002004,tx,-95.29309,32.29656,860,57,85,28,49.1
423002006,tx,-95.29673,32.277,1556,57,85,28,49.1
423002009,tx,-95.20719,32.22884,3374,59,86,27,45.8
423002010,tx,-95.25915,32.28764,1893,57,85,28,49.1
423002011,tx,-95.24539,32.25829,1372,57,85,28,49.1
423002012,tx,-95.29948,32.26387,1070,56,84,28,50
423002013,tx,-95.29859,32.23371,1561,57,85,28,49.1
423002101,tx,-95.06659,32.18378,3228,58,86,28,48.3
423002102,tx,-95.11312,32.25248,4151,58,85,27,46.6
423002200,tx,-95.23051,32.18127,3358,58,86,28,48.3
423980000,tx,-95.40218,32.35437,22,52,81,29,55.8
425000101,tx,-97.79423,32.25628,2428,61,84,23,37.7
425000102,tx,-97.75536,32.18827,2009,58,82,24,41.4
425000200,tx,-97.74978,32.23364,1194,61,84,23,37.7
427950101,tx,-98.60955,26.65606,1709,101,125,24,23.8
427950104,tx,-98.88949,26.45391,2502,110,132,22,20
427950105,tx,-98.91442,26.40396,1304,110,132,22,20
427950106,tx,-98.75578,26.3453,1254,111,133,22,19.8
427950107,tx,-98.78187,26.34997,1835,111,132,21,18.9
427950108,tx,-98.77854,26.47563,2398,109,131,22,20.2
427950202,tx,-98.98892,26.59698,2437,112,133,21,18.8
427950203,tx,-98.98697,26.41013,1308,112,133,21,18.8
427950204,tx,-98.95719,26.44387,2161,111,132,21,18.9
427950402,tx,-98.59867,26.40909,3205,106,128,22,20.8
427950403,tx,-98.72041,26.31506,874,109,131,22,20.2
427950404,tx,-98.64878,26.27824,2104,107,130,23,21.5
427950500,tx,-98.81125,26.38145,2138,111,132,21,18.9
427950601,tx,-98.84797,26.3833,1359,111,132,21,18.9
427950602,tx,-98.82613,26.37334,1402,111,132,21,18.9
427950701,tx,-99.01966,26.41377,1679,112,133,21,18.8
427950702,tx,-99.00229,26.40539,1104,111,133,22,19.8
429950200,tx,-98.93639,32.75266,1941,53,76,23,43.4
429950300,tx,-98.87104,32.73952,1929,52,75,23,44.2
429950500,tx,-98.83437,32.7356,4972,48,72,24,50
431950100,tx,-101.05001,31.82788,2002,22,45,23,104.5
433950300,tx,-100.25331,33.17912,3033,44,67,23,52.3
435950300,tx,-100.53819,30.49829,5516,25,50,25,100
437950200,tx,-101.74659,34.60673,2091,3,11,8,266.7
437950300,tx,-101.77262,34.52628,2770,4,12,8,200
437950400,tx,-101.71275,34.39145,1444,4,12,8,200
439100101,tx,-97.30024,32.78773,1752,59,82,23,39
439100102,tx,-97.31206,32.78338,1612,59,82,23,39
439100201,tx,-97.33153,32.80294,1480,59,82,23,39
439100202,tx,-97.33832,32.79589,2249,59,82,23,39
439100300,tx,-97.36292,32.81388,2308,59,82,23,39
439100401,tx,-97.36621,32.79322,663,59,82,23,39
439100402,tx,-97.3645,32.78608,1361,59,82,23,39
439100503,tx,-97.37876,32.78977,700,59,82,23,39
439100504,tx,-97.3902,32.7949,1591,58,82,24,41.4
439100505,tx,-97.38995,32.81574,659,58,82,24,41.4
439100506,tx,-97.37431,32.80368,1533,59,82,23,39
439100601,tx,-97.47825,32.82301,1356,58,81,23,39.7
439100602,tx,-97.43417,32.78134,984,57,81,24,42.1
439100700,tx,-97.38223,32.76899,1501,58,81,23,39.7
439100800,tx,-97.35682,32.77462,1673,58,82,24,41.4
439100900,tx,-97.3474,32.78012,939,59,82,23,39
439101201,tx,-97.25226,32.77627,1269,58,81,23,39.7
439101202,tx,-97.29723,32.76531,2111,58,81,23,39.7
439101301,tx,-97.21604,32.74152,1954,58,81,23,39.7
439101302,tx,-97.21602,32.72899,1473,58,82,24,41.4
439101401,tx,-97.24765,32.75245,1700,58,81,23,39.7
439101402,tx,-97.26153,32.73897,1350,58,81,23,39.7
439101403,tx,-97.24439,32.73857,1354,58,81,23,39.7
439101500,tx,-97.27642,32.74613,1630,57,81,24,42.1
439101700,tx,-97.31146,32.75199,604,58,81,23,39.7
439102000,tx,-97.35744,32.74965,896,58,81,23,39.7
439102101,tx,-97.37069,32.75433,986,58,81,23,39.7
439102102,tx,-97.37127,32.765,599,58,81,23,39.7
439102201,tx,-97.39112,32.7508,1314,57,81,24,42.1
439102202,tx,-97.39517,32.73945,1437,57,81,24,42.1
439102301,tx,-97.4408,32.72788,1431,56,80,24,42.9
439102302,tx,-97.44656,32.70512,2014,56,80,24,42.9
439102401,tx,-97.41828,32.7226,1254,57,80,23,40.4
439102402,tx,-97.43012,32.71179,1786,57,80,23,40.4
439102500,tx,-97.40442,32.72168,2454,57,80,23,40.4
439102601,tx,-97.39652,32.72801,1127,57,80,23,40.4
439102602,tx,-97.3817,32.73048,1678,57,81,24,42.1
439102700,tx,-97.37617,32.74081,1700,58,81,23,39.7
439103500,tx,-97.28179,32.73305,2147,58,82,24,41.4
439103601,tx,-97.24748,32.72611,1405,58,82,24,41.4
439103602,tx,-97.23119,32.72622,988,58,82,24,41.4
439103701,tx,-97.28013,32.72289,1507,58,82,24,41.4
439103702,tx,-97.26346,32.72337,1079,58,82,24,41.4
439103800,tx,-97.30238,32.72131,1846,58,82,24,41.4
439104100,tx,-97.33766,32.72322,1293,58,81,23,39.7
439104202,tx,-97.36911,32.69472,1305,57,80,23,40.4
439104203,tx,-97.36637,32.70652,191,57,80,23,40.4
439104204,tx,-97.36123,32.71702,1016,57,80,23,40.4
439104301,tx,-97.35642,32.70535,1002,57,80,23,40.4
439104302,tx,-97.34817,32.71598,932,57,81,24,42.1
439104400,tx,-97.33782,32.70837,1884,58,81,23,39.7
439104502,tx,-97.32578,32.70675,1337,58,81,23,39.7
439104503,tx,-97.32615,32.69144,1013,58,81,23,39.7
439104504,tx,-97.31126,32.69138,1292,58,81,23,39.7
439104505,tx,-97.31211,32.70824,1757,58,81,23,39.7
439104601,tx,-97.27008,32.71152,1519,58,82,24,41.4
439104602,tx,-97.27265,32.69915,1512,58,82,24,41.4
439104603,tx,-97.27022,32.68545,1329,58,82,24,41.4
439104604,tx,-97.28861,32.71181,1073,58,82,24,41.4
439104605,tx,-97.29299,32.6954,1609,58,82,24,41.4
439104701,tx,-97.33603,32.69172,1336,58,81,23,39.7
439104702,tx,-97.33298,32.67405,920,57,81,24,42.1
439104802,tx,-97.35134,32.67783,1484,57,81,24,42.1
439104803,tx,-97.34602,32.69572,1523,58,81,23,39.7
439104804,tx,-97.35621,32.6902,912,57,81,24,42.1
439104900,tx,-97.29789,32.80235,1011,59,82,23,39
439105007,tx,-97.30161,32.85015,1093,58,81,23,39.7
439105008,tx,-97.32498,32.85002,2025,59,82,23,39
439105009,tx,-97.32238,32.8231,2254,59,82,23,39
439105201,tx,-97.45853,32.73098,906,56,80,24,42.9
439105203,tx,-97.46809,32.72072,730,56,80,24,42.9
439105204,tx,-97.47759,32.73138,149,56,80,24,42.9
439105206,tx,-97.47065,32.72789,250,56,80,24,42.9
439105207,tx,-97.47029,32.73497,25,55,79,24,43.6
439105403,tx,-97.37686,32.71276,1436,57,80,23,40.4
439105404,tx,-97.38373,32.68618,1560,56,80,24,42.9
439105405,tx,-97.40156,32.70056,1027,57,80,23,40.4
439105407,tx,-97.41822,32.70172,71,57,80,23,40.4
439105408,tx,-97.4278,32.69668,751,57,80,23,40.4
439105502,tx,-97.3793,32.66282,1904,56,80,24,42.9
439105503,tx,-97.39702,32.65339,1899,56,80,24,42.9
439105505,tx,-97.39344,32.67106,1119,56,80,24,42.9
439105511,tx,-97.37956,32.63497,1762,56,80,24,42.9
439105512,tx,-97.38364,32.64525,1652,56,80,24,42.9
439105513,tx,-97.41485,32.66871,50,56,80,24,42.9
439105514,tx,-97.40505,32.67518,90,56,80,24,42.9
439105515,tx,-97.40411,32.63804,1600,56,80,24,42.9
439105516,tx,-97.39833,32.63031,776,56,80,24,42.9
439105517,tx,-97.40885,32.65526,323,56,80,24,42.9
439105518,tx,-97.4202,32.65458,937,56,80,24,42.9
439105519,tx,-97.42455,32.67381,957,56,80,24,42.9
439105520,tx,-97.43774,32.65714,1172,56,80,24,42.9
439105600,tx,-97.36707,32.67671,2004,56,80,24,42.9
439105701,tx,-97.36115,32.66347,1288,56,80,24,42.9
439105703,tx,-97.36397,32.65474,1118,56,80,24,42.9
439105705,tx,-97.36445,32.64214,1092,56,80,24,42.9
439105706,tx,-97.35389,32.64162,1105,56,80,24,42.9
439105800,tx,-97.34278,32.66538,1202,57,81,24,42.1
439105901,tx,-97.31961,32.67703,1005,57,81,24,42.1
439105902,tx,-97.29541,32.6752,376,58,82,24,41.4
439106002,tx,-97.30419,32.64867,1362,58,82,24,41.4
439106004,tx,-97.27959,32.62324,2365,58,82,24,41.4
439106005,tx,-97.32621,32.64843,1146,58,82,24,41.4
439106006,tx,-97.34074,32.64193,1331,58,82,24,41.4
439106101,tx,-97.25076,32.69108,606,58,82,24,41.4
439106102,tx,-97.25101,32.67662,460,58,82,24,41.4
439106201,tx,-97.25866,32.70801,1408,58,82,24,41.4
439106202,tx,-97.24639,32.70704,1306,58,82,24,41.4
439106300,tx,-97.23846,32.71547,1533,58,82,24,41.4
439106400,tx,-97.22606,32.69723,977,58,82,24,41.4
439106502,tx,-97.22636,32.75417,1037,58,81,23,39.7
439106503,tx,-97.20833,32.75247,1642,58,82,24,41.4
439106507,tx,-97.25081,32.76446,645,58,81,23,39.7
439106509,tx,-97.15914,32.78907,1389,57,81,24,42.1
439106512,tx,-97.19053,32.75252,1067,58,82,24,41.4
439106513,tx,-97.19082,32.73759,1037,58,82,24,41.4
439106514,tx,-97.17258,32.7505,1073,57,81,24,42.1
439106515,tx,-97.22709,32.77104,751,58,81,23,39.7
439106518,tx,-97.04631,32.82307,199,58,81,23,39.7
439106519,tx,-97.21986,32.76465,174,58,82,24,41.4
439106520,tx,-97.2318,32.76237,33,58,81,23,39.7
439106521,tx,-97.18369,32.76951,1797,58,81,23,39.7
439106522,tx,-97.20437,32.76968,897,58,82,24,41.4
439106523,tx,-97.06726,32.82475,98,57,81,24,42.1
439106524,tx,-97.10748,32.81319,1615,57,81,24,42.1
439106525,tx,-97.20007,32.80401,704,58,81,23,39.7
439106526,tx,-97.19509,32.79087,2451,58,81,23,39.7
439106600,tx,-97.42769,32.80243,96,58,81,23,39.7
439106700,tx,-97.44619,32.84489,939,58,81,23,39.7
439110102,tx,-97.26522,32.8079,1217,58,82,24,41.4
439110103,tx,-97.26847,32.82878,913,58,81,23,39.7
439110104,tx,-97.25945,32.8298,632,58,81,23,39.7
439110202,tx,-97.28184,32.80235,1428,59,82,23,39
439110204,tx,-97.28169,32.82479,2340,58,82,24,41.4
439110205,tx,-97.28373,32.84933,1229,58,81,23,39.7
439110206,tx,-97.27181,32.85173,912,58,81,23,39.7
439110301,tx,-97.25711,32.79271,1730,58,82,24,41.4
439110302,tx,-97.2825,32.78777,1732,59,82,23,39
439110401,tx,-97.43055,32.81297,2238,58,81,23,39.7
439110402,tx,-97.40206,32.80274,1762,58,81,23,39.7
439110500,tx,-97.39843,32.77667,2975,58,81,23,39.7
439110600,tx,-97.42382,32.75986,1099,57,81,24,42.1
439110703,tx,-97.47031,32.74808,1888,55,79,24,43.6
439110704,tx,-97.45038,32.74767,1412,55,79,24,43.6
439110705,tx,-97.46594,32.77232,1409,56,79,23,41.1
439110706,tx,-97.4658,32.76139,1409,55,79,24,43.6
439110805,tx,-97.49199,32.74923,2391,55,78,23,41.8
439110806,tx,-97.52786,32.75569,2220,55,78,23,41.8
439110807,tx,-97.51547,32.72656,3180,55,79,24,43.6
439110808,tx,-97.51833,32.67454,2565,56,80,24,42.9
439110809,tx,-97.4975,32.66253,1111,57,80,23,40.4
439110901,tx,-97.46256,32.70573,2102,56,80,24,42.9
439110903,tx,-97.41796,32.68799,585,56,80,24,42.9
439110905,tx,-97.44508,32.67723,2122,57,81,24,42.1
439110906,tx,-97.47682,32.65068,1948,57,81,24,42.1
439110907,tx,-97.47885,32.67303,1270,57,80,23,40.4
439111003,tx,-97.34062,32.65553,1446,57,81,24,42.1
439111010,tx,-97.49037,32.59947,2635,56,79,23,41.1
439111015,tx,-97.35151,32.56989,1126,57,81,24,42.1
439111018,tx,-97.42624,32.57365,1171,56,80,24,42.9
439111019,tx,-97.33607,32.62288,2216,58,82,24,41.4
439111020,tx,-97.34838,32.62848,1069,57,81,24,42.1
439111021,tx,-97.37221,32.59374,1538,56,81,25,44.6
439111022,tx,-97.37353,32.56553,2663,57,81,24,42.1
439111023,tx,-97.37238,32.6113,2112,56,80,24,42.9
439111024,tx,-97.37758,32.6218,1450,56,80,24,42.9
439111025,tx,-97.3628,32.63101,1123,56,80,24,42.9
439111026,tx,-97.36207,32.62219,1679,56,80,24,42.9
439111027,tx,-97.33399,32.60073,1276,58,82,24,41.4
439111028,tx,-97.34379,32.58619,2319,58,82,24,41.4
439111029,tx,-97.3398,32.56503,2576,58,82,24,41.4
439111030,tx,-97.32671,32.56004,1546,58,82,24,41.4
439111031,tx,-97.42012,32.61294,1485,56,80,24,42.9
439111032,tx,-97.39944,32.62246,2456,56,80,24,42.9
439111033,tx,-97.40203,32.60238,2084,56,80,24,42.9
439111102,tx,-97.2633,32.65463,2403,58,82,24,41.4
439111103,tx,-97.25863,32.6685,1485,58,82,24,41.4
439111104,tx,-97.27502,32.67094,1242,58,82,24,41.4
439111202,tx,-97.28279,32.6296,2117,58,82,24,41.4
439111203,tx,-97.28608,32.591,2955,58,82,24,41.4
439111204,tx,-97.27853,32.56603,2496,58,82,24,41.4
439111304,tx,-97.12537,32.59411,2470,61,85,24,39.3
439111306,tx,-97.16038,32.56779,2021,60,84,24,40
439111307,tx,-97.14585,32.58473,596,61,84,23,37.7
439111308,tx,-97.13175,32.57068,717,61,85,24,39.3
439111309,tx,-97.12549,32.55766,1392,62,85,23,37.1
439111311,tx,-97.1009,32.59726,2171,62,86,24,38.7
439111312,tx,-97.10724,32.56961,1508,62,85,23,37.1
439111314,tx,-97.06744,32.55684,2194,63,86,23,36.5
439111315,tx,-97.08598,32.59923,1420,64,87,23,35.9
439111316,tx,-97.09144,32.61468,2185,63,86,23,36.5
439111317,tx,-97.21919,32.57432,2216,59,83,24,40.7
439111318,tx,-97.20403,32.59176,2254,59,83,24,40.7
439111319,tx,-97.07886,32.57431,2089,64,87,23,35.9
439111320,tx,-97.04688,32.57085,1947,64,88,24,37.5
439111402,tx,-97.17001,32.64202,2215,59,83,24,40.7
439111405,tx,-97.22974,32.63313,1433,58,82,24,41.4
439111406,tx,-97.15989,32.60415,1691,60,84,24,40
439111407,tx,-97.14816,32.62747,1526,60,84,24,40
439111408,tx,-97.19143,32.62021,1597,58,82,24,41.4
439111409,tx,-97.15439,32.63594,2100,59,83,24,40.7
439111410,tx,-97.21317,32.66502,462,58,82,24,41.4
439111411,tx,-97.20766,32.64495,2163,58,82,24,41.4
439111505,tx,-97.1575,32.72843,1287,57,81,24,42.1
439111506,tx,-97.16157,32.71574,1855,57,81,24,42.1
439111513,tx,-97.07027,32.66403,1346,61,84,23,37.7
439111514,tx,-97.0842,32.66322,2264,61,84,23,37.7
439111516,tx,-97.12451,32.66615,1889,59,83,24,40.7
439111522,tx,-97.08916,32.69892,2176,58,81,23,39.7
439111525,tx,-97.11426,32.68391,1773,59,83,24,40.7
439111526,tx,-97.13464,32.70314,1563,57,81,24,42.1
439111529,tx,-97.17527,32.69757,1503,58,81,23,39.7
439111530,tx,-97.15071,32.66699,2338,59,82,23,39
439111531,tx,-97.17747,32.6687,1827,58,82,24,41.4
439111532,tx,-97.19759,32.65889,2783,58,82,24,41.4
439111533,tx,-97.1489,32.6544,1634,59,82,23,39
439111534,tx,-97.17819,32.65481,2501,58,82,24,41.4
439111536,tx,-97.04905,32.69876,576,60,83,23,38.3
439111538,tx,-97.04828,32.67127,1334,62,85,23,37.1
439111540,tx,-97.10115,32.66477,1662,60,83,23,38.3
439111541,tx,-97.10978,32.6523,1389,60,84,24,40
439111542,tx,-97.1088,32.63565,1975,61,84,23,37.7
439111543,tx,-97.12496,32.65021,1561,60,83,23,38.3
439111544,tx,-97.12525,32.63561,2518,61,84,23,37.7
439111545,tx,-97.15856,32.69361,927,58,82,24,41.4
439111546,tx,-97.17614,32.68121,2421,58,82,24,41.4
439111551,tx,-97.13309,32.60463,2082,61,85,24,39.3
439111552,tx,-97.13938,32.69369,1393,58,81,23,39.7
439111553,tx,-97.1399,32.68242,748,59,82,23,39
439111554,tx,-97.0491,32.66146,1561,62,85,23,37.1
439111555,tx,-97.05144,32.65303,1527,63,86,23,36.5
439111556,tx,-97.06702,32.69875,1275,58,81,23,39.7
439111557,tx,-97.07632,32.69876,780,58,81,23,39.7
439111558,tx,-97.10578,32.69959,1408,57,81,24,42.1
439111559,tx,-97.11806,32.69628,224,57,81,24,42.1
439111560,tx,-97.09541,32.63764,1889,63,86,23,36.5
439111561,tx,-97.08247,32.63947,1475,63,86,23,36.5
439111562,tx,-97.07435,32.63178,1567,63,86,23,36.5
439111563,tx,-97.05123,32.64119,1498,65,88,23,35.4
439111564,tx,-97.06124,32.61696,1275,64,87,23,35.9
439111565,tx,-97.06241,32.59198,1589,64,87,23,35.9
439111566,tx,-97.04466,32.60657,1900,65,88,23,35.4
439111567,tx,-97.12756,32.619,1609,61,84,23,37.7
439111568,tx,-97.1086,32.61895,2218,61,84,23,37.7
439111569,tx,-97.08803,32.68498,920,61,84,23,37.7
439111570,tx,-97.07078,32.68418,636,61,84,23,37.7
439111571,tx,-97.05268,32.68441,845,62,85,23,37.1
439111572,tx,-97.04038,32.68367,681,62,85,23,37.1
439113003,tx,-97.04872,32.78861,542,58,82,24,41.4
439113004,tx,-97.04257,32.76931,911,58,82,24,41.4
439113005,tx,-97.04989,32.75038,885,58,81,23,39.7
439113006,tx,-97.05117,32.73147,234,59,83,24,40.7
439113007,tx,-97.04122,32.7218,823,59,83,24,40.7
439113102,tx,-97.11725,32.79112,906,57,81,24,42.1
439113104,tx,-97.08844,32.77783,338,57,81,24,42.1
439113107,tx,-97.11903,32.76975,1066,57,80,23,40.4
439113108,tx,-97.13646,32.77007,1845,57,80,23,40.4
439113109,tx,-97.0758,32.76587,804,57,80,23,40.4
439113110,tx,-97.09134,32.76739,351,57,80,23,40.4
439113112,tx,-97.10922,32.76791,584,57,80,23,40.4
439113115,tx,-97.0687,32.77237,285,57,81,24,42.1
439113116,tx,-97.065,32.77991,247,57,81,24,42.1
439113117,tx,-97.10143,32.77277,123,57,80,23,40.4
439113118,tx,-97.10043,32.76559,33,57,80,23,40.4
439113119,tx,-97.07445,32.7854,410,57,81,24,42.1
439113120,tx,-97.08005,32.80065,2958,57,81,24,42.1
439113121,tx,-97.05674,32.79935,4,58,82,24,41.4
439113122,tx,-97.05942,32.80064,28,57,81,24,42.1
439113206,tx,-97.24876,32.8182,1562,58,81,23,39.7
439113207,tx,-97.22494,32.88722,1550,57,80,23,40.4
439113210,tx,-97.20229,32.88288,2986,57,80,23,40.4
439113212,tx,-97.24335,32.83152,1410,58,81,23,39.7
439113213,tx,-97.22234,32.83122,1249,58,81,23,39.7
439113214,tx,-97.23189,32.87169,1931,57,80,23,40.4
439113215,tx,-97.21919,32.87079,1831,57,80,23,40.4
439113216,tx,-97.2277,32.85377,1718,58,81,23,39.7
439113217,tx,-97.2224,32.84338,1396,57,81,24,42.1
439113218,tx,-97.19518,32.8659,1294,57,80,23,40.4
439113221,tx,-97.20266,32.85384,1566,57,81,24,42.1
439113222,tx,-97.19788,32.84077,92,57,81,24,42.1
439113223,tx,-97.20854,32.84057,826,57,81,24,42.1
439113301,tx,-97.22546,32.81568,1659,58,81,23,39.7
439113302,tx,-97.23115,32.80376,1402,58,81,23,39.7
439113403,tx,-97.1945,32.83012,1048,57,81,24,42.1
439113404,tx,-97.17601,32.83136,1835,58,81,23,39.7
439113407,tx,-97.1586,32.81498,1065,58,81,23,39.7
439113408,tx,-97.17619,32.81533,2099,58,81,23,39.7
439113409,tx,-97.19803,32.81192,952,58,81,23,39.7
439113410,tx,-97.20139,32.81881,522,57,81,24,42.1
439113509,tx,-97.09133,32.84481,1342,57,81,24,42.1
439113510,tx,-97.07226,32.84441,1683,57,81,24,42.1
439113511,tx,-97.11515,32.82388,1429,57,81,24,42.1
439113512,tx,-97.12185,32.83108,1607,57,81,24,42.1
439113513,tx,-97.07872,32.82923,1800,57,81,24,42.1
439113514,tx,-97.09194,32.83134,1267,57,81,24,42.1
439113516,tx,-97.09098,32.85937,1450,57,81,24,42.1
439113517,tx,-97.07813,32.85867,937,57,81,24,42.1
439113519,tx,-97.09019,32.87306,2206,58,81,23,39.7
439113520,tx,-97.07452,32.872,1007,58,81,23,39.7
439113521,tx,-97.07132,32.8587,8,57,81,24,42.1
439113522,tx,-97.06723,32.85623,103,58,81,23,39.7
439113607,tx,-97.15988,32.8324,1193,58,81,23,39.7
439113611,tx,-97.17857,32.87095,1842,57,81,24,42.1
439113612,tx,-97.16999,32.86005,1972,58,81,23,39.7
439113613,tx,-97.17693,32.84572,1758,58,81,23,39.7
439113618,tx,-97.14411,32.82977,1971,58,81,23,39.7
439113619,tx,-97.14473,32.81822,366,58,81,23,39.7
439113622,tx,-97.12947,32.87427,2789,57,81,24,42.1
439113623,tx,-97.11581,32.86287,1489,57,81,24,42.1
439113624,tx,-97.11583,32.85558,1593,57,81,24,42.1
439113625,tx,-97.14548,32.8638,1268,57,81,24,42.1
439113626,tx,-97.14605,32.8565,1474,58,81,23,39.7
439113628,tx,-97.11685,32.84114,782,57,81,24,42.1
439113629,tx,-97.14835,32.84385,1165,58,81,23,39.7
439113630,tx,-97.14302,32.84774,1048,57,81,24,42.1
439113632,tx,-97.11434,32.90352,1832,57,81,24,42.1
439113633,tx,-97.11225,32.88746,1510,57,81,24,42.1
439113634,tx,-97.136,32.89412,2071,57,81,24,42.1
439113635,tx,-97.11097,32.91515,787,57,81,24,42.1
439113636,tx,-97.10178,32.91478,179,57,81,24,42.1
439113637,tx,-97.12345,32.84844,683,57,81,24,42.1
439113638,tx,-97.10695,32.84812,542,57,81,24,42.1
439113639,tx,-97.1679,32.89089,3067,57,81,24,42.1
439113640,tx,-97.16192,32.9112,2368,57,80,23,40.4
439113707,tx,-97.10801,32.96715,2025,58,81,23,39.7
439113709,tx,-97.091,32.89543,1895,58,81,23,39.7
439113710,tx,-97.09681,32.96043,996,58,81,23,39.7
439113711,tx,-97.09855,32.94708,1324,58,81,23,39.7
439113712,tx,-97.07645,32.9323,1751,58,81,23,39.7
439113713,tx,-97.10742,32.92895,404,57,81,24,42.1
439113714,tx,-97.08188,32.96272,1384,58,81,23,39.7
439113715,tx,-97.05622,32.97497,606,58,81,23,39.7
439113716,tx,-97.06663,32.95277,655,58,81,23,39.7
439113803,tx,-97.24938,32.88734,2039,57,80,23,40.4
439113808,tx,-97.2485,32.87533,2380,57,80,23,40.4
439113809,tx,-97.25264,32.86549,1807,57,80,23,40.4
439113810,tx,-97.2495,32.85504,1979,57,81,24,42.1
439113811,tx,-97.25489,32.84536,1011,58,81,23,39.7
439113812,tx,-97.24697,32.9034,1926,57,80,23,40.4
439113813,tx,-97.22607,32.9004,1777,57,80,23,40.4
439113814,tx,-97.19822,32.89923,1740,57,80,23,40.4
439113815,tx,-97.20474,32.91586,2144,57,80,23,40.4
439113816,tx,-97.23624,32.91898,1925,57,80,23,40.4
439113906,tx,-97.1698,32.96171,2799,57,80,23,40.4
439113908,tx,-97.17036,32.93152,1924,57,80,23,40.4
439113912,tx,-97.20166,32.93628,2430,57,80,23,40.4
439113916,tx,-97.29837,32.86683,1261,58,81,23,39.7
439113917,tx,-97.2728,32.86667,2263,58,81,23,39.7
439113918,tx,-97.28547,32.87051,1534,58,81,23,39.7
439113919,tx,-97.27997,32.88365,2440,58,81,23,39.7
439113920,tx,-97.26631,32.88559,1763,58,81,23,39.7
439113923,tx,-97.31146,32.87926,847,58,81,23,39.7
439113924,tx,-97.29961,32.88798,1646,58,81,23,39.7
439113925,tx,-97.29598,32.87835,1337,58,81,23,39.7
439113930,tx,-97.33539,32.88219,3972,58,82,24,41.4
439113931,tx,-97.32352,32.90635,3360,59,82,23,39
439113932,tx,-97.33163,32.9548,3122,59,82,23,39
439113933,tx,-97.31147,32.92703,85,59,82,23,39
439113934,tx,-97.29748,32.92811,2074,58,81,23,39.7
439113935,tx,-97.28863,32.92577,1062,58,81,23,39.7
439113936,tx,-97.29725,32.90668,2102,58,81,23,39.7
439113937,tx,-97.31188,32.90561,76,59,82,23,39
439113938,tx,-97.30096,32.89807,597,58,81,23,39.7
439113939,tx,-97.29136,32.9448,1006,58,81,23,39.7
439113940,tx,-97.29641,32.9559,2503,58,81,23,39.7
439113941,tx,-97.28269,32.97965,1675,58,81,23,39.7
439113942,tx,-97.27266,32.9661,2019,58,81,23,39.7
439113943,tx,-97.25605,32.96897,1876,57,81,24,42.1
439113944,tx,-97.27482,32.94767,1498,58,81,23,39.7
439113945,tx,-97.26224,32.94507,1166,58,81,23,39.7
439113946,tx,-97.28119,32.8975,1243,58,81,23,39.7
439113947,tx,-97.28179,32.90724,1261,58,81,23,39.7
439113948,tx,-97.26499,32.90337,1334,57,80,23,40.4
439113949,tx,-97.27943,32.91756,1013,58,81,23,39.7
439113950,tx,-97.26684,32.92667,2421,58,81,23,39.7
439113951,tx,-97.23738,32.93062,1241,57,80,23,40.4
439113952,tx,-97.23411,32.94072,1813,57,80,23,40.4
439113953,tx,-97.23121,32.96701,2670,57,81,24,42.1
439113954,tx,-97.19736,32.9696,1822,57,80,23,40.4
439113955,tx,-97.13907,32.98034,1258,57,81,24,42.1
439113956,tx,-97.13477,32.95504,1940,57,81,24,42.1
439113957,tx,-97.13554,32.93359,1628,57,81,24,42.1
439113958,tx,-97.14177,32.92174,878,57,81,24,42.1
439114003,tx,-97.35425,32.86606,3377,58,82,24,41.4
439114006,tx,-97.37474,32.85344,2304,59,82,23,39
439114009,tx,-97.41398,32.8609,2861,58,81,23,39.7
439114010,tx,-97.40493,32.83755,2200,58,81,23,39.7
439114011,tx,-97.41762,32.8347,2438,58,81,23,39.7
439114012,tx,-97.40631,32.87296,3725,58,82,24,41.4
439114013,tx,-97.37825,32.84001,2112,59,82,23,39
439114014,tx,-97.38381,32.86915,2367,59,82,23,39
439114015,tx,-97.37232,32.86457,782,59,82,23,39
439114105,tx,-97.46622,32.95492,2228,60,83,23,38.3
439114106,tx,-97.42729,32.90491,2601,59,82,23,39
439114107,tx,-97.46268,32.87245,1624,59,82,23,39
439114108,tx,-97.46789,32.89171,2231,59,82,23,39
439114109,tx,-97.36157,32.90308,5589,59,82,23,39
439114110,tx,-97.39392,32.92588,3995,59,82,23,39
439114111,tx,-97.37345,32.95183,1381,59,82,23,39
439114112,tx,-97.40523,32.98012,1840,59,82,23,39
439114113,tx,-97.36243,32.9822,1832,60,82,22,36.7
439114203,tx,-97.52328,32.94762,3711,61,83,22,36.1
439114204,tx,-97.52364,32.89512,2847,60,83,23,38.3
439114205,tx,-97.53312,32.87343,1658,60,83,23,38.3
439114206,tx,-97.52034,32.8403,1874,59,82,23,39
439114207,tx,-97.51554,32.7942,3166,56,80,24,42.9
439121605,tx,-97.12594,32.74739,1210,56,80,24,42.9
439121606,tx,-97.18824,32.71924,1308,58,81,23,39.7
439121608,tx,-97.18988,32.70045,2109,58,82,24,41.4
439121609,tx,-97.2128,32.68993,2267,58,82,24,41.4
439121610,tx,-97.1943,32.68772,909,58,82,24,41.4
439121611,tx,-97.21102,32.67588,1705,58,82,24,41.4
439121612,tx,-97.16173,32.74401,1167,57,81,24,42.1
439121613,tx,-97.14723,32.74291,1361,57,81,24,42.1
439121614,tx,-97.13774,32.73833,392,56,80,24,42.9
439121615,tx,-97.13871,32.75291,1267,57,80,23,40.4
439121702,tx,-97.0814,32.74983,554,57,80,23,40.4
439121703,tx,-97.11527,32.75139,754,56,80,24,42.9
439121704,tx,-97.10412,32.75288,857,56,80,24,42.9
439121904,tx,-97.05849,32.72125,736,58,82,24,41.4
439121905,tx,-97.07208,32.70961,162,58,81,23,39.7
439121906,tx,-97.07126,32.71695,471,58,81,23,39.7
439121907,tx,-97.05154,32.72433,384,60,83,23,38.3
439121908,tx,-97.05178,32.71421,59,60,83,23,38.3
439122001,tx,-97.07131,32.7244,1007,58,81,23,39.7
439122002,tx,-97.07146,32.73161,1022,57,81,24,42.1
439122100,tx,-97.08323,32.73232,2220,57,81,24,42.1
439122200,tx,-97.10819,32.74035,647,56,80,24,42.9
439122300,tx,-97.10984,32.73297,634,57,81,24,42.1
439122401,tx,-97.10576,32.72444,469,57,81,24,42.1
439122402,tx,-97.12415,32.72746,742,57,81,24,42.1
439122500,tx,-97.14029,32.72805,1572,57,81,24,42.1
439122600,tx,-97.14013,32.71436,1343,57,81,24,42.1
439122701,tx,-97.11899,32.71494,462,57,81,24,42.1
439122702,tx,-97.12685,32.71323,810,57,81,24,42.1
439122801,tx,-97.11188,32.71408,287,57,81,24,42.1
439122802,tx,-97.10353,32.71329,1028,57,81,24,42.1
439122901,tx,-97.08891,32.71734,1088,58,81,23,39.7
439122902,tx,-97.08904,32.70996,737,58,81,23,39.7
439123001,tx,-97.43024,32.74424,625,57,80,23,40.4
439123002,tx,-97.41554,32.7427,641,57,81,24,42.1
439123100,tx,-97.30872,32.73857,2420,58,82,24,41.4
439123200,tx,-97.32842,32.76957,1430,58,82,24,41.4
439123301,tx,-97.34505,32.74538,431,58,82,24,41.4
439123302,tx,-97.32839,32.75261,502,58,82,24,41.4
439123500,tx,-97.31725,32.72529,2043,58,81,23,39.7
439123600,tx,-97.32831,32.73019,1084,58,82,24,41.4
439123700,tx,-97.34444,32.73291,1633,58,81,23,39.7
439980000,tx,-97.05417,32.89651,199,58,82,24,41.4
441010100,tx,-99.70405,32.46985,1712,29,54,25,86.2
441010200,tx,-99.72943,32.48101,950,31,55,24,77.4
441010300,tx,-99.75255,32.4836,646,31,55,24,77.4
441010400,tx,-99.74861,32.47437,1179,30,54,24,80
441010500,tx,-99.76685,32.47446,1119,30,54,24,80
441010600,tx,-99.76968,32.46582,1515,30,54,24,80
441010700,tx,-99.74895,32.46554,1394,30,54,24,80
441010800,tx,-99.72859,32.46573,1141,30,54,24,80
441010900,tx,-99.70354,32.44807,2239,29,53,24,82.8
441011000,tx,-99.73195,32.45466,1039,30,54,24,80
441011200,tx,-99.74939,32.45563,1108,30,54,24,80
441011300,tx,-99.77153,32.45657,1475,30,55,25,83.3
441011400,tx,-99.77898,32.44208,1834,29,54,25,86.2
441011500,tx,-99.76482,32.44117,1441,29,53,24,82.8
441011600,tx,-99.75118,32.43774,1217,28,53,25,89.3
441011700,tx,-99.74159,32.44624,1292,30,54,24,80
441011900,tx,-99.73475,32.43712,1305,28,52,24,85.7
441012000,tx,-99.7114,32.42105,1163,28,52,24,85.7
441012100,tx,-99.7167,32.41958,36,28,52,24,85.7
441012200,tx,-99.73383,32.41058,1358,28,52,24,85.7
441012300,tx,-99.75082,32.42419,1504,28,52,24,85.7
441012400,tx,-99.75148,32.40584,1226,28,52,24,85.7
441012500,tx,-99.76474,32.41983,1284,28,53,25,89.3
441012600,tx,-99.77519,32.42381,1268,29,53,24,82.8
441012701,tx,-99.76252,32.38116,2064,27,51,24,88.9
441012702,tx,-99.75502,32.3896,1454,27,51,24,88.9
441012801,tx,-99.76896,32.40098,453,28,52,24,85.7
441012802,tx,-99.78765,32.40807,713,29,53,24,82.8
441012900,tx,-99.82042,32.41929,2,30,55,25,83.3
441013000,tx,-99.84229,32.42352,37,31,56,25,80.6
441013100,tx,-99.80945,32.45556,2193,30,54,24,80
441013200,tx,-99.83081,32.48582,1629,32,57,25,78.1
441013300,tx,-99.67992,32.49094,2379,31,56,25,80.6
441013401,tx,-99.79979,32.42373,1099,29,53,24,82.8
441013402,tx,-99.80497,32.36459,3870,27,52,25,92.6
441013404,tx,-99.67982,32.3712,4929,26,51,25,96.2
441013501,tx,-99.92619,32.17206,3524,27,51,24,88.9
441013502,tx,-99.73301,32.25164,4399,25,49,24,96
441013601,tx,-100.00418,32.46394,2281,34,58,24,70.6
441013602,tx,-100.01625,32.39383,3205,30,54,24,80
441980000,tx,-99.68411,32.41117,6,28,52,24,85.7
443950100,tx,-102.07649,30.22496,5450,25,48,23,92
445950100,tx,-102.33727,33.17389,3485,5,16,11,220
445950300,tx,-102.28879,33.17634,1991,5,16,11,220
445950400,tx,-102.24337,33.1686,3366,5,16,11,220
447950300,tx,-99.21237,33.17749,3651,54,75,21,38.9
449950100,tx,-94.98967,33.33489,2283,62,87,25,40.3
449950200,tx,-95.07878,33.14849,2288,62,87,25,40.3
449950301,tx,-94.92316,33.26105,2506,65,89,24,36.9
449950302,tx,-94.99861,33.15801,2427,65,89,24,36.9
449950400,tx,-94.86795,33.13185,4115,65,89,24,36.9
449950500,tx,-94.94973,33.16794,1317,67,90,23,34.3
449950600,tx,-94.98344,33.16759,1504,66,90,24,36.4
449950700,tx,-94.97544,33.14743,885,66,90,24,36.4
449950800,tx,-94.95295,33.14389,1760,67,90,23,34.3
451000100,tx,-100.47178,31.50308,1107,30,54,24,80
451000200,tx,-100.45018,31.5105,2115,30,54,24,80
451000300,tx,-100.40524,31.50111,2717,30,55,25,83.3
451000400,tx,-100.44309,31.48169,2961,30,55,25,83.3
451000700,tx,-100.40489,31.46263,1744,31,55,24,77.4
451000801,tx,-100.40508,31.41276,2095,30,55,25,83.3
451000802,tx,-100.39801,31.44669,1608,30,55,25,83.3
451000900,tx,-100.43128,31.45248,1393,31,55,24,77.4
451001000,tx,-100.45631,31.44894,2463,31,55,24,77.4
451001101,tx,-100.49928,31.44397,2309,29,54,25,86.2
451001102,tx,-100.46239,31.45921,2074,31,55,24,77.4
451001200,tx,-100.47702,31.46873,2875,30,54,24,80
451001301,tx,-100.4664,31.43639,1856,29,54,25,86.2
451001303,tx,-100.49113,31.42966,1318,29,54,25,86.2
451001304,tx,-100.47352,31.4236,694,29,54,25,86.2
451001401,tx,-100.44892,31.42017,820,29,54,25,86.2
451001402,tx,-100.43808,31.43652,1332,29,54,25,86.2
451001500,tx,-100.40442,31.43218,4,29,54,25,86.2
451001600,tx,-100.26724,31.38287,4906,32,57,25,78.1
451001702,tx,-100.54851,31.57825,2372,27,52,25,92.6
451001706,tx,-100.48666,31.41536,1145,29,54,25,86.2
451001707,tx,-100.50442,31.4157,2448,29,54,25,86.2
451001708,tx,-100.47733,31.33898,3737,28,53,25,89.3
451001709,tx,-100.69637,31.58086,3734,26,50,24,92.3
451001710,tx,-100.55367,31.23622,3586,25,49,24,96
451001800,tx,-100.45018,31.46997,1743,31,55,24,77.4
451980000,tx,-100.49855,31.35523,8,28,53,25,89.3
453000101,tx,-97.75319,30.32334,1456,61,87,26,42.6
453000102,tx,-97.76707,30.32585,1092,63,88,25,39.7
453000203,tx,-97.73667,30.31262,35,62,87,25,40.3
453000204,tx,-97.74446,30.30716,1167,64,89,25,39.1
453000205,tx,-97.73433,30.32616,919,61,86,25,41
453000206,tx,-97.74352,30.32614,961,61,86,25,41
453000302,tx,-97.7265,30.30256,1325,63,89,26,41.3
453000304,tx,-97.71691,30.30937,912,63,88,25,39.7
453000305,tx,-97.72631,30.31487,1040,62,88,26,41.9
453000307,tx,-97.71257,30.29703,640,63,88,25,39.7
453000308,tx,-97.69444,30.29612,1306,63,88,25,39.7
453000309,tx,-97.70478,30.29794,1099,63,88,25,39.7
453000401,tx,-97.72506,30.28825,1077,63,88,25,39.7
453000402,tx,-97.71552,30.28414,1021,63,88,25,39.7
453000500,tx,-97.73418,30.29607,857,64,89,25,39.1
453000601,tx,-97.73804,30.28741,106,64,89,25,39.1
453000605,tx,-97.74785,30.29284,211,64,89,25,39.1
453000606,tx,-97.74387,30.2907,131,64,89,25,39.1
453000607,tx,-97.74946,30.28575,227,64,89,25,39.1
453000608,tx,-97.74335,30.285,98,64,89,25,39.1
453000700,tx,-97.74112,30.2777,422,64,89,25,39.1
453000801,tx,-97.70146,30.26693,611,64,90,26,40.6
453000802,tx,-97.70799,30.27355,921,63,89,26,41.3
453000803,tx,-97.72047,30.27681,1082,63,89,26,41.3
453000804,tx,-97.72195,30.27009,884,64,90,26,40.6
453000901,tx,-97.72374,30.26557,682,64,90,26,40.6
453000902,tx,-97.71597,30.25919,1813,64,90,26,40.6
453001000,tx,-97.72571,30.25306,1336,64,90,26,40.6
453001101,tx,-97.74248,30.27111,503,64,90,26,40.6
453001102,tx,-97.74757,30.26627,119,64,90,26,40.6
453001103,tx,-97.73973,30.26085,231,64,90,26,40.6
453001200,tx,-97.76012,30.27372,977,64,89,25,39.1
453001304,tx,-97.77343,30.24841,1330,63,88,25,39.7
453001307,tx,-97.7686,30.23635,869,64,89,25,39.1
453001308,tx,-97.76176,30.23274,769,65,90,25,38.5
453001309,tx,-97.76427,30.26108,571,63,89,26,41.3
453001310,tx,-97.76259,30.25622,295,64,90,26,40.6
453001311,tx,-97.75148,30.25771,180,64,90,26,40.6
453001312,tx,-97.75795,30.24842,1519,64,90,26,40.6
453001401,tx,-97.74599,30.2501,661,64,90,26,40.6
453001402,tx,-97.74057,30.24356,854,64,90,26,40.6
453001403,tx,-97.73507,30.23991,386,64,90,26,40.6
453001501,tx,-97.7433,30.34658,1949,61,86,25,41
453001503,tx,-97.71577,30.32726,1417,60,85,25,41.7
453001504,tx,-97.72509,30.34654,2135,60,86,26,43.3
453001505,tx,-97.73043,30.33639,1639,60,86,26,43.3
453001602,tx,-97.77593,30.28555,641,65,90,25,38.5
453001603,tx,-97.75644,30.29843,1818,64,89,25,39.1
453001604,tx,-97.77321,30.30287,1651,65,90,25,38.5
453001605,tx,-97.76057,30.28677,1103,64,89,25,39.1
453001606,tx,-97.76083,30.30567,17,64,89,25,39.1
453001910,tx,-97.79802,30.27037,1270,63,88,25,39.7
453001911,tx,-97.78588,30.25849,113,63,88,25,39.7
453001912,tx,-97.8209,30.32613,1364,62,87,25,40.3
453001913,tx,-97.79884,30.31659,1862,65,89,24,36.9
453001914,tx,-97.83913,30.25713,1639,62,87,25,40.3
453001915,tx,-97.8367,30.24056,441,61,86,25,41
453001916,tx,-97.87905,30.30386,1136,59,84,25,42.4
453001917,tx,-97.8287,30.2744,1758,61,86,25,41
453001918,tx,-97.81172,30.29348,1177,63,88,25,39.7
453001919,tx,-97.79513,30.27717,1463,64,89,25,39.1
453001920,tx,-97.8875,30.25582,877,59,84,25,42.4
453001921,tx,-97.88174,30.28305,1220,59,84,25,42.4
453001922,tx,-97.79197,30.24536,589,63,88,25,39.7
453001923,tx,-97.77922,30.25629,865,63,88,25,39.7
453002002,tx,-97.78482,30.22309,1201,63,89,26,41.3
453002003,tx,-97.77459,30.21919,870,63,89,26,41.3
453002004,tx,-97.78823,30.23607,154,63,88,25,39.7
453002006,tx,-97.77814,30.23251,333,63,88,25,39.7
453002007,tx,-97.7817,30.23718,352,63,88,25,39.7
453002104,tx,-97.69657,30.31473,1040,62,87,25,40.3
453002105,tx,-97.7056,30.31491,610,62,88,26,41.9
453002106,tx,-97.69032,30.30672,1016,63,88,25,39.7
453002107,tx,-97.68286,30.29567,1154,63,89,26,41.3
453002108,tx,-97.66895,30.29743,823,63,89,26,41.3
453002109,tx,-97.69058,30.28151,1617,63,89,26,41.3
453002110,tx,-97.67722,30.27409,1490,64,90,26,40.6
453002111,tx,-97.68592,30.25729,1552,64,90,26,40.6
453002112,tx,-97.6826,30.31392,1043,62,88,26,41.9
453002113,tx,-97.67243,30.31713,1232,63,88,25,39.7
453002201,tx,-97.65544,30.31783,822,63,89,26,41.3
453002211,tx,-97.61926,30.2743,1043,64,90,26,40.6
453002213,tx,-97.64049,30.28816,1139,63,89,26,41.3
453002214,tx,-97.65438,30.27836,589,64,90,26,40.6
453002215,tx,-97.58466,30.26132,1371,65,92,27,41.5
453002216,tx,-97.58205,30.23145,3374,65,91,26,40
453002217,tx,-97.47412,30.33925,2434,66,92,26,39.4
453002218,tx,-97.49155,30.31519,1839,64,91,27,42.2
453002219,tx,-97.53753,30.28453,2800,65,91,26,40
453002220,tx,-97.63662,30.31785,542,63,89,26,41.3
453002221,tx,-97.61714,30.32036,131,63,89,26,41.3
453002222,tx,-97.63326,30.30049,878,63,89,26,41.3
453002304,tx,-97.72331,30.24369,157,64,90,26,40.6
453002307,tx,-97.74097,30.22311,668,65,90,25,38.5
453002310,tx,-97.65886,30.23994,720,65,91,26,40
453002313,tx,-97.72602,30.22018,372,65,91,26,40
453002314,tx,-97.71552,30.2247,144,66,91,25,37.9
453002315,tx,-97.73214,30.23392,107,64,90,26,40.6
453002316,tx,-97.72794,30.23542,59,64,90,26,40.6
453002319,tx,-97.64492,30.1998,17,65,91,26,40
453002320,tx,-97.69517,30.22193,533,66,91,25,37.9
453002321,tx,-97.69398,30.23189,1005,65,91,26,40
453002322,tx,-97.75567,30.22301,158,65,90,25,38.5
453002323,tx,-97.75025,30.2325,470,64,90,26,40.6
453002324,tx,-97.71887,30.23513,8,64,90,26,40.6
453002325,tx,-97.7065,30.23148,560,65,91,26,40
453002326,tx,-97.71174,30.24535,11,64,90,26,40.6
453002327,tx,-97.70397,30.24098,307,64,90,26,40.6
453002403,tx,-97.76223,30.21206,1019,65,90,25,38.5
453002407,tx,-97.8149,30.13018,2133,62,87,25,40.3
453002409,tx,-97.79358,30.20753,1054,63,89,26,41.3
453002410,tx,-97.78666,30.20577,740,63,89,26,41.3
453002411,tx,-97.74892,30.20528,1080,65,90,25,38.5
453002412,tx,-97.75149,30.1894,1395,66,91,25,37.9
453002413,tx,-97.74027,30.19709,697,65,91,26,40
453002419,tx,-97.7609,30.19128,83,66,91,25,37.9
453002422,tx,-97.78481,30.18344,1504,64,90,26,40.6
453002423,tx,-97.80621,30.17973,2031,64,89,25,39.1
453002424,tx,-97.79925,30.19219,1058,64,89,25,39.1
453002430,tx,-97.75478,30.17178,960,66,91,25,37.9
453002432,tx,-97.71528,30.13521,2026,66,91,25,37.9
453002434,tx,-97.74143,30.07329,953,63,88,25,39.7
453002436,tx,-97.6665,30.10321,1188,64,89,25,39.1
453002437,tx,-97.79437,30.16449,849,65,90,25,38.5
453002438,tx,-97.81262,30.16207,1500,63,89,26,41.3
453002439,tx,-97.75111,30.16292,1107,66,91,25,37.9
453002440,tx,-97.74816,30.14177,2123,65,90,25,38.5
453002441,tx,-97.76802,30.182,767,66,91,25,37.9
453002442,tx,-97.75526,30.17831,1030,66,91,25,37.9
453002443,tx,-97.77109,30.19933,134,64,89,25,39.1
453002444,tx,-97.77909,30.20399,1279,63,89,26,41.3
453002445,tx,-97.76849,30.12826,2005,62,88,26,41.9
453002446,tx,-97.78919,30.12743,794,62,87,25,40.3
453002447,tx,-97.72794,30.2049,1051,65,91,26,40
453002448,tx,-97.71527,30.19196,2470,66,91,25,37.9
453002449,tx,-97.65632,30.15968,2134,64,90,26,40.6
453002450,tx,-97.61083,30.13598,1197,63,89,26,41.3
453002451,tx,-97.77849,30.1633,1089,65,90,25,38.5
453002452,tx,-97.63061,30.18906,738,64,90,26,40.6
453002453,tx,-97.56876,30.18777,1970,64,91,27,42.2
453002500,tx,-97.75514,30.41668,1212,58,84,26,44.8
453030000,tx,-97.77396,30.36987,1492,60,85,25,41.7
453030100,tx,-97.7552,30.38252,885,59,85,26,44.1
453030200,tx,-97.74634,30.37279,1373,59,85,26,44.1
453030300,tx,-97.7972,30.22385,1213,63,89,26,41.3
453030400,tx,-97.8053,30.21079,1306,62,88,26,41.9
453030500,tx,-97.80259,30.3935,1523,60,85,25,41.7
453030600,tx,-97.76102,30.34831,1414,61,87,26,42.6
453030700,tx,-97.78104,30.34944,1664,64,89,25,39.1
453030800,tx,-97.75302,30.39886,297,58,84,26,44.8
453030900,tx,-97.81656,30.19574,2596,62,87,25,40.3
453031000,tx,-97.82938,30.20275,1571,61,86,25,41
453031100,tx,-97.92915,30.21344,1778,58,83,25,43.1
453031200,tx,-97.85979,30.21869,2484,60,85,25,41.7
453031300,tx,-97.85711,30.19004,1220,61,86,25,41
453031400,tx,-97.93053,30.41037,2013,58,84,26,44.8
453031500,tx,-97.93577,30.36463,4084,59,84,25,42.4
453031600,tx,-97.73786,30.42441,760,58,84,26,44.8
453031700,tx,-97.83826,30.18607,1170,63,88,25,39.7
453031800,tx,-97.8246,30.18076,1447,63,88,25,39.7
453031900,tx,-97.83913,30.17023,1834,63,88,25,39.7
453032000,tx,-97.84422,30.23052,957,61,86,25,41
453032100,tx,-97.81906,30.22279,988,61,87,26,42.6
453032200,tx,-97.75775,30.36287,901,59,85,26,44.1
453032300,tx,-97.74983,30.35761,55,60,85,25,41.7
453032400,tx,-97.73874,30.39075,61,59,85,26,44.1
453032500,tx,-97.73714,30.40649,1222,58,84,26,44.8
453032600,tx,-97.77855,30.4093,2125,58,84,26,44.8
453032700,tx,-97.7698,30.42614,1470,58,84,26,44.8
453032800,tx,-97.76397,30.39786,659,59,84,25,42.4
453032900,tx,-97.83028,30.36107,2288,61,86,25,41
453033000,tx,-97.90128,30.24267,2266,56,81,25,44.6
453033100,tx,-97.98459,30.37213,2243,57,83,26,45.6
453033200,tx,-97.83944,30.13623,1860,62,87,25,40.3
453033300,tx,-97.88368,30.16332,3025,61,86,25,41
453033400,tx,-97.84045,30.21184,1156,61,86,25,41
453033500,tx,-97.84977,30.20471,1816,61,86,25,41
453033600,tx,-97.96521,30.36656,2121,58,84,26,44.8
453033700,tx,-97.79646,30.43977,837,57,83,26,45.6
453033800,tx,-97.79305,30.42937,1563,58,84,26,44.8
453033900,tx,-97.86981,30.33228,2337,60,85,25,41.7
453034000,tx,-97.92527,30.3235,1841,58,83,25,43.1
453034100,tx,-97.73613,30.44438,603,57,83,26,45.6
453034200,tx,-97.74856,30.43362,625,58,84,26,44.8
453034300,tx,-97.81368,30.43667,1579,56,82,26,46.4
453034400,tx,-97.8316,30.44093,329,56,82,26,46.4
453034500,tx,-97.82159,30.43262,721,57,82,25,43.9
453034600,tx,-97.83455,30.41352,98,57,82,25,43.9
453034700,tx,-97.8809,30.22248,1695,60,85,25,41.7
453034800,tx,-97.88105,30.20598,1554,60,85,25,41.7
453034900,tx,-97.90052,30.37634,2309,59,85,26,44.1
453035000,tx,-97.87635,30.36884,1605,59,85,26,44.1
453035100,tx,-97.91692,30.34038,1339,59,84,25,42.4
453035200,tx,-98.03182,30.41684,2963,58,83,25,43.1
453035300,tx,-98.08188,30.42204,1977,57,82,25,43.9
453035400,tx,-98.02361,30.34953,2690,54,79,25,46.3
453035500,tx,-97.85423,30.47906,1345,54,80,26,48.1
453035600,tx,-97.8873,30.46554,1466,56,81,25,44.6
453035700,tx,-97.85082,30.46041,1521,55,80,25,45.5
453035800,tx,-97.86898,30.42112,1352,55,81,26,47.3
453035900,tx,-97.96035,30.5887,1302,51,76,25,49
453036000,tx,-97.89713,30.54535,802,53,78,25,47.2
453036100,tx,-97.87955,30.52861,1930,52,77,25,48.1
453036200,tx,-97.91179,30.52902,1256,53,79,26,49.1
453036300,tx,-98.01173,30.5476,903,53,79,26,49.1
453036400,tx,-98.03247,30.48905,4810,55,81,26,47.3
453036500,tx,-98.08886,30.344,3751,53,79,26,49.1
453036600,tx,-97.97699,30.2667,3940,54,79,25,46.3
453036700,tx,-97.90369,30.1957,2668,59,84,25,42.4
453036800,tx,-97.87874,30.18558,1475,61,86,25,41
453036900,tx,-97.98575,30.34279,1560,54,79,25,46.3
453037000,tx,-97.9758,30.32165,1546,55,81,26,47.3
453037100,tx,-97.85684,30.15884,940,62,87,25,40.3
453037200,tx,-97.84411,30.15635,2084,63,88,25,39.7
453037300,tx,-97.99042,30.45726,3220,56,82,26,46.4
453037400,tx,-98.01093,30.42821,5323,58,83,25,43.1
453037500,tx,-97.90553,30.49895,1286,54,80,26,48.1
453037600,tx,-97.96028,30.43325,3992,57,83,26,45.6
453040000,tx,-97.70732,30.34194,912,60,85,25,41.7
453040100,tx,-97.71033,30.3572,705,60,85,25,41.7
453040200,tx,-97.68501,30.32617,268,60,86,26,43.3
453040300,tx,-97.68755,30.3451,550,60,85,25,41.7
453040400,tx,-97.73467,30.3666,1027,59,85,26,44.1
453040500,tx,-97.72221,30.36021,1352,60,85,25,41.7
453040600,tx,-97.70267,30.36342,418,60,85,25,41.7
453040700,tx,-97.71483,30.3718,595,60,85,25,41.7
453040800,tx,-97.70861,30.38098,1349,60,85,25,41.7
453040900,tx,-97.69632,30.37419,1101,60,85,25,41.7
453041000,tx,-97.6869,30.3701,989,60,85,25,41.7
453041100,tx,-97.6792,30.3851,655,61,87,26,42.6
453041200,tx,-97.68303,30.40225,438,60,85,25,41.7
453041300,tx,-97.72373,30.42158,1628,59,85,26,44.1
453041400,tx,-97.71283,30.41641,498,60,85,25,41.7
453041500,tx,-97.66882,30.38015,798,61,87,26,42.6
453041600,tx,-97.6765,30.364,1673,61,87,26,42.6
453041700,tx,-97.7001,30.38849,917,60,85,25,41.7
453041800,tx,-97.70137,30.39597,860,60,85,25,41.7
453041900,tx,-97.69045,30.39249,887,60,85,25,41.7
453042000,tx,-97.71375,30.43597,993,60,85,25,41.7
453042100,tx,-97.6856,30.41805,1183,60,85,25,41.7
453042200,tx,-97.70178,30.41191,484,60,85,25,41.7
453042300,tx,-97.6801,30.444,1281,59,85,26,44.1
453042400,tx,-97.57933,30.3698,4546,63,89,26,41.3
453042500,tx,-97.5241,30.44205,2310,63,89,26,41.3
453042600,tx,-97.64597,30.45251,1042,59,85,26,44.1
453042700,tx,-97.63903,30.46375,1579,60,86,26,43.3
453042800,tx,-97.62669,30.45311,1844,60,86,26,43.3
453042900,tx,-97.67628,30.43233,254,60,86,26,43.3
453043000,tx,-97.7018,30.44903,362,58,84,26,44.8
453043100,tx,-97.6946,30.3568,454,60,85,25,41.7
453043200,tx,-97.70062,30.3506,402,60,85,25,41.7
453043300,tx,-97.69564,30.33294,496,60,85,25,41.7
453043400,tx,-97.70031,30.32633,310,60,85,25,41.7
453043500,tx,-97.65902,30.36216,2145,61,87,26,42.6
453043600,tx,-97.66215,30.33793,659,61,87,26,42.6
453043700,tx,-97.66732,30.39231,178,61,87,26,42.6
453043800,tx,-97.65831,30.3838,1039,61,87,26,42.6
453043900,tx,-97.65726,30.40723,1286,60,86,26,43.3
453044000,tx,-97.66322,30.39868,553,61,87,26,42.6
453044100,tx,-97.6527,30.44083,1109,59,85,26,44.1
453044200,tx,-97.66326,30.43088,594,60,86,26,43.3
453044300,tx,-97.64843,30.41826,1316,60,86,26,43.3
453044400,tx,-97.63549,30.4339,1514,62,87,25,40.3
453044500,tx,-97.6245,30.43552,1095,62,87,25,40.3
453044600,tx,-97.63674,30.4212,1553,62,87,25,40.3
453044700,tx,-97.62819,30.41431,661,62,87,25,40.3
453044800,tx,-97.59817,30.41482,579,62,87,25,40.3
453044900,tx,-97.62145,30.3923,1731,62,88,26,41.9
453045000,tx,-97.63636,30.36719,764,61,87,26,42.6
453045100,tx,-97.69243,30.43309,478,60,85,25,41.7
453045200,tx,-97.68879,30.42446,1421,60,85,25,41.7
453045300,tx,-97.71135,30.39955,79,60,85,25,41.7
453045400,tx,-97.72502,30.39189,212,59,85,26,44.1
453045500,tx,-97.68956,30.45307,489,57,83,26,45.6
453045600,tx,-97.68094,30.46725,1547,58,84,26,44.8
453045700,tx,-97.67219,30.45389,761,59,85,26,44.1
453045800,tx,-97.44041,30.40445,1333,66,92,26,39.4
453045900,tx,-97.50299,30.37591,4430,65,91,26,40
453046000,tx,-97.59785,30.48779,1286,60,85,25,41.7
453046100,tx,-97.60971,30.4709,1861,60,86,26,43.3
453046200,tx,-97.63023,30.47398,2066,60,86,26,43.3
453046300,tx,-97.6123,30.44866,786,60,86,26,43.3
453046400,tx,-97.65776,30.47311,1218,59,85,26,44.1
453046500,tx,-97.65928,30.45862,652,59,85,26,44.1
453046600,tx,-97.56886,30.48964,1907,61,86,25,41
453046700,tx,-97.58051,30.47362,1293,62,88,26,41.9
453046800,tx,-97.56065,30.47085,3954,62,88,26,41.9
453046900,tx,-97.57902,30.4538,2657,62,88,26,41.9
453047000,tx,-97.59159,30.43731,636,62,87,25,40.3
453980000,tx,-97.66666,30.19466,128,66,91,25,37.9
455950100,tx,-94.99944,31.16645,3006,70,95,25,35.7
455950200,tx,-95.17119,31.04453,7747,71,97,26,36.6
455950300,tx,-95.32395,31.02635,3103,71,96,25,35.2
455950400,tx,-95.3369,30.90816,10260,71,96,25,35.2
455950500,tx,-95.38295,30.95088,1619,70,96,26,37.1
457950100,tx,-94.43868,30.94887,3571,70,95,25,35.7
457950201,tx,-94.35989,30.7544,1741,72,97,25,34.7
457950202,tx,-94.49883,30.77112,6422,73,98,25,34.2
457950300,tx,-94.42882,30.77576,1384,71,96,25,35.2
457950400,tx,-94.20871,30.68076,5203,72,98,26,36.1
457950500,tx,-94.45208,30.60319,3831,77,102,25,32.5
459950101,tx,-94.78158,32.82378,3062,67,91,24,35.8
459950102,tx,-94.77614,32.73779,2622,66,91,25,37.9
459950200,tx,-94.99999,32.84501,3378,64,89,25,39.1
459950301,tx,-94.96324,32.73409,2847,64,90,26,40.6
459950302,tx,-95.03022,32.70128,2710,63,89,26,41.3
459950400,tx,-94.94586,32.7305,2440,65,90,25,38.5
459950501,tx,-95.02417,32.59225,1919,63,89,26,41.3
459950502,tx,-95.11093,32.65223,1909,62,88,26,41.9
459950600,tx,-94.95593,32.56895,2281,63,89,26,41.3
459950700,tx,-94.84743,32.63175,3572,63,88,25,39.7
461950100,tx,-101.95822,31.38662,1963,19,42,23,121.1
461950200,tx,-102.21358,31.33276,2334,30,54,24,80
463950100,tx,-99.53242,29.43625,5057,51,78,27,52.9
463950201,tx,-99.89474,29.37052,6105,59,85,26,44.1
463950202,tx,-99.66476,29.16134,2121,75,99,24,32
463950300,tx,-99.79722,29.22396,3195,77,100,23,29.9
463950400,tx,-99.77607,29.22429,1372,77,100,23,29.9
463950500,tx,-99.7851,29.19463,2571,77,100,23,29.9
465950202,tx,-100.91428,29.39613,1763,65,89,24,36.9
465950203,tx,-100.92076,29.41946,1817,64,88,24,37.5
465950301,tx,-100.91622,29.379,1628,66,89,23,34.8
465950302,tx,-100.92487,29.36632,2818,66,89,23,34.8
465950400,tx,-100.87794,29.37656,1596,65,89,24,36.9
465950501,tx,-100.80119,29.31963,777,65,89,24,36.9
465950502,tx,-100.75344,29.41621,1807,64,88,24,37.5
465950601,tx,-100.87284,29.3653,1619,65,88,23,35.4
465950602,tx,-100.88487,29.35623,2453,66,89,23,34.8
465950701,tx,-100.89461,29.35078,1306,67,90,23,34.3
465950702,tx,-100.91987,29.34315,1796,68,91,23,33.8
465950801,tx,-100.98833,29.41788,2743,65,89,24,36.9
465950802,tx,-101.16835,29.92251,10323,54,79,25,46.3
465980000,tx,-100.92557,29.37383,48,66,89,23,34.8
467950100,tx,-95.72221,32.66069,3542,60,86,26,43.3
467950200,tx,-95.70834,32.67547,1898,61,86,25,41
467950300,tx,-95.87016,32.70894,3430,60,85,25,41.7
467950400,tx,-96.00712,32.71415,4993,59,85,26,44.1
467950500,tx,-95.99959,32.7078,2915,57,83,26,45.6
467950601,tx,-95.84466,32.57602,4906,59,85,26,44.1
467950602,tx,-95.90971,32.53379,2472,59,85,26,44.1
467950700,tx,-95.8749,32.55582,2575,59,85,26,44.1
467950801,tx,-95.65637,32.55888,2752,59,85,26,44.1
467950802,tx,-95.6813,32.4933,1031,58,85,27,46.6
467950901,tx,-95.71866,32.40592,5000,59,87,28,47.5
467950902,tx,-95.57656,32.41637,1995,56,84,28,50
467951001,tx,-95.89715,32.41139,1993,59,86,27,45.8
467951002,tx,-96.01794,32.45739,2742,60,87,27,45
469000100,tx,-97.00496,28.79681,985,83,109,26,31.3
469000201,tx,-96.98967,28.80047,1140,83,109,26,31.3
469000202,tx,-96.9731,28.79913,1901,83,109,26,31.3
469000301,tx,-96.99835,28.77304,1338,83,109,26,31.3
469000302,tx,-96.97896,28.78062,1226,83,109,26,31.3
469000400,tx,-97.01403,28.81706,1090,82,108,26,31.7
469000501,tx,-96.99966,28.83181,1327,82,108,26,31.7
469000502,tx,-96.98647,28.82767,1109,82,108,26,31.7
469000601,tx,-96.99771,28.81325,1256,82,109,27,32.9
469000602,tx,-96.98161,28.81534,1271,83,109,26,31.3
469000700,tx,-96.88263,28.79608,3104,82,108,26,31.7
469000800,tx,-96.76281,28.77276,1734,79,106,27,34.2
469001300,tx,-97.05008,28.62868,2221,83,110,27,32.5
469001401,tx,-97.07683,28.80391,2547,84,110,26,31
469001402,tx,-97.17194,28.85228,3102,84,110,26,31
469001501,tx,-97.06018,28.95784,2580,82,107,25,30.5
469001503,tx,-97.00828,28.85404,842,82,108,26,31.7
469001504,tx,-97.01896,28.88215,3381,80,107,27,33.8
469001601,tx,-96.98898,28.84847,1665,82,108,26,31.7
469001604,tx,-96.97391,28.83436,2008,83,109,26,31.3
469001605,tx,-96.96179,28.82406,1025,84,110,26,31
469001607,tx,-96.90883,28.95482,2309,80,106,26,32.5
469001608,tx,-96.9629,28.84183,1824,83,109,26,31.3
469001700,tx,-96.91572,28.68338,2611,82,108,26,31.7
469980000,tx,-96.92334,28.85334,8,83,109,26,31.3
471790101,tx,-95.52239,30.90942,2519,68,94,26,38.2
471790102,tx,-95.48437,30.81513,3451,66,93,27,40.9
471790103,tx,-95.41375,30.77636,4555,67,94,27,40.3
471790200,tx,-95.42568,30.61985,4192,67,94,27,40.3
471790301,tx,-95.68825,30.6371,2216,65,93,28,43.1
471790302,tx,-95.5625,30.58356,5784,67,94,27,40.3
471790401,tx,-95.7549,30.76142,2556,65,93,28,43.1
471790402,tx,-95.65959,30.82141,1454,64,92,28,43.8
471790500,tx,-95.56346,30.72926,1915,62,90,28,45.2
471790600,tx,-95.53818,30.73001,1285,63,91,28,44.4
471790700,tx,-95.53672,30.70094,1171,63,91,28,44.4
471790800,tx,-95.55474,30.70762,692,63,91,28,44.4
473680100,tx,-95.87146,29.8127,4331,75,103,28,37.3
473680201,tx,-95.99588,29.86496,3232,78,105,27,34.6
473680202,tx,-95.96433,29.7718,2706,78,105,27,34.6
473680301,tx,-95.95233,30.06675,2372,75,101,26,34.7
473680302,tx,-95.94208,29.99265,1770,76,102,26,34.2
473680303,tx,-96.00902,30.08834,3040,73,100,27,37
473680501,tx,-96.05692,29.9863,2978,75,102,27,36
473680502,tx,-96.08184,30.16146,5274,72,99,27,37.5
473680601,tx,-95.86023,30.13017,1425,74,101,27,36.5
473680602,tx,-95.87861,30.19751,3530,74,100,26,35.1
473980000,tx,-95.98226,30.09477,5,74,101,27,36.5
475950100,tx,-103.10366,31.50901,8636,38,61,23,60.5
475950200,tx,-102.87398,31.59209,1855,37,62,25,67.6
475950300,tx,-102.90088,31.58479,1636,38,63,25,65.8
477170100,tx,-96.34148,30.20389,1798,75,101,26,34.7
477170201,tx,-96.40992,30.17469,1364,76,102,26,34.2
477170202,tx,-96.45965,30.19039,1705,76,102,26,34.2
477170300,tx,-96.36789,30.13246,2633,76,101,25,32.9
477170400,tx,-96.4319,30.12151,2737,76,102,26,34.2
477170501,tx,-96.60998,30.17707,3427,71,97,26,36.6
477170502,tx,-96.41082,30.28674,2983,72,98,26,36.1
477170601,tx,-96.23815,30.15358,2543,74,100,26,35.1
477170602,tx,-96.19381,30.30005,1771,72,98,26,36.1
479000101,tx,-99.47348,27.4992,1388,96,116,20,20.8
479000105,tx,-99.46753,27.4907,912,95,115,20,21.1
479000106,tx,-99.46711,27.48501,997,94,115,21,22.3
479000107,tx,-99.46806,27.47737,638,93,114,21,22.6
479000108,tx,-99.46614,27.469,738,93,114,21,22.6
479000109,tx,-99.47698,27.47041,702,94,115,21,22.3
479000200,tx,-99.48688,27.50075,1262,97,118,21,21.6
479000300,tx,-99.49929,27.50425,729,97,118,21,21.6
479000601,tx,-99.51361,27.51679,755,97,118,21,21.6
479000602,tx,-99.52043,27.52175,698,98,118,20,20.4
479000700,tx,-99.50641,27.51668,718,97,118,21,21.6
479000800,tx,-99.49759,27.51296,695,97,118,21,21.6
479000901,tx,-99.48414,27.5184,1138,97,118,21,21.6
479000903,tx,-99.48962,27.52642,435,95,116,21,22.1
479000904,tx,-99.48967,27.5167,787,97,118,21,21.6
479001001,tx,-99.46999,27.51256,1248,95,116,21,22.1
479001003,tx,-99.45703,27.5028,671,94,115,21,22.3
479001004,tx,-99.46932,27.50567,590,95,115,20,21.1
479001101,tx,-99.47189,27.52714,733,95,116,21,22.1
479001103,tx,-99.46545,27.52034,333,94,115,21,22.3
479001104,tx,-99.47412,27.52026,766,95,116,21,22.1
479001105,tx,-99.45976,27.52114,559,94,115,21,22.3
479001201,tx,-99.49748,27.52667,736,96,116,20,20.8
479001202,tx,-99.49783,27.51984,512,97,118,21,21.6
479001300,tx,-99.50951,27.52722,879,95,116,21,22.1
479001401,tx,-99.50795,27.53723,1007,95,116,21,22.1
479001402,tx,-99.51824,27.53566,773,97,118,21,21.6
479001501,tx,-99.49816,27.53517,714,95,116,21,22.1
479001502,tx,-99.48729,27.53435,980,95,116,21,22.1
479001601,tx,-99.47635,27.54186,873,95,116,21,22.1
479001602,tx,-99.45676,27.5679,1760,94,115,21,22.3
479001706,tx,-99.49312,27.54277,875,95,116,21,22.1
479001709,tx,-99.48671,27.56376,1577,95,116,21,22.1
479001710,tx,-99.44224,27.91326,6737,93,114,21,22.6
479001711,tx,-99.54382,27.63634,2972,95,116,21,22.1
479001714,tx,-99.4344,27.55446,1441,94,115,21,22.3
479001715,tx,-99.51288,27.59642,2103,97,118,21,21.6
479001716,tx,-99.52162,27.58527,1317,97,118,21,21.6
479001717,tx,-99.51094,27.56496,993,96,117,21,21.9
479001718,tx,-99.49694,27.55241,662,95,116,21,22.1
479001719,tx,-99.48571,27.55145,879,95,116,21,22.1
479001720,tx,-99.49132,27.57439,1401,94,115,21,22.3
479001721,tx,-99.47738,27.57941,651,94,115,21,22.3
479001722,tx,-99.45871,27.587,2578,94,115,21,22.3
479001723,tx,-99.48746,27.59811,772,94,115,21,22.3
479001724,tx,-99.48916,27.58445,878,94,115,21,22.3
479001725,tx,-99.45882,27.59981,1799,94,115,21,22.3
479001726,tx,-99.47589,27.60841,1463,94,115,21,22.3
479001727,tx,-99.44011,27.61872,2231,92,113,21,22.8
479001806,tx,-99.46674,27.45879,1914,94,115,21,22.3
479001809,tx,-99.46349,27.43245,2846,94,115,21,22.3
479001810,tx,-99.39621,27.47154,2354,93,114,21,22.6
479001811,tx,-99.45617,27.48784,1245,94,115,21,22.3
479001813,tx,-99.13002,27.3682,2012,90,111,21,23.3
479001815,tx,-99.01591,27.57837,2821,89,111,22,24.7
479001816,tx,-99.39149,27.53171,1393,93,114,21,22.6
479001818,tx,-99.47311,27.30647,944,99,119,20,20.2
479001819,tx,-99.48614,27.42868,1903,98,118,20,20.4
479001820,tx,-99.48646,27.44649,1102,96,117,21,21.9
479001821,tx,-99.46019,27.44833,953,93,114,21,22.6
479001822,tx,-99.47123,27.44893,898,94,114,20,21.3
479001823,tx,-99.45639,27.47605,1215,93,114,21,22.6
479001824,tx,-99.44771,27.47788,1256,94,114,20,21.3
479001825,tx,-99.44446,27.50229,1112,94,115,21,22.3
479001826,tx,-99.38368,27.49282,1470,91,112,21,23.1
479001827,tx,-99.48335,27.38298,89,97,118,21,21.6
479001828,tx,-99.48464,27.35316,1523,97,117,20,20.6
479001900,tx,-99.51648,27.50493,1346,97,118,21,21.6
479980000,tx,-99.46246,27.54446,20,95,116,21,22.1
481740100,tx,-96.18057,29.47191,5760,76,105,29,38.2
481740200,tx,-96.09618,29.35656,807,73,102,29,39.7
481740300,tx,-96.15881,29.3019,1265,73,103,30,41.1
481740400,tx,-96.08618,29.2878,3255,73,102,29,39.7
481740500,tx,-96.01773,29.37055,2050,72,102,30,41.7
481740600,tx,-95.98305,29.23542,3300,72,101,29,40.3
481740700,tx,-96.14041,29.17605,1335,73,103,30,41.1
481740800,tx,-96.22761,29.24761,1699,74,104,30,40.5
481740901,tx,-96.30476,29.2993,2350,74,104,30,40.5
481740902,tx,-96.28455,29.20084,1742,74,104,30,40.5
481741000,tx,-96.2203,29.10125,2740,72,102,30,41.7
481741100,tx,-96.42305,29.18033,3025,72,102,30,41.7
483950100,tx,-100.24918,35.47032,3981,17,34,17,100
483950300,tx,-100.31007,35.26492,3368,21,39,18,85.7
485010100,tx,-98.48604,33.90374,1602,57,77,20,35.1
485010200,tx,-98.49892,33.90611,661,57,77,20,35.1
485010400,tx,-98.47591,33.92117,1940,57,77,20,35.1
485010600,tx,-98.49723,33.89093,1228,57,77,20,35.1
485010700,tx,-98.51078,33.89548,985,57,77,20,35.1
485010800,tx,-98.52018,33.89476,1116,57,77,20,35.1
485010900,tx,-98.52556,33.90351,655,58,77,19,32.8
485011000,tx,-98.51489,33.91117,1101,57,77,20,35.1
485011100,tx,-98.5047,33.93022,1110,57,77,20,35.1
485011200,tx,-98.46632,33.99086,1116,57,77,20,35.1
485011300,tx,-98.43978,33.91349,1010,57,77,20,35.1
485011400,tx,-98.46435,33.89443,1265,56,77,21,37.5
485011500,tx,-98.45427,33.85981,983,57,77,20,35.1
485011600,tx,-98.49359,33.86181,1697,57,77,20,35.1
485011700,tx,-98.50034,33.86991,999,57,77,20,35.1
485011800,tx,-98.50553,33.86142,854,57,77,20,35.1
485011901,tx,-98.51458,33.86888,451,57,77,20,35.1
485011902,tx,-98.50922,33.88398,532,57,77,20,35.1
485012001,tx,-98.52786,33.85834,981,57,77,20,35.1
485012002,tx,-98.52608,33.87411,805,58,78,20,34.5
485012100,tx,-98.54202,33.86458,1445,58,78,20,34.5
485012201,tx,-98.51727,33.84729,561,57,77,20,35.1
485012202,tx,-98.54848,33.85008,1870,57,77,20,35.1
485012301,tx,-98.56967,33.84669,1895,57,77,20,35.1
485012302,tx,-98.59119,33.84701,1032,57,77,20,35.1
485012401,tx,-98.6194,33.85246,1092,57,77,20,35.1
485012402,tx,-98.5691,33.87067,1805,57,77,20,35.1
485012600,tx,-98.54648,33.87942,1841,58,78,20,34.5
485012700,tx,-98.53473,33.88968,1237,58,78,20,34.5
485012800,tx,-98.6404,33.87903,2287,57,77,20,35.1
485012900,tx,-98.60719,33.92068,1498,58,77,19,32.8
485013000,tx,-98.53441,33.93465,1059,58,77,19,32.8
485013100,tx,-98.5857,33.98177,2303,57,77,20,35.1
485013201,tx,-98.51937,33.95679,1124,57,77,20,35.1
485013202,tx,-98.53515,34.01199,1120,56,76,20,35.7
485013300,tx,-98.52372,33.97688,1,57,77,20,35.1
485013401,tx,-98.50677,33.97288,4,57,77,20,35.1
485013502,tx,-98.55635,34.06097,2164,57,77,20,35.1
485013503,tx,-98.58443,34.09123,1442,57,76,19,33.3
485013504,tx,-98.56535,34.09432,1344,57,76,19,33.3
485013600,tx,-98.67726,33.94594,3077,57,77,20,35.1
485013700,tx,-98.93006,34.02809,2136,56,76,20,35.7
485013800,tx,-98.78145,34.01288,3896,57,76,19,33.3
485980000,tx,-98.49663,33.98961,1,56,75,19,33.9
487950300,tx,-99.2386,34.07844,2749,55,75,20,36.4
487950500,tx,-99.34041,34.15029,1297,54,74,20,37
487950600,tx,-99.31416,34.12711,2818,54,74,20,37
487950700,tx,-99.25617,34.13614,1932,55,74,19,34.5
489950300,tx,-97.81496,26.48636,2481,99,125,26,26.3
489950400,tx,-97.73463,26.48482,2378,98,124,26,26.5
489950500,tx,-97.72778,26.40749,2239,98,125,27,27.6
489950600,tx,-97.69618,26.34851,1682,99,124,25,25.3
489950700,tx,-97.57292,26.4965,4568,82,110,28,34.1
489990000,tx,-97.22397,26.50627,44,52,88,36,69.2
491020106,tx,-97.67925,30.71244,1642,53,79,26,49.1
491020108,tx,-97.67329,30.68763,1363,54,79,25,46.3
491020109,tx,-97.76943,30.69228,1932,50,75,25,50
491020111,tx,-97.70534,30.66626,1518,53,78,25,47.2
491020113,tx,-97.65898,30.67061,822,55,81,26,47.3
491020114,tx,-97.6839,30.6659,1548,54,79,25,46.3
491020115,tx,-97.70594,30.69928,2121,52,77,25,48.1
491020116,tx,-97.7041,30.72098,2481,51,76,25,49
491020117,tx,-97.71815,30.73837,1558,51,76,25,49
491020118,tx,-97.7351,30.70925,2657,50,75,25,50
491020119,tx,-97.75769,30.72283,1453,50,75,25,50
491020120,tx,-97.8372,30.66007,2918,51,76,25,49
491020121,tx,-97.70391,30.6479,1240,54,79,25,46.3
491020122,tx,-97.76997,30.65919,1939,52,77,25,48.1
491020123,tx,-97.70663,30.62383,1142,55,80,25,45.5
491020124,tx,-97.77396,30.61623,3331,53,78,25,47.2
491020201,tx,-97.72268,30.83479,1364,49,75,26,53.1
491020203,tx,-97.76353,30.74637,2335,50,75,25,50
491020205,tx,-97.83357,30.72753,2209,50,75,25,50
491020206,tx,-97.8335,30.82358,1535,49,74,25,51
491020207,tx,-97.90374,30.69699,2233,50,75,25,50
491020208,tx,-97.92893,30.76107,1705,49,75,26,53.1
491020310,tx,-97.76728,30.54595,1926,58,83,25,43.1
491020311,tx,-97.79197,30.48532,2604,56,82,26,46.4
491020319,tx,-97.81898,30.55912,2796,55,81,26,47.3
491020321,tx,-97.84736,30.54887,753,54,79,25,46.3
491020323,tx,-97.85321,30.53436,817,52,78,26,50
491020325,tx,-97.84182,30.53665,844,55,80,25,45.5
491020326,tx,-97.84818,30.49227,2377,55,80,25,45.5
491020327,tx,-97.83672,30.51681,1386,55,80,25,45.5
491020329,tx,-97.87285,30.63441,4552,52,77,25,48.1
491020330,tx,-97.97189,30.65539,2525,49,75,26,53.1
491020331,tx,-97.87553,30.56794,2129,52,77,25,48.1
491020332,tx,-97.85527,30.56484,1614,52,77,25,48.1
491020333,tx,-97.83048,30.46676,1759,55,80,25,45.5
491020334,tx,-97.81629,30.47237,1240,55,80,25,45.5
491020335,tx,-97.83654,30.50312,1374,55,81,26,47.3
491020336,tx,-97.83012,30.49407,1425,55,81,26,47.3
491020337,tx,-97.86195,30.53712,1693,52,77,25,48.1
491020338,tx,-97.86745,30.55347,1892,52,77,25,48.1
491020339,tx,-97.81019,30.57699,795,54,79,25,46.3
491020340,tx,-97.83851,30.59839,1599,53,78,25,47.2
491020341,tx,-97.83937,30.57074,1195,54,79,25,46.3
491020342,tx,-97.87492,30.60414,1183,52,77,25,48.1
491020343,tx,-97.90036,30.5832,935,51,77,26,51
491020344,tx,-97.86672,30.58619,1604,52,77,25,48.1
491020345,tx,-97.76405,30.5204,2655,57,83,26,45.6
491020346,tx,-97.78778,30.53864,364,57,82,25,43.9
491020347,tx,-97.79008,30.51146,904,57,82,25,43.9
491020348,tx,-97.79845,30.52922,794,57,82,25,43.9
491020349,tx,-97.81843,30.51461,1075,55,81,26,47.3
491020350,tx,-97.80349,30.51408,1930,56,82,26,46.4
491020351,tx,-97.81816,30.54545,2062,55,80,25,45.5
491020352,tx,-97.82105,30.53003,1101,55,80,25,45.5
491020353,tx,-97.84798,30.52222,1133,54,80,26,48.1
491020354,tx,-97.86063,30.51975,1431,53,78,25,47.2
491020355,tx,-97.82002,30.49029,948,55,81,26,47.3
491020356,tx,-97.81389,30.48118,701,55,80,25,45.5
491020403,tx,-97.80446,30.46177,803,55,81,26,47.3
491020404,tx,-97.81607,30.45516,1382,55,80,25,45.5
491020405,tx,-97.79425,30.44821,1652,56,81,25,44.6
491020406,tx,-97.77598,30.44571,812,56,82,26,46.4
491020408,tx,-97.78597,30.4614,1364,55,81,26,47.3
491020409,tx,-97.76653,30.46691,1589,56,81,25,44.6
491020410,tx,-97.76393,30.44199,1653,57,82,25,43.9
491020411,tx,-97.74144,30.46088,1883,57,83,26,45.6
491020503,tx,-97.71351,30.4896,2381,58,83,25,43.1
491020505,tx,-97.71107,30.51583,928,58,84,26,44.8
491020507,tx,-97.73203,30.49948,929,57,83,26,45.6
491020508,tx,-97.77425,30.48786,804,56,82,26,46.4
491020509,tx,-97.75393,30.50824,2354,57,83,26,45.6
491020511,tx,-97.68481,30.4936,930,58,84,26,44.8
491020512,tx,-97.68666,30.4833,408,58,84,26,44.8
491020513,tx,-97.6999,30.46996,371,57,83,26,45.6
491020514,tx,-97.72578,30.5187,1537,57,83,26,45.6
491020515,tx,-97.7264,30.5075,1326,57,83,26,45.6
491020516,tx,-97.7611,30.49252,2002,57,83,26,45.6
491020517,tx,-97.74186,30.49331,1889,57,83,26,45.6
491020602,tx,-97.69942,30.52399,1855,59,85,26,44.1
491020604,tx,-97.73673,30.58649,2948,56,81,25,44.6
491020606,tx,-97.74028,30.54124,1337,58,84,26,44.8
491020607,tx,-97.7107,30.5448,1983,60,85,25,41.7
491020608,tx,-97.72806,30.56009,2426,58,83,25,43.1
491020609,tx,-97.73725,30.57437,1101,57,82,25,43.9
491020701,tx,-97.67344,30.50915,789,58,84,26,44.8
491020704,tx,-97.66809,30.5032,1419,59,84,25,42.4
491020706,tx,-97.61877,30.51297,1482,59,84,25,42.4
491020707,tx,-97.65215,30.50547,1947,59,84,25,42.4
491020709,tx,-97.66455,30.48886,1126,59,84,25,42.4
491020710,tx,-97.64716,30.48286,860,59,85,26,44.1
491020711,tx,-97.6294,30.50509,1480,59,84,25,42.4
491020712,tx,-97.64291,30.49691,1745,59,84,25,42.4
491020713,tx,-97.61978,30.49308,1220,59,84,25,42.4
491020808,tx,-97.45967,30.5526,1470,62,87,25,40.3
491020810,tx,-97.56171,30.50965,2236,61,86,25,41
491020811,tx,-97.5533,30.52714,1405,61,87,26,42.6
491020812,tx,-97.57679,30.58099,2064,60,86,26,43.3
491020813,tx,-97.52905,30.58794,2842,61,86,25,41
491020814,tx,-97.59984,30.5131,1801,60,85,25,41.7
491020815,tx,-97.60879,30.51901,733,59,84,25,42.4
491020816,tx,-97.58263,30.52219,1825,61,86,25,41
491020817,tx,-97.58295,30.54953,2319,61,87,26,42.6
491020818,tx,-97.61177,30.55254,2841,61,86,25,41
491020819,tx,-97.51801,30.51331,1211,62,87,25,40.3
491020820,tx,-97.54397,30.53116,2226,61,87,26,42.6
491020821,tx,-97.62399,30.59722,1954,59,85,26,44.1
491020822,tx,-97.61036,30.64112,1854,57,82,25,43.9
491020900,tx,-97.30458,30.54506,4876,62,88,26,41.9
491021000,tx,-97.39568,30.55934,1762,62,88,26,41.9
491021100,tx,-97.42133,30.57085,1214,61,87,26,42.6
491021201,tx,-97.43522,30.58696,1218,61,87,26,42.6
491021202,tx,-97.42271,30.58977,1456,61,87,26,42.6
491021203,tx,-97.40327,30.59546,1080,61,87,26,42.6
491021300,tx,-97.43287,30.7249,3436,56,82,26,46.4
491021402,tx,-97.68007,30.63805,1208,56,81,25,44.6
491021404,tx,-97.64384,30.63179,1965,57,83,26,45.6
491021405,tx,-97.65488,30.62348,2205,58,83,25,43.1
491021406,tx,-97.67737,30.60065,1820,58,84,26,44.8
491021407,tx,-97.66138,30.6088,1799,58,84,26,44.8
491021502,tx,-97.6782,30.532,1251,61,86,25,41
491021503,tx,-97.67925,30.52179,824,60,85,25,41.7
491021506,tx,-97.63348,30.5525,1171,61,86,25,41
491021509,tx,-97.65454,30.57855,1953,60,85,25,41.7
491021510,tx,-97.67943,30.57231,1431,60,85,25,41.7
491021511,tx,-97.62903,30.5304,945,61,86,25,41
491021512,tx,-97.64406,30.53182,1728,61,86,25,41
491021513,tx,-97.68364,30.54666,156,61,86,25,41
491021514,tx,-97.67373,30.55935,479,61,87,26,42.6
491021515,tx,-97.66636,30.55518,1497,61,87,26,42.6
491021516,tx,-97.65476,30.55694,817,61,87,26,42.6
491021517,tx,-97.66064,30.52512,990,60,86,26,43.3
491021518,tx,-97.65926,30.53655,1093,61,87,26,42.6
491021601,tx,-97.57701,30.78916,4410,52,78,26,50
491021602,tx,-97.57438,30.68663,1609,57,83,26,45.6
491021603,tx,-97.6494,30.78778,1686,51,77,26,51
493000102,tx,-98.03482,29.31349,2901,69,95,26,37.7
493000103,tx,-98.1571,29.36037,1707,68,93,25,36.8
493000104,tx,-98.12299,29.31619,2100,69,94,25,36.2
493000201,tx,-98.32014,29.17547,1406,75,100,25,33.3
493000202,tx,-98.25479,29.0869,1537,77,102,25,32.5
493000300,tx,-98.17686,29.14075,2466,78,102,24,30.8
493000402,tx,-98.07436,29.18193,1322,75,100,25,33.3
493000404,tx,-98.1606,29.23156,3149,72,97,25,34.7
493000405,tx,-98.21333,29.29589,1076,68,93,25,36.8
493000406,tx,-98.23686,29.26302,2321,72,97,25,34.7
493000500,tx,-97.89371,29.23272,3199,69,94,25,36.2
493000600,tx,-98.0993,29.03066,2747,78,102,24,30.8
495950200,tx,-103.10155,31.86345,1509,23,46,23,100
495950300,tx,-103.08889,31.85183,2200,24,47,23,95.8
495950400,tx,-103.04783,31.84998,2635,25,48,23,92
497150101,tx,-97.51244,33.32973,3250,52,75,23,44.2
497150103,tx,-97.48759,33.18923,3185,55,77,22,40
497150104,tx,-97.62616,33.17192,1844,56,78,22,39.3
497150201,tx,-97.59129,33.22195,1154,50,74,24,48
497150202,tx,-97.58148,33.25401,1885,48,71,23,47.9
497150300,tx,-97.65764,33.38398,2151,54,76,22,40.7
497150402,tx,-97.83347,33.09012,5797,61,83,22,36.1
497150403,tx,-97.70821,33.12851,2363,61,83,22,36.1
497150404,tx,-97.82192,33.36105,2065,56,78,22,39.3
497150405,tx,-97.82566,33.24943,4539,64,85,21,32.8
497150500,tx,-97.73331,33.20812,2542,64,85,21,32.8
497150603,tx,-97.45938,33.01716,2221,59,81,22,37.3
497150604,tx,-97.6546,33.02577,2136,56,79,23,41.1
497150605,tx,-97.58822,33.05918,2418,59,81,22,37.3
497150606,tx,-97.43469,33.06821,1522,57,80,23,40.4
497150607,tx,-97.48502,33.11007,2035,56,79,23,41.1
499950100,tx,-95.25105,32.87481,4631,59,84,25,42.4
499950200,tx,-95.27815,32.94662,1948,57,83,26,45.6
499950301,tx,-95.37308,32.78639,3593,61,87,26,42.6
499950303,tx,-95.48217,32.90048,4529,63,88,25,39.7
499950304,tx,-95.5755,32.87479,4139,62,87,25,40.3
499950401,tx,-95.59346,32.72685,1940,64,89,25,39.1
499950402,tx,-95.58552,32.80427,2073,64,89,25,39.1
499950500,tx,-95.44463,32.79599,1578,63,89,26,41.3
499950601,tx,-95.26604,32.63416,5066,60,86,26,43.3
499950602,tx,-95.21017,32.71017,4711,61,86,25,41
499950700,tx,-95.45644,32.67663,3781,63,88,25,39.7
499950800,tx,-95.48018,32.66013,2936,63,88,25,39.7
501950100,tx,-102.83927,33.22143,2586,4,12,8,200
501950200,tx,-102.79132,33.01892,3473,4,13,9,225
503950200,tx,-98.65433,33.32416,3733,59,80,21,35.6
503950401,tx,-98.50684,33.13269,1981,55,77,22,40
503950402,tx,-98.75599,33.10484,4082,56,78,22,39.3
503950500,tx,-98.58686,33.10926,1716,56,78,22,39.3
503950600,tx,-98.56971,33.10184,2577,57,78,21,36.8
505950303,tx,-99.2732,26.91565,612,109,130,21,19.3
505950304,tx,-99.26063,26.91949,1253,110,131,21,19.1
505950305,tx,-99.28966,26.88878,2101,111,132,21,18.9
505950306,tx,-99.24808,26.8996,1100,110,131,21,19.1
505950401,tx,-99.23999,26.84275,2305,111,132,21,18.9
505950402,tx,-99.16559,27.00523,4491,107,128,21,19.6
507950100,tx,-99.6144,28.95588,1624,84,106,22,26.2
507950200,tx,-99.94155,28.99322,1900,84,106,22,26.2
507950301,tx,-99.79403,28.76152,2379,89,111,22,24.7
507950302,tx,-99.82214,28.6658,3175,91,113,22,24.2
