tract,state_abbr,lon,lat,count_prop,days_above_100_today,days_above_100_30yrs,change_days_above_100,change_perc_above_100
001000100,nj,-74.46317,39.35707,774,2,5,3,150
001000200,nj,-74.45975,39.34374,836,2,5,3,150
001000300,nj,-74.45464,39.35356,611,2,5,3,150
001000400,nj,-74.44843,39.34821,560,2,5,3,150
001000500,nj,-74.44773,39.35736,788,2,5,3,150
001001100,nj,-74.43413,39.36574,334,2,5,3,150
001001200,nj,-74.44042,39.37001,1124,2,5,3,150
001001300,nj,-74.45968,39.38675,1200,2,5,3,150
001001400,nj,-74.42851,39.37805,819,2,5,3,150
001001500,nj,-74.42606,39.36815,690,2,5,3,150
001001900,nj,-74.41019,39.36351,552,2,5,3,150
001002300,nj,-74.4386,39.35569,1129,2,5,3,150
001002400,nj,-74.42521,39.35857,1279,2,5,3,150
001002500,nj,-74.41588,39.37117,1539,2,5,3,150
001010101,nj,-74.36738,39.42265,2933,2,5,3,150
001010102,nj,-74.37304,39.39863,2120,2,5,3,150
001010104,nj,-74.38914,39.38723,1917,2,4,2,100
001010105,nj,-74.40552,39.38389,2169,2,5,3,150
001010200,nj,-74.48782,39.42456,2769,4,10,6,150
001010300,nj,-74.50863,39.41902,1138,5,11,6,120
001010401,nj,-74.57252,39.52471,5505,10,20,10,100
001010403,nj,-74.55521,39.46801,3249,9,17,8,88.9
001010501,nj,-74.41208,39.49454,4770,6,12,6,100
001010503,nj,-74.50627,39.48817,3003,6,12,6,100
001010505,nj,-74.44593,39.43861,1705,4,10,6,150
001010506,nj,-74.51596,39.45742,2154,7,14,7,100
001010600,nj,-74.59613,39.56399,4522,11,21,10,90.9
001010700,nj,-74.68052,39.60186,6194,12,23,11,91.7
001010800,nj,-74.7823,39.67642,1328,15,26,11,73.3
001010900,nj,-74.74049,39.67002,2512,15,26,11,73.3
001011000,nj,-74.80141,39.61,1325,15,26,11,73.3
001011100,nj,-74.83037,39.6311,1367,15,26,11,73.3
001011201,nj,-74.84244,39.59288,1633,14,26,12,85.7
001011202,nj,-74.88827,39.51504,9629,14,25,11,78.6
001011300,nj,-74.94477,39.52823,1838,13,24,11,84.6
001011401,nj,-74.7291,39.52192,4404,11,22,11,100
001011403,nj,-74.64262,39.46557,2548,10,20,10,100
001011404,nj,-74.67852,39.43265,8417,10,20,10,100
001011500,nj,-74.80792,39.48793,14049,12,23,11,91.7
001011600,nj,-74.77197,39.3615,8848,11,21,10,90.9
001011702,nj,-74.56148,39.4349,2035,8,16,8,100
001011703,nj,-74.6029,39.42199,2177,9,18,9,100
001011704,nj,-74.59171,39.42894,1436,9,18,9,100
001011803,nj,-74.57606,39.37016,1249,5,11,6,120
001011804,nj,-74.64123,39.34142,3082,6,14,8,133.3
001011805,nj,-74.68577,39.37499,1863,8,17,9,112.5
001011806,nj,-74.60643,39.36959,3105,6,13,7,116.7
001011807,nj,-74.59997,39.39769,3908,8,16,8,100
001011808,nj,-74.64082,39.4092,1682,9,18,9,100
001011901,nj,-74.52838,39.39886,1160,5,11,6,120
001011902,nj,-74.51875,39.40875,844,6,12,6,100
001012000,nj,-74.50284,39.38973,1412,3,8,5,166.7
001012100,nj,-74.51504,39.37356,898,5,10,5,100
001012200,nj,-74.53689,39.38845,1734,5,10,5,100
001012302,nj,-74.56247,39.37638,1388,5,11,6,120
001012401,nj,-74.54298,39.37124,1612,5,10,5,100
001012402,nj,-74.5555,39.36282,1262,5,11,6,120
001012501,nj,-74.57268,39.35788,882,5,11,6,120
001012502,nj,-74.58418,39.34104,649,5,11,6,120
001012602,nj,-74.5734,39.33159,619,5,11,6,120
001012701,nj,-74.60745,39.32897,1159,5,12,7,140
001012702,nj,-74.61933,39.31415,686,5,12,7,140
001012801,nj,-74.58872,39.32239,1420,5,11,6,120
001012802,nj,-74.60748,39.3066,1248,5,11,6,120
001013000,nj,-74.49951,39.33141,3468,2,6,4,200
001013101,nj,-74.5068,39.32541,1292,2,6,4,200
001013102,nj,-74.51183,39.3193,1900,2,6,4,200
001013201,nj,-74.47234,39.34679,865,2,5,3,150
001013202,nj,-74.47612,39.34218,847,2,6,4,200
001013301,nj,-74.49192,39.34078,1809,2,6,4,200
001013302,nj,-74.48007,39.3385,1393,2,6,4,200
001013500,nj,-74.54151,39.33119,2209,4,10,6,150
001983400,nj,-74.5359,39.48771,41,9,18,9,100
003001001,nj,-74.12512,41.03641,1236,6,13,7,116.7
003001002,nj,-74.14124,41.03011,1277,6,13,7,116.7
003002100,nj,-73.91982,40.96167,800,7,15,8,114.3
003002200,nj,-73.94255,41.00677,1886,7,15,8,114.3
003002300,nj,-73.95099,40.99333,2282,7,15,8,114.3
003003100,nj,-73.98664,40.93048,1649,7,14,7,100
003003200,nj,-73.99589,40.92531,1257,7,14,7,100
003003300,nj,-74.00483,40.9294,2002,7,14,7,100
003003401,nj,-74.01208,40.91787,846,7,14,7,100
003003402,nj,-74.00556,40.91536,1073,7,14,7,100
003003500,nj,-73.98903,40.91773,721,7,14,7,100
003004001,nj,-74.02973,40.87948,913,7,15,8,114.3
003004002,nj,-74.02907,40.87182,1376,7,15,8,114.3
003005000,nj,-74.06118,40.8247,2372,7,15,8,114.3
003006101,nj,-73.9869,40.83045,1672,6,13,7,116.7
003006102,nj,-73.99049,40.82635,887,6,13,7,116.7
003006201,nj,-73.98662,40.82153,1167,6,13,7,116.7
003006202,nj,-73.9809,40.82684,2163,6,13,7,116.7
003006301,nj,-73.99386,40.81305,683,6,14,8,133.3
003006302,nj,-73.98939,40.81443,890,6,14,8,133.3
003007001,nj,-73.97473,40.97466,1540,7,15,8,114.3
003007002,nj,-73.94853,40.97217,1819,7,14,7,100
003008001,nj,-73.95435,40.9405,2255,6,14,8,133.3
003008002,nj,-73.97121,40.94049,3065,7,14,7,100
003009100,nj,-73.95679,40.95504,1973,7,14,7,100
003009200,nj,-73.9976,40.96223,1331,7,15,8,114.3
003010100,nj,-73.98232,40.94596,1926,7,15,8,114.3
003010200,nj,-73.99492,40.94002,1040,7,15,8,114.3
003010300,nj,-73.99883,40.94696,2339,7,15,8,114.3
003011100,nj,-74.12128,40.91785,1102,8,16,8,100
003011200,nj,-74.12698,40.91051,1088,8,16,8,100
003011300,nj,-74.12343,40.89643,1359,8,16,8,100
003011400,nj,-74.11249,40.90269,1858,8,16,8,100
003012001,nj,-74.08259,40.81513,1415,7,15,8,114.3
003012002,nj,-74.11268,40.84503,1053,7,15,8,114.3
003013002,nj,-73.96645,40.83603,2332,6,14,8,133.3
003013003,nj,-73.98057,40.81118,1462,6,14,8,133.3
003013004,nj,-73.98484,40.81507,611,6,14,8,133.3
003014000,nj,-74.02389,40.97486,2609,8,16,8,100
003015100,nj,-73.96118,40.89722,978,6,14,8,133.3
003015200,nj,-73.97671,40.90726,1745,7,14,7,100
003015300,nj,-73.98674,40.89634,1648,6,13,7,116.7
003015401,nj,-73.97573,40.89579,830,6,13,7,116.7
003015402,nj,-73.98515,40.88247,666,6,13,7,116.7
003015500,nj,-73.97056,40.87922,2040,6,13,7,116.7
003016000,nj,-73.94672,40.88227,2186,6,14,8,133.3
003017101,nj,-74.11246,40.94655,1919,8,16,8,100
003017102,nj,-74.10604,40.94054,605,8,16,8,100
003017200,nj,-74.1335,40.94253,2789,8,16,8,100
003017301,nj,-74.13593,40.92833,1904,8,16,8,100
003017302,nj,-74.12629,40.93018,1690,8,16,8,100
003017400,nj,-74.10368,40.93526,2592,8,16,8,100
003017501,nj,-74.11387,40.92539,2759,8,16,8,100
003017502,nj,-74.09925,40.92467,1533,8,16,8,100
003018101,nj,-73.99828,40.81251,711,6,14,8,133.3
003018102,nj,-73.99457,40.81914,509,6,13,7,116.7
003018200,nj,-74.00431,40.81922,1603,6,13,7,116.7
003019102,nj,-73.95813,40.85768,583,6,14,8,133.3
003019103,nj,-73.97278,40.86311,519,6,14,8,133.3
003019104,nj,-73.96731,40.86054,1253,6,14,8,133.3
003019202,nj,-73.9643,40.85066,622,6,14,8,133.3
003019203,nj,-73.97494,40.85573,612,6,14,8,133.3
003019204,nj,-73.97844,40.85362,762,6,13,7,116.7
003019303,nj,-73.98122,40.8471,1395,6,13,7,116.7
003019304,nj,-73.98529,40.83644,853,6,13,7,116.7
003019305,nj,-73.97417,40.8428,1308,6,14,8,133.3
003019306,nj,-73.97806,40.83321,969,6,13,7,116.7
003020100,nj,-74.19669,41.02562,1682,4,10,6,150
003020200,nj,-74.21592,40.99752,2543,4,11,7,175
003021101,nj,-74.10933,40.88931,894,8,16,8,100
003021102,nj,-74.10861,40.88452,556,8,16,8,100
003021200,nj,-74.11996,40.88392,1362,8,16,8,100
003021300,nj,-74.10877,40.8783,1025,8,16,8,100
003021400,nj,-74.09879,40.88013,1063,8,16,8,100
003021500,nj,-74.102,40.86858,1037,8,16,8,100
003021600,nj,-74.10976,40.87015,790,8,16,8,100
003022100,nj,-74.12661,40.9672,1428,8,16,8,100
003022200,nj,-74.12426,40.95689,2739,8,16,8,100
003023100,nj,-74.03636,40.89616,824,7,15,8,114.3
003023201,nj,-74.04607,40.89856,1323,7,15,8,114.3
003023202,nj,-74.04185,40.90572,1241,7,15,8,114.3
003023301,nj,-74.05047,40.90522,1373,7,15,8,114.3
003023303,nj,-74.05187,40.8931,418,7,15,8,114.3
003023304,nj,-74.05589,40.895,891,7,15,8,114.3
003023401,nj,-74.05941,40.88806,195,7,15,8,114.3
003023402,nj,-74.05991,40.87879,1976,7,15,8,114.3
003023501,nj,-74.04724,40.88969,992,7,15,8,114.3
003023502,nj,-74.05078,40.88457,1236,7,15,8,114.3
003023601,nj,-74.03923,40.86608,1237,7,15,8,114.3
003023602,nj,-74.04476,40.87571,1268,7,15,8,114.3
003024100,nj,-73.98559,41.01639,2141,7,15,8,114.3
003024200,nj,-73.98035,40.98991,1739,7,15,8,114.3
003025100,nj,-74.07003,40.86176,1849,7,15,8,114.3
003025200,nj,-74.07995,40.86192,1988,7,15,8,114.3
003026100,nj,-74.02856,41.00826,1580,7,15,8,114.3
003026200,nj,-74.05496,41.00675,2102,7,15,8,114.3
003027000,nj,-74.09718,41.00005,1632,7,15,8,114.3
003028001,nj,-73.99326,40.86517,1467,6,13,7,116.7
003028002,nj,-73.98376,40.86128,1244,6,13,7,116.7
003029100,nj,-74.03638,40.8545,903,6,14,8,133.3
003029200,nj,-74.03966,40.84349,1746,6,14,8,133.3
003030100,nj,-74.0733,40.88329,1244,7,15,8,114.3
003030201,nj,-74.09273,40.87424,811,7,15,8,114.3
003030202,nj,-74.08762,40.88391,665,7,15,8,114.3
003030300,nj,-74.08588,40.87623,1087,7,15,8,114.3
003030401,nj,-74.08606,40.86651,567,7,15,8,114.3
003030402,nj,-74.07855,40.87327,847,7,15,8,114.3
003031100,nj,-74.10259,40.79094,1417,7,15,8,114.3
003031200,nj,-74.12494,40.81628,1334,7,15,8,114.3
003031300,nj,-74.13298,40.80952,1617,7,15,8,114.3
003031400,nj,-74.12209,40.80346,1616,7,15,8,114.3
003032102,nj,-74.18329,41.05073,2645,5,11,6,120
003032103,nj,-74.163,41.0806,2640,5,11,6,120
003032104,nj,-74.20302,41.09281,1480,4,10,6,150
003032201,nj,-74.12697,41.08343,2535,5,11,6,120
003032202,nj,-74.14221,41.09592,2460,5,11,6,120
003033100,nj,-74.06028,40.91004,1365,8,16,8,100
003033200,nj,-74.06707,40.90002,915,8,16,8,100
003033300,nj,-74.06249,40.89513,770,7,15,8,114.3
003034001,nj,-74.14338,40.99022,1003,7,14,7,100
003034002,nj,-74.13932,40.99882,1479,7,14,7,100
003035100,nj,-74.0498,41.05289,3109,6,13,7,116.7
003035200,nj,-74.06034,41.02529,2131,6,14,8,133.3
003036100,nj,-74.05569,40.86011,928,7,15,8,114.3
003036200,nj,-74.05765,40.83996,872,7,14,7,100
003037100,nj,-74.01625,40.94543,1825,7,15,8,114.3
003037201,nj,-74.01845,40.93372,1382,7,15,8,114.3
003037203,nj,-74.02419,40.9215,1192,7,15,8,114.3
003037204,nj,-74.02096,40.92579,80,7,15,8,114.3
003038100,nj,-74.12263,40.78582,1578,7,15,8,114.3
003038200,nj,-74.13591,40.7843,849,7,15,8,114.3
003038300,nj,-74.13795,40.79395,1837,7,15,8,114.3
003039100,nj,-74.2476,41.03832,1849,4,10,6,150
003039200,nj,-74.22048,41.03714,2010,4,10,6,150
003039300,nj,-74.24433,41.0124,1175,4,10,6,150
003040001,nj,-74.02896,40.96085,1200,8,16,8,100
003040002,nj,-74.0349,40.94977,1641,8,16,8,100
003041100,nj,-74.00241,40.85093,1271,6,13,7,116.7
003041200,nj,-73.99312,40.84826,1130,6,13,7,116.7
003041301,nj,-73.99782,40.84193,1174,6,13,7,116.7
003041302,nj,-73.98774,40.84473,1331,6,13,7,116.7
003042101,nj,-74.05293,40.93294,1078,7,15,8,114.3
003042102,nj,-74.05296,40.94538,1519,8,15,7,87.5
003042301,nj,-74.08513,40.9664,1478,7,15,8,114.3
003042302,nj,-74.0652,40.9637,1658,7,15,8,114.3
003042400,nj,-74.08001,40.94505,1630,8,15,7,87.5
003042500,nj,-74.0726,40.92317,1639,8,16,8,100
003043001,nj,-74.05195,41.03956,1567,6,13,7,116.7
003043002,nj,-74.03167,41.03051,1644,6,13,7,116.7
003044100,nj,-74.15754,41.05658,2020,5,11,6,120
003044201,nj,-74.13243,41.05191,1267,5,12,7,140
003044202,nj,-74.13467,41.06825,2372,5,12,7,140
003045101,nj,-74.00137,40.82794,1122,6,13,7,116.7
003045102,nj,-73.99753,40.83361,954,6,13,7,116.7
003045200,nj,-74.01962,40.83142,1040,6,13,7,116.7
003046100,nj,-74.01538,40.85136,1114,6,14,8,133.3
003046200,nj,-74.02641,40.86321,1223,7,15,8,114.3
003046300,nj,-74.0255,40.85251,1120,6,14,8,133.3
003047100,nj,-74.09674,40.98735,2025,7,15,8,114.3
003047200,nj,-74.12248,40.99721,1347,7,15,8,114.3
003047300,nj,-74.13483,40.97966,1090,8,16,8,100
003047400,nj,-74.12021,40.97822,1520,8,16,8,100
003047500,nj,-74.10271,40.9708,2184,8,16,8,100
003048100,nj,-74.03343,40.92506,989,7,15,8,114.3
003048200,nj,-74.04168,40.9278,2538,7,15,8,114.3
003049001,nj,-74.00949,41.02711,1692,7,15,8,114.3
003049002,nj,-74.00613,40.99614,1990,7,15,8,114.3
003050000,nj,-74.07911,40.90697,3116,8,16,8,100
003051100,nj,-74.11553,40.83747,1653,7,15,8,114.3
003051200,nj,-74.11787,40.82706,920,7,15,8,114.3
003051300,nj,-74.10635,40.82885,1338,7,15,8,114.3
003051400,nj,-74.09883,40.80952,1688,7,15,8,114.3
003052100,nj,-74.09769,40.9105,2596,8,16,8,100
003052200,nj,-74.09254,40.89387,1976,7,16,9,128.6
003053100,nj,-74.09558,41.0273,1451,6,13,7,116.7
003053201,nj,-74.0961,41.05666,1593,5,12,7,140
003053202,nj,-74.10121,41.07098,1267,5,11,6,120
003054101,nj,-73.99467,40.90243,1390,7,14,7,100
003054102,nj,-73.99782,40.8869,1237,6,13,7,116.7
003054200,nj,-74.00455,40.89947,1064,6,13,7,116.7
003054300,nj,-74.01711,40.90549,2271,7,15,8,114.3
003054400,nj,-74.02678,40.8913,1984,7,15,8,114.3
003054500,nj,-74.01403,40.88581,1513,6,14,8,133.3
003054601,nj,-74.01185,40.86785,992,7,14,7,100
003054602,nj,-74.00559,40.87608,1796,6,13,7,116.7
003055100,nj,-73.94567,40.91511,2368,6,14,8,133.3
003055201,nj,-73.97452,40.91859,1254,6,14,8,133.3
003055202,nj,-73.97224,40.92979,1327,6,14,8,133.3
003056100,nj,-74.11047,41.01235,1756,7,15,8,114.3
003056200,nj,-74.13406,41.01384,1969,7,14,7,100
003057101,nj,-74.10201,40.85696,592,8,16,8,100
003057102,nj,-74.10771,40.84898,1162,7,15,8,114.3
003057200,nj,-74.11462,40.85555,768,8,16,8,100
003058100,nj,-74.07084,40.99144,1518,7,15,8,114.3
003058200,nj,-74.05644,40.98542,2086,7,15,8,114.3
003059100,nj,-74.02089,40.9889,1610,7,15,8,114.3
003059200,nj,-74.04122,40.98678,2020,7,15,8,114.3
003060001,nj,-74.08225,40.84551,1322,7,15,8,114.3
003060002,nj,-74.09241,40.85558,2043,7,15,8,114.3
003061100,nj,-74.15997,41.0134,1706,6,13,7,116.7
003061200,nj,-74.17588,41.00593,1280,6,13,7,116.7
003061300,nj,-74.18016,40.98737,1144,6,13,7,116.7
003061400,nj,-74.1576,40.98708,1787,7,14,7,100
005700102,nj,-75.02207,39.99945,1134,15,26,11,73.3
005700103,nj,-75.03226,40.00996,1322,15,26,11,73.3
005700104,nj,-75.04262,40.00092,975,15,26,11,73.3
005700200,nj,-75.01491,40.01157,1114,15,27,12,80
005700303,nj,-74.99313,40.014,1203,15,27,12,80
005700304,nj,-75.01396,39.99315,960,15,26,11,73.3
005700305,nj,-74.99913,39.98329,1827,16,27,11,68.8
005700306,nj,-74.97928,39.99904,929,15,27,12,80
005700307,nj,-74.97057,39.99306,949,15,27,12,80
005700401,nj,-75.00156,39.9644,898,17,28,11,64.7
005700402,nj,-75.01207,39.95817,1396,17,28,11,64.7
005700403,nj,-75.00033,39.95165,1742,17,28,11,64.7
005700405,nj,-74.99342,39.94714,703,17,28,11,64.7
005700407,nj,-74.98178,39.9474,497,17,28,11,64.7
005700408,nj,-74.9755,39.93762,293,15,27,12,80
005700501,nj,-74.96355,39.95423,2235,17,28,11,64.7
005700502,nj,-74.98148,39.97306,1020,17,28,11,64.7
005700503,nj,-74.95358,39.97217,1527,17,28,11,64.7
005700504,nj,-74.9339,39.965,1593,17,28,11,64.7
005700505,nj,-74.92001,39.99141,2078,16,27,11,68.8
005700602,nj,-74.93282,40.01346,2566,15,27,12,80
005700603,nj,-74.96517,40.02569,1722,15,26,11,73.3
005700605,nj,-74.95829,40.00304,1445,15,27,12,80
005700701,nj,-74.96335,40.03346,1098,14,25,11,78.6
005700702,nj,-74.95318,40.03344,856,14,25,11,78.6
005700703,nj,-74.95188,40.03904,922,14,25,11,78.6
005700800,nj,-74.94569,40.04917,1822,15,25,10,66.7
005700900,nj,-74.92219,40.06519,1101,15,26,11,73.3
005701001,nj,-74.91638,40.04917,1455,15,26,11,73.3
005701002,nj,-74.90332,40.0626,1237,15,26,11,73.3
005701102,nj,-74.82407,40.05418,1981,14,25,11,78.6
005701103,nj,-74.8227,40.09234,2165,14,24,10,71.4
005701104,nj,-74.88151,40.0636,1997,15,25,10,66.7
005701105,nj,-74.8496,40.04449,2234,15,25,10,66.7
005701201,nj,-74.85186,40.0683,2355,14,25,11,78.6
005701203,nj,-74.84476,40.08579,858,14,24,10,71.4
005701204,nj,-74.85424,40.07795,1396,14,25,11,78.6
005701205,nj,-74.86715,40.07597,1313,14,25,11,78.6
005701301,nj,-74.80955,40.11923,1027,12,22,10,83.3
005701302,nj,-74.77821,40.11828,829,12,22,10,83.3
005701303,nj,-74.7859,40.09153,2210,13,23,10,76.9
005701401,nj,-74.71112,40.08708,2144,12,22,10,83.3
005701402,nj,-74.75295,40.06811,1079,14,25,11,78.6
005701502,nj,-74.69446,40.16753,1102,11,21,10,90.9
005701700,nj,-74.70835,40.14939,1478,12,21,9,75
005702101,nj,-74.58529,40.04932,6,12,21,9,75
005702203,nj,-74.6492,39.94141,1466,14,24,10,71.4
005702204,nj,-74.68434,39.98573,1000,14,24,10,71.4
005702206,nj,-74.52955,39.96512,5415,13,23,10,76.9
005702207,nj,-74.58941,39.9579,3909,13,23,10,76.9
005702208,nj,-74.54808,39.93286,3783,12,22,10,83.3
005702209,nj,-74.55332,39.98123,14208,12,22,10,83.3
005702210,nj,-74.58006,39.98133,8548,13,23,10,76.9
005702300,nj,-74.68584,39.9714,642,14,25,11,78.6
005702400,nj,-74.71106,40.03701,1702,14,24,10,71.4
005702500,nj,-74.75533,40.00097,1883,15,25,10,66.7
005702601,nj,-74.78249,40.00147,1724,15,26,11,73.3
005702603,nj,-74.7861,39.99392,1193,15,26,11,73.3
005702701,nj,-74.85069,40.01566,975,15,26,11,73.3
005702702,nj,-74.8084,40.01734,2269,15,26,11,73.3
005702801,nj,-74.8614,40.03386,796,15,25,10,66.7
005702802,nj,-74.87287,40.03581,1197,15,25,10,66.7
005702803,nj,-74.86897,40.02111,1421,15,26,11,73.3
005702804,nj,-74.87907,40.02014,1037,16,27,11,68.8
005702805,nj,-74.88908,40.02654,1347,15,26,11,73.3
005702806,nj,-74.88514,40.04087,1317,15,25,10,66.7
005702807,nj,-74.89417,40.04673,1027,15,26,11,73.3
005702808,nj,-74.90164,40.03267,1175,15,26,11,73.3
005702809,nj,-74.90994,40.03722,736,15,26,11,73.3
005702810,nj,-74.90711,40.02258,592,15,26,11,73.3
005702811,nj,-74.87898,40.00699,982,16,27,11,68.8
005702905,nj,-74.94061,39.92856,1375,15,26,11,73.3
005702906,nj,-74.95696,39.92993,1108,15,26,11,73.3
005702907,nj,-74.92067,39.92574,1316,15,27,12,80
005702908,nj,-74.90057,39.92866,2130,15,27,12,80
005702909,nj,-74.92732,39.94563,2766,16,27,11,68.8
005702910,nj,-74.89285,39.95028,2157,16,28,12,75
005702913,nj,-74.87391,39.9746,2132,16,28,12,75
005702914,nj,-74.87305,39.98704,1748,16,27,11,68.8
005702915,nj,-74.8756,39.96117,1676,16,28,12,75
005702917,nj,-74.86509,39.9664,881,16,28,12,75
005702918,nj,-74.86672,39.94589,977,16,28,12,75
005703000,nj,-74.83695,39.97673,3273,16,27,11,68.8
005703102,nj,-74.82285,39.94664,963,16,27,11,68.8
005703103,nj,-74.7748,39.96394,1353,16,27,11,68.8
005703104,nj,-74.79782,39.97309,2176,16,27,11,68.8
005703201,nj,-74.69134,39.91545,1781,14,25,11,78.6
005703202,nj,-74.76096,39.91376,1449,15,27,12,80
005703203,nj,-74.71201,39.9002,2700,14,25,11,78.6
005703600,nj,-74.65507,39.81923,3017,15,26,11,73.3
005703700,nj,-74.72722,39.77814,2622,16,27,11,68.8
005703801,nj,-74.79721,39.88078,2807,16,27,11,68.8
005703802,nj,-74.84155,39.90932,1689,16,27,11,68.8
005703803,nj,-74.83831,39.87724,2039,16,27,11,68.8
005703804,nj,-74.8368,39.82646,2971,15,27,12,80
005703900,nj,-74.80537,39.85818,5433,16,27,11,68.8
005704004,nj,-74.92828,39.90579,1177,15,26,11,73.3
005704005,nj,-74.94382,39.90436,1445,15,26,11,73.3
005704006,nj,-74.92829,39.88375,1113,14,25,11,78.6
005704007,nj,-74.91117,39.88756,1177,15,26,11,73.3
005704008,nj,-74.90412,39.87082,1657,15,26,11,73.3
005704009,nj,-74.87527,39.87673,3239,15,26,11,73.3
005704011,nj,-74.88875,39.81419,1487,14,25,11,78.6
005704012,nj,-74.88126,39.84619,2811,15,26,11,73.3
005704013,nj,-74.90549,39.90062,1819,15,26,11,73.3
005704015,nj,-74.87287,39.90688,814,16,27,11,68.8
005704016,nj,-74.89752,39.91084,1666,16,27,11,68.8
005704201,nj,-74.69345,40.13532,2031,12,21,9,75
005704202,nj,-74.73073,40.12966,460,12,22,10,83.3
005704302,nj,-74.64467,40.11442,2011,11,21,10,90.9
005704500,nj,-74.58788,40.07991,1613,11,21,10,90.9
005704600,nj,-74.78889,39.99084,2002,15,26,11,73.3
005704700,nj,-74.5165,39.73057,32924,13,23,10,76.9
005704801,nj,-74.5685,40.0042,383,12,21,9,75
005981802,nj,-74.67133,40.15999,13,11,21,10,90.9
005982111,nj,-74.58772,40.02485,2,13,22,9,69.2
005982200,nj,-74.62785,40.01535,22,12,22,10,83.3
007600200,nj,-75.10753,39.9366,1416,15,26,11,73.3
007600400,nj,-75.11809,39.93292,2244,15,26,11,73.3
007600700,nj,-75.12535,39.95616,767,15,27,12,80
007600800,nj,-75.11389,39.95166,1751,15,27,12,80
007600900,nj,-75.10145,39.95293,1193,15,26,11,73.3
007601000,nj,-75.08992,39.96079,2085,15,26,11,73.3
007601101,nj,-75.08683,39.94868,1215,15,26,11,73.3
007601102,nj,-75.07881,39.95338,1402,15,26,11,73.3
007601200,nj,-75.07787,39.94451,1763,15,26,11,73.3
007601300,nj,-75.09395,39.94195,1789,15,26,11,73.3
007601400,nj,-75.09427,39.93145,1811,14,26,12,85.7
007601500,nj,-75.09916,39.92433,2168,15,26,11,73.3
007601600,nj,-75.11085,39.92603,823,15,26,11,73.3
007601700,nj,-75.1098,39.91997,531,15,26,11,73.3
007601800,nj,-75.12364,39.91885,1167,15,26,11,73.3
007601900,nj,-75.10922,39.91284,972,15,26,11,73.3
007602000,nj,-75.10409,39.90527,2073,15,26,11,73.3
007602503,nj,-75.07621,39.93882,953,15,26,11,73.3
007602601,nj,-75.05913,39.93989,1078,15,26,11,73.3
007602602,nj,-75.0646,39.94291,929,15,26,11,73.3
007602901,nj,-75.02535,39.96729,2080,16,27,11,68.8
007602902,nj,-75.03882,39.96235,995,16,27,11,68.8
007603001,nj,-75.04971,39.95665,1384,15,27,12,80
007603002,nj,-75.06265,39.95653,1619,15,26,11,73.3
007603100,nj,-75.05034,39.95022,1422,15,27,12,80
007603201,nj,-75.03132,39.94385,1725,15,27,12,80
007603202,nj,-75.04494,39.92838,1710,15,26,11,73.3
007603301,nj,-75.02117,39.92698,1742,15,26,11,73.3
007603302,nj,-74.99709,39.93483,2356,15,27,12,80
007603303,nj,-75.0082,39.92377,696,15,26,11,73.3
007603400,nj,-74.98813,39.91881,2776,15,26,11,73.3
007603501,nj,-74.97195,39.90104,2429,15,25,10,66.7
007603503,nj,-74.98416,39.87784,1722,14,25,11,78.6
007603504,nj,-74.99228,39.8707,1355,14,25,11,78.6
007603505,nj,-75.00516,39.86728,1366,14,25,11,78.6
007603506,nj,-74.94916,39.88854,2190,14,25,11,78.6
007603507,nj,-74.95682,39.87444,2562,14,25,11,78.6
007603601,nj,-75.01406,39.88719,1677,14,25,11,78.6
007603602,nj,-75.00282,39.89835,965,14,25,11,78.6
007603603,nj,-74.99573,39.90698,951,15,26,11,73.3
007603700,nj,-75.02015,39.90948,1252,15,26,11,73.3
007603800,nj,-75.051,39.91683,2015,15,26,11,73.3
007603901,nj,-75.0539,39.90344,1755,14,26,12,85.7
007603902,nj,-75.06451,39.90167,854,14,25,11,78.6
007604100,nj,-75.09562,39.91665,990,14,26,12,85.7
007604200,nj,-75.07734,39.92205,1156,14,26,12,85.7
007604300,nj,-75.06505,39.9178,1650,14,26,12,85.7
007604400,nj,-75.07477,39.91337,1293,14,26,12,85.7
007604600,nj,-75.07822,39.9047,772,14,25,11,78.6
007604700,nj,-75.08415,39.90011,833,14,25,11,78.6
007605100,nj,-75.10926,39.89353,1063,14,25,11,78.6
007605200,nj,-75.10728,39.88541,894,14,25,11,78.6
007605300,nj,-75.12075,39.87881,974,14,25,11,78.6
007605400,nj,-75.09455,39.87855,1321,14,25,11,78.6
007605602,nj,-75.07244,39.88619,998,14,25,11,78.6
007605700,nj,-75.06379,39.89333,1408,14,25,11,78.6
007605800,nj,-75.07473,39.87776,1295,14,25,11,78.6
007605900,nj,-75.06328,39.87717,1007,14,25,11,78.6
007606000,nj,-75.05296,39.88307,796,14,25,11,78.6
007606100,nj,-75.04419,39.8967,805,14,25,11,78.6
007606200,nj,-75.03374,39.90676,1762,15,26,11,73.3
007606300,nj,-75.02705,39.89187,998,14,25,11,78.6
007606400,nj,-75.03419,39.88343,1113,14,25,11,78.6
007606500,nj,-75.0289,39.86731,1451,14,25,11,78.6
007606600,nj,-75.04527,39.87316,915,14,25,11,78.6
007606700,nj,-75.05687,39.86511,1598,14,25,11,78.6
007606800,nj,-75.07341,39.8663,1499,14,25,11,78.6
007607000,nj,-75.11027,39.86844,1350,14,25,11,78.6
007607100,nj,-75.08406,39.85051,1557,14,25,11,78.6
007607200,nj,-75.06557,39.85354,1579,14,25,11,78.6
007607300,nj,-75.0364,39.8562,2014,14,25,11,78.6
007607401,nj,-75.02936,39.84467,1071,14,25,11,78.6
007607402,nj,-75.01557,39.84601,1308,14,25,11,78.6
007607502,nj,-74.97649,39.85028,2346,14,25,11,78.6
007607503,nj,-74.93737,39.8601,2193,14,25,11,78.6
007607504,nj,-74.92392,39.83419,1438,14,25,11,78.6
007607505,nj,-74.9448,39.83216,1767,14,24,10,71.4
007607506,nj,-74.99115,39.85264,965,14,25,11,78.6
007607507,nj,-75.0052,39.85152,1180,14,25,11,78.6
007607600,nj,-74.96574,39.8332,1400,14,24,10,71.4
007607701,nj,-74.96774,39.81482,1434,14,24,10,71.4
007607702,nj,-74.98859,39.8251,1716,14,25,11,78.6
007607801,nj,-75.01652,39.81181,1347,13,24,11,84.6
007607802,nj,-75.0011,39.81412,1046,13,24,11,84.6
007607900,nj,-75.00524,39.82132,968,14,25,11,78.6
007608001,nj,-75.00786,39.83194,1003,14,25,11,78.6
007608202,nj,-75.03988,39.82332,1582,14,25,11,78.6
007608205,nj,-75.04151,39.83664,1443,14,25,11,78.6
007608206,nj,-75.05432,39.84387,1432,14,25,11,78.6
007608209,nj,-75.04041,39.81296,916,14,24,10,71.4
007608210,nj,-75.04471,39.78641,713,13,24,11,84.6
007608211,nj,-75.02533,39.79043,2072,13,24,11,84.6
007608302,nj,-75.07613,39.83282,1479,14,25,11,78.6
007608303,nj,-75.07374,39.81191,1184,13,24,11,84.6
007608304,nj,-75.05858,39.81795,2700,13,24,11,84.6
007608401,nj,-74.99646,39.77109,1481,13,24,11,84.6
007608402,nj,-74.98635,39.76165,1350,13,24,11,84.6
007608403,nj,-75.01062,39.74597,2633,13,24,11,84.6
007608404,nj,-75.02511,39.766,2684,13,23,10,76.9
007608503,nj,-75.00487,39.79778,890,13,24,11,84.6
007608504,nj,-75.00199,39.78622,779,13,24,11,84.6
007608600,nj,-74.985,39.80457,2501,13,24,11,84.6
007608700,nj,-74.93746,39.79152,3200,14,25,11,78.6
007608800,nj,-74.92548,39.80535,2639,14,25,11,78.6
007608901,nj,-74.88688,39.77221,2620,14,26,12,85.7
007608903,nj,-74.84492,39.76979,1403,15,26,11,73.3
007608904,nj,-74.80677,39.73175,885,15,27,12,80
007609000,nj,-74.87858,39.73064,1305,15,27,12,80
007609103,nj,-74.91317,39.75244,2608,14,25,11,78.6
007609201,nj,-74.99564,39.72219,1592,13,24,11,84.6
007609202,nj,-74.97014,39.71843,1755,14,25,11,78.6
007609204,nj,-74.96116,39.70645,1348,14,25,11,78.6
007609205,nj,-74.8964,39.67621,2939,15,26,11,73.3
007609206,nj,-74.98232,39.73544,1605,13,24,11,84.6
007609207,nj,-74.9587,39.7521,1975,14,24,10,71.4
007610300,nj,-75.12964,39.94035,742,15,26,11,73.3
007610400,nj,-75.11907,39.94126,2446,15,26,11,73.3
007610500,nj,-75.08134,39.96784,2279,15,26,11,73.3
007610600,nj,-75.07568,39.93062,254,14,26,12,85.7
007610800,nj,-75.04303,39.98344,1400,15,27,12,80
007610900,nj,-75.0829,39.89267,952,14,25,11,78.6
007611000,nj,-75.12502,39.8953,2798,14,25,11,78.6
007611100,nj,-75.09261,39.86495,984,14,25,11,78.6
007611200,nj,-75.02169,39.82865,1538,14,25,11,78.6
007611300,nj,-75.0679,39.79022,1726,13,24,11,84.6
007611400,nj,-74.97111,39.78501,1951,13,24,11,84.6
007611500,nj,-74.85036,39.69136,2261,15,27,12,80
007611600,nj,-75.08904,39.91035,1094,14,26,12,85.7
007611700,nj,-75.09198,39.88867,1623,14,25,11,78.6
009020101,nj,-74.56746,39.28216,4624,5,10,5,100
009020102,nj,-74.58229,39.27397,4216,3,9,6,200
009020201,nj,-74.56965,39.29591,1578,4,10,6,150
009020203,nj,-74.60051,39.27551,4335,2,7,5,250
009020205,nj,-74.63712,39.2288,3591,2,7,5,250
009020206,nj,-74.61733,39.25079,2946,3,8,5,166.7
009020301,nj,-74.65738,39.26979,6187,4,10,6,150
009020302,nj,-74.6921,39.21485,3793,4,10,6,150
009020400,nj,-74.77756,39.27193,9169,7,15,8,114.3
009020500,nj,-74.80962,39.22835,1071,7,16,9,128.6
009020600,nj,-74.85955,39.22386,2199,7,16,9,128.6
009020700,nj,-74.75892,39.16869,3697,5,12,7,140
009020800,nj,-74.69526,39.15079,13671,3,8,5,166.7
009020901,nj,-74.76711,39.0417,6526,2,7,5,250
009020902,nj,-74.73134,39.09072,12496,2,7,5,250
009021001,nj,-74.79423,39.07989,2329,3,9,6,200
009021002,nj,-74.86717,39.11669,2961,3,9,6,200
009021100,nj,-74.82048,39.07882,2871,3,9,6,200
009021300,nj,-74.7959,39.00404,6620,2,7,5,250
009021400,nj,-74.81612,38.9891,3639,2,7,5,250
009021500,nj,-74.82583,38.99001,1640,2,7,5,250
009021600,nj,-74.83671,38.97027,8566,2,7,5,250
009021701,nj,-74.91361,38.98761,1278,3,8,5,166.7
009021702,nj,-74.87526,38.97445,3851,2,8,6,300
009021803,nj,-74.94668,39.01559,5456,3,8,5,166.7
009021804,nj,-74.92384,39.01536,6731,3,8,5,166.7
009021805,nj,-74.9368,38.98875,3161,3,8,5,166.7
009021806,nj,-74.95565,38.97816,3584,3,8,5,166.7
009021900,nj,-74.94597,38.94781,4070,3,9,6,200
009022000,nj,-74.90266,38.93867,5632,3,9,6,200
009022101,nj,-74.90845,39.03775,939,3,8,5,166.7
009022102,nj,-74.87782,39.04237,4790,3,8,5,166.7
009990100,nj,-74.89671,39.02826,8,3,8,5,166.7
011010101,nj,-74.93507,39.30609,7653,10,20,10,100
011010103,nj,-74.9538,39.23943,1,8,17,9,112.5
011010200,nj,-75.04142,39.27458,4290,11,22,11,100
011010301,nj,-75.18897,39.33463,4804,10,20,10,100
011010302,nj,-75.13319,39.2714,2192,10,20,10,100
011010401,nj,-75.24635,39.3714,2813,10,20,10,100
011010402,nj,-75.1606,39.38508,1,9,19,10,111.1
011010500,nj,-75.35941,39.42483,1443,10,20,10,100
011010600,nj,-75.27843,39.43768,2613,10,20,10,100
011010701,nj,-75.21505,39.50934,1918,10,20,10,100
011010702,nj,-75.21713,39.46533,1756,10,21,11,110
011010800,nj,-75.13708,39.46416,1680,11,21,10,90.9
011020100,nj,-75.23326,39.42887,415,11,22,11,100
011020200,nj,-75.2403,39.4262,711,11,22,11,100
011020301,nj,-75.22961,39.44051,489,11,22,11,100
011020302,nj,-75.22502,39.43322,881,11,22,11,100
011020400,nj,-75.21549,39.43952,1249,10,20,10,100
011020502,nj,-75.20758,39.41323,2,10,20,10,100
011020503,nj,-75.2211,39.41722,1819,11,21,10,90.9
011020600,nj,-75.24301,39.42975,1351,11,22,11,100
011030100,nj,-75.03905,39.4052,410,11,21,10,90.9
011030200,nj,-75.03003,39.39699,1903,11,21,10,90.9
011030300,nj,-75.04918,39.39626,1354,11,21,10,90.9
011030401,nj,-75.00638,39.40006,1333,11,21,10,90.9
011030402,nj,-75.08484,39.42176,1475,11,21,10,90.9
011030501,nj,-75.07458,39.37409,5968,11,22,11,100
011030502,nj,-75.00416,39.37025,1405,11,21,10,90.9
011040300,nj,-75.00721,39.48465,1079,13,24,11,84.6
011040400,nj,-75.02222,39.49754,2189,13,24,11,84.6
011040500,nj,-75.04493,39.47732,1535,12,23,11,91.7
011040601,nj,-75.00238,39.46821,1202,12,23,11,91.7
011040602,nj,-75.01997,39.4708,744,12,23,11,91.7
011040701,nj,-75.00038,39.45857,1628,12,23,11,91.7
011040702,nj,-74.98211,39.48946,1306,13,24,11,84.6
011040800,nj,-74.96623,39.4639,2078,12,23,11,91.7
011040901,nj,-75.05938,39.52139,2471,14,25,11,78.6
011040902,nj,-75.02044,39.52341,2200,14,25,11,78.6
011041001,nj,-74.9512,39.42573,1515,12,22,10,83.3
011041002,nj,-75.04516,39.44956,1575,12,22,10,83.3
011041101,nj,-75.02934,39.48776,1087,13,24,11,84.6
011041102,nj,-75.02738,39.48213,845,12,23,11,91.7
011990000,nj,-75.18367,39.1973,15,7,15,8,114.3
013000100,nj,-74.16913,40.78248,852,8,16,8,100
013000200,nj,-74.17677,40.77143,387,7,15,8,114.3
013000300,nj,-74.17827,40.77727,376,7,15,8,114.3
013000400,nj,-74.18289,40.77433,428,8,16,8,100
013000500,nj,-74.18366,40.76799,258,8,15,7,87.5
013000600,nj,-74.18725,40.7686,600,8,16,8,100
013000700,nj,-74.19194,40.75933,895,8,16,8,100
013000800,nj,-74.18539,40.76113,636,8,16,8,100
013000900,nj,-74.18777,40.75419,526,8,16,8,100
013001000,nj,-74.1824,40.74773,633,8,15,7,87.5
013001100,nj,-74.18248,40.74323,371,8,16,8,100
013001300,nj,-74.19436,40.74227,411,8,16,8,100
013001400,nj,-74.19856,40.74311,737,8,16,8,100
013001500,nj,-74.19188,40.74625,220,8,16,8,100
013001600,nj,-74.1928,40.75095,352,8,16,8,100
013001700,nj,-74.19766,40.7506,613,8,16,8,100
013001800,nj,-74.20381,40.74491,609,8,16,8,100
013001900,nj,-74.21351,40.74535,494,8,16,8,100
013002000,nj,-74.23191,40.74863,854,8,17,9,112.5
013002100,nj,-74.23462,40.7432,941,8,17,9,112.5
013002202,nj,-74.24005,40.73573,773,9,17,8,88.9
013002203,nj,-74.24886,40.73706,10,8,17,9,112.5
013002204,nj,-74.24451,40.73775,450,8,17,9,112.5
013002300,nj,-74.23217,40.73868,1061,8,17,9,112.5
013002400,nj,-74.22614,40.74179,856,8,16,8,100
013002500,nj,-74.22092,40.74372,887,8,16,8,100
013002600,nj,-74.20864,40.73978,503,8,16,8,100
013002800,nj,-74.20088,40.73594,432,8,16,8,100
013003100,nj,-74.19236,40.73178,266,8,16,8,100
013003500,nj,-74.21167,40.7333,550,8,16,8,100
013003700,nj,-74.20781,40.72872,672,8,17,9,112.5
013003800,nj,-74.19975,40.73078,568,8,16,8,100
013003900,nj,-74.19459,40.72705,49,8,17,9,112.5
013004100,nj,-74.20597,40.72461,599,8,17,9,112.5
013004200,nj,-74.21343,40.72568,641,8,17,9,112.5
013004300,nj,-74.21828,40.71864,568,8,17,9,112.5
013004400,nj,-74.21675,40.71426,410,8,17,9,112.5
013004500,nj,-74.22301,40.71089,562,8,17,9,112.5
013004600,nj,-74.21578,40.70985,593,8,17,9,112.5
013004700,nj,-74.21244,40.70536,792,8,17,9,112.5
013004801,nj,-74.20202,40.71085,277,8,17,9,112.5
013004802,nj,-74.20082,40.69982,555,8,16,8,100
013004900,nj,-74.20709,40.70926,721,8,17,9,112.5
013005000,nj,-74.19779,40.71498,695,8,17,9,112.5
013005100,nj,-74.20682,40.71456,529,8,17,9,112.5
013005200,nj,-74.21319,40.71916,414,8,17,9,112.5
013005300,nj,-74.20913,40.7192,528,8,17,9,112.5
013005400,nj,-74.20323,40.72008,499,8,17,9,112.5
013005700,nj,-74.18462,40.71829,807,8,16,8,100
013006200,nj,-74.18623,40.7297,126,8,16,8,100
013006400,nj,-74.184,40.73759,135,8,16,8,100
013006600,nj,-74.18714,40.72706,57,8,17,9,112.5
013006700,nj,-74.18008,40.72535,396,8,16,8,100
013006800,nj,-74.17376,40.7191,1036,8,16,8,100
013006900,nj,-74.16639,40.72364,627,8,16,8,100
013007000,nj,-74.16126,40.72232,515,8,16,8,100
013007100,nj,-74.15646,40.7205,584,8,16,8,100
013007200,nj,-74.15376,40.72402,574,8,16,8,100
013007300,nj,-74.15001,40.72747,781,8,16,8,100
013007400,nj,-74.1336,40.71797,709,7,15,8,114.3
013007501,nj,-74.13371,40.7365,689,7,15,8,114.3
013007502,nj,-74.12922,40.72952,517,6,14,8,133.3
013007600,nj,-74.15539,40.73004,421,8,16,8,100
013007700,nj,-74.15981,40.72828,418,8,16,8,100
013007800,nj,-74.16707,40.72729,530,8,16,8,100
013007900,nj,-74.1625,40.73192,633,8,16,8,100
013008000,nj,-74.16951,40.73369,560,7,15,8,114.3
013008100,nj,-74.17678,40.73413,540,7,15,8,114.3
013008200,nj,-74.18859,40.74056,46,8,16,8,100
013008700,nj,-74.16966,40.75523,800,7,15,8,114.3
013008800,nj,-74.17301,40.75286,324,7,15,8,114.3
013008900,nj,-74.17554,40.7552,334,7,15,8,114.3
013009000,nj,-74.18107,40.75379,39,7,15,8,114.3
013009100,nj,-74.1796,40.75955,519,7,15,8,114.3
013009200,nj,-74.16743,40.75968,373,7,15,8,114.3
013009300,nj,-74.16586,40.76587,686,7,15,8,114.3
013009400,nj,-74.173,40.7665,751,7,15,8,114.3
013009500,nj,-74.16749,40.77411,777,7,15,8,114.3
013009600,nj,-74.15729,40.77372,836,7,15,8,114.3
013009700,nj,-74.16133,40.77768,608,8,15,7,87.5
013009900,nj,-74.21824,40.78232,504,8,16,8,100
013010000,nj,-74.21478,40.77967,636,8,16,8,100
013010100,nj,-74.20636,40.77819,691,8,16,8,100
013010200,nj,-74.19756,40.77227,1092,8,16,8,100
013010300,nj,-74.19859,40.76623,661,8,16,8,100
013010400,nj,-74.21031,40.77193,361,8,16,8,100
013010500,nj,-74.21641,40.76977,555,8,16,8,100
013010600,nj,-74.20963,40.76448,397,8,16,8,100
013010700,nj,-74.20308,40.76185,613,8,16,8,100
013010800,nj,-74.19737,40.75981,554,8,16,8,100
013010900,nj,-74.2054,40.75407,549,8,16,8,100
013011100,nj,-74.21167,40.75685,78,8,16,8,100
013011200,nj,-74.216,40.75977,450,8,16,8,100
013011300,nj,-74.22038,40.76422,256,8,16,8,100
013011400,nj,-74.23087,40.75588,551,8,17,9,112.5
013011500,nj,-74.22593,40.75572,659,8,16,8,100
013011600,nj,-74.21949,40.75572,479,8,16,8,100
013011700,nj,-74.21875,40.75166,698,8,16,8,100
013011800,nj,-74.22428,40.74795,538,8,16,8,100
013011900,nj,-74.22821,40.72722,352,9,18,9,100
013012000,nj,-74.24673,40.71576,1020,9,18,9,100
013012100,nj,-74.24401,40.72258,562,9,18,9,100
013012200,nj,-74.24143,40.72686,980,9,18,9,100
013012300,nj,-74.23464,40.73197,911,9,17,8,88.9
013012400,nj,-74.23747,40.721,630,9,18,9,100
013012500,nj,-74.22672,40.73356,775,9,17,8,88.9
013012600,nj,-74.22153,40.73509,533,8,16,8,100
013012700,nj,-74.23422,40.71191,870,9,18,9,100
013012800,nj,-74.23115,40.71667,740,9,18,9,100
013012900,nj,-74.22714,40.72294,629,9,17,8,88.9
013013000,nj,-74.22105,40.73024,7,8,17,9,112.5
013013100,nj,-74.22117,40.72233,589,8,17,9,112.5
013013200,nj,-74.21737,40.73221,618,8,16,8,100
013013300,nj,-74.21399,40.73842,762,8,16,8,100
013013400,nj,-74.15912,40.83001,1503,8,16,8,100
013013500,nj,-74.14923,40.82183,1478,8,16,8,100
013013600,nj,-74.14231,40.81428,2024,7,15,8,114.3
013013700,nj,-74.1576,40.81229,1075,8,16,8,100
013013800,nj,-74.16603,40.82201,1478,8,16,8,100
013013900,nj,-74.17309,40.81428,1599,8,16,8,100
013014000,nj,-74.1735,40.8008,1667,8,16,8,100
013014100,nj,-74.16617,40.80027,1094,8,16,8,100
013014200,nj,-74.15829,40.80163,1252,8,16,8,100
013014300,nj,-74.15087,40.80049,1331,8,16,8,100
013014400,nj,-74.14614,40.79398,1095,8,16,8,100
013014500,nj,-74.16099,40.78728,805,8,16,8,100
013014600,nj,-74.15874,40.79226,943,8,16,8,100
013014700,nj,-74.17886,40.78528,1626,8,16,8,100
013014800,nj,-74.18477,40.83597,1250,8,15,7,87.5
013014900,nj,-74.17336,40.83533,1721,8,16,8,100
013015000,nj,-74.18869,40.82214,951,8,15,7,87.5
013015100,nj,-74.18379,40.81804,1382,8,16,8,100
013015200,nj,-74.18795,40.80643,869,8,16,8,100
013015300,nj,-74.18188,40.80217,386,8,16,8,100
013015400,nj,-74.19558,40.7999,1138,8,16,8,100
013015500,nj,-74.18671,40.79232,1023,8,16,8,100
013015600,nj,-74.20335,40.7885,904,8,16,8,100
013015700,nj,-74.19649,40.78387,465,8,16,8,100
013015800,nj,-74.1883,40.78518,853,8,16,8,100
013015900,nj,-74.19138,40.77635,1210,8,16,8,100
013016000,nj,-74.2043,40.80404,2348,8,16,8,100
013016100,nj,-74.20383,40.85068,1129,7,15,8,114.3
013016200,nj,-74.1932,40.84511,1196,8,15,7,87.5
013016300,nj,-74.20002,40.83488,1181,8,15,7,87.5
013016400,nj,-74.21613,40.83143,1133,7,15,8,114.3
013016500,nj,-74.20449,40.82321,1215,8,15,7,87.5
013016600,nj,-74.21417,40.82009,677,8,15,7,87.5
013016700,nj,-74.20876,40.81131,565,8,16,8,100
013016800,nj,-74.21832,40.81515,880,8,16,8,100
013016900,nj,-74.22911,40.80935,806,8,16,8,100
013017000,nj,-74.22004,40.80539,729,8,16,8,100
013017100,nj,-74.21254,40.80489,439,8,16,8,100
013017200,nj,-74.21981,40.79561,884,8,16,8,100
013017301,nj,-74.2675,40.81279,2221,7,14,7,100
013017302,nj,-74.2861,40.78041,1941,7,15,8,114.3
013017400,nj,-74.2542,40.80246,2367,8,16,8,100
013017500,nj,-74.24677,40.78843,1979,8,16,8,100
013017600,nj,-74.23182,40.79321,1144,8,16,8,100
013017700,nj,-74.23071,40.78591,1092,8,16,8,100
013017800,nj,-74.24351,40.77287,759,8,17,9,112.5
013017900,nj,-74.25354,40.76745,1209,8,17,9,112.5
013018000,nj,-74.27191,40.76987,2252,8,16,8,100
013018100,nj,-74.22372,40.78406,346,8,16,8,100
013018200,nj,-74.22822,40.77877,590,8,16,8,100
013018300,nj,-74.23005,40.77484,618,8,16,8,100
013018400,nj,-74.2244,40.76792,491,8,16,8,100
013018600,nj,-74.23458,40.77001,840,8,17,9,112.5
013018700,nj,-74.23489,40.76327,620,8,17,9,112.5
013018800,nj,-74.24284,40.75793,1050,8,17,9,112.5
013018900,nj,-74.24742,40.76351,782,8,17,9,112.5
013019000,nj,-74.2705,40.75296,1692,9,17,8,88.9
013019100,nj,-74.24826,40.75019,1308,8,17,9,112.5
013019200,nj,-74.25241,40.74186,871,8,17,9,112.5
013019300,nj,-74.26308,40.7431,1025,8,17,9,112.5
013019400,nj,-74.28229,40.74576,1056,9,17,8,88.9
013019500,nj,-74.26509,40.73068,1383,9,18,9,100
013019600,nj,-74.25285,40.72977,1656,9,18,9,100
013019700,nj,-74.25976,40.71871,1597,9,18,9,100
013019800,nj,-74.27227,40.72257,941,10,19,9,90
013019900,nj,-74.28124,40.73056,847,10,19,9,90
013020000,nj,-74.34295,40.74019,1942,9,18,9,100
013020100,nj,-74.31257,40.74574,1713,9,17,8,88.9
013020200,nj,-74.29552,40.72447,1620,10,19,9,90
013020300,nj,-74.31834,40.72111,1385,10,19,9,90
013020400,nj,-74.33387,40.80472,1812,7,15,8,114.3
013020500,nj,-74.29985,40.7977,2825,7,14,7,100
013020600,nj,-74.31047,40.77198,1800,8,15,7,87.5
013020700,nj,-74.32214,40.78585,1586,7,15,8,114.3
013020800,nj,-74.34792,40.77694,2674,8,16,8,100
013020901,nj,-74.27985,40.82703,835,6,12,6,100
013020902,nj,-74.30868,40.8208,2268,6,13,7,116.7
013021000,nj,-74.25018,40.83804,1532,6,13,7,116.7
013021100,nj,-74.23345,40.83263,2287,7,14,7,100
013021200,nj,-74.24175,40.82454,1375,6,13,7,116.7
013021300,nj,-74.23535,40.8631,1947,6,13,7,116.7
013021400,nj,-74.22144,40.84917,2169,7,14,7,100
013021601,nj,-74.30414,40.88283,3663,6,13,7,116.7
013021602,nj,-74.25759,40.86294,2231,6,13,7,116.7
013021701,nj,-74.27369,40.84167,1042,6,12,6,100
013021702,nj,-74.28025,40.83714,1185,6,12,6,100
013021801,nj,-74.31059,40.83811,936,6,13,7,116.7
013021802,nj,-74.29777,40.85379,1247,6,13,7,116.7
013021803,nj,-74.27376,40.84933,1536,6,12,6,100
013022700,nj,-74.18798,40.72267,448,8,16,8,100
013022800,nj,-74.18429,40.73339,85,8,16,8,100
013022900,nj,-74.17154,40.74536,745,7,15,8,114.3
013023000,nj,-74.19386,40.73665,375,8,16,8,100
013023100,nj,-74.20584,40.73497,529,8,16,8,100
013023200,nj,-74.1945,40.7201,564,8,17,9,112.5
013980100,nj,-74.16713,40.71364,49,8,16,8,100
013980200,nj,-74.15485,40.69805,314,7,15,8,114.3
015500100,nj,-75.13016,39.87044,1808,14,25,11,78.6
015500201,nj,-75.15937,39.8707,1188,14,25,11,78.6
015500202,nj,-75.15583,39.85253,1813,13,24,11,84.6
015500203,nj,-75.17976,39.80876,1878,13,24,11,84.6
015500204,nj,-75.19417,39.82584,1811,13,24,11,84.6
015500205,nj,-75.2047,39.84846,2325,13,24,11,84.6
015500300,nj,-75.1852,39.86762,2488,14,25,11,78.6
015500400,nj,-75.23964,39.83997,2758,14,24,10,71.4
015500500,nj,-75.28961,39.82998,2661,14,25,11,78.6
015500601,nj,-75.22522,39.79991,2693,13,23,10,76.9
015500602,nj,-75.2547,39.78026,1404,13,24,11,84.6
015500702,nj,-75.14549,39.7679,2505,12,23,11,91.7
015500703,nj,-75.17363,39.74936,758,12,22,10,83.3
015500704,nj,-75.17866,39.78707,1695,13,24,11,84.6
015500705,nj,-75.19023,39.77539,1616,13,23,10,76.9
015500800,nj,-75.14856,39.79133,1017,13,24,11,84.6
015500900,nj,-75.15118,39.81598,1435,13,24,11,84.6
015501001,nj,-75.14475,39.84692,1001,13,24,11,84.6
015501002,nj,-75.1481,39.83356,1527,13,24,11,84.6
015501003,nj,-75.16174,39.83751,1853,13,24,11,84.6
015501101,nj,-75.13233,39.84485,1690,13,24,11,84.6
015501102,nj,-75.10922,39.84415,2724,13,24,11,84.6
015501103,nj,-75.09549,39.80961,3061,13,24,11,84.6
015501104,nj,-75.11519,39.82091,1146,13,24,11,84.6
015501105,nj,-75.13491,39.82217,1095,13,24,11,84.6
015501106,nj,-75.12578,39.79297,1771,13,24,11,84.6
015501107,nj,-75.16041,39.80247,1829,13,24,11,84.6
015501201,nj,-75.06646,39.77063,2263,13,23,10,76.9
015501202,nj,-75.08205,39.75592,1629,12,23,11,91.7
015501203,nj,-75.06479,39.74959,1408,12,23,11,91.7
015501204,nj,-75.03549,39.75017,1565,13,23,10,76.9
015501205,nj,-75.03676,39.72748,1256,13,23,10,76.9
015501206,nj,-75.05683,39.73921,1240,13,23,10,76.9
015501208,nj,-75.10153,39.74266,1904,12,23,11,91.7
015501209,nj,-75.09965,39.77409,2337,13,23,10,76.9
015501210,nj,-75.08601,39.72331,1267,12,23,11,91.7
015501212,nj,-75.07481,39.73082,1561,12,23,11,91.7
015501213,nj,-75.06822,39.71595,1779,13,23,10,76.9
015501301,nj,-75.12304,39.73624,1322,12,22,10,83.3
015501302,nj,-75.13153,39.72905,1191,12,22,10,83.3
015501303,nj,-75.1387,39.7323,882,12,22,10,83.3
015501402,nj,-75.0935,39.69041,2528,12,23,11,91.7
015501403,nj,-75.14114,39.7,3243,12,22,10,83.3
015501404,nj,-75.12541,39.71377,385,12,22,10,83.3
015501405,nj,-75.1068,39.72083,1460,12,22,10,83.3
015501406,nj,-75.10643,39.71132,1340,12,22,10,83.3
015501501,nj,-75.07174,39.66832,1414,13,24,11,84.6
015501502,nj,-75.0888,39.65364,1990,13,24,11,84.6
015501603,nj,-74.98871,39.69647,2436,14,25,11,78.6
015501604,nj,-74.9794,39.67816,2570,14,26,12,85.7
015501605,nj,-74.9279,39.63763,2075,15,26,11,73.3
015501606,nj,-74.98303,39.64983,3761,14,26,12,85.7
015501608,nj,-75.01264,39.70852,1617,13,24,11,84.6
015501609,nj,-75.0453,39.69074,2045,13,24,11,84.6
015501701,nj,-75.03353,39.61986,2193,14,25,11,78.6
015501702,nj,-74.97074,39.58583,1356,14,25,11,78.6
015501703,nj,-75.02223,39.56208,2806,14,26,12,85.7
015501704,nj,-75.08693,39.62218,2081,14,25,11,78.6
015501800,nj,-75.01666,39.54842,954,15,26,11,73.3
015501900,nj,-75.15315,39.66558,2361,13,24,11,84.6
015502001,nj,-75.24334,39.74037,1915,13,24,11,84.6
015502002,nj,-75.18775,39.71919,2809,12,23,11,91.7
015502100,nj,-75.2566,39.69689,1382,14,25,11,78.6
015502201,nj,-75.33145,39.7494,964,14,25,11,78.6
015502202,nj,-75.35625,39.73387,877,14,25,11,78.6
015502203,nj,-75.32823,39.71448,948,15,26,11,73.3
015502204,nj,-75.29604,39.75264,1214,14,25,11,78.6
015502300,nj,-75.31174,39.74587,1081,14,25,11,78.6
015502400,nj,-75.35499,39.79233,3098,14,26,12,85.7
017000101,nj,-74.05302,40.75678,481,5,12,7,140
017000102,nj,-74.04982,40.75514,682,5,12,7,140
017000200,nj,-74.04689,40.75328,854,5,12,7,140
017000300,nj,-74.04256,40.75033,804,5,12,7,140
017000400,nj,-74.05845,40.74978,871,6,12,6,100
017000500,nj,-74.05133,40.74992,781,5,12,7,140
017000600,nj,-74.05295,40.74616,992,5,12,7,140
017000700,nj,-74.04694,40.74615,783,5,12,7,140
017000800,nj,-74.04403,40.74408,982,5,12,7,140
017000902,nj,-74.06237,40.73996,1682,6,13,7,116.7
017001000,nj,-74.05901,40.74466,390,6,13,7,116.7
017001100,nj,-74.05438,40.74083,1007,6,12,6,100
017001201,nj,-74.05631,40.73695,369,5,12,7,140
017001202,nj,-74.05551,40.73222,285,6,13,7,116.7
017001300,nj,-74.04698,40.73809,731,5,12,7,140
017001400,nj,-74.0521,40.73449,610,6,12,6,100
017001701,nj,-74.07702,40.73686,886,6,13,7,116.7
017001800,nj,-74.06998,40.73439,514,6,13,7,116.7
017001900,nj,-74.06216,40.73332,360,6,13,7,116.7
017002001,nj,-74.06608,40.73271,209,6,13,7,116.7
017002002,nj,-74.06525,40.7294,341,6,13,7,116.7
017002200,nj,-74.05037,40.72539,677,6,13,7,116.7
017002300,nj,-74.04769,40.72359,886,6,13,7,116.7
017002400,nj,-74.04527,40.72658,912,6,13,7,116.7
017002700,nj,-74.08243,40.73214,968,6,13,7,116.7
017002800,nj,-74.07316,40.72665,990,6,13,7,116.7
017002900,nj,-74.06947,40.72819,1049,6,13,7,116.7
017003000,nj,-74.0671,40.72415,536,6,13,7,116.7
017003101,nj,-74.06397,40.72192,344,6,13,7,116.7
017003102,nj,-74.06424,40.72286,415,6,13,7,116.7
017003500,nj,-74.04893,40.71981,596,6,13,7,116.7
017004000,nj,-74.08868,40.72609,1157,6,13,7,116.7
017004102,nj,-74.07101,40.71971,609,6,13,7,116.7
017004103,nj,-74.07746,40.72071,549,6,13,7,116.7
017004104,nj,-74.07523,40.72297,591,6,13,7,116.7
017004200,nj,-74.07955,40.71783,836,6,13,7,116.7
017004300,nj,-74.07094,40.71646,564,6,13,7,116.7
017004400,nj,-74.07656,40.71442,364,6,13,7,116.7
017004500,nj,-74.07245,40.71129,838,6,13,7,116.7
017004600,nj,-74.06759,40.71022,587,6,13,7,116.7
017004700,nj,-74.06256,40.70854,838,6,13,7,116.7
017004800,nj,-74.09537,40.71861,1057,6,13,7,116.7
017004900,nj,-74.08493,40.71371,787,6,13,7,116.7
017005200,nj,-74.08522,40.70891,773,6,13,7,116.7
017005300,nj,-74.07569,40.70411,603,6,13,7,116.7
017005400,nj,-74.10439,40.70818,2043,6,14,8,133.3
017005500,nj,-74.0834,40.70436,515,6,13,7,116.7
017005600,nj,-74.09135,40.70597,713,6,13,7,116.7
017005801,nj,-74.08263,40.70006,944,6,13,7,116.7
017005802,nj,-74.06617,40.68196,1080,6,14,8,133.3
017005901,nj,-74.09822,40.7016,703,6,13,7,116.7
017005902,nj,-74.09431,40.704,851,6,13,7,116.7
017006000,nj,-74.0894,40.69878,869,6,13,7,116.7
017006101,nj,-74.10163,40.69779,831,6,14,8,133.3
017006102,nj,-74.09854,40.69122,503,6,13,7,116.7
017006200,nj,-74.09481,40.69603,642,6,13,7,116.7
017006300,nj,-74.09218,40.69092,800,6,13,7,116.7
017006400,nj,-74.04548,40.71815,941,6,13,7,116.7
017006500,nj,-74.05254,40.72054,699,6,13,7,116.7
017006600,nj,-74.05832,40.72487,308,6,13,7,116.7
017006700,nj,-74.06112,40.71779,325,6,13,7,116.7
017006800,nj,-74.07933,40.71075,837,6,13,7,116.7
017006900,nj,-74.067,40.75233,270,6,13,7,116.7
017007001,nj,-74.04286,40.72386,409,6,13,7,116.7
017007002,nj,-74.0435,40.72107,441,6,13,7,116.7
017007100,nj,-74.0577,40.72881,634,6,13,7,116.7
017007200,nj,-74.04802,40.72892,633,6,13,7,116.7
017007300,nj,-74.04823,40.71339,1130,6,13,7,116.7
017007400,nj,-74.03147,40.71312,1056,6,13,7,116.7
017007500,nj,-74.0393,40.71579,915,6,13,7,116.7
017007601,nj,-74.03869,40.72155,647,6,13,7,116.7
017007602,nj,-74.02973,40.72034,1317,6,13,7,116.7
017007701,nj,-74.03137,40.72654,39,6,13,7,116.7
017007702,nj,-74.03683,40.73171,16,6,13,7,116.7
017007703,nj,-74.03082,40.73172,621,6,13,7,116.7
017007800,nj,-74.04406,40.73189,185,6,13,7,116.7
017010100,nj,-74.11079,40.6919,1171,7,14,7,100
017010200,nj,-74.1045,40.68219,774,7,14,7,100
017010300,nj,-74.08199,40.67225,652,7,14,7,100
017010400,nj,-74.08505,40.66773,855,7,14,7,100
017010500,nj,-74.11858,40.68173,1344,7,14,7,100
017010601,nj,-74.12843,40.67348,461,7,14,7,100
017010602,nj,-74.11937,40.67012,759,7,14,7,100
017010701,nj,-74.11401,40.66905,515,7,14,7,100
017010702,nj,-74.11388,40.66666,242,7,14,7,100
017010800,nj,-74.09423,40.65696,1030,7,14,7,100
017010900,nj,-74.11833,40.66117,406,7,14,7,100
017011000,nj,-74.12079,40.66289,431,7,14,7,100
017011100,nj,-74.12917,40.66675,648,7,14,7,100
017011200,nj,-74.1378,40.66063,1594,7,14,7,100
017011300,nj,-74.12464,40.65676,668,7,14,7,100
017011400,nj,-74.12481,40.6493,808,6,13,7,116.7
017011500,nj,-74.14583,40.64905,824,6,13,7,116.7
017011600,nj,-74.13308,40.64553,762,4,10,6,150
017012300,nj,-74.13476,40.77661,439,7,15,8,114.3
017012400,nj,-74.14261,40.78052,968,7,15,8,114.3
017012500,nj,-74.14912,40.77222,1042,7,15,8,114.3
017012600,nj,-74.14275,40.77095,776,7,15,8,114.3
017012700,nj,-74.11259,40.74938,1849,6,14,8,133.3
017012800,nj,-74.14281,40.7549,1093,7,15,8,114.3
017012900,nj,-74.14853,40.75891,687,7,15,8,114.3
017013000,nj,-74.15155,40.7587,542,7,15,8,114.3
017013100,nj,-74.15292,40.76581,427,7,15,8,114.3
017013200,nj,-74.15486,40.75779,713,7,15,8,114.3
017013300,nj,-74.15885,40.75968,578,7,15,8,114.3
017013400,nj,-74.16226,40.75096,420,7,15,8,114.3
017013500,nj,-74.15107,40.7504,743,7,15,8,114.3
017013600,nj,-74.1565,40.74821,335,7,15,8,114.3
017013700,nj,-74.16204,40.74726,445,7,15,8,114.3
017013800,nj,-74.15973,40.74052,474,7,15,8,114.3
017013900,nj,-74.14883,40.74102,615,7,15,8,114.3
017014000,nj,-74.00543,40.80784,890,6,14,8,133.3
017014101,nj,-73.99322,40.79578,342,6,14,8,133.3
017014102,nj,-74.00075,40.80252,1323,6,14,8,133.3
017014200,nj,-74.00469,40.79624,1113,6,14,8,133.3
017014300,nj,-74.01016,40.80128,995,6,14,8,133.3
017014401,nj,-74.01002,40.81031,899,6,14,8,133.3
017014402,nj,-74.01443,40.80449,761,6,14,8,133.3
017014501,nj,-74.01877,40.79898,1172,6,13,7,116.7
017014502,nj,-74.02306,40.79449,345,6,13,7,116.7
017014600,nj,-74.02645,40.80274,986,6,13,7,116.7
017014700,nj,-74.03231,40.78087,1026,6,13,7,116.7
017014801,nj,-74.0433,40.76837,830,5,12,7,140
017014802,nj,-74.04799,40.77394,335,6,13,7,116.7
017014900,nj,-74.04746,40.76007,578,5,12,7,140
017015001,nj,-73.99662,40.78919,620,6,14,8,133.3
017015003,nj,-74.00752,40.79408,374,6,14,8,133.3
017015004,nj,-74.00342,40.79206,601,6,14,8,133.3
017015100,nj,-74.01249,40.7961,547,6,14,8,133.3
017015201,nj,-73.99986,40.78523,539,6,14,8,133.3
017015202,nj,-74.00795,40.78817,1193,6,14,8,133.3
017015300,nj,-74.00658,40.7903,467,6,14,8,133.3
017015500,nj,-74.01903,40.79032,746,6,13,7,116.7
017015600,nj,-74.01222,40.78786,459,6,14,8,133.3
017015700,nj,-74.01355,40.7863,456,6,14,8,133.3
017015801,nj,-74.0049,40.78004,679,6,14,8,133.3
017015802,nj,-74.01431,40.78216,383,6,14,8,133.3
017015900,nj,-74.01669,40.78431,683,6,13,7,116.7
017016000,nj,-74.02128,40.78597,552,6,13,7,116.7
017016100,nj,-74.0181,40.77944,543,6,13,7,116.7
017016200,nj,-74.02374,40.77978,758,6,13,7,116.7
017016300,nj,-74.02125,40.77744,913,6,13,7,116.7
017016400,nj,-74.0247,40.77514,691,6,13,7,116.7
017016500,nj,-74.02533,40.77114,1087,5,12,7,140
017016600,nj,-74.0294,40.77517,778,6,13,7,116.7
017016700,nj,-74.03316,40.77285,354,5,12,7,140
017016800,nj,-74.03039,40.77039,434,5,12,7,140
017016900,nj,-74.03204,40.76698,415,5,12,7,140
017017000,nj,-74.03619,40.76893,698,5,12,7,140
017017100,nj,-74.03926,40.76479,885,5,12,7,140
017017200,nj,-74.03392,40.76404,402,5,12,7,140
017017300,nj,-74.03118,40.76121,462,5,12,7,140
017017400,nj,-74.03559,40.7614,323,5,12,7,140
017017500,nj,-74.03757,40.7587,413,5,12,7,140
017017600,nj,-74.04104,40.76004,433,5,12,7,140
017017700,nj,-74.04312,40.75765,664,5,12,7,140
017017800,nj,-74.03823,40.75481,976,5,12,7,140
017017900,nj,-74.01471,40.76712,259,6,13,7,116.7
017018000,nj,-74.01565,40.77715,621,6,14,8,133.3
017018100,nj,-74.01964,40.77211,565,6,13,7,116.7
017018200,nj,-74.02771,40.76414,976,5,12,7,140
017018301,nj,-74.02297,40.74021,1382,5,12,7,140
017018302,nj,-74.02102,40.75396,1105,5,12,7,140
017018401,nj,-74.02991,40.75114,751,5,12,7,140
017018402,nj,-74.03191,40.7548,1134,5,12,7,140
017018501,nj,-74.03505,40.74892,1586,5,12,7,140
017018502,nj,-74.03375,40.74695,902,5,12,7,140
017018600,nj,-74.03024,40.74686,841,5,12,7,140
017018701,nj,-74.02649,40.74452,535,5,12,7,140
017018702,nj,-74.02722,40.74896,1230,5,12,7,140
017018800,nj,-74.0318,40.74211,1136,5,12,7,140
017018900,nj,-74.03608,40.74456,1306,5,12,7,140
017019000,nj,-74.03875,40.74259,997,5,12,7,140
017019100,nj,-74.03715,40.73992,1191,5,12,7,140
017019200,nj,-74.03976,40.73794,2532,5,12,7,140
017019300,nj,-74.03187,40.73707,940,5,12,7,140
017019400,nj,-74.02969,40.73923,493,5,12,7,140
017019800,nj,-74.04823,40.79645,1336,6,13,7,116.7
017019900,nj,-74.06674,40.78073,756,6,13,7,116.7
017020000,nj,-74.06187,40.78696,1261,6,14,8,133.3
017020100,nj,-74.08278,40.76517,147,6,13,7,116.7
017032400,nj,-74.01348,40.79284,873,6,14,8,133.3
017980100,nj,-74.04461,40.7,107,6,13,7,116.7
019010100,nj,-74.77834,40.69511,2777,6,13,7,116.7
019010201,nj,-74.90669,40.73792,1354,4,9,5,125
019010202,nj,-74.86763,40.71538,2006,4,9,5,125
019010300,nj,-74.9517,40.70358,1429,5,10,5,100
019010400,nj,-75.01259,40.66824,2202,6,12,6,100
019010500,nj,-75.1221,40.59656,2373,7,15,8,114.3
019010600,nj,-75.03379,40.58757,2732,6,13,7,116.7
019010701,nj,-74.96722,40.63391,2147,7,14,7,100
019010702,nj,-74.93511,40.56621,1490,6,12,6,100
019010801,nj,-74.91246,40.63592,1079,8,17,9,112.5
019010802,nj,-74.83506,40.64324,581,7,14,7,100
019010900,nj,-74.89402,40.66837,1576,7,14,7,100
019011001,nj,-74.8591,40.66142,2015,7,15,8,114.3
019011003,nj,-74.88845,40.60738,2242,8,16,8,100
019011004,nj,-74.84059,40.61618,885,8,16,8,100
019011100,nj,-74.75424,40.62723,2604,9,18,9,100
019011202,nj,-74.79561,40.53623,1549,10,20,10,100
019011203,nj,-74.76209,40.57537,1726,10,19,9,90
019011204,nj,-74.82285,40.57725,949,9,18,9,100
019011301,nj,-74.88007,40.53355,2837,9,18,9,100
019011303,nj,-74.83245,40.49459,2048,10,19,9,90
019011304,nj,-74.80679,40.49849,1196,10,19,9,90
019011305,nj,-74.84773,40.47179,1294,10,19,9,90
019011306,nj,-74.88737,40.48347,1662,10,19,9,90
019011400,nj,-74.85987,40.50864,1179,10,20,10,100
019011500,nj,-75.02077,40.49185,2556,7,14,7,100
019011600,nj,-74.95452,40.44381,2619,9,17,8,88.9
019011700,nj,-74.82197,40.4346,1951,8,15,7,87.5
019011800,nj,-74.89547,40.37915,1486,8,16,8,100
019011900,nj,-74.9431,40.36875,2140,9,18,9,100
021000100,nj,-74.75545,40.19547,1013,11,20,9,81.8
021000200,nj,-74.74981,40.20223,1465,11,20,9,81.8
021000300,nj,-74.73874,40.20355,1781,11,20,9,81.8
021000400,nj,-74.74666,40.20703,1727,11,20,9,81.8
021000500,nj,-74.74162,40.21104,1506,11,20,9,81.8
021000600,nj,-74.73627,40.21544,1900,11,20,9,81.8
021000700,nj,-74.74725,40.21332,901,11,20,9,81.8
021000800,nj,-74.75457,40.21021,785,11,20,9,81.8
021000900,nj,-74.75983,40.21954,1798,11,21,10,90.9
021001000,nj,-74.76411,40.21094,1092,11,20,9,81.8
021001101,nj,-74.77752,40.2225,687,11,21,10,90.9
021001102,nj,-74.77952,40.22848,1120,11,21,10,90.9
021001200,nj,-74.80161,40.23508,1439,10,20,10,100
021001300,nj,-74.79449,40.2409,1323,10,19,9,90
021001401,nj,-74.77402,40.23572,1102,10,20,10,100
021001402,nj,-74.77913,40.2331,917,11,20,9,81.8
021001500,nj,-74.7691,40.22739,1581,11,21,10,90.9
021001600,nj,-74.76137,40.22671,595,11,20,9,81.8
021001700,nj,-74.75701,40.23361,1816,11,20,9,81.8
021001800,nj,-74.74333,40.23955,1816,10,19,9,90
021001900,nj,-74.74486,40.2326,959,11,20,9,81.8
021002000,nj,-74.7524,40.22663,658,11,20,9,81.8
021002100,nj,-74.74652,40.21965,1639,11,20,9,81.8
021002200,nj,-74.73909,40.22489,2219,11,20,9,81.8
021002500,nj,-74.72596,40.1803,2897,11,21,10,90.9
021002601,nj,-74.72808,40.20696,1920,11,20,9,81.8
021002602,nj,-74.71482,40.19755,1552,11,20,9,81.8
021002701,nj,-74.71727,40.21328,1497,11,20,9,81.8
021002702,nj,-74.70205,40.21486,1831,10,20,10,100
021002800,nj,-74.72413,40.22834,2000,11,20,9,81.8
021002902,nj,-74.71624,40.23988,1817,10,19,9,90
021002903,nj,-74.70143,40.25415,1614,10,19,9,90
021002904,nj,-74.67729,40.25639,2093,9,18,9,100
021003001,nj,-74.63094,40.16936,2438,11,20,9,81.8
021003002,nj,-74.64784,40.21254,2160,10,19,9,90
021003003,nj,-74.66941,40.18885,2773,11,20,9,81.8
021003004,nj,-74.68736,40.1966,2403,11,20,9,81.8
021003006,nj,-74.6667,40.2387,2467,10,18,8,80
021003007,nj,-74.64937,40.22908,1358,10,19,9,90
021003008,nj,-74.68148,40.22664,1893,10,19,9,90
021003009,nj,-74.67764,40.21149,2665,10,19,9,90
021003100,nj,-74.73753,40.24931,2533,10,19,9,90
021003201,nj,-74.74454,40.27224,2989,10,19,9,90
021003202,nj,-74.71494,40.27291,2454,10,19,9,90
021003301,nj,-74.7282,40.30216,2915,10,19,9,90
021003303,nj,-74.68315,40.2837,1563,9,18,9,100
021003304,nj,-74.71761,40.3206,909,9,18,9,100
021003400,nj,-74.76472,40.24187,2096,10,19,9,90
021003500,nj,-74.76388,40.25811,4345,10,19,9,90
021003601,nj,-74.78607,40.24901,1385,10,19,9,90
021003602,nj,-74.78607,40.25748,1305,10,19,9,90
021003703,nj,-74.77579,40.27172,1780,10,19,9,90
021003704,nj,-74.78317,40.28271,885,9,18,9,100
021003706,nj,-74.83991,40.27749,1281,9,18,9,100
021003707,nj,-74.80766,40.27436,757,10,19,9,90
021003708,nj,-74.8219,40.25583,1815,10,19,9,90
021003800,nj,-74.84392,40.33061,3181,9,17,8,88.9
021003902,nj,-74.7638,40.38931,862,8,17,9,112.5
021003903,nj,-74.79071,40.32626,1066,8,17,9,112.5
021003904,nj,-74.76588,40.31536,2444,9,18,9,100
021003905,nj,-74.76532,40.37773,2042,8,17,9,112.5
021004000,nj,-74.65454,40.35506,1724,9,18,9,100
021004203,nj,-74.68941,40.36643,1694,9,17,8,88.9
021004204,nj,-74.66888,40.33469,1753,9,18,9,100
021004205,nj,-74.6416,40.37523,1346,9,17,8,88.9
021004206,nj,-74.66002,40.36248,958,9,17,8,88.9
021004306,nj,-74.64013,40.2697,1767,9,18,9,100
021004307,nj,-74.62346,40.30165,1867,9,18,9,100
021004309,nj,-74.58148,40.21307,1770,9,18,9,100
021004311,nj,-74.63258,40.22783,2903,10,18,8,80
021004312,nj,-74.60127,40.24246,1169,9,18,9,100
021004313,nj,-74.64212,40.30884,792,9,18,9,100
021004314,nj,-74.65238,40.31386,1681,9,18,9,100
021004315,nj,-74.60065,40.29479,1124,9,18,9,100
021004316,nj,-74.59156,40.27691,1895,9,17,8,88.9
021004403,nj,-74.52525,40.26861,1911,9,17,8,88.9
021004404,nj,-74.49168,40.26303,2538,8,17,9,112.5
021004406,nj,-74.55011,40.28418,1487,9,17,8,88.9
021004407,nj,-74.56166,40.26487,1540,9,17,8,88.9
021004408,nj,-74.53805,40.25147,1496,9,17,8,88.9
021004409,nj,-74.51222,40.25154,1515,9,17,8,88.9
021004501,nj,-74.65322,40.34849,652,9,18,9,100
021004502,nj,-74.67176,40.34809,417,9,18,9,100
021980000,nj,-74.75624,40.20726,3,11,20,9,81.8
023000101,nj,-74.51275,40.57645,1153,11,20,9,81.8
023000102,nj,-74.5114,40.56625,1583,10,20,10,100
023000200,nj,-74.48914,40.57927,2258,11,20,9,81.8
023000300,nj,-74.46565,40.59029,2203,11,20,9,81.8
023000401,nj,-74.46888,40.57726,1267,11,20,9,81.8
023000403,nj,-74.4826,40.56542,2234,10,19,9,90
023000404,nj,-74.46019,40.56817,1361,10,20,10,100
023000501,nj,-74.4477,40.58802,1625,11,20,9,81.8
023000503,nj,-74.44657,40.57292,590,10,19,9,90
023000504,nj,-74.44093,40.56674,90,10,19,9,90
023000603,nj,-74.45853,40.54968,1036,10,19,9,90
023000608,nj,-74.46007,40.53144,658,10,19,9,90
023000609,nj,-74.43068,40.53236,856,10,19,9,90
023000610,nj,-74.42324,40.54028,1694,9,18,9,100
023000701,nj,-74.50398,40.55235,838,10,19,9,90
023000702,nj,-74.48584,40.53534,2066,10,19,9,90
023000801,nj,-74.43221,40.59163,1304,11,20,9,81.8
023000802,nj,-74.42378,40.58536,982,11,20,9,81.8
023000901,nj,-74.41469,40.59203,809,11,20,9,81.8
023000902,nj,-74.40273,40.59136,1679,11,20,9,81.8
023001001,nj,-74.39674,40.58059,937,10,20,10,100
023001003,nj,-74.41532,40.56874,2485,10,19,9,90
023001004,nj,-74.42146,40.55324,720,9,18,9,100
023001100,nj,-74.43522,40.50533,1218,9,18,9,100
023001200,nj,-74.41821,40.50064,2230,9,18,9,100
023001300,nj,-74.4276,40.49365,1549,9,18,9,100
023001409,nj,-74.34796,40.57845,1367,10,19,9,90
023001410,nj,-74.35273,40.59098,1290,10,19,9,90
023001411,nj,-74.34692,40.5978,1392,10,19,9,90
023001412,nj,-74.38043,40.59353,1406,10,19,9,90
023001413,nj,-74.36841,40.58405,2215,10,19,9,90
023001414,nj,-74.39083,40.55769,2136,10,18,8,80
023001415,nj,-74.37183,40.5649,2441,10,19,9,90
023001417,nj,-74.3524,40.5632,908,9,18,9,100
023001418,nj,-74.3415,40.56524,1231,9,17,8,88.9
023001419,nj,-74.33582,40.55864,86,9,17,8,88.9
023001502,nj,-74.40383,40.51937,2825,9,18,9,100
023001504,nj,-74.39334,40.54164,1265,9,18,9,100
023001505,nj,-74.40221,40.53257,491,9,18,9,100
023001506,nj,-74.42108,40.52034,444,9,18,9,100
023001600,nj,-74.40704,40.50492,2456,9,18,9,100
023001701,nj,-74.3772,40.52277,1969,8,17,9,112.5
023001702,nj,-74.39405,40.51263,1200,9,18,9,100
023001803,nj,-74.39928,40.4972,2686,9,18,9,100
023001804,nj,-74.38234,40.50677,1315,8,17,9,112.5
023001805,nj,-74.35149,40.52299,1780,8,17,9,112.5
023001806,nj,-74.35503,40.49826,1271,8,16,8,100
023001901,nj,-74.33545,40.54571,815,9,17,8,88.9
023001902,nj,-74.32368,40.53161,1405,9,17,8,88.9
023001903,nj,-74.33862,40.53561,1647,9,17,8,88.9
023002000,nj,-74.372,40.54429,2472,9,18,9,100
023002101,nj,-74.35981,40.54807,1212,9,18,9,100
023002102,nj,-74.35152,40.54468,1983,9,18,9,100
023002200,nj,-74.36327,40.53267,1800,9,18,9,100
023002301,nj,-74.32679,40.60291,1341,10,19,9,90
023002302,nj,-74.32999,40.59295,1306,10,19,9,90
023002401,nj,-74.30883,40.59795,1975,9,18,9,100
023002402,nj,-74.31378,40.58652,567,9,18,9,100
023002500,nj,-74.32824,40.57705,2280,10,19,9,90
023002603,nj,-74.31536,40.56604,1213,9,17,8,88.9
023002604,nj,-74.30281,40.57107,2359,9,17,8,88.9
023002605,nj,-74.29762,40.58353,886,9,17,8,88.9
023002701,nj,-74.28606,40.58525,1059,9,17,8,88.9
023002703,nj,-74.27946,40.57704,1665,9,17,8,88.9
023002805,nj,-74.27959,40.5672,1023,8,16,8,100
023002901,nj,-74.26708,40.56291,896,7,15,8,114.3
023002902,nj,-74.27927,40.55662,873,8,16,8,100
023003001,nj,-74.28769,40.55449,1576,8,16,8,100
023003002,nj,-74.3044,40.55182,1409,8,16,8,100
023003101,nj,-74.3254,40.55763,892,9,17,8,88.9
023003102,nj,-74.3188,40.54451,1035,9,17,8,88.9
023003201,nj,-74.31225,40.53531,1244,9,17,8,88.9
023003203,nj,-74.30629,40.52695,1228,8,16,8,100
023003300,nj,-74.2934,40.53033,1553,7,15,8,114.3
023003401,nj,-74.25584,40.55315,1420,6,13,7,116.7
023003500,nj,-74.24424,40.59111,1061,6,13,7,116.7
023003601,nj,-74.22102,40.5814,1705,6,13,7,116.7
023003700,nj,-74.23181,40.58599,1059,6,13,7,116.7
023003801,nj,-74.23389,40.57772,1558,6,13,7,116.7
023003802,nj,-74.22366,40.57053,400,6,13,7,116.7
023004000,nj,-74.27965,40.53414,1132,8,16,8,100
023004100,nj,-74.28445,40.52463,1328,7,15,8,114.3
023004200,nj,-74.27839,40.52287,1173,7,14,7,100
023004300,nj,-74.27071,40.52741,1532,8,15,7,87.5
023004400,nj,-74.27273,40.51999,1228,6,14,8,133.3
023004501,nj,-74.26593,40.52071,902,4,11,7,175
023004502,nj,-74.25764,40.52938,520,5,11,6,120
023004600,nj,-74.26302,40.51309,1289,5,11,6,120
023004700,nj,-74.28056,40.51664,1282,6,14,8,133.3
023004800,nj,-74.28352,40.50803,1564,6,14,8,133.3
023004900,nj,-74.26597,40.50728,1014,6,12,6,100
023005000,nj,-74.26916,40.50025,1108,6,13,7,116.7
023005100,nj,-74.45495,40.50356,783,9,18,9,100
023005200,nj,-74.45535,40.4964,847,9,18,9,100
023005300,nj,-74.45395,40.49201,446,9,18,9,100
023005500,nj,-74.47365,40.47911,842,9,18,9,100
023005601,nj,-74.46218,40.47828,422,9,18,9,100
023005602,nj,-74.45176,40.48753,986,9,18,9,100
023005700,nj,-74.44918,40.4797,1202,9,18,9,100
023005800,nj,-74.44402,40.48492,935,9,18,9,100
023006001,nj,-74.40665,40.48578,507,9,18,9,100
023006002,nj,-74.42863,40.48372,187,9,18,9,100
023006101,nj,-74.44752,40.47214,1321,9,18,9,100
023006103,nj,-74.4706,40.46351,1321,9,18,9,100
023006104,nj,-74.49199,40.4628,1222,9,18,9,100
023006204,nj,-74.51923,40.4383,474,9,18,9,100
023006205,nj,-74.50965,40.4489,2764,9,18,9,100
023006206,nj,-74.44375,40.45938,803,9,18,9,100
023006207,nj,-74.47357,40.45158,1833,9,18,9,100
023006208,nj,-74.49822,40.4354,1610,9,18,9,100
023006209,nj,-74.48816,40.42766,608,9,18,9,100
023006300,nj,-74.43509,40.45041,3309,9,18,9,100
023006403,nj,-74.39787,40.47325,1068,9,17,8,88.9
023006500,nj,-74.41163,40.43319,2591,9,18,9,100
023006601,nj,-74.45637,40.42754,1012,9,18,9,100
023006604,nj,-74.42364,40.39302,2656,9,18,9,100
023006605,nj,-74.43246,40.40946,1164,9,18,9,100
023006606,nj,-74.43315,40.42568,1030,9,18,9,100
023006607,nj,-74.3982,40.41195,989,9,18,9,100
023006608,nj,-74.39884,40.42564,1914,9,18,9,100
023006701,nj,-74.38087,40.41778,2033,8,16,8,100
023006703,nj,-74.37164,40.42583,2591,8,16,8,100
023006800,nj,-74.38844,40.45482,1812,8,16,8,100
023006900,nj,-74.37803,40.4488,1095,8,16,8,100
023007000,nj,-74.37152,40.4383,2512,8,16,8,100
023007101,nj,-74.36906,40.46382,1884,8,16,8,100
023007102,nj,-74.35105,40.46187,2037,8,16,8,100
023007103,nj,-74.34245,40.44198,424,8,16,8,100
023007202,nj,-74.33456,40.46825,1945,7,15,8,114.3
023007203,nj,-74.31371,40.46987,1775,7,15,8,114.3
023007301,nj,-74.31667,40.45983,1220,7,15,8,114.3
023007303,nj,-74.29959,40.4623,737,7,15,8,114.3
023007305,nj,-74.2906,40.45946,490,7,15,8,114.3
023007306,nj,-74.27874,40.45221,912,7,15,8,114.3
023007402,nj,-74.26814,40.47061,3773,7,14,7,100
023007500,nj,-74.28077,40.48943,1179,7,14,7,100
023007600,nj,-74.2735,40.48171,1978,7,14,7,100
023007702,nj,-74.34552,40.36114,1800,8,16,8,100
023007703,nj,-74.36776,40.39522,1131,8,16,8,100
023007704,nj,-74.35401,40.39536,951,8,16,8,100
023007801,nj,-74.32495,40.42216,856,8,16,8,100
023007804,nj,-74.33136,40.3917,1821,8,16,8,100
023007805,nj,-74.31993,40.39352,1479,8,16,8,100
023007806,nj,-74.32608,40.40159,1102,8,16,8,100
023007905,nj,-74.30469,40.44935,840,7,15,8,114.3
023007906,nj,-74.30001,40.41041,226,7,15,8,114.3
023007907,nj,-74.29509,40.42818,876,7,15,8,114.3
023007908,nj,-74.29008,40.44393,41,7,15,8,114.3
023007909,nj,-74.27451,40.41473,1529,6,13,7,116.7
023007910,nj,-74.26607,40.43145,1590,5,11,6,120
023007911,nj,-74.27246,40.39707,1162,6,13,7,116.7
023007913,nj,-74.30128,40.38253,1428,7,15,8,114.3
023007914,nj,-74.29134,40.39135,1402,7,15,8,114.3
023008001,nj,-74.24484,40.45683,2882,4,10,6,150
023008101,nj,-74.38989,40.39289,1719,8,17,9,112.5
023008102,nj,-74.39604,40.39887,1399,9,18,9,100
023008103,nj,-74.42379,40.37765,1015,9,18,9,100
023008204,nj,-74.46994,40.3123,3184,9,17,8,88.9
023008205,nj,-74.44756,40.31153,2606,9,17,8,88.9
023008206,nj,-74.46511,40.33391,2544,9,17,8,88.9
023008207,nj,-74.44542,40.32952,2501,9,17,8,88.9
023008209,nj,-74.37995,40.37045,1880,8,17,9,112.5
023008210,nj,-74.44733,40.35944,3859,9,18,9,100
023008211,nj,-74.40388,40.36684,2620,9,18,9,100
023008212,nj,-74.40109,40.34214,1652,9,17,8,88.9
023008213,nj,-74.40741,40.30382,8028,8,17,9,112.5
023008214,nj,-74.46293,40.27925,4239,9,17,8,88.9
023008300,nj,-74.43997,40.34935,2045,9,17,8,88.9
023008403,nj,-74.57807,40.39881,2921,9,17,8,88.9
023008404,nj,-74.56044,40.41274,1091,9,17,8,88.9
023008405,nj,-74.54398,40.42263,1718,9,18,9,100
023008406,nj,-74.52817,40.43263,1096,9,18,9,100
023008501,nj,-74.53249,40.40572,655,9,18,9,100
023008502,nj,-74.49868,40.37388,2558,9,17,8,88.9
023008504,nj,-74.58157,40.37345,2988,9,17,8,88.9
023008505,nj,-74.5154,40.38435,1542,9,17,8,88.9
023008506,nj,-74.52934,40.37897,1407,9,17,8,88.9
023008601,nj,-74.60657,40.34714,1943,9,18,9,100
023008602,nj,-74.56814,40.34322,1479,9,18,9,100
023008604,nj,-74.58358,40.3201,1628,9,18,9,100
023008605,nj,-74.57643,40.332,622,9,18,9,100
023008606,nj,-74.56428,40.33265,320,9,18,9,100
023008700,nj,-74.52016,40.31128,1619,9,17,8,88.9
023008801,nj,-74.45335,40.51959,659,9,18,9,100
023009000,nj,-74.26131,40.58466,550,7,15,8,114.3
023009101,nj,-74.23889,40.56917,933,6,13,7,116.7
023009200,nj,-74.31635,40.48759,3015,7,15,8,114.3
023009300,nj,-74.4409,40.49342,668,9,18,9,100
023009400,nj,-74.41101,40.45497,2226,9,17,8,88.9
023980000,nj,-74.21798,40.58269,141,6,13,7,116.7
023980100,nj,-74.31822,40.5106,97,7,14,7,100
023980200,nj,-74.46118,40.5214,32,9,18,9,100
025800101,nj,-73.99235,40.40773,1898,2,5,3,150
025800102,nj,-73.9844,40.39447,728,1,4,3,300
025800200,nj,-74.02427,40.42134,1948,2,6,4,200
025800400,nj,-74.05654,40.42623,1537,2,6,4,200
025800500,nj,-74.07306,40.44136,1869,2,6,4,200
025800601,nj,-74.10324,40.44578,2067,2,7,5,250
025800602,nj,-74.12205,40.4287,1362,2,7,5,250
025800701,nj,-74.12091,40.41876,1678,2,7,5,250
025800702,nj,-74.11342,40.41096,1096,2,7,5,250
025800800,nj,-74.09388,40.40527,2291,2,6,4,200
025800900,nj,-74.03535,40.38981,2393,2,6,4,200
025801000,nj,-74.08947,40.38539,1359,3,7,4,133.3
025801100,nj,-74.12603,40.39035,1633,3,8,5,166.7
025801200,nj,-74.1266,40.36654,1229,3,8,5,166.7
025801300,nj,-74.09801,40.35259,3403,2,7,5,250
025801400,nj,-74.07923,40.36527,1634,2,7,5,250
025801500,nj,-74.12822,40.33909,2059,3,8,5,166.7
025801600,nj,-74.11237,40.46404,2037,2,7,5,250
025801700,nj,-74.15588,40.46998,1522,2,6,4,200
025801800,nj,-74.16998,40.4455,2513,4,9,5,125
025801900,nj,-74.19334,40.43706,1113,4,9,5,125
025802000,nj,-74.2057,40.43025,1272,4,9,5,125
025802100,nj,-74.16446,40.43212,2039,4,9,5,125
025802200,nj,-74.14022,40.43637,1350,3,8,5,166.7
025802300,nj,-74.17399,40.42269,1449,4,9,5,125
025802400,nj,-74.19727,40.41599,2103,4,9,5,125
025802500,nj,-74.21605,40.45713,1421,4,9,5,125
025802600,nj,-74.23306,40.43406,1627,5,11,6,120
025802700,nj,-74.21876,40.41544,1390,4,10,6,150
025802800,nj,-74.21642,40.39636,1860,5,12,7,140
025802900,nj,-74.23961,40.39614,897,5,12,7,140
025803000,nj,-74.23878,40.40709,1793,5,11,6,120
025803100,nj,-74.23307,40.42162,981,5,11,6,120
025803201,nj,-74.14949,40.41573,1682,3,8,5,166.7
025803202,nj,-74.16623,40.39753,2023,5,11,6,120
025803300,nj,-74.17801,40.36353,2383,5,12,7,140
025803400,nj,-74.07638,40.34246,1427,2,6,4,200
025803500,nj,-74.06095,40.34392,1025,2,5,3,150
025803601,nj,-74.06631,40.35451,759,2,6,4,200
025803602,nj,-74.05725,40.35101,1240,2,5,3,150
025803700,nj,-74.03924,40.36183,2250,2,5,3,150
025803800,nj,-74.00945,40.35665,1194,1,5,4,400
025803900,nj,-73.99486,40.37445,1448,1,4,3,300
025804100,nj,-73.98579,40.33627,1690,1,4,3,300
025804200,nj,-74.03462,40.33573,2619,2,5,3,150
025804600,nj,-74.09944,40.29754,1249,2,7,5,250
025804801,nj,-74.10183,40.24673,4365,3,7,4,133.3
025804802,nj,-74.08365,40.24471,392,2,7,5,250
025805001,nj,-74.0654,40.29843,900,2,6,4,200
025805100,nj,-74.05382,40.28196,1808,2,5,3,150
025805300,nj,-74.01609,40.31624,2212,1,4,3,300
025805400,nj,-73.983,40.31835,1490,1,4,3,300
025805500,nj,-73.99736,40.31154,1093,1,4,3,300
025805600,nj,-73.98737,40.30839,438,1,4,3,300
025805700,nj,-74.0003,40.30267,859,1,4,3,300
025805800,nj,-73.98111,40.30041,724,1,4,3,300
025805900,nj,-73.99693,40.29592,1290,1,4,3,300
025806000,nj,-73.98606,40.28672,1441,1,4,3,300
025806100,nj,-73.99272,40.27309,1561,1,5,4,400
025806201,nj,-74.01482,40.28094,1012,1,4,3,300
025806202,nj,-74.0211,40.29345,1672,1,4,3,300
025806300,nj,-74.00827,40.25935,1348,2,6,4,200
025806400,nj,-74.02775,40.26312,2090,2,6,4,200
025806501,nj,-74.05801,40.26655,900,2,6,4,200
025806502,nj,-74.0567,40.25552,948,2,6,4,200
025806503,nj,-74.06328,40.23988,1770,2,6,4,200
025806504,nj,-74.04501,40.23995,519,2,6,4,200
025806600,nj,-74.02733,40.24032,2391,2,6,4,200
025807004,nj,-74.00165,40.228,1226,2,6,4,200
025807005,nj,-74.00879,40.2186,812,2,6,4,200
025807006,nj,-74.00304,40.22251,561,2,6,4,200
025807100,nj,-74.01719,40.22566,922,2,6,4,200
025807200,nj,-74.01692,40.21693,306,2,6,4,200
025807300,nj,-74.02214,40.21856,827,2,6,4,200
025807401,nj,-74.00433,40.21293,967,2,6,4,200
025807402,nj,-74.01138,40.21062,1225,2,6,4,200
025807500,nj,-74.0258,40.20677,971,2,6,4,200
025807600,nj,-74.0266,40.21699,962,2,6,4,200
025807700,nj,-74.04205,40.21638,1216,2,6,4,200
025807800,nj,-74.06029,40.21944,1626,2,6,4,200
025807900,nj,-74.07874,40.21953,1167,2,6,4,200
025808001,nj,-74.04318,40.19208,2176,2,6,4,200
025808002,nj,-74.0704,40.20365,832,2,6,4,200
025808100,nj,-74.03334,40.20048,1662,2,6,4,200
025808201,nj,-74.01497,40.20103,1247,2,6,4,200
025808202,nj,-74.0089,40.20288,971,2,6,4,200
025808300,nj,-74.01507,40.19134,965,2,6,4,200
025808401,nj,-74.01652,40.18268,1111,2,6,4,200
025808402,nj,-74.02876,40.17796,1658,2,6,4,200
025808501,nj,-74.05658,40.1747,1386,2,6,4,200
025808502,nj,-74.03992,40.16861,1302,2,6,4,200
025808600,nj,-74.11167,40.19325,2401,3,7,4,133.3
025808701,nj,-74.07847,40.14973,2048,3,7,4,133.3
025808702,nj,-74.11025,40.13492,1902,3,7,4,133.3
025808800,nj,-74.05793,40.13405,1792,3,7,4,133.3
025808901,nj,-74.04341,40.14891,1710,2,6,4,200
025808902,nj,-74.04181,40.1599,722,2,6,4,200
025809000,nj,-74.02622,40.17061,1004,2,6,4,200
025809100,nj,-74.02621,40.15321,1899,2,6,4,200
025809200,nj,-74.03335,40.12999,1333,2,6,4,200
025809301,nj,-74.05175,40.1245,1490,2,6,4,200
025809302,nj,-74.03159,40.10979,2427,2,6,4,200
025809400,nj,-74.0637,40.10484,2274,3,7,4,133.3
025809503,nj,-74.24682,40.37863,2350,6,12,6,100
025809504,nj,-74.22807,40.35462,842,5,12,7,140
025809505,nj,-74.2631,40.34846,1557,6,13,7,116.7
025809506,nj,-74.28873,40.36109,1429,7,15,8,114.3
025809600,nj,-74.29857,40.34006,2544,7,15,8,114.3
025809701,nj,-74.24074,40.31694,1933,5,12,7,140
025809703,nj,-74.27817,40.31891,1859,7,14,7,100
025809704,nj,-74.2584,40.29956,2057,6,13,7,116.7
025809901,nj,-74.20295,40.30937,1983,5,12,7,140
025809902,nj,-74.1582,40.29658,1936,5,11,6,120
025809903,nj,-74.14563,40.26437,7,4,9,5,125
025810001,nj,-74.34625,40.32159,1922,8,16,8,100
025810002,nj,-74.31667,40.32756,2283,8,15,7,87.5
025810003,nj,-74.33205,40.31269,1699,7,15,8,114.3
025810004,nj,-74.33167,40.29815,1376,7,15,8,114.3
025810101,nj,-74.29531,40.30787,1380,7,14,7,100
025810102,nj,-74.31125,40.28983,1641,7,15,8,114.3
025810201,nj,-74.34636,40.24902,2257,8,17,9,112.5
025810202,nj,-74.37198,40.27418,2848,8,17,9,112.5
025810300,nj,-74.36068,40.29712,717,8,15,7,87.5
025810401,nj,-74.28599,40.27726,1446,7,15,8,114.3
025810402,nj,-74.24374,40.27007,2685,7,14,7,100
025810501,nj,-74.25983,40.23993,1311,8,16,8,100
025810503,nj,-74.30978,40.24565,2172,8,17,9,112.5
025810504,nj,-74.28546,40.23384,1610,8,17,9,112.5
025810505,nj,-74.31166,40.22704,1244,9,17,8,88.9
025810600,nj,-74.32054,40.19214,2996,8,17,9,112.5
025810700,nj,-74.27104,40.26717,656,8,16,8,100
025810800,nj,-74.26792,40.25782,807,8,16,8,100
025810900,nj,-74.27892,40.25298,894,8,17,9,112.5
025811000,nj,-74.28327,40.26175,926,8,17,9,112.5
025811101,nj,-74.24642,40.22022,2710,7,15,8,114.3
025811102,nj,-74.19005,40.22711,3177,7,14,7,100
025811200,nj,-74.21118,40.16714,5399,7,15,8,114.3
025811301,nj,-74.25543,40.17865,1915,7,15,8,114.3
025811303,nj,-74.24258,40.15006,1561,9,17,8,88.9
025811304,nj,-74.23155,40.1266,1280,9,18,9,100
025811401,nj,-74.20503,40.15354,1816,8,16,8,100
025811402,nj,-74.21884,40.14973,1388,8,17,9,112.5
025811501,nj,-74.15293,40.11396,2225,7,14,7,100
025811502,nj,-74.16093,40.15817,3957,7,14,7,100
025811600,nj,-74.17008,40.19836,448,6,13,7,116.7
025811900,nj,-74.5283,40.15518,3231,10,19,9,90
025812000,nj,-74.58731,40.17779,703,10,20,10,100
025812100,nj,-74.00299,40.43937,1364,1,4,3,300
025812200,nj,-74.04532,40.30658,1602,1,5,4,400
025812300,nj,-74.06053,40.32439,1939,2,6,4,200
025812400,nj,-74.00163,40.24409,1896,2,6,4,200
025812501,nj,-74.4039,40.22026,2529,8,17,9,112.5
025812502,nj,-74.45924,40.2056,2137,8,16,8,100
025812600,nj,-74.08311,40.31377,2562,2,6,4,200
027040101,nj,-74.31104,40.93689,1265,6,14,8,133.3
027040102,nj,-74.29683,40.91242,2940,6,14,8,133.3
027040200,nj,-74.29016,40.96036,2836,6,13,7,116.7
027040301,nj,-74.31893,40.96893,1138,6,13,7,116.7
027040302,nj,-74.30511,40.9541,1294,6,13,7,116.7
027040400,nj,-74.3124,40.9921,1110,5,12,7,140
027040500,nj,-74.34099,41.00108,1075,5,11,6,120
027040600,nj,-74.3499,40.99807,1489,4,9,5,125
027040701,nj,-74.3631,40.97359,2369,4,10,6,150
027040702,nj,-74.40742,40.99491,1428,3,7,4,133.3
027040801,nj,-74.36881,40.93772,2045,6,13,7,116.7
027040803,nj,-74.34783,40.87105,2001,7,15,8,114.3
027040804,nj,-74.37433,40.90814,1453,6,13,7,116.7
027040805,nj,-74.34358,40.90728,2257,6,14,8,133.3
027040900,nj,-74.42527,40.9311,1798,4,10,6,150
027041000,nj,-74.39984,40.90328,1700,5,12,7,140
027041100,nj,-74.41573,40.90771,1152,5,11,6,120
027041200,nj,-74.44072,40.89062,1725,6,13,7,116.7
027041300,nj,-74.47078,40.91095,1932,4,10,6,150
027041400,nj,-74.49078,40.88915,2570,4,10,6,150
027041500,nj,-74.50775,40.86582,2592,4,9,5,125
027041602,nj,-74.46011,40.87417,1281,5,12,7,140
027041603,nj,-74.42082,40.87964,960,6,14,8,133.3
027041604,nj,-74.45897,40.85919,1725,6,13,7,116.7
027041605,nj,-74.50089,40.84643,1551,5,12,7,140
027041606,nj,-74.48881,40.85104,600,6,13,7,116.7
027041701,nj,-74.38788,40.88317,1374,7,14,7,100
027041702,nj,-74.37573,40.88005,1311,7,15,8,114.3
027041704,nj,-74.36382,40.86197,1196,7,15,8,114.3
027041705,nj,-74.38938,40.86786,488,7,14,7,100
027041706,nj,-74.3974,40.8809,549,6,14,8,133.3
027041801,nj,-74.42758,40.86152,488,6,13,7,116.7
027041802,nj,-74.44322,40.84854,1889,7,14,7,100
027041803,nj,-74.38961,40.84723,1792,7,15,8,114.3
027041901,nj,-74.35233,40.831,2448,8,15,7,87.5
027041902,nj,-74.37473,40.80789,2223,9,17,8,88.9
027042000,nj,-74.41512,40.82926,1816,7,15,8,114.3
027042100,nj,-74.4205,40.80756,1578,8,16,8,100
027042200,nj,-74.45431,40.82178,1854,7,14,7,100
027042301,nj,-74.48601,40.82795,984,6,13,7,116.7
027042302,nj,-74.47623,40.83805,1342,6,13,7,116.7
027042500,nj,-74.39003,40.77902,1267,9,17,8,88.9
027042601,nj,-74.41704,40.78259,608,8,17,9,112.5
027042602,nj,-74.37978,40.77248,1656,9,17,8,88.9
027042700,nj,-74.38106,40.74663,1331,9,18,9,100
027042800,nj,-74.38685,40.73369,1689,9,17,8,88.9
027042900,nj,-74.4149,40.76799,1155,9,17,8,88.9
027043000,nj,-74.4031,40.75708,1510,9,17,8,88.9
027043100,nj,-74.41594,40.74891,1157,9,17,8,88.9
027043200,nj,-74.43152,40.76291,873,9,17,8,88.9
027043301,nj,-74.4536,40.80315,1059,7,15,8,114.3
027043302,nj,-74.44914,40.78402,1576,8,15,7,87.5
027043303,nj,-74.48007,40.7737,1690,8,15,7,87.5
027043401,nj,-74.50785,40.82125,2314,6,12,6,100
027043402,nj,-74.51714,40.79541,2013,6,13,7,116.7
027043500,nj,-74.47693,40.80587,545,7,14,7,100
027043601,nj,-74.47278,40.79568,608,7,15,8,114.3
027043602,nj,-74.46352,40.79363,370,7,15,8,114.3
027043700,nj,-74.47617,40.78725,863,7,14,7,100
027043801,nj,-74.48948,40.79877,711,7,14,7,100
027043802,nj,-74.48433,40.80727,766,6,14,8,133.3
027043900,nj,-74.4079,40.73293,2148,9,17,8,88.9
027044000,nj,-74.43418,40.72595,1985,9,17,8,88.9
027044101,nj,-74.51507,40.66853,1151,9,17,8,88.9
027044102,nj,-74.4782,40.68912,2454,9,17,8,88.9
027044200,nj,-74.49993,40.74085,1971,8,16,8,100
027044300,nj,-74.5155,40.89693,2243,4,9,5,125
027044401,nj,-74.49099,40.97159,2434,3,7,4,133.3
027044403,nj,-74.50987,40.92674,2069,4,9,5,125
027044404,nj,-74.51653,40.91518,1524,4,9,5,125
027044502,nj,-74.53703,40.8923,1296,3,7,4,133.3
027044503,nj,-74.55264,40.91782,1538,3,8,5,166.7
027044504,nj,-74.54409,40.9055,1266,3,8,5,166.7
027044601,nj,-74.49055,41.0238,1874,2,6,4,200
027044602,nj,-74.53736,41.02871,2345,2,6,4,200
027044701,nj,-74.62185,40.96589,2666,2,6,4,200
027044702,nj,-74.58595,40.96223,2596,3,7,4,133.3
027044800,nj,-74.5489,40.88472,1765,3,7,4,133.3
027044900,nj,-74.56654,40.87929,1487,3,6,3,100
027045000,nj,-74.56253,40.89291,1156,3,6,3,100
027045100,nj,-74.5808,40.89985,1955,3,7,4,133.3
027045200,nj,-74.59995,40.87822,1524,2,6,4,200
027045300,nj,-74.6255,40.89635,2094,3,6,3,100
027045402,nj,-74.66599,40.905,2169,2,6,4,200
027045403,nj,-74.6431,40.90256,1266,3,7,4,133.3
027045404,nj,-74.63614,40.93098,1071,3,7,4,133.3
027045501,nj,-74.65774,40.84624,1898,2,6,4,200
027045503,nj,-74.66208,40.85704,1450,3,6,3,100
027045504,nj,-74.67775,40.87532,1581,3,7,4,133.3
027045603,nj,-74.56104,40.86701,836,3,7,4,133.3
027045701,nj,-74.61063,40.8316,2192,2,6,4,200
027045703,nj,-74.55934,40.82395,1383,4,9,5,125
027045704,nj,-74.5571,40.84234,1917,4,9,5,125
027045804,nj,-74.59427,40.7828,2282,4,10,6,150
027045901,nj,-74.69213,40.78739,706,2,6,4,200
027045903,nj,-74.69534,40.75473,1283,4,10,6,150
027045904,nj,-74.67213,40.80606,1728,3,7,4,133.3
027046000,nj,-74.70191,40.89851,1013,2,5,3,150
027046103,nj,-74.69583,40.83535,1498,2,6,4,200
027046104,nj,-74.73133,40.84179,1771,2,6,4,200
027046107,nj,-74.74827,40.86894,893,1,4,3,300
027046108,nj,-74.73553,40.88591,779,1,4,3,300
027046109,nj,-74.71725,40.87467,1514,2,5,3,150
027046110,nj,-74.76746,40.8855,2121,1,4,3,300
027046201,nj,-74.79785,40.83119,1952,2,5,3,150
027046202,nj,-74.76924,40.80992,1436,2,5,3,150
027046297,nj,-74.83496,40.78675,1495,2,6,4,200
027046298,nj,-74.76727,40.7632,2145,3,7,4,133.3
027046400,nj,-74.60028,40.76871,1903,4,9,5,125
027046500,nj,-74.57282,40.86185,2310,3,7,4,133.3
029710101,nj,-74.04524,40.0972,2043,2,6,4,200
029710102,nj,-74.04198,40.08514,1608,2,6,4,200
029711100,nj,-74.0594,40.08387,1969,3,7,4,133.3
029711200,nj,-74.08054,40.08688,1888,3,8,5,166.7
029711300,nj,-74.07273,40.0771,1720,3,8,5,166.7
029711400,nj,-74.06924,40.06754,3002,3,8,5,166.7
029713000,nj,-74.09984,40.0837,1726,4,9,5,125
029713100,nj,-74.10815,40.0922,6246,4,9,5,125
029713201,nj,-74.10542,40.11927,1249,4,9,5,125
029713202,nj,-74.12581,40.11162,2384,4,9,5,125
029713203,nj,-74.12019,40.10149,3524,4,10,6,150
029713300,nj,-74.13197,40.08626,2837,5,10,5,100
029713401,nj,-74.14201,40.08935,3199,7,14,7,100
029713402,nj,-74.1468,40.0683,2043,7,14,7,100
029713500,nj,-74.11682,40.06574,1825,4,10,6,150
029713600,nj,-74.09921,40.06891,1603,4,8,4,100
029713700,nj,-74.08487,40.05901,2411,4,8,4,100
029713800,nj,-74.0767,40.04277,3282,4,8,4,100
029713900,nj,-74.12577,40.05208,5868,4,10,6,150
029714000,nj,-74.15033,40.04485,4199,9,16,7,77.8
029714100,nj,-74.14229,40.02545,2202,5,11,6,120
029714200,nj,-74.12061,40.0326,4624,4,9,5,125
029714300,nj,-74.08946,40.02351,3737,3,7,4,133.3
029715001,nj,-74.17739,40.0869,1943,9,17,8,88.9
029715002,nj,-74.162,40.09524,1098,9,17,8,88.9
029715201,nj,-74.19528,40.10279,1442,10,18,8,80
029715202,nj,-74.20497,40.08978,685,10,18,8,80
029715301,nj,-74.20983,40.10594,1630,10,18,8,80
029715303,nj,-74.20927,40.09886,204,10,18,8,80
029715304,nj,-74.2132,40.09357,495,10,18,8,80
029715401,nj,-74.24028,40.10647,1308,10,19,9,90
029715403,nj,-74.22068,40.09781,303,10,18,8,80
029715404,nj,-74.22811,40.09519,391,10,18,8,80
029715501,nj,-74.23981,40.09478,1265,10,19,9,90
029715502,nj,-74.25019,40.0898,565,10,19,9,90
029715503,nj,-74.23701,40.0834,1106,10,19,9,90
029715600,nj,-74.21277,40.07863,1349,10,18,8,80
029715701,nj,-74.23035,40.06952,2294,10,19,9,90
029715702,nj,-74.24065,40.06165,1860,11,21,10,90.9
029715800,nj,-74.19324,40.06269,3003,10,19,9,90
029715901,nj,-74.20526,40.04538,1024,10,19,9,90
029715902,nj,-74.1852,40.04452,2988,10,18,8,80
029716000,nj,-74.16749,40.03976,3306,9,16,7,77.8
029717001,nj,-74.25339,40.136,952,9,18,9,100
029717002,nj,-74.25808,40.12659,1177,9,18,9,100
029717101,nj,-74.28466,40.15106,2764,9,17,8,88.9
029717102,nj,-74.30555,40.13266,2043,9,18,9,100
029717200,nj,-74.35461,40.14712,3846,9,18,9,100
029717300,nj,-74.41977,40.12347,2262,10,18,8,80
029717400,nj,-74.36752,40.07298,2304,10,19,9,90
029717501,nj,-74.27135,40.1108,3086,9,18,9,100
029717502,nj,-74.28145,40.08587,3752,10,19,9,90
029718000,nj,-74.49492,40.07509,3479,10,19,9,90
029720001,nj,-74.39786,39.90633,5530,11,21,10,90.9
029720102,nj,-74.3457,39.95826,1555,11,21,10,90.9
029720104,nj,-74.36729,39.96041,350,11,20,9,81.8
029720105,nj,-74.35286,39.98958,3992,11,20,9,81.8
029720106,nj,-74.31687,39.95856,852,12,21,9,75
029720107,nj,-74.34396,39.94035,658,11,21,10,90.9
029720202,nj,-74.26141,40.01619,2550,11,21,10,90.9
029720203,nj,-74.27227,40.00528,6304,11,20,9,81.8
029720204,nj,-74.25546,39.9986,9030,10,19,9,90
029720205,nj,-74.29501,40.02497,2682,12,22,10,83.3
029720206,nj,-74.27436,40.03969,3286,11,21,10,90.9
029721000,nj,-74.3206,40.01319,876,11,21,10,90.9
029722001,nj,-74.24558,40.04745,3241,12,21,9,75
029722003,nj,-74.2273,40.0237,1404,11,20,9,81.8
029722004,nj,-74.23086,40.00931,1455,9,18,9,100
029722100,nj,-74.20485,40.02285,3311,10,18,8,80
029722200,nj,-74.16936,40.02178,1798,7,14,7,100
029722300,nj,-74.1782,40.00203,1498,7,14,7,100
029722401,nj,-74.11681,40.01002,3002,3,7,4,133.3
029722402,nj,-74.13496,40.00308,3406,4,8,4,100
029722500,nj,-74.0793,39.99032,4654,2,6,4,200
029722600,nj,-74.12107,39.98469,1396,4,9,5,125
029722701,nj,-74.16412,39.98661,1669,6,13,7,116.7
029722702,nj,-74.14811,39.97632,1641,6,12,6,100
029722800,nj,-74.19202,39.97366,1596,8,16,8,100
029722900,nj,-74.20459,39.9797,1234,8,16,8,100
029723000,nj,-74.23181,39.97787,2138,8,17,9,112.5
029723100,nj,-74.19008,39.9571,1736,7,15,8,114.3
029723200,nj,-74.16733,39.965,2541,6,13,7,116.7
029723300,nj,-74.1389,39.95946,5220,4,9,5,125
029723400,nj,-74.11145,39.95828,3218,3,7,4,133.3
029723500,nj,-74.12196,39.94334,1791,3,8,5,166.7
029723600,nj,-74.17283,39.9483,1876,7,14,7,100
029724000,nj,-74.20868,39.94177,1338,8,16,8,100
029725001,nj,-74.20934,39.92829,1290,8,16,8,100
029725002,nj,-74.19782,39.92466,2101,8,16,8,100
029725100,nj,-74.1869,39.93811,902,8,15,7,87.5
029726000,nj,-74.1453,39.94235,1031,5,12,7,140
029727001,nj,-74.07846,39.96872,3028,2,5,3,150
029727002,nj,-74.08037,39.95386,3683,2,5,3,150
029728001,nj,-74.08392,39.9119,2092,2,6,4,200
029728002,nj,-74.08467,39.92904,2010,2,6,4,200
029728003,nj,-74.0715,39.94217,1503,2,6,4,200
029728004,nj,-74.08213,39.94728,824,2,6,4,200
029729000,nj,-74.13391,39.92824,1206,3,8,5,166.7
029730000,nj,-74.17009,39.93581,2988,6,13,7,116.7
029731001,nj,-74.12092,39.91717,7293,4,9,5,125
029731002,nj,-74.13295,39.88591,8243,4,10,6,150
029731101,nj,-74.15947,39.93112,1547,6,13,7,116.7
029731102,nj,-74.16906,39.90568,4558,5,12,7,140
029731103,nj,-74.19141,39.89831,12579,6,12,6,100
029731201,nj,-74.27092,39.97593,3185,11,20,9,81.8
029731202,nj,-74.27554,39.96472,3339,11,20,9,81.8
029731203,nj,-74.29319,39.95283,1386,11,21,10,90.9
029731204,nj,-74.25996,39.92739,6599,10,19,9,90
029731205,nj,-74.22783,39.95378,4492,9,17,8,88.9
029731206,nj,-74.24956,39.97263,1746,9,18,9,100
029732001,nj,-74.30753,39.86452,24917,8,15,7,87.5
029732003,nj,-74.20559,39.85086,6418,5,12,7,140
029732004,nj,-74.21455,39.82865,8067,5,11,6,120
029732101,nj,-74.15299,39.85747,6492,4,10,6,150
029732103,nj,-74.16605,39.83639,2112,5,10,5,100
029732104,nj,-74.13276,39.83106,3348,5,11,6,120
029733001,nj,-74.16975,39.78521,3382,4,10,6,150
029733002,nj,-74.27209,39.79488,6804,6,12,6,100
029734002,nj,-74.20496,39.75885,3309,4,9,5,125
029734003,nj,-74.19567,39.73278,3083,4,10,6,150
029734004,nj,-74.34592,39.78753,5257,8,15,7,87.5
029734005,nj,-74.26551,39.76949,2498,6,12,6,100
029735001,nj,-74.29274,39.7442,2955,8,16,8,100
029735003,nj,-74.32906,39.73077,1289,7,15,8,114.3
029735004,nj,-74.281,39.73016,2600,7,15,8,114.3
029735101,nj,-74.28238,39.68961,1236,7,14,7,100
029735104,nj,-74.21449,39.69918,2509,4,9,5,125
029735105,nj,-74.22353,39.66356,2937,3,8,5,166.7
029735106,nj,-74.23778,39.66224,2296,4,9,5,125
029736001,nj,-74.34605,39.65768,2720,6,13,7,116.7
029736002,nj,-74.29219,39.64819,1571,6,12,6,100
029736101,nj,-74.37518,39.60435,2848,6,13,7,116.7
029736105,nj,-74.38524,39.55149,3630,5,11,6,120
029736106,nj,-74.3495,39.57378,1597,6,12,6,100
029736107,nj,-74.36065,39.59787,2203,6,13,7,116.7
029737000,nj,-74.33054,39.5973,2218,5,11,6,120
029738001,nj,-74.22572,39.60976,6491,2,6,4,200
029738002,nj,-74.26109,39.54358,4701,2,5,3,150
029738100,nj,-74.13265,39.73531,5315,2,5,3,150
029739000,nj,-74.17441,39.65527,4854,2,6,4,200
029739100,nj,-74.43816,39.98601,1039,11,20,9,81.8
029739200,nj,-74.05573,40.03388,4354,2,6,4,200
029980000,nj,-74.09628,39.82914,30,2,6,4,200
029980100,nj,-74.32343,39.53919,71,4,9,5,125
031116500,nj,-74.33188,41.03002,2782,5,11,6,120
031124201,nj,-74.17185,40.8896,1102,8,16,8,100
031124202,nj,-74.17631,40.88189,1376,8,16,8,100
031124311,nj,-74.1776,40.86826,1903,8,16,8,100
031124312,nj,-74.18712,40.8593,1722,7,15,8,114.3
031124321,nj,-74.16393,40.86553,1947,8,16,8,100
031124322,nj,-74.16367,40.84719,1651,8,16,8,100
031124323,nj,-74.17125,40.85287,322,8,16,8,100
031124402,nj,-74.13453,40.83138,2110,8,16,8,100
031124403,nj,-74.15107,40.84298,1102,8,16,8,100
031124404,nj,-74.14996,40.85476,1025,8,16,8,100
031124500,nj,-74.14898,40.86545,1596,8,16,8,100
031124601,nj,-74.16184,40.88594,944,8,16,8,100
031124602,nj,-74.15367,40.87838,1091,8,16,8,100
031124700,nj,-74.13961,40.88828,1651,8,16,8,100
031124800,nj,-74.14239,40.87956,1110,8,16,8,100
031124900,nj,-74.13886,40.87271,960,8,16,8,100
031125000,nj,-74.13031,40.87955,1147,8,16,8,100
031125100,nj,-74.12433,40.87697,544,8,16,8,100
031133701,nj,-74.18494,40.93325,1401,7,15,8,114.3
031133702,nj,-74.19069,40.93788,1122,7,14,7,100
031143201,nj,-74.15018,40.96838,675,8,16,8,100
031143202,nj,-74.16249,40.96625,1569,8,16,8,100
031143301,nj,-74.154,40.96126,723,8,16,8,100
031143302,nj,-74.14897,40.95535,1207,8,16,8,100
031143401,nj,-74.15608,40.94387,1028,8,16,8,100
031143402,nj,-74.1662,40.9497,979,8,16,8,100
031154003,nj,-74.21215,40.8734,1272,7,14,7,100
031154004,nj,-74.19943,40.86827,207,7,14,7,100
031154005,nj,-74.23519,40.88077,1004,6,13,7,116.7
031154006,nj,-74.23196,40.88289,2675,6,13,7,116.7
031163501,nj,-74.17588,40.96167,1754,8,16,8,100
031163502,nj,-74.19135,40.96366,1388,6,13,7,116.7
031175200,nj,-74.11512,40.86788,376,8,16,8,100
031175301,nj,-74.12149,40.86666,316,8,16,8,100
031175302,nj,-74.12101,40.87206,430,8,16,8,100
031175401,nj,-74.1292,40.86881,641,8,16,8,100
031175402,nj,-74.12312,40.86213,527,8,16,8,100
031175501,nj,-74.13571,40.86428,469,8,16,8,100
031175502,nj,-74.13835,40.86732,530,8,16,8,100
031175601,nj,-74.13793,40.84611,565,8,16,8,100
031175603,nj,-74.1384,40.8591,542,8,16,8,100
031175604,nj,-74.14135,40.8529,629,8,16,8,100
031175701,nj,-74.12538,40.84348,854,7,15,8,114.3
031175703,nj,-74.12995,40.85393,447,7,15,8,114.3
031175704,nj,-74.13027,40.84792,561,7,15,8,114.3
031175801,nj,-74.12543,40.85686,303,8,16,8,100
031175803,nj,-74.1316,40.86435,275,8,16,8,100
031175804,nj,-74.13057,40.8607,320,8,16,8,100
031175900,nj,-74.11212,40.86042,433,8,16,8,100
031180101,nj,-74.19332,40.91491,950,7,14,7,100
031180102,nj,-74.20014,40.91841,938,7,14,7,100
031180201,nj,-74.19276,40.92483,426,7,14,7,100
031180203,nj,-74.18731,40.92,536,7,14,7,100
031180204,nj,-74.18496,40.91616,448,7,14,7,100
031180301,nj,-74.18275,40.92263,555,7,15,8,114.3
031180302,nj,-74.18535,40.92663,550,7,15,8,114.3
031180600,nj,-74.17704,40.92932,724,8,16,8,100
031180700,nj,-74.16859,40.92828,703,8,16,8,100
031180800,nj,-74.16163,40.92977,567,8,16,8,100
031180900,nj,-74.15816,40.93319,594,8,16,8,100
031181000,nj,-74.14698,40.93666,831,8,16,8,100
031181101,nj,-74.14544,40.92985,432,8,16,8,100
031181102,nj,-74.15151,40.93015,564,8,16,8,100
031181200,nj,-74.14996,40.9243,620,8,16,8,100
031181300,nj,-74.15105,40.91947,681,8,16,8,100
031181400,nj,-74.15811,40.9215,555,8,16,8,100
031181500,nj,-74.16306,40.92252,574,8,16,8,100
031181702,nj,-74.1643,40.91598,394,8,16,8,100
031181800,nj,-74.17669,40.91537,402,8,16,8,100
031181900,nj,-74.18631,40.90912,1148,7,15,8,114.3
031182000,nj,-74.1758,40.90973,229,8,16,8,100
031182100,nj,-74.17172,40.90191,600,8,16,8,100
031182200,nj,-74.1677,40.91038,433,8,16,8,100
031182301,nj,-74.16022,40.91181,256,8,16,8,100
031182302,nj,-74.15761,40.91539,783,8,16,8,100
031182400,nj,-74.14937,40.91184,851,8,16,8,100
031182501,nj,-74.14356,40.91786,666,8,16,8,100
031182502,nj,-74.13657,40.91849,559,8,16,8,100
031182600,nj,-74.13811,40.90357,1148,8,16,8,100
031182701,nj,-74.15495,40.9078,480,8,16,8,100
031182702,nj,-74.15004,40.90533,431,8,16,8,100
031182800,nj,-74.1613,40.90581,440,8,16,8,100
031182900,nj,-74.16837,40.90386,423,8,16,8,100
031183001,nj,-74.1562,40.89473,563,8,16,8,100
031183002,nj,-74.16017,40.8927,596,8,16,8,100
031183101,nj,-74.14408,40.89719,647,8,16,8,100
031183102,nj,-74.15179,40.89857,1092,8,16,8,100
031183200,nj,-74.16991,40.91866,732,8,16,8,100
031196401,nj,-74.28879,40.98876,1565,5,12,7,140
031196403,nj,-74.28744,41.0123,753,5,12,7,140
031196404,nj,-74.28048,41.00447,1133,5,12,7,140
031203600,nj,-74.17361,40.93806,1195,8,16,8,100
031216701,nj,-74.2564,41.1207,2592,3,8,5,166.7
031216702,nj,-74.29681,41.08963,2299,4,10,6,150
031223801,nj,-74.20568,40.90273,1003,7,14,7,100
031223802,nj,-74.22362,40.90433,2850,7,14,7,100
031223900,nj,-74.22935,40.90208,27,6,14,8,133.3
031236601,nj,-74.29678,41.026,1794,4,11,7,175
031236603,nj,-74.27219,41.0429,690,4,10,6,150
031236604,nj,-74.30239,41.05201,1484,4,10,6,150
031246001,nj,-74.21975,40.96736,1687,6,13,7,116.7
031246002,nj,-74.26478,40.99798,1233,5,11,6,120
031246003,nj,-74.26069,40.97655,2170,6,12,6,100
031246101,nj,-74.21388,40.93948,2376,6,14,8,133.3
031246102,nj,-74.22721,40.95367,672,6,13,7,116.7
031246103,nj,-74.23703,40.9407,2070,6,13,7,116.7
031246104,nj,-74.2261,40.92089,867,7,14,7,100
031246201,nj,-74.26435,40.95723,2037,6,13,7,116.7
031246202,nj,-74.2566,40.94057,1891,6,13,7,116.7
031246203,nj,-74.25487,40.92161,1460,7,14,7,100
031246300,nj,-74.26471,40.91091,2083,6,14,8,133.3
031256801,nj,-74.38984,41.16953,2626,3,7,4,133.3
031256802,nj,-74.33509,41.14545,2168,3,8,5,166.7
031256803,nj,-74.37855,41.123,2300,2,7,5,250
031256804,nj,-74.37493,41.0784,2893,3,7,4,133.3
031256805,nj,-74.43121,41.07821,2180,3,7,4,133.3
031264101,nj,-74.19369,40.89976,2221,7,14,7,100
031264102,nj,-74.19524,40.8878,2492,7,14,7,100
031264200,nj,-74.17595,40.92287,555,8,16,8,100
033020100,nj,-75.41223,39.73862,1323,15,27,12,80
033020200,nj,-75.4672,39.73201,886,14,26,12,85.7
033020300,nj,-75.47032,39.72469,984,14,25,11,78.6
033020400,nj,-75.45482,39.7327,904,14,26,12,85.7
033020500,nj,-75.46264,39.71084,1154,14,26,12,85.7
033020600,nj,-75.44494,39.68962,1449,14,26,12,85.7
033020700,nj,-75.32153,39.65575,1982,15,27,12,80
033020800,nj,-75.32512,39.6503,1397,15,28,13,86.7
033020900,nj,-75.2101,39.61165,1824,14,26,12,85.7
033021000,nj,-75.17401,39.5919,905,14,26,12,85.7
033021101,nj,-75.15684,39.56433,1794,14,26,12,85.7
033021102,nj,-75.10873,39.52288,2103,13,25,12,92.3
033021201,nj,-75.31935,39.56118,2087,12,22,10,83.3
033021202,nj,-75.38431,39.5274,1702,10,21,11,110
033021300,nj,-75.42035,39.61864,1188,12,24,12,100
033021400,nj,-75.49401,39.65976,1452,13,24,11,84.6
033021500,nj,-75.50405,39.67966,863,13,24,11,84.6
033021600,nj,-75.52481,39.61175,3439,11,21,10,90.9
033021700,nj,-75.48992,39.61931,834,11,22,11,100
033021900,nj,-75.46334,39.57193,901,11,22,11,100
033022000,nj,-75.46459,39.56101,727,12,23,11,91.7
033022100,nj,-75.48092,39.56986,668,12,23,11,91.7
033022201,nj,-75.4505,39.47093,1256,10,20,10,100
033022202,nj,-75.49978,39.53461,852,12,23,11,91.7
035050100,nj,-74.61612,40.57245,863,10,19,9,90
035050200,nj,-74.61206,40.57664,495,10,19,9,90
035050300,nj,-74.59779,40.57148,1252,10,19,9,90
035050400,nj,-74.61219,40.56372,734,10,19,9,90
035050500,nj,-74.63151,40.56923,892,10,19,9,90
035050600,nj,-74.64652,40.57419,1352,10,18,8,80
035050701,nj,-74.66673,40.55878,1554,9,18,9,100
035050703,nj,-74.63366,40.58649,1534,10,18,8,80
035050704,nj,-74.67107,40.58002,2732,9,18,9,100
035050801,nj,-74.65373,40.60584,1321,9,18,9,100
035050802,nj,-74.6321,40.61229,1680,9,18,9,100
035050901,nj,-74.61639,40.62812,1973,8,15,7,87.5
035050902,nj,-74.56541,40.58581,1579,10,19,9,90
035050903,nj,-74.57479,40.60439,2071,9,18,9,100
035051000,nj,-74.57169,40.56295,2229,10,19,9,90
035051100,nj,-74.5334,40.56386,847,10,19,9,90
035051200,nj,-74.54589,40.56463,1111,10,19,9,90
035051300,nj,-74.53353,40.57273,843,10,19,9,90
035051400,nj,-74.58676,40.53727,5238,10,19,9,90
035051500,nj,-74.59572,40.53904,2877,10,19,9,90
035051600,nj,-74.58976,40.5487,3377,10,19,9,90
035051700,nj,-74.42992,40.62385,1004,11,21,10,90.9
035051800,nj,-74.43808,40.61816,926,11,21,10,90.9
035051900,nj,-74.4515,40.61143,1348,11,20,9,81.8
035052001,nj,-74.42198,40.63229,1308,11,21,10,90.9
035052002,nj,-74.44423,40.62451,904,11,21,10,90.9
035052100,nj,-74.4825,40.60376,2837,11,20,9,81.8
035052201,nj,-74.4835,40.64587,2461,9,18,9,100
035052203,nj,-74.52444,40.61015,2041,9,18,9,100
035052204,nj,-74.54248,40.63544,1740,8,16,8,100
035052300,nj,-74.43912,40.64316,2307,11,20,9,81.8
035052400,nj,-74.54401,40.70987,1903,8,16,8,100
035052603,nj,-74.5346,40.67109,2075,9,17,8,88.9
035052604,nj,-74.58855,40.66077,1361,7,15,8,114.3
035052605,nj,-74.61056,40.65571,2026,7,14,7,100
035052701,nj,-74.60167,40.72256,1709,6,13,7,116.7
035052702,nj,-74.56664,40.73768,1392,6,14,8,133.3
035052800,nj,-74.65608,40.71681,982,7,15,8,114.3
035052901,nj,-74.6257,40.69054,440,7,14,7,100
035052904,nj,-74.68512,40.6702,1083,8,16,8,100
035052905,nj,-74.63479,40.65819,2010,7,14,7,100
035052906,nj,-74.63901,40.64811,1578,7,15,8,114.3
035053000,nj,-74.52767,40.55357,1505,10,19,9,90
035053102,nj,-74.48192,40.5077,762,9,18,9,100
035053103,nj,-74.50027,40.49556,1955,9,18,9,100
035053105,nj,-74.50348,40.5141,2901,9,18,9,100
035053200,nj,-74.47626,40.49627,3627,9,18,9,100
035053300,nj,-74.48177,40.48717,3714,9,18,9,100
035053402,nj,-74.59862,40.42063,2718,9,17,8,88.9
035053403,nj,-74.55038,40.43897,2087,9,18,9,100
035053405,nj,-74.54563,40.47897,1481,9,18,9,100
035053406,nj,-74.53309,40.45776,1193,9,18,9,100
035053501,nj,-74.55692,40.52873,3219,10,19,9,90
035053602,nj,-74.73061,40.53411,2100,9,18,9,100
035053603,nj,-74.69609,40.57798,1931,9,18,9,100
035053604,nj,-74.69525,40.60899,1639,9,18,9,100
035053703,nj,-74.73117,40.47804,1646,9,17,8,88.9
035053704,nj,-74.66969,40.49207,1032,9,18,9,100
035053705,nj,-74.66072,40.50149,2469,9,18,9,100
035053706,nj,-74.6553,40.53229,1650,9,18,9,100
035053707,nj,-74.69094,40.5265,1472,9,18,9,100
035053801,nj,-74.59213,40.5002,201,10,19,9,90
035053804,nj,-74.63156,40.53727,1797,9,18,9,100
035053805,nj,-74.61017,40.51974,1817,10,19,9,90
035053806,nj,-74.63346,40.47904,1019,9,18,9,100
035053807,nj,-74.59872,40.47854,2151,9,18,9,100
035053901,nj,-74.64055,40.40014,330,8,17,9,112.5
035053904,nj,-74.64331,40.43567,1208,9,17,8,88.9
035053905,nj,-74.62991,40.45497,1625,9,18,9,100
035054100,nj,-74.56123,40.67233,2918,8,17,9,112.5
035054201,nj,-74.68448,40.39552,2771,9,17,8,88.9
035054202,nj,-74.69588,40.43263,2798,9,18,9,100
035054301,nj,-74.53242,40.52082,1442,10,19,9,90
035054302,nj,-74.52027,40.51054,2623,10,19,9,90
037371000,nj,-74.731,41.29509,3173,2,5,3,150
037371100,nj,-74.60169,41.26911,1876,5,11,6,120
037371200,nj,-74.60786,41.20957,652,6,13,7,116.7
037371300,nj,-74.53331,41.24389,2884,4,9,5,125
037371400,nj,-74.48011,41.22989,1471,3,9,6,200
037371502,nj,-74.46236,41.15367,3064,2,5,3,150
037371503,nj,-74.42708,41.20239,1477,2,5,3,150
037371600,nj,-74.5123,41.16745,2304,2,6,4,200
037371700,nj,-74.53392,41.19786,2498,3,7,4,133.3
037371801,nj,-74.66634,41.23278,1652,5,11,6,120
037371802,nj,-74.62339,41.19063,1640,6,12,6,100
037371900,nj,-74.8459,41.18288,2347,3,7,4,133.3
037372000,nj,-74.80242,41.10888,1828,4,9,5,125
037372100,nj,-74.7491,41.08616,952,4,9,5,125
037372200,nj,-74.78773,41.15591,1875,3,7,4,133.3
037372300,nj,-74.72001,41.16323,2035,5,10,5,100
037372400,nj,-74.67572,41.11471,1320,4,10,6,150
037372500,nj,-74.60904,41.13588,1484,4,10,6,150
037372600,nj,-74.54234,41.11517,3224,3,7,4,133.3
037372700,nj,-74.5735,41.14848,1599,4,9,5,125
037372800,nj,-74.58283,41.10505,605,3,7,4,133.3
037372900,nj,-74.59281,41.1138,1237,3,7,4,133.3
037373000,nj,-74.59733,41.07691,1066,2,6,4,200
037373100,nj,-74.64719,41.06834,2866,3,7,4,133.3
037373200,nj,-74.58744,41.04195,1645,2,6,4,200
037373300,nj,-74.63026,41.01113,1362,2,6,4,200
037373400,nj,-74.65765,41.02038,3189,2,6,4,200
037373500,nj,-74.71539,41.01071,1644,3,7,4,133.3
037373600,nj,-74.73928,41.0302,1324,3,8,5,166.7
037373700,nj,-74.76063,41.057,944,4,9,5,125
037373800,nj,-74.74641,41.05062,1602,4,9,5,125
037373900,nj,-74.87023,41.07288,2600,4,8,4,100
037374000,nj,-74.81517,41.02935,1440,4,8,4,100
037374100,nj,-74.79787,40.97408,1517,3,7,4,133.3
037374200,nj,-74.75194,40.93488,1452,2,6,4,200
037374300,nj,-74.71337,40.95151,1616,2,6,4,200
037374400,nj,-74.68675,40.98475,1041,2,6,4,200
037374500,nj,-74.65674,40.96857,1797,2,6,4,200
037374600,nj,-74.7027,40.91414,1753,2,5,3,150
037374700,nj,-74.64891,40.9458,2172,2,6,4,200
037374800,nj,-74.67529,40.92327,1958,2,6,4,200
037374900,nj,-74.6678,40.93735,1978,2,6,4,200
039030200,nj,-74.1922,40.65705,506,8,16,8,100
039030400,nj,-74.18761,40.65141,792,7,15,8,114.3
039030500,nj,-74.19533,40.64694,942,6,14,8,133.3
039030600,nj,-74.20505,40.64223,603,6,14,8,133.3
039030701,nj,-74.22219,40.6496,327,7,14,7,100
039030703,nj,-74.22006,40.65317,628,8,16,8,100
039030704,nj,-74.21786,40.65819,343,8,16,8,100
039030802,nj,-74.21257,40.6554,439,8,16,8,100
039030900,nj,-74.20418,40.65125,993,8,16,8,100
039031000,nj,-74.19805,40.65517,619,8,16,8,100
039031100,nj,-74.20609,40.65902,976,8,16,8,100
039031200,nj,-74.20213,40.66351,1023,8,16,8,100
039031301,nj,-74.19734,40.67501,605,8,16,8,100
039031302,nj,-74.2015,40.6697,697,8,16,8,100
039031400,nj,-74.20851,40.67176,655,8,16,8,100
039031500,nj,-74.20094,40.68169,733,8,16,8,100
039031601,nj,-74.21119,40.67734,380,8,16,8,100
039031602,nj,-74.20905,40.68586,647,8,16,8,100
039031700,nj,-74.21697,40.67699,579,8,16,8,100
039031801,nj,-74.2279,40.66939,727,9,17,8,88.9
039031802,nj,-74.22278,40.67199,300,8,16,8,100
039031903,nj,-74.2252,40.66215,572,8,17,9,112.5
039031904,nj,-74.22076,40.66414,261,8,16,8,100
039032002,nj,-74.22917,40.65635,689,9,17,8,88.9
039032003,nj,-74.23245,40.6619,609,9,17,8,88.9
039032004,nj,-74.23837,40.66117,378,9,17,8,88.9
039032101,nj,-74.239,40.6672,954,9,17,8,88.9
039032102,nj,-74.24337,40.67088,1037,9,17,8,88.9
039032200,nj,-74.22248,40.70246,1718,9,17,8,88.9
039032300,nj,-74.23268,40.70254,732,9,17,8,88.9
039032401,nj,-74.23216,40.69243,1135,9,18,9,100
039032402,nj,-74.24167,40.69917,1031,9,18,9,100
039032500,nj,-74.22077,40.68749,1811,8,16,8,100
039032600,nj,-74.25325,40.70617,954,9,18,9,100
039032701,nj,-74.28037,40.70374,1042,10,19,9,90
039032702,nj,-74.26839,40.70973,1469,10,19,9,90
039032800,nj,-74.28111,40.71744,1503,10,19,9,90
039032901,nj,-74.28911,40.71162,1289,10,19,9,90
039032902,nj,-74.29697,40.70196,1672,10,19,9,90
039033000,nj,-74.2925,40.69167,1721,10,19,9,90
039033100,nj,-74.26573,40.69832,1865,10,18,8,80
039033200,nj,-74.25222,40.69195,1435,9,18,9,100
039033300,nj,-74.26745,40.6849,1335,10,18,8,80
039033400,nj,-74.25596,40.68211,1322,9,18,9,100
039033501,nj,-74.25491,40.67829,1417,9,18,9,100
039033502,nj,-74.23861,40.67774,797,9,17,8,88.9
039033600,nj,-74.2889,40.67816,3061,10,19,9,90
039033700,nj,-74.25543,40.66639,1384,9,17,8,88.9
039033800,nj,-74.27398,40.66607,1525,10,19,9,90
039033900,nj,-74.26806,40.66283,797,10,18,8,80
039034000,nj,-74.26528,40.6585,1331,9,18,9,100
039034100,nj,-74.24583,40.65564,1036,9,17,8,88.9
039034200,nj,-74.26735,40.65362,978,9,18,9,100
039034300,nj,-74.26893,40.64589,1249,9,17,8,88.9
039034400,nj,-74.25378,40.64939,1333,8,16,8,100
039034500,nj,-74.23754,40.64865,1217,7,15,8,114.3
039034600,nj,-74.25018,40.64235,1090,7,14,7,100
039034700,nj,-74.25692,40.63723,1030,7,14,7,100
039034800,nj,-74.2766,40.64047,1786,10,18,8,80
039034900,nj,-74.27179,40.63226,1960,9,17,8,88.9
039035000,nj,-74.26413,40.62508,906,7,15,8,114.3
039035100,nj,-74.24811,40.63543,1215,7,14,7,100
039035200,nj,-74.22609,40.64364,707,6,14,8,133.3
039035300,nj,-74.24464,40.62489,1262,7,14,7,100
039035400,nj,-74.22826,40.61807,1088,7,14,7,100
039035500,nj,-74.27876,40.61879,1979,10,18,8,80
039035600,nj,-74.29827,40.60696,1384,9,17,8,88.9
039035700,nj,-74.28875,40.6071,1685,9,18,9,100
039035800,nj,-74.27739,40.59822,1056,8,16,8,100
039035900,nj,-74.27946,40.6061,1032,9,17,8,88.9
039036000,nj,-74.26644,40.60738,1263,8,16,8,100
039036100,nj,-74.28985,40.63488,704,10,18,8,80
039036200,nj,-74.29702,40.62271,2549,10,18,8,80
039036301,nj,-74.31432,40.62636,1543,10,19,9,90
039036302,nj,-74.33179,40.6109,1301,10,19,9,90
039036400,nj,-74.33622,40.66592,2329,11,20,9,81.8
039036500,nj,-74.36316,40.6602,1725,10,20,10,100
039036600,nj,-74.34995,40.64991,1605,11,20,9,81.8
039036700,nj,-74.34362,40.64291,1929,11,20,9,81.8
039036800,nj,-74.33259,40.63445,2462,10,20,10,100
039036900,nj,-74.32315,40.65133,1563,11,20,9,81.8
039037000,nj,-74.29818,40.66618,2206,10,19,9,90
039037100,nj,-74.31736,40.66568,1535,11,20,9,81.8
039037200,nj,-74.29819,40.65518,1304,10,19,9,90
039037300,nj,-74.29358,40.64501,1706,10,18,8,80
039037400,nj,-74.31093,40.64447,1513,10,19,9,90
039037500,nj,-74.31446,40.71139,1646,10,19,9,90
039037601,nj,-74.33653,40.70073,1711,10,19,9,90
039037602,nj,-74.31943,40.68953,2007,10,20,10,100
039037700,nj,-74.35843,40.72707,1533,9,18,9,100
039037800,nj,-74.37477,40.71979,1855,9,17,8,88.9
039037900,nj,-74.37092,40.703,1944,9,17,8,88.9
039038000,nj,-74.34776,40.7127,1672,10,18,8,80
039038101,nj,-74.39862,40.69303,1326,9,18,9,100
039038103,nj,-74.41416,40.69878,1328,9,17,8,88.9
039038104,nj,-74.39752,40.70857,1441,9,17,8,88.9
039038201,nj,-74.41251,40.67622,2178,10,18,8,80
039038202,nj,-74.44157,40.67665,2702,9,17,8,88.9
039038300,nj,-74.36011,40.68105,2759,10,20,10,100
039038400,nj,-74.39533,40.66034,2146,10,20,10,100
039038500,nj,-74.3802,40.65673,2232,10,20,10,100
039038601,nj,-74.35491,40.62593,2282,11,20,9,81.8
039038602,nj,-74.37787,40.61495,1437,11,20,9,81.8
039038701,nj,-74.38894,40.63854,1381,11,21,10,90.9
039038702,nj,-74.3821,40.6452,1283,11,20,9,81.8
039038800,nj,-74.40378,40.6366,1213,11,21,10,90.9
039038900,nj,-74.41291,40.62949,965,11,21,10,90.9
039039000,nj,-74.41195,40.62392,822,11,21,10,90.9
039039100,nj,-74.39449,40.62364,1288,11,21,10,90.9
039039200,nj,-74.40856,40.61786,852,11,21,10,90.9
039039301,nj,-74.42624,40.61362,368,11,21,10,90.9
039039302,nj,-74.42101,40.61668,321,11,21,10,90.9
039039400,nj,-74.44374,40.6051,1074,11,20,9,81.8
039039501,nj,-74.43639,40.60212,683,11,20,9,81.8
039039502,nj,-74.44422,40.60115,654,11,20,9,81.8
039039600,nj,-74.4238,40.60355,994,11,20,9,81.8
039039700,nj,-74.40653,40.60676,1514,11,20,9,81.8
039039801,nj,-74.17131,40.65089,723,8,16,8,100
039039900,nj,-74.2151,40.66592,447,8,16,8,100
039980000,nj,-74.16899,40.67195,204,8,16,8,100
041030600,nj,-75.1866,40.69755,1438,7,15,8,114.3
041030700,nj,-75.19466,40.69137,1845,8,15,7,87.5
041030800,nj,-75.17065,40.68703,1155,8,16,8,100
041030900,nj,-75.18477,40.68089,1169,8,16,8,100
041031101,nj,-75.01424,41.00034,2795,4,9,5,125
041031102,nj,-74.91015,40.98781,2088,4,9,5,125
041031200,nj,-75.01109,40.90866,4381,4,8,4,100
041031301,nj,-74.87875,40.88009,2369,3,6,3,100
041031302,nj,-74.83001,40.91885,2883,2,6,4,200
041031401,nj,-74.81844,40.86294,1508,2,5,3,150
041031402,nj,-74.83388,40.84371,1388,2,5,3,150
041031500,nj,-74.91087,40.81023,3338,3,7,4,133.3
041031601,nj,-75.0414,40.82178,2362,4,8,4,100
041031602,nj,-74.99484,40.80897,1240,4,9,5,125
041031700,nj,-75.07279,40.82944,1123,5,11,6,120
041031800,nj,-75.12461,40.75268,1643,5,11,6,120
041031900,nj,-74.98531,40.75406,3059,5,10,5,100
041032000,nj,-74.98248,40.7587,2531,5,11,6,120
041032101,nj,-75.04948,40.71396,1686,6,11,5,83.3
041032102,nj,-75.11217,40.6791,2063,7,14,7,100
041032200,nj,-75.1551,40.70914,3554,7,15,8,114.3
041032300,nj,-75.16286,40.64025,1812,7,15,8,114.3
041032400,nj,-75.15711,40.65976,1095,8,16,8,100
001000100,ny,-73.73631,42.66892,735,5,11,6,120
001000201,ny,-73.75519,42.65838,1264,5,11,6,120
001000202,ny,-73.74995,42.66701,369,5,11,6,120
001000301,ny,-73.77664,42.67262,804,4,11,7,175
001000302,ny,-73.78336,42.68193,1006,5,11,6,120
001000401,ny,-73.86497,42.70635,897,3,9,6,200
001000403,ny,-73.80526,42.67687,1526,4,11,7,175
001000404,ny,-73.8296,42.69008,25,4,10,6,150
001000501,ny,-73.78243,42.67034,748,4,11,7,175
001000502,ny,-73.78673,42.66701,565,4,11,7,175
001000600,ny,-73.77365,42.66459,1013,4,11,7,175
001000700,ny,-73.7664,42.67029,1241,5,11,6,120
001000800,ny,-73.76521,42.66036,744,5,11,6,120
001001100,ny,-73.75091,42.65245,668,4,11,7,175
001001400,ny,-73.76855,42.65657,796,5,11,6,120
001001500,ny,-73.78168,42.6575,943,4,11,7,175
001001600,ny,-73.78953,42.65863,1122,4,11,7,175
001001700,ny,-73.79887,42.66093,1218,4,11,7,175
001001802,ny,-73.8204,42.66902,1939,4,10,6,150
001001803,ny,-73.81133,42.66264,1393,4,10,6,150
001001804,ny,-73.81997,42.64666,1459,4,10,6,150
001001901,ny,-73.79227,42.65064,1005,5,11,6,120
001001902,ny,-73.79637,42.64493,1171,5,12,7,140
001002000,ny,-73.78494,42.63477,1829,5,12,7,140
001002100,ny,-73.77754,42.65033,574,5,11,6,120
001002200,ny,-73.76548,42.65042,722,5,11,6,120
001002300,ny,-73.76356,42.64522,721,4,10,6,150
001002500,ny,-73.75501,42.64116,1014,4,10,6,150
001002600,ny,-73.76518,42.63085,1821,5,11,6,120
001012700,ny,-73.68773,42.77012,783,5,11,6,120
001012800,ny,-73.70016,42.76388,1127,5,11,6,120
001012900,ny,-73.70767,42.78255,751,5,11,6,120
001013000,ny,-73.71877,42.77454,2545,4,11,7,175
001013100,ny,-73.69259,42.7474,852,5,11,6,120
001013200,ny,-73.70136,42.72884,818,4,10,6,150
001013300,ny,-73.71065,42.73113,1166,4,10,6,150
001013400,ny,-73.70686,42.71471,816,4,10,6,150
001013503,ny,-73.73009,42.77847,1841,4,10,6,150
001013505,ny,-73.74772,42.73792,1131,4,10,6,150
001013507,ny,-73.78009,42.7483,913,3,9,6,200
001013509,ny,-73.72124,42.74581,1414,4,11,7,175
001013510,ny,-73.74715,42.74962,1233,4,10,6,150
001013511,ny,-73.75204,42.78472,1079,3,9,6,200
001013512,ny,-73.78607,42.77434,1676,3,8,5,166.7
001013602,ny,-73.7271,42.69106,1121,4,11,7,175
001013603,ny,-73.73462,42.70616,1119,4,11,7,175
001013604,ny,-73.73692,42.72489,1431,4,11,7,175
001013703,ny,-73.81481,42.74496,1019,3,8,5,166.7
001013706,ny,-73.76157,42.69727,877,4,11,7,175
001013707,ny,-73.77263,42.7221,2518,4,9,5,125
001013708,ny,-73.79394,42.71223,1344,3,9,6,200
001013709,ny,-73.77399,42.69187,1390,4,10,6,150
001013802,ny,-73.84587,42.76173,1850,3,8,5,166.7
001013803,ny,-73.87812,42.75779,1505,3,8,5,166.7
001013804,ny,-73.87869,42.74163,1877,3,8,5,166.7
001013901,ny,-73.84066,42.71623,1100,3,9,6,200
001013902,ny,-73.82713,42.7231,2024,3,9,6,200
001014001,ny,-73.81425,42.70214,1489,3,9,6,200
001014002,ny,-73.7943,42.6931,1808,4,10,6,150
001014100,ny,-73.84395,42.64419,2267,4,10,6,150
001014201,ny,-73.79479,42.61471,2307,5,11,6,120
001014202,ny,-73.86594,42.61922,2167,4,10,6,150
001014203,ny,-73.84448,42.60583,2275,4,10,6,150
001014301,ny,-73.77934,42.56157,1265,5,11,6,120
001014303,ny,-73.81281,42.58984,1927,4,11,7,175
001014304,ny,-73.84489,42.55975,1565,4,10,6,150
001014401,ny,-73.88553,42.4941,1889,3,7,4,133.3
001014402,ny,-73.81131,42.47559,1072,4,10,6,150
001014501,ny,-73.95188,42.63928,1442,3,8,5,166.7
001014502,ny,-73.93508,42.58023,1872,3,7,4,133.3
001014503,ny,-73.93481,42.65173,1154,3,9,6,200
001014606,ny,-73.97239,42.74164,1660,3,9,6,200
001014608,ny,-73.8542,42.69001,1187,4,10,6,150
001014609,ny,-73.85591,42.67615,1610,4,10,6,150
001014611,ny,-73.93491,42.69121,817,3,9,6,200
001014612,ny,-74.03395,42.70559,639,2,7,5,250
001014613,ny,-74.00934,42.70461,1439,3,7,4,133.3
001014614,ny,-73.88624,42.68247,1598,4,10,6,150
001014615,ny,-73.91413,42.6955,329,4,10,6,150
001014616,ny,-73.92839,42.73322,2278,3,9,6,200
001014617,ny,-73.89872,42.72429,1146,4,9,5,125
001014700,ny,-74.11068,42.68224,1541,1,3,2,200
001014801,ny,-74.11605,42.5927,2067,1,2,1,100
001014802,ny,-74.17424,42.4752,1915,1,3,2,200
001014803,ny,-74.03979,42.49647,2091,1,3,2,200
003940200,ny,-78.30332,42.2317,2,0,1,1,NA
003950100,ny,-77.83835,42.40381,2679,0,1,1,NA
003950300,ny,-78.1961,42.46635,2409,1,2,1,100
003950401,ny,-78.24262,42.29655,1652,0,1,1,NA
003950402,ny,-78.17745,42.33507,2611,0,1,1,NA
003950500,ny,-78.23374,42.17867,2552,0,1,1,NA
003950600,ny,-78.05183,42.21083,2474,0,1,1,NA
003950700,ny,-77.9268,42.17405,2278,0,1,1,NA
003950800,ny,-77.86286,42.26278,2243,0,1,1,NA
003950900,ny,-77.80504,42.14091,2613,0,1,1,NA
003951000,ny,-77.90204,42.04069,2545,0,1,1,NA
003951100,ny,-78.04267,42.08301,2575,0,1,1,NA
003951201,ny,-78.14973,42.07258,1816,0,1,1,NA
003951202,ny,-78.24931,42.07045,1990,0,1,1,NA
003951301,ny,-78.08383,42.34545,1580,0,1,1,NA
003951302,ny,-77.99253,42.41688,2188,0,1,1,NA
005000100,ny,-73.8836,40.79272,1,6,13,7,116.7
005000200,ny,-73.86007,40.80602,926,6,13,7,116.7
005000400,ny,-73.85088,40.80839,806,6,13,7,116.7
005001600,ny,-73.85808,40.81885,372,6,13,7,116.7
005001901,ny,-73.92805,40.80679,83,6,13,7,116.7
005001902,ny,-73.91593,40.80368,301,6,13,7,116.7
005001903,ny,-73.91262,40.8022,82,6,13,7,116.7
005001904,ny,-73.90192,40.79858,11,6,13,7,116.7
005002001,ny,-73.86788,40.81739,22,6,13,7,116.7
005002002,ny,-73.86442,40.81764,465,6,13,7,116.7
005002300,ny,-73.92584,40.80908,11,6,13,7,116.7
005002400,ny,-73.87038,40.81497,9,6,13,7,116.7
005002500,ny,-73.92087,40.807,164,6,13,7,116.7
005002701,ny,-73.91635,40.80508,48,6,13,7,116.7
005002702,ny,-73.91377,40.80645,161,6,13,7,116.7
005002800,ny,-73.87821,40.8216,112,6,13,7,116.7
005003100,ny,-73.90569,40.8099,80,6,13,7,116.7
005003300,ny,-73.91194,40.80824,175,6,13,7,116.7
005003500,ny,-73.90867,40.81097,134,6,13,7,116.7
005003700,ny,-73.91217,40.81146,12,6,13,7,116.7
005003800,ny,-73.86334,40.82029,140,6,13,7,116.7
005003900,ny,-73.92143,40.80972,374,6,13,7,116.7
005004001,ny,-73.85834,40.82827,216,6,13,7,116.7
005004100,ny,-73.91941,40.81139,200,6,13,7,116.7
005004200,ny,-73.86201,40.82393,81,6,13,7,116.7
005004300,ny,-73.91704,40.81362,339,6,13,7,116.7
005004400,ny,-73.86641,40.82652,102,6,13,7,116.7
005004600,ny,-73.86918,40.82242,50,6,13,7,116.7
005004800,ny,-73.8743,40.82702,107,6,13,7,116.7
005005001,ny,-73.87785,40.825,219,6,13,7,116.7
005005002,ny,-73.87844,40.82736,198,6,13,7,116.7
005005100,ny,-73.92757,40.81321,161,6,13,7,116.7
005005200,ny,-73.88243,40.82563,118,6,13,7,116.7
005005300,ny,-73.92178,40.8522,4,6,14,8,133.3
005005400,ny,-73.87972,40.8299,427,6,13,7,116.7
005005600,ny,-73.87908,40.83261,190,6,13,7,116.7
005005902,ny,-73.92344,40.82411,23,6,14,8,133.3
005006000,ny,-73.87777,40.83764,86,6,13,7,116.7
005006100,ny,-73.92267,40.82225,25,6,14,8,133.3
005006200,ny,-73.87552,40.83329,166,6,13,7,116.7
005006301,ny,-73.92905,40.82182,238,6,14,8,133.3
005006302,ny,-73.92641,40.82997,8,6,14,8,133.3
005006400,ny,-73.8722,40.83301,351,6,13,7,116.7
005006500,ny,-73.92166,40.8174,226,6,14,8,133.3
005006700,ny,-73.91818,40.8195,234,6,14,8,133.3
005006800,ny,-73.87048,40.82897,269,6,13,7,116.7
005006900,ny,-73.91576,40.82187,256,6,14,8,133.3
005007000,ny,-73.86562,40.82982,484,6,13,7,116.7
005007100,ny,-73.91283,40.81822,93,6,14,8,133.3
005007200,ny,-73.86069,40.83105,439,6,13,7,116.7
005007300,ny,-73.90939,40.81468,113,6,13,7,116.7
005007400,ny,-73.85286,40.81947,314,6,13,7,116.7
005007500,ny,-73.90862,40.81878,338,6,14,8,133.3
005007600,ny,-73.86766,40.83338,448,6,13,7,116.7
005007700,ny,-73.90442,40.81973,185,6,14,8,133.3
005007800,ny,-73.85265,40.82913,598,6,13,7,116.7
005007900,ny,-73.90487,40.81579,190,6,13,7,116.7
005008300,ny,-73.90184,40.81368,260,6,13,7,116.7
005008400,ny,-73.84774,40.81561,409,6,13,7,116.7
005008500,ny,-73.89908,40.81628,259,6,13,7,116.7
005008600,ny,-73.84981,40.81988,121,6,13,7,116.7
005008700,ny,-73.89728,40.81967,167,6,14,8,133.3
005008900,ny,-73.89391,40.81857,109,6,14,8,133.3
005009000,ny,-73.84119,40.81498,344,5,12,7,140
005009200,ny,-73.85215,40.83234,497,6,13,7,116.7
005009301,ny,-73.88911,40.81435,484,6,13,7,116.7
005009302,ny,-73.88525,40.80422,376,6,13,7,116.7
005009600,ny,-73.84366,40.83449,456,5,12,7,140
005009800,ny,-73.84951,40.82545,784,6,13,7,116.7
005011000,ny,-73.83186,40.8148,16,5,12,7,140
005011502,ny,-73.88603,40.81969,275,6,13,7,116.7
005011701,ny,-73.8836,40.81439,96,6,13,7,116.7
005011702,ny,-73.87343,40.80835,9,6,13,7,116.7
005011800,ny,-73.79797,40.80929,868,5,12,7,140
005011900,ny,-73.88957,40.82327,166,6,13,7,116.7
005012101,ny,-73.88889,40.82828,237,6,13,7,116.7
005012102,ny,-73.88797,40.826,44,6,13,7,116.7
005012300,ny,-73.88736,40.82855,229,6,13,7,116.7
005012500,ny,-73.89352,40.82864,373,6,14,8,133.3
005012701,ny,-73.89233,40.82563,167,6,14,8,133.3
005012901,ny,-73.89873,40.82263,171,6,14,8,133.3
005013000,ny,-73.81475,40.81931,247,5,12,7,140
005013100,ny,-73.8979,40.82595,342,6,14,8,133.3
005013200,ny,-73.81937,40.81175,1290,6,12,6,100
005013300,ny,-73.90348,40.82282,72,6,14,8,133.3
005013500,ny,-73.9021,40.82713,216,6,14,8,133.3
005013800,ny,-73.79447,40.8217,340,5,12,7,140
005014100,ny,-73.91229,40.82377,175,6,14,8,133.3
005014300,ny,-73.91213,40.82775,63,6,14,8,133.3
005014400,ny,-73.82334,40.82126,315,5,12,7,140
005014500,ny,-73.90703,40.83151,107,6,14,8,133.3
005014701,ny,-73.90533,40.83423,21,6,14,8,133.3
005014702,ny,-73.90439,40.83653,18,6,14,8,133.3
005014900,ny,-73.90149,40.8326,202,6,14,8,133.3
005015100,ny,-73.89848,40.83108,401,6,14,8,133.3
005015200,ny,-73.82491,40.82638,528,5,12,7,140
005015300,ny,-73.89414,40.83348,352,6,14,8,133.3
005015500,ny,-73.88999,40.83553,105,6,13,7,116.7
005015700,ny,-73.88545,40.833,317,6,13,7,116.7
005015800,ny,-73.81862,40.82487,262,5,12,7,140
005015900,ny,-73.89355,40.82237,60,6,14,8,133.3
005016000,ny,-73.80339,40.83175,952,5,12,7,140
005016100,ny,-73.88502,40.83685,119,6,13,7,116.7
005016200,ny,-73.82176,40.82885,379,5,12,7,140
005016300,ny,-73.89497,40.83856,4,6,14,8,133.3
005016400,ny,-73.82485,40.8322,296,5,12,7,140
005016500,ny,-73.90028,40.84311,88,6,14,8,133.3
005016600,ny,-73.83018,40.82953,516,5,12,7,140
005016700,ny,-73.90217,40.84048,124,6,14,8,133.3
005016900,ny,-73.90272,40.83779,120,6,14,8,133.3
005017100,ny,-73.9075,40.84042,2,6,14,8,133.3
005017300,ny,-73.91652,40.8263,192,6,14,8,133.3
005017500,ny,-73.91365,40.83082,177,6,14,8,133.3
005017701,ny,-73.91118,40.8332,191,6,14,8,133.3
005017702,ny,-73.90955,40.83618,323,6,14,8,133.3
005017901,ny,-73.91519,40.83483,67,6,14,8,133.3
005017902,ny,-73.9135,40.83701,54,6,14,8,133.3
005018101,ny,-73.91611,40.83161,151,6,14,8,133.3
005018102,ny,-73.91814,40.83227,51,6,14,8,133.3
005018301,ny,-73.92081,40.82864,26,6,14,8,133.3
005018302,ny,-73.91875,40.82791,88,6,14,8,133.3
005018400,ny,-73.82928,40.83742,932,5,12,7,140
005018501,ny,-73.90933,40.82718,201,6,14,8,133.3
005018502,ny,-73.90598,40.82631,262,6,14,8,133.3
005018900,ny,-73.93021,40.83172,287,6,14,8,133.3
005019300,ny,-73.92932,40.83635,109,6,14,8,133.3
005019400,ny,-73.83607,40.83352,374,5,12,7,140
005019500,ny,-73.92252,40.83048,85,6,14,8,133.3
005019700,ny,-73.91998,40.83521,64,6,14,8,133.3
005019900,ny,-73.92545,40.83674,172,6,14,8,133.3
005020000,ny,-73.84552,40.84283,400,5,12,7,140
005020100,ny,-73.92696,40.84216,100,6,14,8,133.3
005020200,ny,-73.84758,40.83849,245,5,12,7,140
005020400,ny,-73.85086,40.84087,313,6,13,7,116.7
005020501,ny,-73.92366,40.84741,139,6,14,8,133.3
005020502,ny,-73.91949,40.85138,178,6,14,8,133.3
005020601,ny,-73.85054,40.83665,343,6,13,7,116.7
005020900,ny,-73.91502,40.84307,74,6,14,8,133.3
005021001,ny,-73.85828,40.84081,9,6,13,7,116.7
005021002,ny,-73.85652,40.83848,11,6,13,7,116.7
005021100,ny,-73.92351,40.8404,194,6,14,8,133.3
005021200,ny,-73.85896,40.83613,1,6,13,7,116.7
005021301,ny,-73.91982,40.84554,48,6,14,8,133.3
005021302,ny,-73.92038,40.84305,144,6,14,8,133.3
005021501,ny,-73.91825,40.84947,67,6,14,8,133.3
005021502,ny,-73.91671,40.84804,151,6,14,8,133.3
005021601,ny,-73.86482,40.83754,223,6,13,7,116.7
005021602,ny,-73.86227,40.83719,79,6,13,7,116.7
005021700,ny,-73.91331,40.84818,122,6,14,8,133.3
005021800,ny,-73.86939,40.83747,403,6,13,7,116.7
005021900,ny,-73.91962,40.83964,80,6,14,8,133.3
005022000,ny,-73.87243,40.84334,131,6,13,7,116.7
005022101,ny,-73.91812,40.83828,41,6,14,8,133.3
005022102,ny,-73.9161,40.83766,52,6,14,8,133.3
005022200,ny,-73.8552,40.83569,282,6,13,7,116.7
005022300,ny,-73.91509,40.84053,45,6,14,8,133.3
005022401,ny,-73.86851,40.85502,32,6,13,7,116.7
005022403,ny,-73.86543,40.85648,28,6,13,7,116.7
005022404,ny,-73.8663,40.85274,29,6,13,7,116.7
005022500,ny,-73.91097,40.84014,123,6,14,8,133.3
005022701,ny,-73.91106,40.8468,97,6,14,8,133.3
005022702,ny,-73.91327,40.84448,21,6,14,8,133.3
005022703,ny,-73.91052,40.84404,17,6,14,8,133.3
005022800,ny,-73.86354,40.85349,200,6,13,7,116.7
005022901,ny,-73.90722,40.84609,157,6,14,8,133.3
005022902,ny,-73.90715,40.8438,132,6,14,8,133.3
005023000,ny,-73.86602,40.84929,273,6,13,7,116.7
005023100,ny,-73.90246,40.84622,116,6,14,8,133.3
005023200,ny,-73.86332,40.84697,362,6,13,7,116.7
005023301,ny,-73.90875,40.84956,97,6,14,8,133.3
005023302,ny,-73.90473,40.84819,77,6,14,8,133.3
005023501,ny,-73.90457,40.85215,41,6,14,8,133.3
005023502,ny,-73.90347,40.85129,92,6,14,8,133.3
005023600,ny,-73.86726,40.84509,215,6,13,7,116.7
005023702,ny,-73.89732,40.86064,35,6,14,8,133.3
005023703,ny,-73.89957,40.86004,82,6,14,8,133.3
005023704,ny,-73.90191,40.85627,57,6,14,8,133.3
005023800,ny,-73.86109,40.84371,387,6,13,7,116.7
005023900,ny,-73.90287,40.85891,229,6,14,8,133.3
005024000,ny,-73.86888,40.84162,526,6,13,7,116.7
005024100,ny,-73.90619,40.85315,143,6,14,8,133.3
005024300,ny,-73.91153,40.85243,179,6,14,8,133.3
005024400,ny,-73.85752,40.84623,394,6,13,7,116.7
005024501,ny,-73.91546,40.85288,166,6,14,8,133.3
005024502,ny,-73.91357,40.85511,131,6,14,8,133.3
005024600,ny,-73.86116,40.85161,358,6,13,7,116.7
005024700,ny,-73.91847,40.8555,36,6,14,8,133.3
005024800,ny,-73.85841,40.85534,401,6,13,7,116.7
005024900,ny,-73.91314,40.85744,5,6,14,8,133.3
005025000,ny,-73.8557,40.85171,468,6,13,7,116.7
005025100,ny,-73.90773,40.85654,358,6,14,8,133.3
005025200,ny,-73.85497,40.84713,504,6,13,7,116.7
005025300,ny,-73.90455,40.86101,167,6,14,8,133.3
005025400,ny,-73.85248,40.8485,401,6,13,7,116.7
005025500,ny,-73.90894,40.86054,150,6,14,8,133.3
005025600,ny,-73.85022,40.84439,293,6,13,7,116.7
005025700,ny,-73.91462,40.86007,77,6,14,8,133.3
005026100,ny,-73.9059,40.86664,2,6,14,8,133.3
005026300,ny,-73.90447,40.86477,128,6,14,8,133.3
005026400,ny,-73.83209,40.84178,989,5,12,7,140
005026500,ny,-73.90024,40.86622,199,6,14,8,133.3
005026601,ny,-73.83411,40.84745,307,5,12,7,140
005026602,ny,-73.83062,40.84597,602,5,12,7,140
005026701,ny,-73.90123,40.86935,54,6,14,8,133.3
005026702,ny,-73.90012,40.87227,153,6,14,8,133.3
005026900,ny,-73.90873,40.86753,131,6,14,8,133.3
005027300,ny,-73.90323,40.87389,246,6,14,8,133.3
005027401,ny,-73.82263,40.84044,1239,5,12,7,140
005027402,ny,-73.81467,40.84287,726,5,12,7,140
005027600,ny,-73.81979,40.85454,9,6,12,6,100
005027700,ny,-73.90147,40.8784,213,6,14,8,133.3
005027900,ny,-73.89729,40.88256,324,6,14,8,133.3
005028100,ny,-73.89065,40.88379,60,6,13,7,116.7
005028300,ny,-73.90257,40.88064,74,6,14,8,133.3
005028400,ny,-73.83869,40.84944,83,5,12,7,140
005028500,ny,-73.90257,40.88643,212,6,14,8,133.3
005028600,ny,-73.84778,40.84918,292,5,12,7,140
005028700,ny,-73.90466,40.88271,265,6,14,8,133.3
005028800,ny,-73.85147,40.85429,671,6,13,7,116.7
005028900,ny,-73.90733,40.87956,109,6,14,8,133.3
005029301,ny,-73.92559,40.88388,61,6,14,8,133.3
005029302,ny,-73.91586,40.87928,156,6,14,8,133.3
005029500,ny,-73.90857,40.88494,199,6,14,8,133.3
005029600,ny,-73.84502,40.85537,213,5,12,7,140
005029700,ny,-73.91184,40.88493,141,6,14,8,133.3
005030000,ny,-73.83123,40.85219,772,5,12,7,140
005030100,ny,-73.91793,40.88324,68,6,14,8,133.3
005030201,ny,-73.8245,40.86192,96,6,13,7,116.7
005030202,ny,-73.82029,40.86529,3,6,13,7,116.7
005030701,ny,-73.91057,40.89315,150,6,14,8,133.3
005030900,ny,-73.91796,40.89962,234,6,14,8,133.3
005031000,ny,-73.83602,40.86125,885,6,13,7,116.7
005031200,ny,-73.84245,40.86206,414,6,13,7,116.7
005031400,ny,-73.84553,40.86154,445,6,13,7,116.7
005031600,ny,-73.84872,40.86197,412,6,13,7,116.7
005031800,ny,-73.85157,40.86195,368,6,13,7,116.7
005031900,ny,-73.91098,40.91404,4,7,14,7,100
005032300,ny,-73.90758,40.90534,223,7,14,7,100
005032400,ny,-73.85971,40.86134,167,6,13,7,116.7
005032600,ny,-73.85548,40.86219,641,6,13,7,116.7
005032800,ny,-73.86313,40.86174,268,6,13,7,116.7
005033000,ny,-73.86603,40.86166,213,6,13,7,116.7
005033201,ny,-73.86923,40.85948,47,6,13,7,116.7
005033202,ny,-73.86894,40.86338,96,6,13,7,116.7
005033400,ny,-73.87549,40.85783,12,6,13,7,116.7
005033500,ny,-73.9052,40.8943,302,6,14,8,133.3
005033601,ny,-73.86889,40.86757,29,6,13,7,116.7
005033602,ny,-73.86888,40.87058,89,6,13,7,116.7
005033700,ny,-73.90252,40.90631,589,7,14,7,100
005033801,ny,-73.86585,40.86757,256,6,13,7,116.7
005033802,ny,-73.86574,40.87055,76,6,13,7,116.7
005034000,ny,-73.86292,40.86844,293,6,13,7,116.7
005034200,ny,-73.86003,40.86842,269,6,13,7,116.7
005034300,ny,-73.89817,40.90967,228,7,14,7,100
005034400,ny,-73.85713,40.86836,347,6,13,7,116.7
005034500,ny,-73.89869,40.90406,407,7,14,7,100
005034800,ny,-73.85307,40.86945,779,6,13,7,116.7
005035000,ny,-73.84826,40.86852,393,6,13,7,116.7
005035100,ny,-73.9,40.89507,265,6,14,8,133.3
005035600,ny,-73.836,40.86696,432,6,13,7,116.7
005035800,ny,-73.8426,40.87398,1386,6,13,7,116.7
005035900,ny,-73.88338,40.84021,64,6,13,7,116.7
005036000,ny,-73.84312,40.86684,538,6,13,7,116.7
005036100,ny,-73.87958,40.84226,92,6,13,7,116.7
005036300,ny,-73.88276,40.84454,270,6,13,7,116.7
005036400,ny,-73.84921,40.87362,501,6,13,7,116.7
005036501,ny,-73.88578,40.84541,124,6,13,7,116.7
005036502,ny,-73.88783,40.84239,152,6,13,7,116.7
005036700,ny,-73.88931,40.84076,155,6,13,7,116.7
005036800,ny,-73.85594,40.87531,334,6,13,7,116.7
005036901,ny,-73.89188,40.84436,101,6,14,8,133.3
005036902,ny,-73.89292,40.84256,61,6,14,8,133.3
005037000,ny,-73.85902,40.87309,419,6,13,7,116.7
005037100,ny,-73.88738,40.84722,334,6,13,7,116.7
005037200,ny,-73.86328,40.8738,253,6,13,7,116.7
005037300,ny,-73.89014,40.84867,302,6,13,7,116.7
005037400,ny,-73.86667,40.87454,176,6,13,7,116.7
005037504,ny,-73.89267,40.85031,158,6,14,8,133.3
005037600,ny,-73.8692,40.87454,200,6,13,7,116.7
005037800,ny,-73.86661,40.87978,196,6,13,7,116.7
005037900,ny,-73.89878,40.85157,195,6,14,8,133.3
005038000,ny,-73.86242,40.87809,404,6,13,7,116.7
005038100,ny,-73.90116,40.85201,178,6,14,8,133.3
005038200,ny,-73.85474,40.87731,434,6,13,7,116.7
005038301,ny,-73.89852,40.85721,124,6,14,8,133.3
005038303,ny,-73.89616,40.85684,33,6,14,8,133.3
005038304,ny,-73.89373,40.85813,88,6,14,8,133.3
005038500,ny,-73.89251,40.85618,287,6,14,8,133.3
005038600,ny,-73.8484,40.87964,750,6,13,7,116.7
005038700,ny,-73.88925,40.85799,202,6,13,7,116.7
005038800,ny,-73.85537,40.8796,442,6,13,7,116.7
005038900,ny,-73.885,40.8564,356,6,13,7,116.7
005039000,ny,-73.86076,40.88124,438,6,13,7,116.7
005039100,ny,-73.88712,40.85312,374,6,13,7,116.7
005039200,ny,-73.86474,40.88329,180,6,13,7,116.7
005039300,ny,-73.88314,40.8525,194,6,13,7,116.7
005039400,ny,-73.8634,40.88648,248,6,13,7,116.7
005039500,ny,-73.89668,40.8482,448,6,14,8,133.3
005039600,ny,-73.85896,40.88442,549,6,13,7,116.7
005039700,ny,-73.88543,40.86184,114,6,13,7,116.7
005039800,ny,-73.85347,40.8827,527,6,13,7,116.7
005039901,ny,-73.89364,40.86351,172,6,13,7,116.7
005039902,ny,-73.89476,40.86042,135,6,14,8,133.3
005040100,ny,-73.89765,40.86461,85,6,14,8,133.3
005040302,ny,-73.8922,40.86785,34,6,13,7,116.7
005040303,ny,-73.89347,40.86968,120,6,14,8,133.3
005040304,ny,-73.89519,40.86767,50,6,14,8,133.3
005040400,ny,-73.85135,40.88617,555,6,13,7,116.7
005040501,ny,-73.89093,40.86713,146,6,13,7,116.7
005040502,ny,-73.88896,40.86588,231,6,13,7,116.7
005040600,ny,-73.85701,40.88795,465,6,13,7,116.7
005040701,ny,-73.89026,40.87158,48,6,13,7,116.7
005040702,ny,-73.887,40.86914,198,6,13,7,116.7
005040800,ny,-73.86171,40.88974,236,6,13,7,116.7
005040900,ny,-73.89315,40.87679,45,6,13,7,116.7
005041100,ny,-73.88714,40.87558,109,6,13,7,116.7
005041300,ny,-73.8852,40.87409,204,6,13,7,116.7
005041400,ny,-73.85409,40.90354,762,6,13,7,116.7
005041500,ny,-73.88355,40.87011,157,6,13,7,116.7
005041800,ny,-73.85846,40.89712,348,6,13,7,116.7
005041900,ny,-73.88168,40.87686,195,6,13,7,116.7
005042000,ny,-73.85986,40.89303,191,6,13,7,116.7
005042100,ny,-73.88273,40.88146,77,6,13,7,116.7
005042200,ny,-73.85528,40.8911,371,6,13,7,116.7
005042300,ny,-73.87732,40.87707,123,6,13,7,116.7
005042400,ny,-73.84954,40.88928,452,6,13,7,116.7
005042500,ny,-73.87909,40.87105,261,6,13,7,116.7
005042600,ny,-73.84193,40.89084,1277,6,13,7,116.7
005042800,ny,-73.8457,40.89451,437,6,13,7,116.7
005042901,ny,-73.87429,40.87495,124,6,13,7,116.7
005042902,ny,-73.87391,40.87712,153,6,13,7,116.7
005043000,ny,-73.85066,40.89346,540,6,13,7,116.7
005043101,ny,-73.87899,40.88373,80,6,13,7,116.7
005043102,ny,-73.87447,40.88025,87,6,13,7,116.7
005043400,ny,-73.85234,40.89821,467,6,13,7,116.7
005043501,ny,-73.86648,40.88664,13,6,13,7,116.7
005043502,ny,-73.87258,40.88954,4,6,13,7,116.7
005043503,ny,-73.88659,40.897,4,6,13,7,116.7
005043600,ny,-73.84976,40.89728,405,6,13,7,116.7
005044200,ny,-73.8462,40.90387,508,6,13,7,116.7
005044400,ny,-73.84373,40.8995,706,6,13,7,116.7
005044800,ny,-73.84131,40.89547,443,6,13,7,116.7
005044901,ny,-73.87339,40.8975,322,6,13,7,116.7
005044902,ny,-73.86899,40.89883,350,6,13,7,116.7
005045101,ny,-73.86431,40.89745,215,6,13,7,116.7
005045102,ny,-73.86415,40.90037,313,6,13,7,116.7
005045600,ny,-73.82137,40.88874,723,6,13,7,116.7
005045800,ny,-73.8452,40.88586,2,6,13,7,116.7
005046000,ny,-73.84265,40.88244,271,6,13,7,116.7
005046203,ny,-73.82478,40.87927,103,6,13,7,116.7
005046204,ny,-73.82612,40.87298,1,6,13,7,116.7
005046205,ny,-73.82908,40.86892,37,6,13,7,116.7
005046206,ny,-73.82785,40.87545,1,6,13,7,116.7
005046207,ny,-73.83165,40.87732,1,6,13,7,116.7
005046208,ny,-73.83697,40.87502,767,6,13,7,116.7
005046209,ny,-73.83089,40.88308,299,6,13,7,116.7
005048401,ny,-73.83316,40.88608,771,6,13,7,116.7
005048402,ny,-73.83851,40.88689,2,6,13,7,116.7
005050400,ny,-73.79088,40.86794,18,5,12,7,140
005051601,ny,-73.78606,40.84371,1477,5,11,6,120
005051602,ny,-73.76889,40.85169,3,5,11,6,120
007000100,ny,-75.94132,42.10729,861,1,3,2,200
007000200,ny,-75.93167,42.11045,1232,1,4,3,300
007000300,ny,-75.92054,42.11704,838,1,4,3,300
007000400,ny,-75.89906,42.11816,774,2,4,2,100
007000500,ny,-75.90365,42.10834,564,1,3,2,200
007000600,ny,-75.89026,42.1137,766,1,4,3,300
007000700,ny,-75.87176,42.10925,1483,1,3,2,200
007000900,ny,-75.88892,42.09928,692,1,3,2,200
007001100,ny,-75.9055,42.09847,357,1,3,2,200
007001200,ny,-75.91049,42.1007,333,1,3,2,200
007001300,ny,-75.92457,42.10311,555,1,3,2,200
007001401,ny,-75.92149,42.09727,456,1,3,2,200
007001402,ny,-75.92623,42.09417,846,1,3,2,200
007001500,ny,-75.93989,42.09714,1829,1,3,2,200
007001600,ny,-75.92799,42.08334,1085,1,3,2,200
007001700,ny,-75.90876,42.08181,1715,1,3,2,200
007001800,ny,-75.89025,42.09292,1510,1,3,2,200
007010200,ny,-76.03128,42.2,2834,1,3,2,200
007011901,ny,-75.92056,42.3678,1605,1,3,2,200
007011902,ny,-75.91266,42.28019,1703,1,3,2,200
007011903,ny,-76.05336,42.36194,1477,1,3,2,200
007012000,ny,-76.0284,42.28185,824,1,3,2,200
007012101,ny,-75.87536,42.20864,1776,1,4,3,300
007012102,ny,-75.85513,42.1753,1878,1,3,2,200
007012103,ny,-75.92676,42.19026,1673,1,4,3,300
007012201,ny,-75.86212,42.15404,1260,1,3,2,200
007012202,ny,-75.79251,42.20758,1866,1,3,2,200
007012300,ny,-75.66273,42.17425,2903,1,3,2,200
007012400,ny,-75.48201,42.09156,2613,1,2,1,100
007012501,ny,-75.6407,42.05086,2421,1,2,1,100
007012502,ny,-75.70811,42.09595,1735,1,2,1,100
007012600,ny,-75.80345,42.08907,2878,1,3,2,200
007012701,ny,-75.83413,42.03967,2836,1,4,3,300
007012702,ny,-75.91201,42.042,2859,1,3,2,200
007012800,ny,-75.90974,42.13013,2221,1,4,3,300
007012900,ny,-75.97787,42.14918,621,1,4,3,300
007013000,ny,-75.99987,42.12352,2025,2,5,3,150
007013100,ny,-76.02668,42.10526,1289,1,4,3,300
007013201,ny,-76.02796,42.1132,997,2,5,3,150
007013202,ny,-76.03048,42.12278,1270,2,5,3,150
007013301,ny,-76.09212,42.09977,2112,2,5,3,150
007013303,ny,-76.08037,42.13672,1311,2,5,3,150
007013304,ny,-76.04286,42.13278,2712,2,5,3,150
007013400,ny,-76.05161,42.11033,1791,2,5,3,150
007013500,ny,-76.04713,42.10277,700,1,3,2,200
007013600,ny,-76.0642,42.09901,1186,1,4,3,300
007013700,ny,-76.07661,42.08729,911,1,4,3,300
007013800,ny,-75.95341,42.12198,1498,2,4,2,100
007013900,ny,-75.95917,42.11414,729,2,4,2,100
007014000,ny,-75.95759,42.10984,832,1,4,3,300
007014100,ny,-75.95916,42.10311,1378,1,3,2,200
007014200,ny,-75.96669,42.13216,1389,2,5,3,150
007014301,ny,-75.9989,42.08411,2011,1,3,2,200
007014302,ny,-75.96607,42.08264,846,1,3,2,200
007014400,ny,-76.03467,42.08403,2400,1,3,2,200
007014500,ny,-76.07883,42.06503,1546,1,4,3,300
007014600,ny,-76.02583,42.02928,2447,1,3,2,200
009940000,ny,-79.00546,42.51092,2,1,4,3,300
009940200,ny,-78.3129,42.23169,1,0,1,1,NA
009940301,ny,-78.84636,42.09571,1084,0,1,1,NA
009940302,ny,-78.64895,42.11293,1516,0,1,1,NA
009960100,ny,-78.38827,42.45212,2268,0,1,1,NA
009960200,ny,-78.50103,42.46013,2139,0,1,1,NA
009960300,ny,-78.69518,42.42453,3705,0,1,1,NA
009960400,ny,-78.98344,42.45045,2367,1,3,2,200
009960500,ny,-78.96829,42.32441,2819,0,1,1,NA
009960600,ny,-78.82649,42.2328,2613,0,1,1,NA
009960703,ny,-78.71202,42.24746,1767,0,1,1,NA
009960704,ny,-78.65394,42.3111,2525,0,1,1,NA
009960800,ny,-78.50016,42.33381,3350,0,1,1,NA
009961000,ny,-78.40391,42.14308,2868,0,1,1,NA
009961100,ny,-78.57783,42.14882,2265,0,1,1,NA
009961200,ny,-78.3763,42.04052,2088,0,1,1,NA
009961301,ny,-78.70471,42.05216,1724,0,1,1,NA
009961302,ny,-78.4712,42.04771,640,0,1,1,NA
009961400,ny,-78.98292,42.12784,3817,0,1,1,NA
009961500,ny,-78.43461,42.0947,1162,0,1,1,NA
009961600,ny,-78.4515,42.07722,1647,0,1,1,NA
009961700,ny,-78.4359,42.08286,1430,0,1,1,NA
009961800,ny,-78.41936,42.07552,2187,0,1,1,NA
009962200,ny,-78.43352,42.24828,2668,0,1,1,NA
011040101,ny,-76.65387,43.20785,919,3,7,4,133.3
011040102,ny,-76.65817,43.31664,2470,2,6,4,200
011040201,ny,-76.53565,43.12594,1808,3,8,5,166.7
011040202,ny,-76.53927,43.21347,1234,2,6,4,200
011040300,ny,-76.64404,43.09391,2289,3,8,5,166.7
011040400,ny,-76.54545,43.04562,1758,3,8,5,166.7
011040500,ny,-76.65602,42.99689,1667,3,8,5,166.7
011040600,ny,-76.51201,42.97238,1847,2,6,4,200
011040700,ny,-76.49402,42.88833,2037,2,6,4,200
011040800,ny,-76.41115,42.7823,2678,1,3,2,200
011040900,ny,-76.34804,42.68869,2314,1,3,2,200
011041001,ny,-76.55589,42.68549,2235,2,4,2,100
011041002,ny,-76.67739,42.74696,1220,3,7,4,133.3
011041101,ny,-76.57784,42.87001,1399,2,6,4,200
011041102,ny,-76.56141,42.79481,1057,1,4,3,300
011041201,ny,-76.67876,42.85343,1277,3,8,5,166.7
011041202,ny,-76.66931,42.92766,1448,3,8,5,166.7
011041300,ny,-76.58281,42.94486,1451,3,7,4,133.3
011041400,ny,-76.55401,42.9464,1545,3,7,4,133.3
011041500,ny,-76.54954,42.93618,1091,3,7,4,133.3
011041600,ny,-76.54656,42.93029,975,3,7,4,133.3
011041700,ny,-76.5567,42.91934,1558,3,7,4,133.3
011041800,ny,-76.5775,42.91824,1460,3,7,4,133.3
011042100,ny,-76.58307,42.92897,976,3,7,4,133.3
013030100,ny,-79.21951,42.11222,1848,1,2,1,100
013030200,ny,-79.23526,42.11053,1582,1,2,1,100
013030300,ny,-79.25311,42.10834,1436,1,2,1,100
013030400,ny,-79.25931,42.09346,2102,1,2,1,100
013030500,ny,-79.24054,42.09449,1280,1,2,1,100
013030600,ny,-79.21834,42.09621,2077,1,2,1,100
013030700,ny,-79.22358,42.08226,2312,1,2,1,100
013030800,ny,-79.25181,42.08216,2001,1,2,1,100
013035100,ny,-79.14722,42.54548,3170,1,4,3,300
013035300,ny,-79.23548,42.49049,2165,1,3,2,200
013035400,ny,-79.31773,42.48144,1341,2,5,3,150
013035500,ny,-79.32363,42.49905,1434,2,5,3,150
013035600,ny,-79.34908,42.48435,1883,2,5,3,150
013035700,ny,-79.33036,42.46901,1433,2,5,3,150
013035800,ny,-79.3188,42.44217,1720,1,4,3,300
013035901,ny,-79.34456,42.43458,1944,1,4,3,300
013035902,ny,-79.33968,42.45238,101,2,5,3,150
013036000,ny,-79.35418,42.41111,3444,1,3,2,200
013036100,ny,-79.17798,42.34796,4162,0,1,1,NA
013036300,ny,-79.467,42.37424,2933,1,3,2,200
013036401,ny,-79.5216,42.21729,3863,1,2,1,100
013036402,ny,-79.39717,42.29242,3868,0,2,2,NA
013036500,ny,-79.59408,42.2842,3713,1,3,2,200
013036600,ny,-79.70081,42.19156,3596,0,1,1,NA
013036700,ny,-79.6251,42.07161,3138,0,1,1,NA
013036801,ny,-79.40797,42.08675,2407,1,2,1,100
013036802,ny,-79.47742,42.08314,1570,0,1,1,NA
013036901,ny,-79.29377,42.21542,2174,0,1,1,NA
013036902,ny,-79.35442,42.15796,2999,1,2,1,100
013037000,ny,-79.31081,42.04151,2283,0,2,2,NA
013037100,ny,-79.33421,42.10249,3918,0,1,1,NA
013037200,ny,-79.28147,42.09511,3192,0,1,1,NA
013037300,ny,-79.23064,42.13786,3636,1,2,1,100
013037400,ny,-79.11927,42.17354,2573,1,2,1,100
013037500,ny,-79.14498,42.04168,3107,1,2,1,100
013037600,ny,-79.11887,42.48565,1777,1,2,1,100
015000100,ny,-76.80346,42.1073,1312,3,7,4,133.3
015000200,ny,-76.82004,42.10764,1028,4,8,4,100
015000300,ny,-76.83235,42.11285,6,3,8,5,166.7
015000400,ny,-76.83015,42.10113,896,4,8,4,100
015000500,ny,-76.82388,42.08702,1074,4,8,4,100
015000600,ny,-76.81492,42.09241,856,4,8,4,100
015000700,ny,-76.79817,42.09194,769,3,7,4,133.3
015000900,ny,-76.79224,42.07921,1412,3,7,4,133.3
015001000,ny,-76.80633,42.08089,896,3,8,5,166.7
015001100,ny,-76.81176,42.07347,1452,3,8,5,166.7
015010100,ny,-76.62734,42.19773,2432,1,4,3,300
015010200,ny,-76.84702,42.24584,3234,2,5,3,150
015010301,ny,-76.91753,42.17332,1993,2,6,4,200
015010302,ny,-76.91113,42.11326,1837,2,5,3,150
015010400,ny,-76.83777,42.1733,1422,3,7,4,133.3
015010500,ny,-76.8245,42.16739,1136,3,7,4,133.3
015010600,ny,-76.84391,42.13841,1546,3,7,4,133.3
015010701,ny,-76.84459,42.18632,1114,3,6,3,100
015010702,ny,-76.76993,42.16337,2065,2,5,3,150
015010800,ny,-76.81844,42.13487,1890,3,7,4,133.3
015010900,ny,-76.84834,42.09592,2504,3,7,4,133.3
015011000,ny,-76.65574,42.07094,2507,2,5,3,150
015011101,ny,-76.78529,42.06392,1579,2,6,4,200
015011102,ny,-76.83666,42.06456,2123,2,6,4,200
015011200,ny,-76.85185,42.033,2303,2,4,2,100
017970101,ny,-75.55641,42.67827,1842,1,4,3,300
017970102,ny,-75.40848,42.70788,1590,1,4,3,300
017970201,ny,-75.7445,42.5562,2475,1,2,1,100
017970202,ny,-75.75045,42.67011,2290,1,3,2,200
017970300,ny,-75.52719,42.53303,1510,1,4,3,300
017970400,ny,-75.51683,42.53372,1042,1,4,3,300
017970501,ny,-75.42284,42.63373,1446,1,3,2,200
017970502,ny,-75.42195,42.55286,2077,1,3,2,200
017970601,ny,-75.55631,42.53576,2116,1,3,2,200
017970602,ny,-75.49271,42.42804,2604,1,3,2,200
017970700,ny,-75.72971,42.46228,1793,1,3,2,200
017970801,ny,-75.51815,42.34328,2511,1,3,2,200
017970802,ny,-75.74079,42.37942,2230,1,4,3,300
017970901,ny,-75.49924,42.24816,1880,1,3,2,200
017970902,ny,-75.59147,42.25114,1365,1,3,2,200
017971000,ny,-75.7513,42.29037,2094,1,3,2,200
019100101,ny,-73.46667,44.96318,1589,1,3,2,200
019100102,ny,-73.38325,44.95331,1667,1,4,3,300
019100200,ny,-73.45896,44.86163,2367,1,4,3,300
019100600,ny,-73.49971,44.77193,2835,1,4,3,300
019100700,ny,-73.5961,44.71247,1647,1,4,3,300
019100800,ny,-73.43521,44.71602,2374,1,4,3,300
019100901,ny,-73.46042,44.70581,850,1,5,4,400
019100902,ny,-73.44271,44.71156,678,1,5,4,400
019101000,ny,-73.47486,44.69338,1441,1,4,3,300
019101600,ny,-73.50434,44.68363,500,1,4,3,300
019101901,ny,-73.55571,44.58772,2113,2,5,3,150
019101902,ny,-73.47341,44.5851,669,2,6,4,200
019102100,ny,-73.43922,44.65176,920,2,5,3,150
019102200,ny,-73.46219,44.68009,712,1,5,4,400
019102800,ny,-73.50035,44.53726,1811,2,5,3,150
019103000,ny,-73.46661,44.69112,3,1,5,4,400
019103100,ny,-73.45736,44.69427,627,1,5,4,400
019103200,ny,-73.44411,44.68692,717,1,5,4,400
019103512,ny,-73.86459,44.84139,4057,1,2,1,100
019103800,ny,-73.7867,44.57675,4133,1,3,2,200
019103900,ny,-73.58984,44.65624,2317,1,4,3,300
019104200,ny,-73.65175,44.91346,3895,1,3,2,200
021000100,ny,-73.43835,42.46904,1498,1,3,2,200
021000200,ny,-73.45909,42.39499,1468,1,3,2,200
021000300,ny,-73.58101,42.42493,2582,2,6,4,200
021000401,ny,-73.67961,42.38048,1274,3,9,6,200
021000402,ny,-73.68478,42.44004,2650,3,9,6,200
021000500,ny,-73.7524,42.40433,1071,5,11,6,120
021000600,ny,-73.75378,42.31813,1233,5,12,7,140
021000700,ny,-73.65086,42.31193,2627,3,8,5,166.7
021000800,ny,-73.50762,42.31239,1508,1,3,2,200
021000900,ny,-73.5325,42.22442,1679,1,4,3,300
021001000,ny,-73.68725,42.2235,3194,3,8,5,166.7
021001100,ny,-73.79352,42.22765,1841,5,12,7,140
021001200,ny,-73.7825,42.25676,1038,5,12,7,140
021001300,ny,-73.78821,42.24794,1259,5,12,7,140
021001400,ny,-73.79545,42.14047,1905,4,10,6,150
021001500,ny,-73.67337,42.13328,1273,2,7,5,250
021001600,ny,-73.55121,42.12857,2951,2,5,3,150
021001700,ny,-73.58221,42.0352,1259,2,6,4,200
021001800,ny,-73.7103,42.05108,1363,3,7,4,133.3
021001900,ny,-73.85604,42.08476,964,5,11,6,120
021002000,ny,-73.87353,42.13406,1152,6,13,7,116.7
023970100,ny,-75.97919,42.67315,2716,1,3,2,200
023970201,ny,-76.17505,42.73923,1613,1,2,1,100
023970202,ny,-76.16954,42.66675,1737,1,4,3,300
023970300,ny,-76.18425,42.63934,1254,2,5,3,150
023970400,ny,-76.11975,42.58805,1580,1,3,2,200
023970500,ny,-76.17039,42.6079,1175,1,4,3,300
023970600,ny,-76.17355,42.59937,831,1,3,2,200
023970700,ny,-76.1922,42.60489,1600,1,4,3,300
023970800,ny,-76.19367,42.59509,94,1,3,2,200
023970900,ny,-76.17561,42.5917,1238,1,3,2,200
023971000,ny,-76.22538,42.59089,2368,1,4,3,300
023971100,ny,-75.96636,42.48695,3212,1,3,2,200
023971200,ny,-76.16171,42.47996,2647,1,3,2,200
025970101,ny,-74.69979,42.45177,1380,0,1,1,NA
025970102,ny,-74.90213,42.45493,2020,0,2,2,NA
025970200,ny,-74.8601,42.37855,2954,0,1,1,NA
025970300,ny,-75.11118,42.33351,2156,0,2,2,NA
025970401,ny,-75.27051,42.30737,1478,1,2,1,100
025970402,ny,-75.39823,42.30567,1673,1,2,1,100
025970501,ny,-75.29859,42.08736,2414,1,2,1,100
025970502,ny,-75.32873,42.20697,1813,0,2,2,NA
025970601,ny,-75.10672,42.12558,1442,0,1,1,NA
025970602,ny,-75.13786,42.19891,2052,0,2,2,NA
025970700,ny,-74.85786,42.15507,3769,0,1,1,NA
025970800,ny,-74.90941,42.27394,2169,0,1,1,NA
025970900,ny,-74.92654,42.27211,6,0,1,1,NA
025971000,ny,-74.70608,42.31058,2851,0,0,0,NA
025971100,ny,-74.55059,42.29811,3227,0,1,1,NA
025971200,ny,-74.62548,42.16074,4330,0,1,1,NA
025971300,ny,-74.95852,42.04175,2953,0,1,1,NA
025971400,ny,-75.16318,41.95729,4167,1,2,1,100
027010000,ny,-73.55338,41.82421,2067,3,7,4,133.3
027020003,ny,-73.73295,41.62473,1705,4,11,7,175
027020004,ny,-73.66249,41.62336,1070,3,8,5,166.7
027020005,ny,-73.69337,41.58343,2250,3,9,6,200
027030000,ny,-73.81702,41.86248,2339,4,10,6,150
027040001,ny,-73.56331,41.71424,1700,3,8,5,166.7
027040003,ny,-73.58539,41.65104,1585,3,8,5,166.7
027050102,ny,-73.83714,41.58124,1566,6,14,8,133.3
027050103,ny,-73.80752,41.60926,2312,5,12,7,140
027050104,ny,-73.76488,41.59128,2426,5,12,7,140
027050203,ny,-73.81178,41.5525,2097,5,12,7,140
027050204,ny,-73.82014,41.5165,1115,4,10,6,150
027050205,ny,-73.73824,41.53515,2161,3,8,5,166.7
027060100,ny,-73.96919,41.53257,1013,7,15,8,114.3
027060201,ny,-73.92035,41.53796,1478,6,14,8,133.3
027060202,ny,-73.95254,41.49073,1758,6,13,7,116.7
027060301,ny,-73.87354,41.54904,1593,6,13,7,116.7
027060302,ny,-73.87449,41.51724,1327,6,13,7,116.7
027060400,ny,-73.89422,41.53368,762,6,14,8,133.3
027070101,ny,-73.9208,41.83704,2148,5,12,7,140
027070102,ny,-73.88631,41.81392,1197,4,11,7,175
027070201,ny,-73.93156,41.77509,1063,5,12,7,140
027070301,ny,-73.88116,41.76436,2170,5,12,7,140
027070401,ny,-73.91773,41.7487,1168,5,12,7,140
027080103,ny,-73.82072,41.69745,2135,5,11,6,120
027080104,ny,-73.76476,41.67963,1553,4,10,6,150
027080201,ny,-73.85578,41.66018,1833,5,12,7,140
027080202,ny,-73.81049,41.65162,1128,5,12,7,140
027090000,ny,-73.77549,41.97458,1778,3,8,5,166.7
027100000,ny,-73.54162,41.94459,1815,2,5,3,150
027110003,ny,-73.63378,41.56275,2080,3,9,6,200
027110004,ny,-73.55886,41.56987,1188,3,7,4,133.3
027110005,ny,-73.59883,41.56348,755,3,9,6,200
027120000,ny,-73.65161,41.96929,1662,3,7,4,133.3
027130003,ny,-73.79309,41.74519,1607,4,11,7,175
027130004,ny,-73.83674,41.78932,793,5,11,6,120
027130005,ny,-73.79078,41.78192,1075,4,10,6,150
027140101,ny,-73.92114,41.72651,1365,5,12,7,140
027140201,ny,-73.86554,41.70314,800,5,12,7,140
027140202,ny,-73.87492,41.72166,1513,5,12,7,140
027140301,ny,-73.89516,41.70505,663,5,12,7,140
027140302,ny,-73.9017,41.69381,829,6,13,7,116.7
027140400,ny,-73.90153,41.65876,1905,6,13,7,116.7
027140500,ny,-73.93427,41.66665,788,6,13,7,116.7
027140602,ny,-73.93782,41.63444,984,7,14,7,100
027140700,ny,-73.89888,41.63471,2427,6,14,8,133.3
027140801,ny,-73.93588,41.60763,886,7,15,8,114.3
027150003,ny,-73.9182,42.0293,791,6,13,7,116.7
027150004,ny,-73.88007,42.02559,1549,5,11,6,120
027150005,ny,-73.84161,42.00387,1217,4,10,6,150
027150006,ny,-73.87693,41.99591,779,4,11,7,175
027160003,ny,-73.91685,41.93471,1445,5,12,7,140
027160004,ny,-73.86865,41.91678,1174,4,9,5,125
027160005,ny,-73.90806,41.92941,1235,5,11,6,120
027170000,ny,-73.69175,41.88844,2179,3,8,5,166.7
027180001,ny,-73.68526,41.69046,1991,3,8,5,166.7
027190101,ny,-73.85925,41.60542,1386,6,14,8,133.3
027190102,ny,-73.84975,41.62782,567,6,13,7,116.7
027190203,ny,-73.89206,41.60776,1052,6,14,8,133.3
027190204,ny,-73.88022,41.5855,2050,6,14,8,133.3
027190301,ny,-73.95244,41.56485,989,7,15,8,114.3
027190401,ny,-73.9219,41.56658,954,6,14,8,133.3
027190402,ny,-73.88107,41.56545,1429,6,13,7,116.7
027200001,ny,-73.67336,41.79183,1743,3,7,4,133.3
027200002,ny,-73.69369,41.78423,703,3,7,4,133.3
027210101,ny,-73.96652,41.51182,1597,6,13,7,116.7
027210201,ny,-73.97785,41.49735,1334,7,14,7,100
027210301,ny,-73.95606,41.4987,1611,5,12,7,140
027220101,ny,-73.93312,41.70911,785,6,13,7,116.7
027220102,ny,-73.94093,41.70837,84,6,13,7,116.7
027220201,ny,-73.92386,41.71051,834,5,13,8,160
027220300,ny,-73.91218,41.70832,1019,5,13,8,160
027220700,ny,-73.93829,41.69453,480,6,13,7,116.7
027220801,ny,-73.92561,41.6907,1069,6,13,7,116.7
027220901,ny,-73.91383,41.69271,1266,6,13,7,116.7
027221001,ny,-73.90763,41.67795,1892,6,13,7,116.7
027221100,ny,-73.91844,41.70038,812,5,13,8,160
027300000,ny,-73.91795,41.59863,1556,6,14,8,133.3
027410000,ny,-73.88522,41.68281,462,5,12,7,140
027610000,ny,-73.72096,41.58107,17,3,8,5,166.7
027640001,ny,-73.94571,41.53204,3,7,15,8,114.3
027640002,ny,-73.95121,41.52144,16,5,12,7,140
029000110,ny,-78.84524,42.84428,1395,1,3,2,200
029000200,ny,-78.82791,42.85284,1526,1,3,2,200
029000500,ny,-78.86927,42.86438,1122,1,2,1,100
029000600,ny,-78.81845,42.83772,1778,1,3,2,200
029000700,ny,-78.80722,42.83715,1342,1,3,2,200
029000800,ny,-78.81713,42.84763,1587,1,3,2,200
029000900,ny,-78.81652,42.85391,726,1,3,2,200
029001000,ny,-78.80517,42.85098,1812,1,3,2,200
029001100,ny,-78.81498,42.86288,1102,1,3,2,200
029001403,ny,-78.86154,42.88231,212,1,2,1,100
029001404,ny,-78.85857,42.88591,423,1,2,1,100
029001500,ny,-78.84849,42.88547,1550,1,3,2,200
029001601,ny,-78.82696,42.88898,640,1,3,2,200
029001602,ny,-78.83955,42.88918,1031,1,3,2,200
029001700,ny,-78.83524,42.88139,944,1,3,2,200
029001900,ny,-78.80948,42.8686,1302,1,3,2,200
029002300,ny,-78.80796,42.88725,1131,1,3,2,200
029002400,ny,-78.81128,42.8936,1886,1,3,2,200
029002502,ny,-78.86183,42.89283,989,1,2,1,100
029002703,ny,-78.83709,42.8988,587,1,3,2,200
029002704,ny,-78.83194,42.89879,823,1,3,2,200
029002801,ny,-78.82105,42.89796,893,1,3,2,200
029002802,ny,-78.82072,42.90197,788,1,3,2,200
029002900,ny,-78.81986,42.90663,1330,1,3,2,200
029003000,ny,-78.80593,42.90355,957,1,3,2,200
029003100,ny,-78.85796,42.90041,1546,1,3,2,200
029003301,ny,-78.84876,42.91838,1175,1,3,2,200
029003302,ny,-78.84896,42.90945,1478,1,3,2,200
029003400,ny,-78.83381,42.9176,1538,1,3,2,200
029003501,ny,-78.82949,42.90882,785,1,3,2,200
029003502,ny,-78.83911,42.90871,1046,1,3,2,200
029003600,ny,-78.81907,42.91638,1566,1,3,2,200
029003700,ny,-78.80905,42.91559,1726,1,3,2,200
029003800,ny,-78.80183,42.91681,1043,1,3,2,200
029003901,ny,-78.82661,42.93337,413,1,3,2,200
029004002,ny,-78.84028,42.93241,625,1,3,2,200
029004003,ny,-78.83388,42.93542,1178,1,3,2,200
029004100,ny,-78.80923,42.92591,1732,1,3,2,200
029004200,ny,-78.81865,42.93525,1473,1,3,2,200
029004300,ny,-78.80717,42.94476,2171,1,3,2,200
029004401,ny,-78.80513,42.9372,1353,1,3,2,200
029004402,ny,-78.80667,42.93087,222,1,3,2,200
029004500,ny,-78.83735,42.94782,1743,1,3,2,200
029004601,ny,-78.82876,42.95549,1189,1,3,2,200
029004701,ny,-78.81774,42.94323,830,1,3,2,200
029004702,ny,-78.8241,42.9468,1129,1,3,2,200
029004800,ny,-78.84884,42.94872,1279,1,3,2,200
029004901,ny,-78.86012,42.94577,374,1,3,2,200
029004902,ny,-78.85998,42.95029,1265,1,3,2,200
029005000,ny,-78.87335,42.95113,901,1,3,2,200
029005100,ny,-78.85848,42.95566,1521,1,3,2,200
029005201,ny,-78.84691,42.93517,908,1,3,2,200
029005202,ny,-78.84877,42.92462,704,1,3,2,200
029005300,ny,-78.85854,42.9313,239,1,3,2,200
029005400,ny,-78.86772,42.93943,1141,1,3,2,200
029005500,ny,-78.88894,42.93888,1184,1,3,2,200
029005600,ny,-78.88661,42.95117,1208,1,3,2,200
029005700,ny,-78.89925,42.94972,848,1,3,2,200
029005801,ny,-78.90046,42.96115,1065,1,3,2,200
029005802,ny,-78.90664,42.95215,1423,1,3,2,200
029005900,ny,-78.90346,42.93825,1196,1,2,1,100
029006100,ny,-78.89683,42.91726,1358,1,2,1,100
029006301,ny,-78.88224,42.92401,1203,1,2,1,100
029006302,ny,-78.87248,42.927,813,1,2,1,100
029006501,ny,-78.88257,42.91784,802,1,2,1,100
029006601,ny,-78.88228,42.91347,679,1,2,1,100
029006602,ny,-78.87114,42.91338,399,1,2,1,100
029006701,ny,-78.88076,42.90748,694,1,2,1,100
029006702,ny,-78.87225,42.90698,442,1,2,1,100
029006801,ny,-78.87282,42.89764,290,1,2,1,100
029006802,ny,-78.87843,42.8992,771,1,2,1,100
029006901,ny,-78.89183,42.91039,1000,1,2,1,100
029006903,ny,-78.88501,42.90521,410,1,2,1,100
029006904,ny,-78.88847,42.90255,510,1,2,1,100
029007000,ny,-78.8994,42.90374,823,1,2,1,100
029007102,ny,-78.88269,42.88919,379,1,2,1,100
029007103,ny,-78.88988,42.89704,245,1,2,1,100
029007104,ny,-78.88654,42.89486,503,1,2,1,100
029007202,ny,-78.89156,42.88654,252,1,2,1,100
029007303,ny,-78.96661,43.04581,2314,2,4,2,100
029007304,ny,-78.92602,43.03061,2706,2,4,2,100
029007305,ny,-78.99201,43.01323,1588,1,4,3,300
029007306,ny,-78.95618,42.97594,2362,1,3,2,200
029007600,ny,-78.86324,43.00652,1432,1,4,3,300
029007700,ny,-78.88104,43.01344,1872,1,4,3,300
029007800,ny,-78.89734,43.00731,2097,1,4,3,300
029007901,ny,-78.83601,43.01886,989,1,4,3,300
029007902,ny,-78.83928,42.99666,2588,1,4,3,300
029007903,ny,-78.84485,42.98634,1503,1,4,3,300
029007904,ny,-78.83004,42.98585,1338,1,4,3,300
029007905,ny,-78.83596,43.00893,1812,1,4,3,300
029008001,ny,-78.83438,42.97554,2112,1,3,2,200
029008002,ny,-78.84769,42.96809,2200,1,3,2,200
029008003,ny,-78.83251,42.96454,2084,1,3,2,200
029008101,ny,-78.86457,42.9906,2181,1,4,3,300
029008102,ny,-78.86161,42.97516,1797,1,3,2,200
029008201,ny,-78.8787,42.98997,1035,1,4,3,300
029008202,ny,-78.8798,42.97571,1355,1,3,2,200
029008300,ny,-78.9065,42.99342,764,1,4,3,300
029008400,ny,-78.91827,42.97271,1271,1,3,2,200
029008500,ny,-78.86163,42.96043,954,1,3,2,200
029008600,ny,-78.86278,42.96625,1662,1,3,2,200
029008700,ny,-78.87456,42.96562,1734,1,3,2,200
029008800,ny,-78.88353,42.96382,1336,1,3,2,200
029008900,ny,-78.73993,42.9591,1778,1,3,2,200
029009004,ny,-78.70998,43.04446,1293,2,5,3,150
029009007,ny,-78.71756,43.01186,2711,1,3,2,200
029009008,ny,-78.71817,42.99545,956,1,3,2,200
029009009,ny,-78.73595,43.0582,1866,2,4,2,100
029009010,ny,-78.72504,43.02881,1848,2,4,2,100
029009011,ny,-78.73003,42.98472,1090,1,3,2,200
029009012,ny,-78.70928,42.98398,1275,1,3,2,200
029009104,ny,-78.75308,42.98471,1618,1,3,2,200
029009106,ny,-78.78564,43.0458,1260,2,4,2,100
029009107,ny,-78.81296,43.03831,1744,2,4,2,100
029009109,ny,-78.77746,42.988,1144,1,3,2,200
029009110,ny,-78.78446,43.00196,12,1,4,3,300
029009112,ny,-78.7785,43.01696,674,1,4,3,300
029009113,ny,-78.75274,43.01355,2321,1,4,3,300
029009114,ny,-78.7513,42.99687,1263,1,4,3,300
029009115,ny,-78.80321,43.00806,174,1,4,3,300
029009116,ny,-78.81118,43.01511,1407,1,4,3,300
029009200,ny,-78.80923,42.98983,1334,1,4,3,300
029009301,ny,-78.81867,42.96926,1658,1,3,2,200
029009302,ny,-78.80888,42.97432,1151,1,3,2,200
029009401,ny,-78.79642,42.97019,1915,1,3,2,200
029009402,ny,-78.77142,42.96857,1817,1,3,2,200
029009501,ny,-78.79606,42.95642,2028,1,3,2,200
029009503,ny,-78.7796,42.95561,985,1,3,2,200
029009504,ny,-78.7589,42.95391,1456,1,3,2,200
029009601,ny,-78.70803,42.95809,624,1,3,2,200
029009602,ny,-78.72875,42.9704,1447,1,3,2,200
029009701,ny,-78.72435,42.91591,1275,1,3,2,200
029009702,ny,-78.70492,42.91941,1871,1,3,2,200
029009800,ny,-78.71007,42.90351,789,1,3,2,200
029009900,ny,-78.7918,42.89209,1559,1,3,2,200
029010001,ny,-78.72807,42.94108,1366,1,3,2,200
029010002,ny,-78.71872,42.92897,1564,1,3,2,200
029010003,ny,-78.74567,42.92065,1502,1,3,2,200
029010101,ny,-78.77439,42.94012,2040,1,3,2,200
029010102,ny,-78.77055,42.92871,1080,1,3,2,200
029010103,ny,-78.76024,42.9409,1531,1,3,2,200
029010201,ny,-78.7871,42.94637,1143,1,3,2,200
029010202,ny,-78.79199,42.93184,1193,1,3,2,200
029010300,ny,-78.79698,42.91397,419,1,3,2,200
029010400,ny,-78.7903,42.90946,718,1,3,2,200
029010500,ny,-78.78779,42.91702,888,1,3,2,200
029010600,ny,-78.76643,42.92231,1103,1,3,2,200
029010700,ny,-78.77344,42.90951,1373,1,3,2,200
029010803,ny,-78.74173,42.90104,1007,1,3,2,200
029010804,ny,-78.71998,42.88801,1444,1,3,2,200
029010805,ny,-78.7094,42.8741,2049,1,3,2,200
029010807,ny,-78.7249,42.8658,1664,1,3,2,200
029010808,ny,-78.74683,42.87384,911,1,3,2,200
029010809,ny,-78.72988,42.87573,1276,1,3,2,200
029010901,ny,-78.77555,42.89161,1147,1,3,2,200
029010902,ny,-78.76447,42.88616,1330,1,3,2,200
029011000,ny,-78.78699,42.87678,779,1,3,2,200
029011100,ny,-78.79224,42.88042,1030,1,3,2,200
029011201,ny,-78.70363,42.85068,658,1,3,2,200
029011202,ny,-78.73863,42.85581,2416,1,3,2,200
029011300,ny,-78.78096,42.86072,1840,1,3,2,200
029011400,ny,-78.79672,42.85125,770,1,3,2,200
029011500,ny,-78.78524,42.84878,582,1,3,2,200
029011600,ny,-78.76749,42.84508,807,1,3,2,200
029011700,ny,-78.77348,42.83606,1483,1,3,2,200
029011800,ny,-78.73426,42.83743,1613,1,3,2,200
029012001,ny,-78.78658,42.82039,2169,1,3,2,200
029012002,ny,-78.76422,42.81888,1398,1,2,1,100
029012003,ny,-78.74527,42.81176,1987,1,2,1,100
029012300,ny,-78.83123,42.82107,1089,1,3,2,200
029012400,ny,-78.83032,42.81038,811,1,3,2,200
029012501,ny,-78.80747,42.82519,1627,1,3,2,200
029012502,ny,-78.80121,42.81085,764,1,2,1,100
029012800,ny,-78.8324,42.79652,1161,1,3,2,200
029012902,ny,-78.81502,42.75807,1195,1,2,1,100
029012903,ny,-78.80469,42.77999,1145,1,2,1,100
029012904,ny,-78.81166,42.79264,1639,1,3,2,200
029013001,ny,-78.84627,42.78448,1525,1,3,2,200
029013002,ny,-78.84493,42.76355,1518,1,2,1,100
029013101,ny,-78.8789,42.75127,2816,1,2,1,100
029013103,ny,-78.93682,42.71416,1738,1,3,2,200
029013104,ny,-78.91855,42.73027,2284,1,3,2,200
029013201,ny,-78.87433,42.71978,3045,1,2,1,100
029013202,ny,-78.81837,42.71732,2318,1,2,1,100
029013300,ny,-78.81903,42.71922,1381,1,2,1,100
029013400,ny,-78.84266,42.72394,2611,1,2,1,100
029013501,ny,-78.76824,42.72996,2859,0,2,2,NA
029013502,ny,-78.71809,42.73204,2822,0,1,1,NA
029013600,ny,-78.7436,42.76304,1081,0,1,1,NA
029013701,ny,-78.77147,42.78411,3083,1,2,1,100
029013702,ny,-78.72186,42.79082,2095,1,2,1,100
029013801,ny,-78.67001,42.72849,1451,0,1,1,NA
029013802,ny,-78.61936,42.74065,2607,0,1,1,NA
029013900,ny,-78.61644,42.76167,870,0,1,1,NA
029014000,ny,-78.60988,42.77307,1513,0,1,1,NA
029014101,ny,-78.60733,42.82412,2891,1,2,1,100
029014102,ny,-78.66691,42.82217,2701,1,2,1,100
029014204,ny,-78.61306,42.90415,1664,1,3,2,200
029014206,ny,-78.6295,42.87626,3032,1,3,2,200
029014207,ny,-78.68746,42.87772,2383,1,3,2,200
029014208,ny,-78.63587,42.93903,2915,1,3,2,200
029014209,ny,-78.6782,42.92537,1662,1,3,2,200
029014300,ny,-78.67156,42.89251,2510,1,3,2,200
029014400,ny,-78.66886,42.90778,1715,1,3,2,200
029014501,ny,-78.68808,42.91873,1589,1,3,2,200
029014502,ny,-78.6898,42.90271,990,1,3,2,200
029014601,ny,-78.66725,42.96581,2007,1,3,2,200
029014603,ny,-78.67076,42.9881,2012,1,3,2,200
029014605,ny,-78.67279,43.00859,1446,1,3,2,200
029014606,ny,-78.6745,43.03033,1572,1,4,3,300
029014701,ny,-78.63015,43.05081,2513,2,4,2,100
029014703,ny,-78.61673,42.99441,1892,1,3,2,200
029014704,ny,-78.60352,42.96994,1251,1,3,2,200
029014801,ny,-78.49392,43.02119,1016,1,4,3,300
029014804,ny,-78.52494,42.98895,1627,1,4,3,300
029014805,ny,-78.52222,43.05628,1125,2,5,3,150
029014901,ny,-78.49461,42.89888,871,1,3,2,200
029014903,ny,-78.52202,42.91166,2842,1,2,1,100
029015001,ny,-78.5322,42.82515,2267,0,1,1,NA
029015002,ny,-78.52128,42.73709,1484,0,1,1,NA
029015003,ny,-78.52164,42.64945,1928,0,1,1,NA
029015101,ny,-78.63853,42.65082,1861,0,1,1,NA
029015102,ny,-78.54952,42.56171,1740,0,1,1,NA
029015201,ny,-78.78083,42.64561,1492,0,1,1,NA
029015202,ny,-78.72801,42.66066,2105,0,1,1,NA
029015301,ny,-78.90838,42.65163,2175,1,2,1,100
029015302,ny,-78.84408,42.65399,1268,0,1,1,NA
029015401,ny,-78.98695,42.70108,1080,1,3,2,200
029015402,ny,-78.99657,42.67824,2461,1,3,2,200
029015501,ny,-79.02952,42.63789,950,1,4,3,300
029015503,ny,-79.00171,42.63153,1596,1,3,2,200
029015504,ny,-79.07956,42.62483,3256,1,3,2,200
029015600,ny,-79.02154,42.58905,1333,1,4,3,300
029015700,ny,-78.86381,42.57083,1975,1,2,1,100
029015800,ny,-78.70962,42.54706,2489,0,1,1,NA
029015900,ny,-78.66963,42.50837,1664,0,2,2,NA
029016200,ny,-78.81674,42.81485,907,1,3,2,200
029016300,ny,-78.83075,42.87215,1446,1,3,2,200
029016400,ny,-78.85834,42.87463,1159,1,3,2,200
029016500,ny,-78.87361,42.88417,535,1,2,1,100
029016600,ny,-78.84577,42.89618,1997,1,3,2,200
029016700,ny,-78.80795,42.87791,1085,1,3,2,200
029016801,ny,-78.86121,42.90778,1108,1,2,1,100
029016802,ny,-78.85802,42.91543,1169,1,2,1,100
029016900,ny,-78.86817,42.91887,878,1,2,1,100
029017000,ny,-78.82962,42.92552,1176,1,3,2,200
029017100,ny,-78.89549,42.92809,1359,1,2,1,100
029017200,ny,-78.86435,43.0171,1010,1,4,3,300
029017301,ny,-78.74087,42.8275,1232,1,3,2,200
029017302,ny,-78.71199,42.82368,1471,1,2,1,100
029017400,ny,-78.85431,42.81966,1239,1,3,2,200
029017501,ny,-78.92813,42.47965,705,1,4,3,300
029017502,ny,-78.85663,42.49143,1398,1,2,1,100
029940000,ny,-79.01605,42.54412,9,2,5,3,150
029940100,ny,-78.4777,43.07502,1,2,5,3,150
029980000,ny,-78.88356,42.93427,5,1,2,1,100
029980300,ny,-78.93219,42.48593,38,1,4,3,300
029980400,ny,-78.55191,42.9305,6,1,3,2,200
029980500,ny,-78.81445,42.95439,7,1,3,2,200
029990000,ny,-79.07157,42.72278,2,1,2,1,100
031960100,ny,-73.47497,44.45673,2095,1,4,3,300
031960200,ny,-73.70177,44.36848,2643,1,3,2,200
031960300,ny,-73.92972,44.37774,2550,0,2,2,NA
031960401,ny,-74.11009,44.31357,541,0,1,1,NA
031960402,ny,-74.00131,44.31713,1542,0,1,1,NA
031960501,ny,-73.99452,44.28175,1633,0,1,1,NA
031960502,ny,-73.99448,44.21838,1450,0,1,1,NA
031960700,ny,-73.52032,44.29654,1942,2,5,3,150
031960800,ny,-73.39388,44.38389,2182,2,6,4,200
031960901,ny,-73.49534,44.22408,1284,2,5,3,150
031960902,ny,-73.71416,44.1711,3233,1,2,1,100
031961001,ny,-73.56816,44.04737,984,1,3,2,200
031961002,ny,-73.47454,44.06662,1855,2,7,5,250
031961100,ny,-73.5254,43.95355,1638,2,6,4,200
031961201,ny,-73.509,43.85415,1731,2,5,3,150
031961202,ny,-73.40922,43.83117,1566,3,7,4,133.3
031961300,ny,-73.76579,43.84975,3613,1,2,1,100
031961400,ny,-74.00115,43.96721,3261,0,1,1,NA
033940000,ny,-74.64731,44.9789,5,2,5,3,150
033950200,ny,-74.48624,44.93775,3267,1,4,3,300
033950301,ny,-74.49601,44.83346,3142,1,3,2,200
033950501,ny,-74.29866,44.84822,1278,1,2,1,100
033950502,ny,-74.32806,44.80334,1134,1,2,1,100
033950601,ny,-74.14486,44.70256,2248,0,1,1,NA
033950701,ny,-74.43275,44.49454,1863,0,1,1,NA
033950800,ny,-74.11106,44.51219,2814,0,1,1,NA
033950900,ny,-74.23566,44.2232,1820,0,1,1,NA
033951000,ny,-74.23873,44.31315,1382,0,1,1,NA
033951100,ny,-74.48434,44.29766,2026,0,1,1,NA
033951200,ny,-74.45927,44.15681,1288,0,1,1,NA
033951300,ny,-74.48377,44.73388,1753,1,2,1,100
033951400,ny,-74.24622,44.78205,2987,1,2,1,100
033952000,ny,-74.16304,44.92714,3834,1,3,2,200
035970100,ny,-74.17469,43.19335,2495,1,4,3,300
035970200,ny,-74.26397,43.15834,1816,1,4,3,300
035970300,ny,-74.25274,43.06273,2186,1,4,3,300
035970400,ny,-74.43906,43.16467,3913,0,1,1,NA
035970500,ny,-74.62997,43.11851,3937,1,3,2,200
035970601,ny,-74.33066,43.04816,2293,1,4,3,300
035970602,ny,-74.43243,43.04432,1975,1,4,3,300
035970700,ny,-74.35665,43.0547,1259,2,5,3,150
035970800,ny,-74.34999,43.03707,1278,1,5,4,400
035970900,ny,-74.33427,43.05074,1328,1,5,4,400
035971000,ny,-74.33246,43.06463,1089,1,5,4,400
035971100,ny,-74.34365,43.06278,957,1,5,4,400
035971200,ny,-74.36286,43.016,1755,2,5,3,150
035971300,ny,-74.38361,43.00174,1920,2,5,3,150
035971400,ny,-74.20472,43.00368,1709,2,5,3,150
035971501,ny,-74.1509,43.03924,1460,1,4,3,300
035971502,ny,-74.16136,43.09929,1691,1,4,3,300
037940100,ny,-78.43575,43.06492,9,2,5,3,150
037950100,ny,-78.02189,43.08826,2876,3,7,4,133.3
037950200,ny,-78.21318,43.08798,3038,3,7,4,133.3
037950301,ny,-78.37998,42.98084,1442,2,5,3,150
037950302,ny,-78.38295,43.06756,1895,2,5,3,150
037950401,ny,-78.22395,43.0236,1361,2,6,4,200
037950402,ny,-78.22843,42.9775,1628,2,5,3,150
037950501,ny,-78.19755,43.00891,671,2,6,4,200
037950502,ny,-78.2053,43.00065,271,2,6,4,200
037950600,ny,-78.18743,43.00737,622,2,6,4,200
037950700,ny,-78.19283,42.99336,1045,2,6,4,200
037950800,ny,-78.17766,43.00472,1094,2,5,3,150
037950900,ny,-78.16262,43.00187,853,2,5,3,150
037951000,ny,-78.16797,42.98884,1007,2,5,3,150
037951100,ny,-78.02249,42.99518,3014,2,5,3,150
037951200,ny,-77.98266,42.98129,1815,2,5,3,150
037951300,ny,-78.0706,42.90958,2468,1,4,3,300
037951400,ny,-78.32797,42.91277,2968,1,4,3,300
039080100,ny,-73.85875,42.41898,2048,4,9,5,125
039080201,ny,-74.00935,42.39375,2481,2,6,4,200
039080202,ny,-74.14657,42.37577,2443,1,4,3,300
039080301,ny,-74.20861,42.31471,3585,0,0,0,NA
039080302,ny,-74.37113,42.32121,1803,0,1,1,NA
039080402,ny,-74.33128,42.21901,4100,0,0,0,NA
039080403,ny,-74.12482,42.20939,1453,0,0,0,NA
039080404,ny,-74.16015,42.15047,2812,0,0,0,NA
039080501,ny,-73.97683,42.31814,1698,4,9,5,125
039080502,ny,-74.04724,42.28321,2642,2,6,4,200
039080600,ny,-73.86897,42.34497,2854,5,12,7,140
039080700,ny,-73.80835,42.36042,1235,6,14,8,133.3
039080800,ny,-73.83068,42.34574,13,6,14,8,133.3
039080900,ny,-73.85828,42.28012,2930,6,13,7,116.7
039081001,ny,-73.87868,42.19739,984,7,15,8,114.3
039081002,ny,-73.85712,42.22557,1071,7,15,8,114.3
039081101,ny,-73.98407,42.21729,2396,4,10,6,150
039081102,ny,-73.9191,42.19434,1551,6,14,8,133.3
041950100,ny,-74.60564,43.94057,3529,0,1,1,NA
041950300,ny,-74.32204,43.78745,2963,0,0,0,NA
041950400,ny,-74.28595,43.39823,2592,0,2,2,NA
041950500,ny,-74.57291,43.52338,3911,0,0,0,NA
043010100,ny,-75.05855,42.92226,4051,1,2,1,100
043010201,ny,-75.06835,43.03455,1599,3,9,6,200
043010202,ny,-75.1416,43.03913,2283,2,5,3,150
043010300,ny,-75.05137,43.00912,2321,1,5,4,400
043010400,ny,-75.0354,43.00142,991,1,5,4,400
043010501,ny,-75.00765,43.01052,1093,2,5,3,150
043010502,ny,-74.96932,42.98313,1190,1,3,2,200
043010701,ny,-74.86543,43.04957,1219,2,7,5,250
043010702,ny,-74.84904,43.04153,1045,3,8,5,166.7
043010900,ny,-74.83295,42.96878,2462,1,5,4,400
043011001,ny,-74.77671,43.10376,1009,2,6,4,200
043011002,ny,-74.80277,43.13036,2425,1,4,3,300
043011100,ny,-74.98488,43.02109,882,2,6,4,200
043011200,ny,-75.0143,43.04264,2367,3,9,6,200
043011301,ny,-74.97782,43.07149,1034,3,8,5,166.7
043011302,ny,-75.09056,43.10511,1587,2,6,4,200
043011400,ny,-74.96326,43.17298,3064,1,3,2,200
043011502,ny,-74.97037,43.72269,7471,0,1,1,NA
043011503,ny,-75.07884,43.26772,1179,1,3,2,200
043011504,ny,-74.87694,43.29314,1975,0,1,1,NA
045060101,ny,-75.9014,44.269,2610,2,5,3,150
045060102,ny,-75.84971,44.34715,1853,2,5,3,150
045060201,ny,-76.06843,44.28218,2622,2,4,2,100
045060202,ny,-76.14423,44.18692,1412,1,3,2,200
045060203,ny,-76.01582,44.20805,1258,2,4,2,100
045060301,ny,-76.28345,44.11337,2196,0,1,1,NA
045060302,ny,-76.1798,44.07327,3291,1,2,1,100
045060401,ny,-76.07588,44.04378,2743,1,2,1,100
045060402,ny,-76.16588,43.92586,1568,1,3,2,200
045060500,ny,-75.91755,44.11291,2198,1,4,3,300
045060601,ny,-75.76108,44.13442,1374,1,4,3,300
045060602,ny,-75.85494,44.06457,640,1,4,3,300
045060700,ny,-75.7084,44.25076,3260,2,4,2,100
045060803,ny,-75.80416,44.05234,4,1,3,2,200
045060805,ny,-75.78391,44.04043,9,1,3,2,200
045060806,ny,-75.7307,44.03921,185,1,2,1,100
045060901,ny,-75.54838,44.01993,1159,1,2,1,100
045060902,ny,-75.63695,44.01296,1326,1,2,1,100
045061000,ny,-75.66847,43.98136,1591,1,2,1,100
045061101,ny,-75.74422,43.98058,1122,1,2,1,100
045061102,ny,-75.83158,43.98675,1272,1,2,1,100
045061200,ny,-75.87674,43.97521,924,1,2,1,100
045061300,ny,-75.89207,43.98327,1258,1,3,2,200
045061400,ny,-75.915,43.98776,1416,1,4,3,300
045061500,ny,-75.93419,43.9779,1627,1,3,2,200
045061600,ny,-75.99772,43.9838,2152,1,3,2,200
045061700,ny,-76.17374,43.83532,2756,0,1,1,NA
045061801,ny,-76.02488,43.86571,1732,0,2,2,NA
045061802,ny,-75.97979,43.86284,1405,0,1,1,NA
045061900,ny,-75.92304,43.96206,1298,1,3,2,200
045062100,ny,-75.90559,43.97334,1884,1,3,2,200
045062200,ny,-75.89643,43.96094,2012,1,3,2,200
045062400,ny,-75.87034,43.86923,2206,0,1,1,NA
045062500,ny,-76.00777,43.73291,2617,0,1,1,NA
045980000,ny,-75.59824,44.12886,22,1,3,2,200
045990001,ny,-76.39371,43.87755,5,1,2,1,100
047000100,ny,-73.99381,40.70021,233,6,13,7,116.7
047000200,ny,-74.01107,40.65325,284,6,13,7,116.7
047000301,ny,-73.99737,40.69637,271,6,13,7,116.7
047000501,ny,-73.9947,40.69581,162,6,13,7,116.7
047000502,ny,-73.99286,40.69513,150,6,13,7,116.7
047000700,ny,-73.99734,40.69235,392,6,13,7,116.7
047000900,ny,-73.9916,40.69172,201,6,13,7,116.7
047001100,ny,-73.98771,40.69329,69,6,13,7,116.7
047001300,ny,-73.98836,40.69761,35,6,13,7,116.7
047001501,ny,-73.98247,40.69591,74,6,13,7,116.7
047001502,ny,-73.98359,40.69232,54,6,13,7,116.7
047001801,ny,-74.00142,40.6649,72,6,13,7,116.7
047001802,ny,-74.01177,40.65996,21,6,13,7,116.7
047001803,ny,-74.02928,40.65579,79,5,12,7,140
047001804,ny,-74.03715,40.64976,5,4,10,6,150
047002000,ny,-74.01593,40.64804,279,4,9,5,125
047002100,ny,-73.98683,40.7033,244,6,13,7,116.7
047002200,ny,-74.02169,40.64346,408,4,10,6,150
047002300,ny,-73.98328,40.69956,11,6,13,7,116.7
047002901,ny,-73.9781,40.69499,10,6,13,7,116.7
047003000,ny,-74.02898,40.63888,274,4,10,6,150
047003101,ny,-73.97968,40.69169,23,6,13,7,116.7
047003102,ny,-73.97549,40.69153,1,6,13,7,116.7
047003300,ny,-73.97811,40.68851,303,6,13,7,116.7
047003400,ny,-74.04465,40.64374,470,4,10,6,150
047003500,ny,-73.97618,40.68533,142,6,13,7,116.7
047003600,ny,-74.0309,40.63469,266,4,10,6,150
047003700,ny,-73.9847,40.68939,110,6,13,7,116.7
047003800,ny,-74.04412,40.63593,253,4,10,6,150
047003900,ny,-73.98082,40.6849,278,6,13,7,116.7
047004100,ny,-73.98505,40.6866,488,6,13,7,116.7
047004300,ny,-73.9896,40.6882,347,6,13,7,116.7
047004400,ny,-74.04427,40.63231,718,4,10,6,150
047004500,ny,-73.99529,40.68815,469,6,13,7,116.7
047004600,ny,-74.04485,40.62802,333,4,10,6,150
047004700,ny,-74.00187,40.68837,158,6,13,7,116.7
047004900,ny,-73.99844,40.688,259,6,13,7,116.7
047005000,ny,-74.04555,40.62444,366,4,10,6,150
047005100,ny,-74.00348,40.6835,398,6,13,7,116.7
047005201,ny,-74.04358,40.62151,139,4,10,6,150
047005202,ny,-74.04466,40.61849,126,4,10,6,150
047005301,ny,-74.02598,40.67667,623,6,13,7,116.7
047005302,ny,-74.02497,40.6677,126,6,13,7,116.7
047005303,ny,-74.01141,40.68241,78,6,13,7,116.7
047005400,ny,-74.03976,40.61625,279,4,10,6,150
047005601,ny,-74.04031,40.61408,225,4,10,6,150
047005602,ny,-74.0397,40.61075,95,4,10,6,150
047005800,ny,-74.03219,40.61909,465,4,10,6,150
047005900,ny,-74.00612,40.6794,345,6,13,7,116.7
047006000,ny,-74.0316,40.62208,448,4,10,6,150
047006200,ny,-74.03045,40.62491,317,4,10,6,150
047006300,ny,-74.00134,40.68195,233,6,13,7,116.7
047006400,ny,-74.02881,40.62893,472,4,10,6,150
047006500,ny,-73.99946,40.67908,784,6,13,7,116.7
047006600,ny,-74.0275,40.63213,322,4,10,6,150
047006700,ny,-73.99722,40.68418,504,6,13,7,116.7
047006800,ny,-74.02623,40.63517,481,4,10,6,150
047006901,ny,-73.99116,40.68619,248,6,13,7,116.7
047006902,ny,-73.99209,40.68455,258,6,13,7,116.7
047007000,ny,-74.0243,40.6382,190,4,10,6,150
047007100,ny,-73.98717,40.68331,284,6,13,7,116.7
047007200,ny,-74.02041,40.6403,131,4,10,6,150
047007400,ny,-74.01703,40.64186,420,4,9,5,125
047007500,ny,-73.99202,40.6813,801,6,13,7,116.7
047007600,ny,-74.01467,40.64408,449,4,9,5,125
047007700,ny,-73.99522,40.67702,672,6,13,7,116.7
047007800,ny,-74.01234,40.64632,434,4,9,5,125
047008000,ny,-74.01002,40.64857,403,4,9,5,125
047008200,ny,-74.00769,40.65082,343,5,12,7,140
047008400,ny,-74.00449,40.6539,405,6,13,7,116.7
047008500,ny,-74.00647,40.67586,7,6,13,7,116.7
047008600,ny,-74.00374,40.64798,1,4,9,5,125
047008800,ny,-74.0014,40.65021,241,5,11,6,120
047009001,ny,-73.99838,40.64792,120,4,9,5,125
047009002,ny,-73.99621,40.64659,125,4,9,5,125
047009201,ny,-74.00044,40.64598,158,4,9,5,125
047009202,ny,-73.99824,40.64465,140,4,9,5,125
047009401,ny,-74.00248,40.64402,250,4,9,5,125
047009402,ny,-74.00028,40.64269,194,4,9,5,125
047009600,ny,-74.00578,40.64602,509,4,9,5,125
047009800,ny,-74.00812,40.64378,480,4,9,5,125
047010000,ny,-74.01045,40.64154,520,4,9,5,125
047010100,ny,-73.99982,40.65839,635,6,13,7,116.7
047010200,ny,-74.01279,40.63928,480,4,9,5,125
047010401,ny,-74.00948,40.63729,250,4,9,5,125
047010402,ny,-74.00728,40.63596,243,4,9,5,125
047010601,ny,-74.00714,40.63954,273,4,9,5,125
047010602,ny,-74.00494,40.63821,253,4,9,5,125
047010801,ny,-74.00481,40.64178,259,4,9,5,125
047010802,ny,-74.00261,40.64045,203,4,9,5,125
047011000,ny,-73.99277,40.64458,297,4,9,5,125
047011200,ny,-73.99567,40.64225,359,4,9,5,125
047011400,ny,-73.99921,40.63942,358,4,9,5,125
047011600,ny,-74.00365,40.63587,405,4,9,5,125
047011700,ny,-73.99331,40.66856,494,6,13,7,116.7
047011800,ny,-74.01149,40.6351,225,4,9,5,125
047011901,ny,-73.98705,40.67651,359,6,13,7,116.7
047011902,ny,-73.99504,40.67309,44,6,13,7,116.7
047012000,ny,-74.01173,40.63278,200,4,9,5,125
047012100,ny,-73.99105,40.67148,329,6,13,7,116.7
047012200,ny,-74.01758,40.63817,410,4,9,5,125
047012600,ny,-74.01904,40.63482,311,4,10,6,150
047012700,ny,-73.98285,40.68175,189,6,13,7,116.7
047012801,ny,-74.0133,40.6308,219,4,9,5,125
047012901,ny,-73.97865,40.68162,325,6,13,7,116.7
047012902,ny,-73.97606,40.68093,312,6,13,7,116.7
047013000,ny,-74.02138,40.63259,492,4,10,6,150
047013100,ny,-73.9796,40.67772,484,6,13,7,116.7
047013200,ny,-74.01567,40.62797,313,4,9,5,125
047013300,ny,-73.98131,40.67518,489,6,13,7,116.7
047013400,ny,-74.02027,40.62952,653,4,10,6,150
047013500,ny,-73.98331,40.67281,352,6,13,7,116.7
047013600,ny,-74.02259,40.6269,593,4,10,6,150
047013700,ny,-73.98533,40.6704,448,6,13,7,116.7
047013800,ny,-74.02552,40.62431,460,4,10,6,150
047013900,ny,-73.98734,40.66799,506,6,13,7,116.7
047014000,ny,-74.01968,40.62078,384,4,10,6,150
047014101,ny,-73.98884,40.66618,211,6,13,7,116.7
047014102,ny,-73.98983,40.66481,231,6,13,7,116.7
047014200,ny,-74.02249,40.6225,322,4,10,6,150
047014300,ny,-73.99266,40.66363,520,6,13,7,116.7
047014500,ny,-73.99496,40.66137,553,6,13,7,116.7
047014700,ny,-73.98967,40.65986,292,6,13,7,116.7
047014800,ny,-74.01296,40.61671,332,4,9,5,125
047014901,ny,-73.98409,40.66389,213,6,13,7,116.7
047014902,ny,-73.98565,40.6618,595,6,13,7,116.7
047015000,ny,-74.01076,40.61538,363,4,9,5,125
047015100,ny,-73.98259,40.66569,521,6,13,7,116.7
047015200,ny,-74.02447,40.61451,414,4,10,6,150
047015300,ny,-73.98058,40.6681,407,6,13,7,116.7
047015400,ny,-74.01892,40.61118,1,4,10,6,150
047015500,ny,-73.97856,40.67051,420,6,13,7,116.7
047015700,ny,-73.97642,40.67305,472,6,13,7,116.7
047015900,ny,-73.97307,40.67519,520,6,13,7,116.7
047016000,ny,-74.02687,40.61898,420,4,10,6,150
047016100,ny,-73.97319,40.67989,382,6,13,7,116.7
047016200,ny,-74.03138,40.61322,253,4,10,6,150
047016300,ny,-73.97001,40.67918,364,6,13,7,116.7
047016400,ny,-74.02949,40.60654,15,4,10,6,150
047016500,ny,-73.97404,40.66998,537,6,13,7,116.7
047016600,ny,-74.01626,40.6187,609,4,9,5,125
047016700,ny,-73.97878,40.6643,522,6,13,7,116.7
047016800,ny,-74.01679,40.60299,293,4,9,5,125
047016900,ny,-73.98128,40.65929,610,6,13,7,116.7
047017000,ny,-74.01263,40.61013,569,4,9,5,125
047017100,ny,-73.97686,40.65696,624,6,13,7,116.7
047017200,ny,-74.01035,40.60888,553,4,9,5,125
047017400,ny,-74.01254,40.60254,403,4,9,5,125
047017500,ny,-73.99024,40.65213,1,6,13,7,116.7
047017600,ny,-74.00991,40.60123,239,4,9,5,125
047017700,ny,-73.96892,40.66161,10,6,13,7,116.7
047017800,ny,-74.00472,40.60697,349,4,9,5,125
047017900,ny,-73.97133,40.68424,292,6,13,7,116.7
047018000,ny,-74.00715,40.6083,421,4,9,5,125
047018100,ny,-73.97237,40.68777,478,6,13,7,116.7
047018200,ny,-74.00268,40.61246,474,4,9,5,125
047018300,ny,-73.97148,40.69138,341,6,13,7,116.7
047018400,ny,-74.00714,40.61371,463,4,9,5,125
047018501,ny,-73.97416,40.69479,63,6,13,7,116.7
047018600,ny,-74.00511,40.61564,346,4,9,5,125
047018700,ny,-73.97064,40.69466,182,6,13,7,116.7
047018800,ny,-74.00274,40.61748,442,4,9,5,125
047019000,ny,-74.00039,40.62104,513,4,9,5,125
047019100,ny,-73.96443,40.69524,440,6,13,7,116.7
047019200,ny,-73.99893,40.62846,389,4,9,5,125
047019300,ny,-73.96264,40.69128,76,6,13,7,116.7
047019400,ny,-74.00111,40.62584,371,4,9,5,125
047019500,ny,-73.9675,40.69141,246,6,13,7,116.7
047019600,ny,-74.00419,40.62342,512,4,9,5,125
047019700,ny,-73.96675,40.688,328,6,13,7,116.7
047019800,ny,-74.00662,40.61936,368,4,9,5,125
047019900,ny,-73.96693,40.68403,294,6,13,7,116.7
047020000,ny,-74.00882,40.62069,444,4,9,5,125
047020100,ny,-73.96339,40.68385,511,6,13,7,116.7
047020200,ny,-74.01102,40.62202,456,4,9,5,125
047020300,ny,-73.96481,40.67996,323,6,13,7,116.7
047020400,ny,-74.01322,40.62335,467,4,9,5,125
047020500,ny,-73.9657,40.67748,365,6,13,7,116.7
047020600,ny,-74.01545,40.62488,444,4,9,5,125
047020700,ny,-73.96661,40.67495,282,6,13,7,116.7
047020800,ny,-74.00977,40.62598,454,4,9,5,125
047021000,ny,-74.00816,40.62763,438,4,9,5,125
047021100,ny,-73.97193,40.69709,310,6,13,7,116.7
047021200,ny,-74.00585,40.62947,463,4,9,5,125
047021300,ny,-73.96047,40.66835,83,6,13,7,116.7
047021400,ny,-74.00318,40.63161,281,4,9,5,125
047021500,ny,-73.96329,40.67338,159,6,13,7,116.7
047021600,ny,-73.99977,40.63279,433,4,9,5,125
047021700,ny,-73.95903,40.67277,175,6,13,7,116.7
047021800,ny,-73.99782,40.63435,477,4,9,5,125
047021900,ny,-73.95526,40.67197,353,6,13,7,116.7
047022000,ny,-73.99556,40.63616,479,4,9,5,125
047022100,ny,-73.95436,40.67617,356,6,13,7,116.7
047022200,ny,-73.99296,40.63824,435,4,9,5,125
047022400,ny,-73.99031,40.64052,486,4,9,5,125
047022600,ny,-73.98635,40.64198,299,4,9,5,125
047022700,ny,-73.95725,40.68151,492,6,13,7,116.7
047022800,ny,-73.98153,40.63912,338,4,9,5,125
047022900,ny,-73.95676,40.68513,510,6,13,7,116.7
047023000,ny,-73.98428,40.63782,408,4,9,5,125
047023100,ny,-73.96084,40.68579,363,6,13,7,116.7
047023200,ny,-73.98622,40.6361,652,4,9,5,125
047023300,ny,-73.95749,40.6888,397,6,13,7,116.7
047023400,ny,-73.98794,40.63387,390,4,9,5,125
047023500,ny,-73.95778,40.69251,296,6,13,7,116.7
047023600,ny,-73.98969,40.63219,345,4,9,5,125
047023800,ny,-73.99144,40.63051,407,4,9,5,125
047024000,ny,-73.99319,40.62883,404,4,9,5,125
047024100,ny,-73.9538,40.69222,273,6,13,7,116.7
047024200,ny,-73.99281,40.62587,405,4,9,5,125
047024300,ny,-73.95286,40.68746,469,6,13,7,116.7
047024400,ny,-73.98624,40.62175,471,4,9,5,125
047024500,ny,-73.9519,40.68288,542,6,13,7,116.7
047024600,ny,-73.98114,40.61817,515,4,9,5,125
047024700,ny,-73.94927,40.67944,278,6,13,7,116.7
047024800,ny,-73.98999,40.62136,427,4,9,5,125
047024900,ny,-73.94839,40.68298,511,6,13,7,116.7
047025000,ny,-73.99584,40.62363,304,4,9,5,125
047025100,ny,-73.94939,40.68785,333,6,13,7,116.7
047025200,ny,-73.99214,40.61983,484,4,9,5,125
047025300,ny,-73.95034,40.69262,405,6,13,7,116.7
047025400,ny,-73.98384,40.6167,482,4,9,5,125
047025500,ny,-73.95129,40.69739,3,6,13,7,116.7
047025600,ny,-73.98567,40.615,470,4,9,5,125
047025700,ny,-73.94734,40.69822,266,6,13,7,116.7
047025800,ny,-73.98741,40.61329,450,4,9,5,125
047025901,ny,-73.94622,40.69497,166,6,13,7,116.7
047025902,ny,-73.94515,40.69697,1,6,13,7,116.7
047026000,ny,-73.99235,40.61692,494,4,9,5,125
047026100,ny,-73.94571,40.6924,580,6,13,7,116.7
047026200,ny,-73.99708,40.61873,447,4,9,5,125
047026300,ny,-73.94513,40.68947,244,6,13,7,116.7
047026400,ny,-73.99748,40.61487,551,4,9,5,125
047026500,ny,-73.94462,40.6869,455,6,13,7,116.7
047026600,ny,-73.99033,40.61263,489,4,9,5,125
047026700,ny,-73.94404,40.68397,574,6,13,7,116.7
047026800,ny,-73.99036,40.61045,460,4,9,5,125
047026900,ny,-73.94332,40.68128,349,6,13,7,116.7
047027000,ny,-73.98999,40.60586,263,4,9,5,125
047027100,ny,-73.93697,40.6788,361,6,13,7,116.7
047027200,ny,-73.99274,40.60818,322,4,9,5,125
047027300,ny,-73.93744,40.68108,319,6,13,7,116.7
047027400,ny,-73.99529,40.61095,412,4,9,5,125
047027500,ny,-73.93818,40.6839,527,6,13,7,116.7
047027600,ny,-73.99949,40.6109,348,4,9,5,125
047027700,ny,-73.93876,40.68683,337,6,13,7,116.7
047027800,ny,-74.00122,40.60686,303,4,9,5,125
047027900,ny,-73.93934,40.68976,535,6,13,7,116.7
047028000,ny,-74.00703,40.60101,260,4,9,5,125
047028100,ny,-73.93993,40.69269,281,6,13,7,116.7
047028200,ny,-74.00525,40.59963,369,4,9,5,125
047028300,ny,-73.94044,40.69526,255,6,13,7,116.7
047028400,ny,-73.99894,40.60567,359,4,9,5,125
047028501,ny,-73.94209,40.69943,48,6,13,7,116.7
047028502,ny,-73.94088,40.69745,4,6,13,7,116.7
047028600,ny,-74.00277,40.59871,214,4,9,5,125
047028700,ny,-73.93543,40.69564,301,6,13,7,116.7
047028800,ny,-73.99656,40.60451,328,4,9,5,125
047028900,ny,-73.933,40.69305,412,6,13,7,116.7
047029000,ny,-73.99435,40.60317,278,4,9,5,125
047029100,ny,-73.93354,40.69043,439,6,13,7,116.7
047029200,ny,-74.00116,40.59678,194,4,9,5,125
047029300,ny,-73.93296,40.6875,336,6,13,7,116.7
047029400,ny,-73.99956,40.5945,120,4,9,5,125
047029500,ny,-73.93238,40.68457,599,6,13,7,116.7
047029600,ny,-73.99302,40.60096,417,4,9,5,125
047029700,ny,-73.93162,40.68127,532,6,13,7,116.7
047029800,ny,-73.98791,40.60082,471,4,9,5,125
047029900,ny,-73.9258,40.67814,309,6,13,7,116.7
047030000,ny,-73.98874,40.5974,488,4,9,5,125
047030100,ny,-73.91623,40.67762,515,6,13,7,116.7
047030200,ny,-73.99065,40.59571,606,4,9,5,125
047030300,ny,-73.91794,40.67512,430,6,13,7,116.7
047030400,ny,-73.998,40.59069,504,4,9,5,125
047030500,ny,-73.95906,40.67732,498,6,13,7,116.7
047030600,ny,-73.98613,40.59116,343,4,9,5,125
047030700,ny,-73.92622,40.67558,390,6,13,7,116.7
047030800,ny,-73.97951,40.58655,295,4,9,5,125
047030900,ny,-73.933,40.67615,248,6,13,7,116.7
047031100,ny,-73.93896,40.67648,364,6,13,7,116.7
047031300,ny,-73.9443,40.67657,377,6,13,7,116.7
047031401,ny,-73.99442,40.58699,535,4,9,5,125
047031402,ny,-73.99442,40.58362,4,4,9,5,125
047031500,ny,-73.94992,40.67691,383,6,13,7,116.7
047031701,ny,-73.95012,40.67387,315,6,13,7,116.7
047031702,ny,-73.95037,40.67119,369,6,13,7,116.7
047031900,ny,-73.9494,40.66689,244,6,13,7,116.7
047032100,ny,-73.95218,40.66687,230,6,13,7,116.7
047032300,ny,-73.95507,40.66655,292,6,13,7,116.7
047032500,ny,-73.95777,40.6673,126,6,13,7,116.7
047032600,ny,-73.98821,40.57653,470,4,9,5,125
047032700,ny,-73.9588,40.66265,273,6,13,7,116.7
047032800,ny,-73.99768,40.57637,575,4,9,5,125
047032900,ny,-73.94842,40.66326,272,6,13,7,116.7
047033000,ny,-73.99846,40.57971,112,4,9,5,125
047033100,ny,-73.94201,40.66416,268,6,13,7,116.7
047033300,ny,-73.94253,40.66584,398,6,13,7,116.7
047033500,ny,-73.94239,40.66759,458,6,13,7,116.7
047033600,ny,-74.00921,40.57595,993,4,9,5,125
047033701,ny,-73.94217,40.66988,206,6,13,7,116.7
047033702,ny,-73.9422,40.66893,216,6,13,7,116.7
047033900,ny,-73.94202,40.67121,466,6,13,7,116.7
047034000,ny,-73.99648,40.57232,30,4,9,5,125
047034100,ny,-73.94459,40.67357,155,6,13,7,116.7
047034200,ny,-73.99686,40.57411,77,4,9,5,125
047034300,ny,-73.93884,40.6735,257,6,13,7,116.7
047034500,ny,-73.93369,40.67323,350,6,13,7,116.7
047034700,ny,-73.92797,40.67266,247,6,13,7,116.7
047034800,ny,-73.98297,40.58086,437,4,9,5,125
047034901,ny,-73.92961,40.67006,133,6,13,7,116.7
047034902,ny,-73.92991,40.66694,164,6,13,7,116.7
047035000,ny,-73.97895,40.57756,31,4,9,5,125
047035101,ny,-73.93238,40.67021,154,6,13,7,116.7
047035102,ny,-73.93267,40.66709,158,6,13,7,116.7
047035200,ny,-73.97962,40.57143,125,4,9,5,125
047035301,ny,-73.93515,40.67036,132,6,13,7,116.7
047035302,ny,-73.93544,40.66724,195,6,13,7,116.7
047035400,ny,-73.97261,40.58013,22,4,9,5,125
047035500,ny,-73.93347,40.6644,173,6,13,7,116.7
047035601,ny,-73.9697,40.58088,1,4,9,5,125
047035602,ny,-73.9702,40.57783,20,4,9,5,125
047035701,ny,-73.92684,40.66991,105,6,13,7,116.7
047035702,ny,-73.92685,40.66686,3,6,13,7,116.7
047035900,ny,-73.92386,40.67043,321,6,13,7,116.7
047036001,ny,-73.96556,40.57579,60,4,9,5,125
047036002,ny,-73.96124,40.57636,53,4,9,5,125
047036100,ny,-73.91996,40.66957,242,6,13,7,116.7
047036200,ny,-73.964,40.57812,440,4,9,5,125
047036300,ny,-73.91699,40.67218,505,6,13,7,116.7
047036400,ny,-73.96386,40.58016,309,4,9,5,125
047036501,ny,-73.91151,40.67503,202,6,13,7,116.7
047036502,ny,-73.90754,40.67473,234,6,13,7,116.7
047036600,ny,-73.96377,40.58287,314,4,9,5,125
047036700,ny,-73.90461,40.67756,227,6,13,7,116.7
047036900,ny,-73.90923,40.67965,590,6,13,7,116.7
047037000,ny,-73.96317,40.58785,592,4,9,5,125
047037100,ny,-73.91384,40.68029,608,6,13,7,116.7
047037300,ny,-73.91522,40.68395,435,6,13,7,116.7
047037401,ny,-73.96775,40.588,412,4,9,5,125
047037402,ny,-73.972,40.58679,312,4,9,5,125
047037500,ny,-73.92152,40.68762,424,6,13,7,116.7
047037700,ny,-73.92019,40.68409,567,6,13,7,116.7
047037900,ny,-73.91937,40.6805,513,6,13,7,116.7
047038100,ny,-73.92543,40.68105,441,6,13,7,116.7
047038200,ny,-73.98148,40.59153,139,4,9,5,125
047038300,ny,-73.92621,40.68452,638,6,13,7,116.7
047038500,ny,-73.92679,40.68746,489,6,13,7,116.7
047038600,ny,-73.97511,40.59235,631,4,9,5,125
047038700,ny,-73.92775,40.69054,486,6,13,7,116.7
047038800,ny,-73.96925,40.59292,494,4,9,5,125
047038900,ny,-73.93723,40.69944,304,6,13,7,116.7
047039000,ny,-73.96443,40.59297,385,4,9,5,125
047039100,ny,-73.93366,40.6998,235,6,13,7,116.7
047039200,ny,-73.96304,40.59585,367,4,9,5,125
047039300,ny,-73.93,40.69563,441,6,13,7,116.7
047039400,ny,-73.96507,40.59849,416,4,9,5,125
047039500,ny,-73.92474,40.69297,418,6,13,7,116.7
047039600,ny,-73.96971,40.59735,385,4,9,5,125
047039700,ny,-73.91914,40.68895,428,6,13,7,116.7
047039800,ny,-73.97551,40.59545,479,4,9,5,125
047039900,ny,-73.91755,40.69024,379,6,13,7,116.7
047040000,ny,-73.97614,40.59781,512,4,9,5,125
047040100,ny,-73.91274,40.68646,456,6,13,7,116.7
047040200,ny,-73.98272,40.596,429,4,9,5,125
047040300,ny,-73.90821,40.68452,524,6,13,7,116.7
047040400,ny,-73.98542,40.60219,375,4,9,5,125
047040500,ny,-73.90518,40.68159,273,6,13,7,116.7
047040600,ny,-73.98232,40.60051,453,4,9,5,125
047040700,ny,-73.90121,40.6843,4,6,13,7,116.7
047040800,ny,-73.97913,40.6012,479,4,9,5,125
047040900,ny,-73.90461,40.69108,370,6,13,7,116.7
047041000,ny,-73.97545,40.60098,331,4,9,5,125
047041100,ny,-73.90715,40.68788,399,6,13,7,116.7
047041200,ny,-73.97419,40.60416,398,4,9,5,125
047041300,ny,-73.91062,40.68981,477,6,13,7,116.7
047041401,ny,-73.97107,40.60171,200,4,9,5,125
047041402,ny,-73.96794,40.60242,204,4,9,5,125
047041500,ny,-73.91439,40.69195,505,6,13,7,116.7
047041600,ny,-73.96349,40.60241,364,4,9,5,125
047041700,ny,-73.91792,40.69376,210,6,13,7,116.7
047041800,ny,-73.96485,40.6054,299,4,9,5,125
047041900,ny,-73.92103,40.69532,329,6,13,7,116.7
047042000,ny,-73.96433,40.60924,350,4,9,5,125
047042100,ny,-73.92404,40.69703,414,6,13,7,116.7
047042200,ny,-73.96999,40.60687,521,4,9,5,125
047042300,ny,-73.92729,40.699,442,6,13,7,116.7
047042400,ny,-73.97605,40.60675,407,4,9,5,125
047042500,ny,-73.93096,40.70145,265,6,13,7,116.7
047042600,ny,-73.98019,40.60568,449,4,9,5,125
047042700,ny,-73.92719,40.70368,394,6,13,7,116.7
047042800,ny,-73.98433,40.60565,372,4,9,5,125
047042900,ny,-73.92346,40.7018,361,6,13,7,116.7
047043000,ny,-73.9842,40.60925,264,4,9,5,125
047043100,ny,-73.9197,40.69966,404,6,13,7,116.7
047043200,ny,-73.98068,40.61068,366,4,9,5,125
047043300,ny,-73.91594,40.69752,282,6,13,7,116.7
047043400,ny,-73.97693,40.61004,327,4,9,5,125
047043500,ny,-73.91218,40.69538,467,6,13,7,116.7
047043600,ny,-73.97786,40.61313,339,4,9,5,125
047043700,ny,-73.90842,40.69325,461,6,13,7,116.7
047043800,ny,-73.97109,40.61033,241,4,9,5,125
047043900,ny,-73.90931,40.69747,466,6,13,7,116.7
047044000,ny,-73.97098,40.61304,413,4,9,5,125
047044100,ny,-73.91405,40.70142,397,6,13,7,116.7
047044200,ny,-73.96559,40.6124,367,4,9,5,125
047044300,ny,-73.91669,40.7033,441,6,13,7,116.7
047044400,ny,-73.96932,40.61577,379,4,9,5,125
047044500,ny,-73.91967,40.70504,424,6,13,7,116.7
047044600,ny,-73.97606,40.61523,270,4,9,5,125
047044700,ny,-73.92262,40.70669,216,6,13,7,116.7
047044800,ny,-73.97323,40.61813,225,4,9,5,125
047044901,ny,-73.93797,40.71977,243,6,13,7,116.7
047044902,ny,-73.92963,40.71745,304,6,13,7,116.7
047045000,ny,-73.97288,40.62169,149,4,9,5,125
047045200,ny,-73.96816,40.62017,361,4,9,5,125
047045300,ny,-73.92896,40.70658,318,6,13,7,116.7
047045400,ny,-73.965,40.61868,306,4,9,5,125
047045600,ny,-73.96662,40.62616,251,4,9,5,125
047045800,ny,-73.96901,40.6257,256,4,9,5,125
047046000,ny,-73.96552,40.63184,335,4,9,5,125
047046201,ny,-73.97352,40.62762,200,4,9,5,125
047046202,ny,-73.97423,40.62459,307,4,9,5,125
047046400,ny,-73.9784,40.62466,388,4,9,5,125
047046800,ny,-73.98065,40.6215,289,4,9,5,125
047047000,ny,-73.98675,40.62559,433,4,9,5,125
047047200,ny,-73.98413,40.62704,357,4,9,5,125
047047400,ny,-73.98237,40.62868,417,4,9,5,125
047047600,ny,-73.98058,40.63057,497,4,9,5,125
047047700,ny,-73.94214,40.71822,491,6,13,7,116.7
047047800,ny,-73.97887,40.6334,517,4,9,5,125
047048000,ny,-73.97449,40.63029,329,4,9,5,125
047048100,ny,-73.9385,40.71386,342,6,13,7,116.7
047048200,ny,-73.96953,40.63321,331,4,9,5,125
047048400,ny,-73.97363,40.63429,341,4,9,5,125
047048500,ny,-73.93635,40.70784,504,6,13,7,116.7
047048600,ny,-73.97843,40.63892,356,4,9,5,125
047048800,ny,-73.97621,40.64048,310,4,9,5,125
047048900,ny,-73.93926,40.70292,4,6,13,7,116.7
047049000,ny,-73.97303,40.63811,274,4,9,5,125
047049100,ny,-73.9441,40.70357,195,6,13,7,116.7
047049200,ny,-73.97021,40.6409,323,4,9,5,125
047049301,ny,-73.94193,40.71,2,6,13,7,116.7
047049302,ny,-73.94111,40.70688,256,6,13,7,116.7
047049400,ny,-73.97383,40.64297,262,4,9,5,125
047049500,ny,-73.94336,40.71236,364,6,13,7,116.7
047049600,ny,-73.98044,40.64369,507,4,9,5,125
047049700,ny,-73.94459,40.71622,422,6,13,7,116.7
047049800,ny,-73.98268,40.64543,424,4,9,5,125
047049900,ny,-73.94688,40.72091,251,6,13,7,116.7
047050001,ny,-73.97782,40.649,233,4,10,6,150
047050002,ny,-73.9765,40.6466,133,4,9,5,125
047050100,ny,-73.94892,40.71574,406,6,13,7,116.7
047050202,ny,-73.97528,40.65351,328,6,13,7,116.7
047050300,ny,-73.94746,40.7122,378,6,13,7,116.7
047050401,ny,-73.97374,40.64992,142,5,11,6,120
047050402,ny,-73.97314,40.64666,133,4,9,5,125
047050500,ny,-73.94495,40.70805,192,6,13,7,116.7
047050600,ny,-73.96686,40.64898,252,4,10,6,150
047050700,ny,-73.94701,40.70141,203,6,13,7,116.7
047050801,ny,-73.96074,40.65124,69,6,13,7,116.7
047050803,ny,-73.96062,40.65391,69,6,13,7,116.7
047050804,ny,-73.96357,40.65283,79,6,13,7,116.7
047050900,ny,-73.95056,40.70328,201,6,13,7,116.7
047051001,ny,-73.95977,40.64612,68,4,9,5,125
047051002,ny,-73.96037,40.64875,125,4,9,5,125
047051100,ny,-73.94858,40.70756,193,6,13,7,116.7
047051200,ny,-73.96336,40.64655,90,4,9,5,125
047051300,ny,-73.95216,40.71179,435,6,13,7,116.7
047051400,ny,-73.96143,40.64279,177,4,9,5,125
047051500,ny,-73.95053,40.71913,137,6,13,7,116.7
047051601,ny,-73.95671,40.63862,194,4,9,5,125
047051602,ny,-73.95814,40.64161,117,4,9,5,125
047051700,ny,-73.9545,40.72065,162,6,13,7,116.7
047051800,ny,-73.9608,40.63799,212,4,9,5,125
047051900,ny,-73.95516,40.71572,480,6,13,7,116.7
047052000,ny,-73.96419,40.63745,343,4,9,5,125
047052300,ny,-73.95881,40.71166,265,6,13,7,116.7
047052500,ny,-73.95998,40.70888,126,6,13,7,116.7
047052600,ny,-73.96668,40.63647,239,4,9,5,125
047052700,ny,-73.95369,40.7084,343,6,13,7,116.7
047052800,ny,-73.96261,40.63085,269,4,9,5,125
047052900,ny,-73.95451,40.70587,323,6,13,7,116.7
047053000,ny,-73.96373,40.62736,374,4,9,5,125
047053101,ny,-73.95508,40.70125,155,6,13,7,116.7
047053102,ny,-73.9533,40.70024,130,6,13,7,116.7
047053200,ny,-73.96025,40.62622,297,4,9,5,125
047053300,ny,-73.95736,40.70377,532,6,13,7,116.7
047053400,ny,-73.96283,40.62258,417,4,9,5,125
047053500,ny,-73.96122,40.70614,274,6,13,7,116.7
047053700,ny,-73.95995,40.7003,202,6,13,7,116.7
047053800,ny,-73.95684,40.6182,266,4,9,5,125
047053900,ny,-73.96256,40.70265,49,6,13,7,116.7
047054200,ny,-73.96098,40.6128,428,4,9,5,125
047054300,ny,-73.97229,40.70226,6,6,13,7,116.7
047054400,ny,-73.95719,40.61322,446,4,9,5,125
047054500,ny,-73.96529,40.70524,31,6,13,7,116.7
047054600,ny,-73.95312,40.61314,279,4,9,5,125
047054700,ny,-73.96659,40.70853,184,6,13,7,116.7
047054800,ny,-73.94838,40.60925,361,4,9,5,125
047054900,ny,-73.96574,40.71117,223,6,13,7,116.7
047055000,ny,-73.95232,40.60873,298,4,9,5,125
047055100,ny,-73.96441,40.71396,395,6,13,7,116.7
047055200,ny,-73.95626,40.60831,277,4,9,5,125
047055300,ny,-73.95924,40.71646,293,6,13,7,116.7
047055400,ny,-73.96007,40.60787,312,4,9,5,125
047055500,ny,-73.96326,40.71808,240,6,13,7,116.7
047055600,ny,-73.95941,40.60316,396,4,9,5,125
047055700,ny,-73.95934,40.722,189,6,13,7,116.7
047055800,ny,-73.95538,40.60365,343,4,9,5,125
047056000,ny,-73.95144,40.60409,365,4,9,5,125
047056100,ny,-73.95657,40.72641,513,6,13,7,116.7
047056200,ny,-73.9475,40.60452,462,4,9,5,125
047056301,ny,-73.95721,40.73406,383,6,13,7,116.7
047056302,ny,-73.95949,40.73592,55,6,13,7,116.7
047056400,ny,-73.94337,40.60692,511,4,9,5,125
047056500,ny,-73.95776,40.73022,420,6,13,7,116.7
047056600,ny,-73.9414,40.60285,394,4,9,5,125
047056800,ny,-73.93782,40.60267,366,4,9,5,125
047056900,ny,-73.95237,40.72377,277,6,13,7,116.7
047057000,ny,-73.93688,40.59927,301,4,9,5,125
047057100,ny,-73.94762,40.72478,591,6,13,7,116.7
047057200,ny,-73.93822,40.59637,4,4,9,5,125
047057300,ny,-73.94883,40.72805,372,6,13,7,116.7
047057400,ny,-73.94434,40.60115,585,4,9,5,125
047057500,ny,-73.95323,40.73211,474,6,13,7,116.7
047057600,ny,-73.94757,40.59987,458,4,9,5,125
047057800,ny,-73.95151,40.59944,383,4,9,5,125
047057901,ny,-73.95202,40.73486,270,6,13,7,116.7
047057902,ny,-73.94682,40.73413,35,6,13,7,116.7
047058000,ny,-73.95545,40.59901,357,4,9,5,125
047058200,ny,-73.95926,40.59854,369,4,9,5,125
047058400,ny,-73.95867,40.59407,407,4,9,5,125
047058600,ny,-73.95461,40.59456,451,4,9,5,125
047058800,ny,-73.95855,40.58962,299,4,9,5,125
047058901,ny,-73.94355,40.72837,318,6,13,7,116.7
047058902,ny,-73.93873,40.72953,14,6,13,7,116.7
047059000,ny,-73.95469,40.58999,325,4,9,5,125
047059100,ny,-73.94293,40.72353,479,6,13,7,116.7
047059200,ny,-73.95145,40.59234,413,4,9,5,125
047059300,ny,-73.93833,40.726,364,6,13,7,116.7
047059402,ny,-73.94302,40.59461,921,4,9,5,125
047059403,ny,-73.94819,40.59527,522,4,9,5,125
047059404,ny,-73.94708,40.59083,542,4,9,5,125
047059600,ny,-73.94006,40.5911,209,4,9,5,125
047059800,ny,-73.93623,40.5879,452,4,9,5,125
047060000,ny,-73.94569,40.58707,784,4,9,5,125
047060600,ny,-73.95612,40.58646,220,4,9,5,125
047060800,ny,-73.94924,40.58394,261,4,9,5,125
047061002,ny,-73.95603,40.57373,89,4,9,5,125
047061003,ny,-73.95869,40.58143,229,4,9,5,125
047061004,ny,-73.95577,40.57987,369,4,9,5,125
047061200,ny,-73.94935,40.58109,265,4,9,5,125
047061600,ny,-73.94043,40.57562,423,4,9,5,125
047062000,ny,-73.94593,40.57918,481,4,9,5,125
047062200,ny,-73.93571,40.58409,383,4,9,5,125
047062600,ny,-73.93444,40.59233,385,4,9,5,125
047062800,ny,-73.92688,40.58989,2251,4,9,5,125
047063200,ny,-73.93157,40.59976,217,4,9,5,125
047063600,ny,-73.93614,40.60994,407,4,9,5,125
047063800,ny,-73.93881,40.60667,384,4,9,5,125
047064000,ny,-73.94025,40.611,437,4,9,5,125
047064200,ny,-73.94639,40.6122,344,4,9,5,125
047064400,ny,-73.94248,40.6138,534,4,9,5,125
047064600,ny,-73.93954,40.61591,539,4,9,5,125
047064800,ny,-73.93646,40.61769,442,4,9,5,125
047065000,ny,-73.93365,40.61998,334,3,9,6,200
047065200,ny,-73.93007,40.61476,379,3,9,6,200
047065400,ny,-73.93181,40.61295,499,3,9,6,200
047065600,ny,-73.93498,40.61301,617,4,9,5,125
047065800,ny,-73.9312,40.60808,536,3,9,6,200
047066000,ny,-73.92808,40.60905,500,3,9,6,200
047066200,ny,-73.92437,40.60931,410,3,9,6,200
047066600,ny,-73.91388,40.58553,6,4,9,5,125
047067000,ny,-73.92276,40.61272,497,3,9,6,200
047067200,ny,-73.9278,40.61875,317,3,9,6,200
047067400,ny,-73.93027,40.61983,500,3,9,6,200
047067600,ny,-73.9272,40.62499,391,3,9,6,200
047067800,ny,-73.92278,40.62615,468,3,9,6,200
047068000,ny,-73.92519,40.62138,481,3,9,6,200
047068200,ny,-73.92413,40.61665,599,3,9,6,200
047068600,ny,-73.91728,40.61482,255,3,9,6,200
047068800,ny,-73.9191,40.61722,462,3,9,6,200
047069000,ny,-73.92067,40.61997,483,3,9,6,200
047069200,ny,-73.92009,40.62368,502,3,9,6,200
047069601,ny,-73.91479,40.62723,428,3,9,6,200
047069602,ny,-73.90865,40.62273,1193,3,9,6,200
047069800,ny,-73.91589,40.61244,435,3,9,6,200
047070000,ny,-73.90674,40.62005,410,3,9,6,200
047070201,ny,-73.90861,40.60877,1916,3,9,6,200
047070202,ny,-73.88989,40.59242,11,3,9,6,200
047070203,ny,-73.85994,40.61337,1,3,8,5,166.7
047070601,ny,-73.90335,40.61656,758,3,9,6,200
047070602,ny,-73.89454,40.61279,17,3,9,6,200
047072000,ny,-73.92005,40.62885,288,3,9,6,200
047072200,ny,-73.92439,40.632,577,3,9,6,200
047072400,ny,-73.92706,40.63411,411,3,9,6,200
047072600,ny,-73.93388,40.63241,555,4,9,5,125
047072800,ny,-73.927,40.62949,456,3,9,6,200
047073000,ny,-73.92985,40.6262,485,3,9,6,200
047073200,ny,-73.93361,40.62793,429,4,9,5,125
047073400,ny,-73.93748,40.62782,366,4,9,5,125
047073600,ny,-73.9358,40.62404,362,4,9,5,125
047073800,ny,-73.93908,40.62241,437,4,9,5,125
047074000,ny,-73.94126,40.62739,382,4,9,5,125
047074200,ny,-73.94498,40.62699,504,4,9,5,125
047074400,ny,-73.94312,40.62233,500,4,9,5,125
047074600,ny,-73.94263,40.61861,411,4,9,5,125
047074800,ny,-73.9469,40.62189,346,4,9,5,125
047075000,ny,-73.94877,40.62657,460,4,9,5,125
047075200,ny,-73.95255,40.62615,300,4,9,5,125
047075400,ny,-73.95071,40.62147,345,4,9,5,125
047075600,ny,-73.94799,40.61686,349,4,9,5,125
047075800,ny,-73.95196,40.61648,404,4,9,5,125
047076000,ny,-73.95479,40.62136,292,4,9,5,125
047076200,ny,-73.95649,40.62572,257,4,9,5,125
047076400,ny,-73.95864,40.63193,182,4,9,5,125
047076600,ny,-73.95684,40.63319,113,4,9,5,125
047076800,ny,-73.9608,40.6188,456,4,9,5,125
047077000,ny,-73.95383,40.63614,254,4,9,5,125
047077200,ny,-73.95318,40.63161,364,4,9,5,125
047077400,ny,-73.94808,40.6312,166,4,9,5,125
047077600,ny,-73.94114,40.63093,354,4,9,5,125
047078000,ny,-73.93915,40.6345,470,4,9,5,125
047078200,ny,-73.94144,40.63785,346,4,9,5,125
047078400,ny,-73.94296,40.63426,401,4,9,5,125
047078601,ny,-73.94796,40.6342,160,4,9,5,125
047078602,ny,-73.94614,40.63464,160,4,9,5,125
047078801,ny,-73.95031,40.63742,222,4,9,5,125
047078802,ny,-73.94669,40.63753,64,4,9,5,125
047079001,ny,-73.95546,40.6415,133,4,9,5,125
047079002,ny,-73.95283,40.64072,305,4,9,5,125
047079201,ny,-73.95641,40.64462,182,4,9,5,125
047079202,ny,-73.9534,40.64491,254,4,9,5,125
047079400,ny,-73.95529,40.64861,275,4,10,6,150
047079601,ny,-73.95827,40.6566,225,6,13,7,116.7
047079602,ny,-73.95766,40.65276,154,6,13,7,116.7
047079801,ny,-73.95872,40.66001,287,6,13,7,116.7
047079802,ny,-73.96137,40.65799,106,6,13,7,116.7
047080000,ny,-73.95377,40.66069,565,6,13,7,116.7
047080200,ny,-73.95344,40.65764,399,6,13,7,116.7
047080400,ny,-73.94899,40.65897,407,6,13,7,116.7
047080600,ny,-73.94386,40.66166,372,6,13,7,116.7
047080800,ny,-73.93949,40.6573,17,6,13,7,116.7
047081000,ny,-73.94455,40.65911,229,6,13,7,116.7
047081400,ny,-73.94024,40.65364,414,6,13,7,116.7
047081600,ny,-73.94421,40.65353,319,6,13,7,116.7
047081800,ny,-73.94798,40.65309,236,6,13,7,116.7
047082000,ny,-73.95131,40.65345,216,6,13,7,116.7
047082200,ny,-73.95443,40.65329,247,6,13,7,116.7
047082400,ny,-73.94936,40.64885,528,4,10,6,150
047082600,ny,-73.94897,40.64506,587,4,9,5,125
047082800,ny,-73.9496,40.64099,384,4,9,5,125
047083000,ny,-73.9455,40.64089,345,4,9,5,125
047083200,ny,-73.94162,40.64152,428,4,9,5,125
047083400,ny,-73.93848,40.64155,409,4,9,5,125
047083600,ny,-73.93513,40.6371,418,4,9,5,125
047083800,ny,-73.93514,40.64176,531,4,9,5,125
047084000,ny,-73.93129,40.64199,450,3,9,6,200
047084600,ny,-73.92745,40.64229,447,3,9,6,200
047084800,ny,-73.92786,40.64643,372,3,9,6,200
047085000,ny,-73.93232,40.64574,362,3,9,6,200
047085200,ny,-73.93825,40.64697,1,4,9,5,125
047085400,ny,-73.94255,40.64467,384,4,9,5,125
047085600,ny,-73.94483,40.64862,376,4,11,7,175
047085800,ny,-73.939,40.65016,401,5,12,7,140
047086000,ny,-73.93293,40.64999,460,5,11,6,120
047086200,ny,-73.92823,40.65022,367,5,11,6,120
047086400,ny,-73.92385,40.65434,354,6,13,7,116.7
047086600,ny,-73.92676,40.65638,396,6,13,7,116.7
047086800,ny,-73.92973,40.65431,411,6,13,7,116.7
047087000,ny,-73.9334,40.65418,390,6,13,7,116.7
047087200,ny,-73.93665,40.65368,381,6,13,7,116.7
047087401,ny,-73.93846,40.66047,303,6,13,7,116.7
047087600,ny,-73.93571,40.66065,255,6,13,7,116.7
047087800,ny,-73.93103,40.65885,226,6,13,7,116.7
047088001,ny,-73.93294,40.66198,115,6,13,7,116.7
047088002,ny,-73.92948,40.66114,233,6,13,7,116.7
047088200,ny,-73.92598,40.66049,454,6,13,7,116.7
047088400,ny,-73.92455,40.66223,441,6,13,7,116.7
047088600,ny,-73.92068,40.65749,301,6,13,7,116.7
047088800,ny,-73.91809,40.65394,386,6,13,7,116.7
047089000,ny,-73.91549,40.65699,385,6,13,7,116.7
047089200,ny,-73.92192,40.66328,213,6,13,7,116.7
047089400,ny,-73.91649,40.6615,496,6,13,7,116.7
047089600,ny,-73.91241,40.65801,310,6,13,7,116.7
047089800,ny,-73.91371,40.66279,346,6,13,7,116.7
047090000,ny,-73.91981,40.66625,408,6,13,7,116.7
047090200,ny,-73.91501,40.66755,468,6,13,7,116.7
047090600,ny,-73.90886,40.67013,191,6,13,7,116.7
047090800,ny,-73.90477,40.67132,292,6,13,7,116.7
047091000,ny,-73.90341,40.66575,59,6,13,7,116.7
047091200,ny,-73.90763,40.66513,9,6,13,7,116.7
047091600,ny,-73.9091,40.6591,418,6,13,7,116.7
047091800,ny,-73.90459,40.66165,368,6,13,7,116.7
047092000,ny,-73.90299,40.65856,448,6,13,7,116.7
047092200,ny,-73.90635,40.65524,172,6,13,7,116.7
047092400,ny,-73.91148,40.66693,368,6,13,7,116.7
047092800,ny,-73.91177,40.65248,364,6,13,7,116.7
047093000,ny,-73.91541,40.64993,477,5,11,6,120
047093200,ny,-73.92951,40.63757,376,3,9,6,200
047093400,ny,-73.91901,40.64893,516,4,10,6,150
047093600,ny,-73.92158,40.6488,306,4,10,6,150
047093800,ny,-73.92456,40.65045,330,5,11,6,120
047094401,ny,-73.92297,40.63874,576,3,9,6,200
047094402,ny,-73.92078,40.63508,2,3,9,6,200
047094600,ny,-73.92328,40.64462,414,3,9,6,200
047095000,ny,-73.91715,40.63625,462,3,9,6,200
047095400,ny,-73.91463,40.63897,716,3,9,6,200
047095600,ny,-73.91092,40.63557,570,3,9,6,200
047095800,ny,-73.91169,40.64082,575,3,9,6,200
047096000,ny,-73.91477,40.64593,130,4,9,5,125
047096200,ny,-73.91052,40.64503,307,3,9,6,200
047096400,ny,-73.90727,40.64195,401,3,9,6,200
047096600,ny,-73.90314,40.64064,419,3,9,6,200
047096800,ny,-73.90388,40.64414,301,3,9,6,200
047097000,ny,-73.90735,40.64726,360,3,9,6,200
047097400,ny,-73.89977,40.64698,371,3,9,6,200
047098200,ny,-73.89437,40.651,8,5,12,7,140
047098400,ny,-73.89179,40.64658,329,3,8,5,166.7
047098600,ny,-73.89432,40.64494,451,3,9,6,200
047098800,ny,-73.89732,40.643,395,3,9,6,200
047099000,ny,-73.89856,40.63937,298,3,9,6,200
047099200,ny,-73.90128,40.6374,314,3,9,6,200
047099400,ny,-73.9044,40.63576,287,3,9,6,200
047099600,ny,-73.90779,40.63344,563,3,9,6,200
047099800,ny,-73.90841,40.62958,534,3,9,6,200
047100400,ny,-73.9038,40.63065,373,3,9,6,200
047100600,ny,-73.90089,40.63225,460,3,9,6,200
047100800,ny,-73.89807,40.63413,379,3,9,6,200
047101000,ny,-73.89497,40.63603,430,3,9,6,200
047101200,ny,-73.89367,40.63973,457,3,9,6,200
047101400,ny,-73.89067,40.64166,459,3,8,5,166.7
047101600,ny,-73.88814,40.6433,272,3,8,5,166.7
047101800,ny,-73.88599,40.64286,294,3,8,5,166.7
047102000,ny,-73.88702,40.63838,410,3,8,5,166.7
047102200,ny,-73.89001,40.63644,402,3,8,5,166.7
047102400,ny,-73.89328,40.63293,363,3,9,6,200
047102600,ny,-73.89848,40.62961,410,3,9,6,200
047102801,ny,-73.88976,40.63118,251,3,8,5,166.7
047102802,ny,-73.89234,40.62621,1,3,9,6,200
047103401,ny,-73.88623,40.63352,4,3,8,5,166.7
047103402,ny,-73.88077,40.63362,2,3,8,5,166.7
047105801,ny,-73.8806,40.64922,13,4,10,6,150
047105804,ny,-73.88344,40.64579,87,3,8,5,166.7
047107001,ny,-73.87072,40.65422,568,6,13,7,116.7
047107002,ny,-73.86657,40.64392,1,3,8,5,166.7
047107003,ny,-73.87768,40.65051,3,4,9,5,125
047107800,ny,-73.87596,40.65884,443,6,13,7,116.7
047109800,ny,-73.90165,40.65266,407,5,12,7,140
047110400,ny,-73.88879,40.6574,648,6,13,7,116.7
047110600,ny,-73.8843,40.65731,7,6,13,7,116.7
047111000,ny,-73.88136,40.66057,2,6,13,7,116.7
047111600,ny,-73.87569,40.66386,559,6,13,7,116.7
047111800,ny,-73.87602,40.66876,417,6,13,7,116.7
047112000,ny,-73.88052,40.66663,441,6,13,7,116.7
047112200,ny,-73.88592,40.66373,410,6,13,7,116.7
047112400,ny,-73.88715,40.666,512,6,13,7,116.7
047112600,ny,-73.89311,40.6649,391,6,13,7,116.7
047112800,ny,-73.89211,40.66174,554,6,13,7,116.7
047113000,ny,-73.89647,40.66217,504,6,13,7,116.7
047113200,ny,-73.89889,40.66129,448,6,13,7,116.7
047113400,ny,-73.89961,40.66778,137,6,13,7,116.7
047114201,ny,-73.89727,40.68049,292,6,13,7,116.7
047114202,ny,-73.89122,40.68248,243,6,13,7,116.7
047114400,ny,-73.89855,40.67281,518,6,13,7,116.7
047114600,ny,-73.89234,40.67921,408,6,13,7,116.7
047115000,ny,-73.88652,40.67392,455,6,13,7,116.7
047115200,ny,-73.89093,40.67327,441,6,13,7,116.7
047115600,ny,-73.89589,40.66833,210,6,13,7,116.7
047115800,ny,-73.89216,40.66888,460,6,13,7,116.7
047116000,ny,-73.88853,40.66942,358,6,13,7,116.7
047116200,ny,-73.88503,40.66994,473,6,13,7,116.7
047116400,ny,-73.88118,40.67051,556,6,13,7,116.7
047116600,ny,-73.88221,40.67456,445,6,13,7,116.7
047116800,ny,-73.88252,40.67899,336,6,13,7,116.7
047117000,ny,-73.88618,40.6776,264,6,13,7,116.7
047117201,ny,-73.88751,40.68081,313,6,13,7,116.7
047117202,ny,-73.88376,40.68274,467,6,13,7,116.7
047117400,ny,-73.87979,40.68286,541,6,13,7,116.7
047117601,ny,-73.87688,40.68478,319,6,13,7,116.7
047117602,ny,-73.87445,40.68623,397,6,13,7,116.7
047117800,ny,-73.87429,40.68165,236,6,13,7,116.7
047118000,ny,-73.87774,40.68948,11,6,13,7,116.7
047118201,ny,-73.8719,40.68791,381,6,13,7,116.7
047118202,ny,-73.869,40.68866,363,6,13,7,116.7
047118400,ny,-73.86941,40.6843,655,6,13,7,116.7
047118600,ny,-73.86778,40.68147,395,6,13,7,116.7
047118800,ny,-73.86591,40.67904,510,6,13,7,116.7
047119000,ny,-73.87163,40.67906,281,6,13,7,116.7
047119200,ny,-73.87816,40.67711,484,6,13,7,116.7
047119400,ny,-73.87706,40.67255,547,6,13,7,116.7
047119600,ny,-73.87316,40.6759,694,6,13,7,116.7
047119800,ny,-73.89439,40.67631,555,6,13,7,116.7
047120000,ny,-73.86727,40.67488,275,6,13,7,116.7
047120200,ny,-73.86436,40.67634,224,6,13,7,116.7
047120801,ny,-73.86845,40.67097,575,6,13,7,116.7
047120802,ny,-73.86475,40.67154,11,6,13,7,116.7
047120803,ny,-73.86126,40.67167,233,6,13,7,116.7
047121000,ny,-73.87224,40.67009,2,6,13,7,116.7
047121400,ny,-73.86518,40.66749,4,6,13,7,116.7
047122000,ny,-73.86287,40.66376,765,6,13,7,116.7
047123700,ny,-73.95674,40.69674,488,6,13,7,116.7
047150200,ny,-73.98128,40.65464,558,6,13,7,116.7
047152200,ny,-73.96718,40.64397,536,4,9,5,125
049950101,ny,-75.31359,43.97044,2260,1,2,1,100
049950200,ny,-75.44424,44.02665,3633,1,2,1,100
049950301,ny,-75.48693,43.80965,1517,1,2,1,100
049950302,ny,-75.65893,43.86417,2755,0,1,1,NA
049950401,ny,-75.37153,43.77236,2207,1,2,1,100
049950500,ny,-75.62076,43.75113,2135,0,1,1,NA
049950601,ny,-75.31761,43.61306,1066,0,2,2,NA
049950700,ny,-75.56275,43.58192,5636,0,1,1,NA
049950800,ny,-75.21317,43.80545,2802,0,1,1,NA
051030100,ny,-77.82873,42.95338,1928,2,6,4,200
051030201,ny,-77.86751,42.86024,1868,2,6,4,200
051030203,ny,-77.76881,42.79048,1185,2,4,2,100
051030204,ny,-77.73308,42.89402,1352,2,5,3,150
051030300,ny,-77.74649,42.91284,1207,2,6,4,200
051030400,ny,-77.80849,42.79422,1136,2,5,3,150
051030500,ny,-77.82341,42.796,3,2,5,3,150
051030600,ny,-77.61004,42.89373,1723,2,5,3,150
051030701,ny,-77.62641,42.80761,1242,1,4,3,300
051030702,ny,-77.69014,42.81122,2478,1,4,3,300
051030800,ny,-77.86383,42.70545,2840,2,6,4,200
051030900,ny,-77.87521,42.7237,1155,3,8,5,166.7
051031000,ny,-77.83222,42.67904,4,3,7,4,133.3
051031101,ny,-77.56752,42.62282,1466,0,2,2,NA
051031102,ny,-77.65608,42.71059,1811,1,2,1,100
051031200,ny,-77.93969,42.56284,2135,1,2,1,100
051031300,ny,-77.75585,42.57823,2924,1,3,2,200
051031400,ny,-77.69591,42.56071,1843,2,4,2,100
053030101,ny,-75.64971,43.09829,962,2,5,3,150
053030102,ny,-75.66496,43.09451,1804,2,5,3,150
053030103,ny,-75.66244,43.07344,1666,2,5,3,150
053030200,ny,-75.75831,43.11712,2459,2,6,4,200
053030300,ny,-75.75748,43.0793,2273,2,5,3,150
053030401,ny,-75.8794,43.05125,1901,2,5,3,150
053030402,ny,-75.85573,43.0498,1588,2,5,3,150
053030403,ny,-75.89665,43.11904,1664,3,7,4,133.3
053030404,ny,-75.89942,43.15666,2080,3,7,4,133.3
053030501,ny,-75.84996,42.92844,1199,1,2,1,100
053030502,ny,-75.86445,42.91119,2171,1,2,1,100
053030601,ny,-75.6269,42.97857,1880,1,3,2,200
053030602,ny,-75.75764,42.99839,2089,1,2,1,100
053030701,ny,-75.62897,42.88138,2422,1,3,2,200
053030702,ny,-75.75421,42.8791,1740,1,2,1,100
053030800,ny,-75.72768,42.78044,3022,1,3,2,200
053030900,ny,-75.54232,42.81455,906,1,4,3,300
053031000,ny,-75.49566,42.83827,3358,1,4,3,300
053031100,ny,-75.34358,42.80786,1862,1,3,2,200
055000200,ny,-77.62482,43.16345,867,2,6,4,200
055000700,ny,-77.60858,43.17339,811,2,6,4,200
055001000,ny,-77.58249,43.15556,652,3,6,3,100
055001300,ny,-77.60701,43.16976,51,2,6,4,200
055001600,ny,-77.59126,43.17284,1148,3,6,3,100
055001800,ny,-77.65264,43.19645,2014,3,7,4,133.3
055001900,ny,-77.63117,43.19901,872,2,6,4,200
055002000,ny,-77.63428,43.19043,1329,3,6,3,100
055002100,ny,-77.64014,43.1862,1013,3,6,3,100
055002200,ny,-77.63964,43.18145,738,3,6,3,100
055002300,ny,-77.63304,43.17533,1122,2,6,4,200
055002400,ny,-77.64204,43.17275,1092,3,7,4,133.3
055002700,ny,-77.62631,43.14851,474,3,7,4,133.3
055002900,ny,-77.58926,43.15037,683,3,7,4,133.3
055003000,ny,-77.59454,43.14454,572,3,7,4,133.3
055003101,ny,-77.57833,43.14663,722,3,7,4,133.3
055003102,ny,-77.58798,43.1463,413,3,7,4,133.3
055003200,ny,-77.60695,43.14622,423,3,7,4,133.3
055003300,ny,-77.59966,43.14085,492,3,7,4,133.3
055003400,ny,-77.60951,43.13911,648,3,7,4,133.3
055003500,ny,-77.60432,43.13392,432,3,7,4,133.3
055003600,ny,-77.59462,43.13672,1117,3,7,4,133.3
055003700,ny,-77.58294,43.13848,808,3,7,4,133.3
055003806,ny,-77.61876,43.11868,985,3,7,4,133.3
055003807,ny,-77.63283,43.12172,533,3,7,4,133.3
055003900,ny,-77.62418,43.17894,538,2,6,4,200
055004000,ny,-77.64416,43.16681,433,3,7,4,133.3
055004100,ny,-77.63493,43.16389,580,2,6,4,200
055004602,ny,-77.62162,43.18701,449,2,6,4,200
055004701,ny,-77.61455,43.21055,544,2,6,4,200
055004702,ny,-77.60856,43.18843,779,2,6,4,200
055004800,ny,-77.60627,43.18442,741,2,6,4,200
055004900,ny,-77.60378,43.18074,675,2,6,4,200
055005000,ny,-77.61808,43.17703,606,2,6,4,200
055005100,ny,-77.61498,43.1818,468,2,6,4,200
055005200,ny,-77.60648,43.17687,664,2,6,4,200
055005400,ny,-77.56825,43.17352,1331,3,6,3,100
055005500,ny,-77.58913,43.16877,728,3,6,3,100
055005600,ny,-77.5815,43.16766,827,3,6,3,100
055005700,ny,-77.576,43.1649,529,3,6,3,100
055005800,ny,-77.56702,43.16693,1149,3,6,3,100
055005900,ny,-77.57446,43.15952,591,3,6,3,100
055006000,ny,-77.55815,43.16381,1237,3,7,4,133.3
055006100,ny,-77.54295,43.16309,1063,3,7,4,133.3
055006200,ny,-77.65358,43.14165,987,3,7,4,133.3
055006300,ny,-77.64219,43.14456,953,3,7,4,133.3
055006400,ny,-77.63046,43.14303,911,3,7,4,133.3
055006500,ny,-77.62148,43.14314,507,3,7,4,133.3
055006600,ny,-77.63079,43.13754,608,3,7,4,133.3
055006700,ny,-77.64213,43.13846,951,3,7,4,133.3
055006800,ny,-77.65607,43.13403,1006,3,7,4,133.3
055006900,ny,-77.6265,43.13547,620,3,7,4,133.3
055007000,ny,-77.63882,43.12839,1048,3,7,4,133.3
055007100,ny,-77.64672,43.12976,1081,3,7,4,133.3
055007500,ny,-77.64741,43.14934,830,3,7,4,133.3
055007600,ny,-77.55492,43.15648,1310,3,7,4,133.3
055007700,ny,-77.55321,43.15072,913,3,7,4,133.3
055007801,ny,-77.5658,43.14734,597,3,7,4,133.3
055007802,ny,-77.56191,43.14056,750,3,7,4,133.3
055007900,ny,-77.59691,43.18455,632,3,6,3,100
055008000,ny,-77.59263,43.17814,752,3,6,3,100
055008100,ny,-77.59091,43.18945,1400,3,6,3,100
055008200,ny,-77.57915,43.18454,1047,3,6,3,100
055008301,ny,-77.56718,43.18184,1337,3,6,3,100
055008400,ny,-77.58207,43.17848,970,3,6,3,100
055008500,ny,-77.61526,43.25402,1377,3,7,4,133.3
055008600,ny,-77.62532,43.22359,1774,3,6,3,100
055008702,ny,-77.66212,43.15077,647,3,7,4,133.3
055008801,ny,-77.65718,43.16916,2172,3,7,4,133.3
055009200,ny,-77.61627,43.16777,320,2,6,4,200
055009301,ny,-77.5991,43.16396,754,3,6,3,100
055009302,ny,-77.59813,43.15259,426,3,6,3,100
055009401,ny,-77.60524,43.15957,299,2,6,4,200
055009402,ny,-77.60283,43.15483,222,2,6,4,200
055009403,ny,-77.61346,43.15241,1,2,6,4,200
055009404,ny,-77.61426,43.15533,235,2,6,4,200
055009500,ny,-77.61751,43.14968,650,3,6,3,100
055009601,ny,-77.62977,43.15203,512,3,6,3,100
055009602,ny,-77.63912,43.15469,728,3,6,3,100
055009605,ny,-77.64109,43.16043,1268,3,6,3,100
055010100,ny,-77.59391,43.24789,1858,3,7,4,133.3
055010200,ny,-77.60028,43.23475,1702,3,7,4,133.3
055010300,ny,-77.60718,43.21703,1660,2,6,4,200
055010400,ny,-77.60988,43.2034,1730,2,6,4,200
055010500,ny,-77.57849,43.22001,1954,3,6,3,100
055010601,ny,-77.56979,43.20427,1083,3,6,3,100
055010602,ny,-77.58926,43.20314,1441,3,6,3,100
055010700,ny,-77.54494,43.22712,1754,3,7,4,133.3
055010800,ny,-77.54458,43.21022,1520,3,7,4,133.3
055010901,ny,-77.57284,43.19228,1240,3,6,3,100
055010902,ny,-77.55164,43.19711,1159,3,7,4,133.3
055011000,ny,-77.538,43.18708,2021,3,7,4,133.3
055011100,ny,-77.5441,43.17219,1974,3,7,4,133.3
055011201,ny,-77.52225,43.21972,1740,2,6,4,200
055011203,ny,-77.50353,43.23791,932,2,6,4,200
055011205,ny,-77.48236,43.22165,2030,2,6,4,200
055011207,ny,-77.49391,43.20567,1599,2,6,4,200
055011209,ny,-77.45237,43.20313,1205,2,6,4,200
055011210,ny,-77.46451,43.20718,385,2,6,4,200
055011302,ny,-77.46161,43.24014,2407,2,6,4,200
055011303,ny,-77.39565,43.25208,1280,2,6,4,200
055011304,ny,-77.43328,43.24919,1858,2,6,4,200
055011401,ny,-77.39931,43.21517,829,2,6,4,200
055011402,ny,-77.42874,43.20384,1453,2,6,4,200
055011403,ny,-77.43431,43.2159,412,2,6,4,200
055011503,ny,-77.50491,43.16705,2258,2,6,4,200
055011504,ny,-77.45758,43.16334,2730,2,6,4,200
055011505,ny,-77.40515,43.15097,2176,3,7,4,133.3
055011506,ny,-77.42947,43.18923,1633,2,6,4,200
055011507,ny,-77.50556,43.18772,1040,2,6,4,200
055011601,ny,-77.45734,43.13107,2206,3,7,4,133.3
055011603,ny,-77.49886,43.12768,88,3,7,4,133.3
055011604,ny,-77.5047,43.14373,1087,3,7,4,133.3
055011605,ny,-77.47928,43.1394,809,3,7,4,133.3
055011705,ny,-77.47707,43.06448,1003,3,7,4,133.3
055011707,ny,-77.40554,43.07649,2474,3,7,4,133.3
055011708,ny,-77.42082,43.04793,1720,2,6,4,200
055011709,ny,-77.38777,43.10182,1051,3,7,4,133.3
055011710,ny,-77.41771,43.10722,1986,3,7,4,133.3
055011711,ny,-77.43713,43.06627,760,2,6,4,200
055011712,ny,-77.45563,43.06584,2158,2,6,4,200
055011800,ny,-77.44298,43.09839,2042,3,6,3,100
055011901,ny,-77.4582,43.11335,2099,3,7,4,133.3
055011903,ny,-77.44646,43.08404,712,3,6,3,100
055011904,ny,-77.47118,43.08995,1620,3,6,3,100
055012000,ny,-77.48006,43.11352,1086,3,7,4,133.3
055012100,ny,-77.49062,43.11137,1598,3,7,4,133.3
055012201,ny,-77.5193,43.11283,1372,3,7,4,133.3
055012202,ny,-77.49692,43.09013,1473,3,7,4,133.3
055012301,ny,-77.52977,43.08975,2259,3,7,4,133.3
055012304,ny,-77.5077,43.0642,1642,3,7,4,133.3
055012305,ny,-77.51346,43.04463,1622,3,7,4,133.3
055012307,ny,-77.55698,43.05109,907,2,6,4,200
055012308,ny,-77.54677,43.07657,1308,3,7,4,133.3
055012401,ny,-77.60051,42.95578,1121,3,6,3,100
055012402,ny,-77.5409,42.98993,2693,3,6,3,100
055012500,ny,-77.52935,43.1471,1656,3,7,4,133.3
055012600,ny,-77.53998,43.12903,1711,3,7,4,133.3
055012700,ny,-77.56028,43.12928,1524,3,7,4,133.3
055012800,ny,-77.58403,43.12987,1256,3,7,4,133.3
055012900,ny,-77.58279,43.12049,1754,3,7,4,133.3
055013003,ny,-77.56342,43.11225,647,3,7,4,133.3
055013004,ny,-77.5628,43.1033,1284,3,6,3,100
055013005,ny,-77.60128,43.10466,666,3,6,3,100
055013006,ny,-77.65074,43.10239,1202,3,6,3,100
055013101,ny,-77.5842,43.08328,2916,3,6,3,100
055013103,ny,-77.67725,43.08116,606,3,6,3,100
055013104,ny,-77.6326,43.08109,1643,3,6,3,100
055013203,ny,-77.5936,43.05826,2140,2,6,4,200
055013205,ny,-77.67962,43.05756,1653,2,6,4,200
055013206,ny,-77.69497,43.03108,2304,2,6,4,200
055013207,ny,-77.62611,43.03304,2054,2,6,4,200
055013208,ny,-77.63258,43.05823,869,2,6,4,200
055013300,ny,-77.67221,42.98056,1788,3,6,3,100
055013401,ny,-77.63476,43.26533,844,3,7,4,133.3
055013402,ny,-77.6957,43.29821,1531,2,5,3,150
055013503,ny,-77.72881,43.29406,2265,2,6,4,200
055013505,ny,-77.70626,43.21695,1245,3,7,4,133.3
055013507,ny,-77.70725,43.25206,2023,3,7,4,133.3
055013508,ny,-77.73385,43.25844,1672,3,7,4,133.3
055013509,ny,-77.70654,43.23117,811,3,7,4,133.3
055013510,ny,-77.72488,43.22626,1336,3,7,4,133.3
055013511,ny,-77.74273,43.2299,801,3,7,4,133.3
055013601,ny,-77.653,43.24207,1740,3,7,4,133.3
055013603,ny,-77.67509,43.26225,2174,3,7,4,133.3
055013604,ny,-77.67786,43.24565,1637,3,7,4,133.3
055013701,ny,-77.63009,43.24583,903,3,7,4,133.3
055013702,ny,-77.6402,43.24903,1331,3,7,4,133.3
055013800,ny,-77.63764,43.22874,2235,3,6,3,100
055013901,ny,-77.65077,43.22264,1600,3,7,4,133.3
055013902,ny,-77.65258,43.2099,828,3,7,4,133.3
055014001,ny,-77.67795,43.23103,1710,3,7,4,133.3
055014003,ny,-77.68665,43.21615,1633,3,7,4,133.3
055014004,ny,-77.66819,43.21459,1075,3,7,4,133.3
055014102,ny,-77.68289,43.19935,1538,3,7,4,133.3
055014103,ny,-77.71545,43.20503,1705,3,7,4,133.3
055014104,ny,-77.71817,43.19174,1372,3,6,3,100
055014202,ny,-77.73675,43.14755,2781,3,6,3,100
055014204,ny,-77.72215,43.15471,954,3,6,3,100
055014205,ny,-77.71461,43.17587,1172,3,6,3,100
055014206,ny,-77.71894,43.16889,1028,3,6,3,100
055014301,ny,-77.69076,43.17154,1013,3,6,3,100
055014302,ny,-77.69301,43.15693,2060,3,6,3,100
055014400,ny,-77.68785,43.13777,2102,3,7,4,133.3
055014501,ny,-77.76515,43.11655,1843,3,6,3,100
055014503,ny,-77.73107,43.1197,1279,3,6,3,100
055014504,ny,-77.70653,43.11506,2243,3,6,3,100
055014505,ny,-77.80187,43.11761,1409,2,6,4,200
055014601,ny,-77.79815,43.0748,1805,3,6,3,100
055014602,ny,-77.73579,43.07466,2090,3,6,3,100
055014700,ny,-77.81758,43.01246,2304,3,6,3,100
055014802,ny,-77.80432,43.23924,2503,3,7,4,133.3
055014803,ny,-77.78357,43.31809,1639,2,6,4,200
055014805,ny,-77.78804,43.28093,1162,2,6,4,200
055014806,ny,-77.78374,43.29601,1172,2,6,4,200
055014901,ny,-77.81063,43.18634,2031,2,6,4,200
055014903,ny,-77.85002,43.16256,2272,2,6,4,200
055014905,ny,-77.77811,43.13973,1868,3,6,3,100
055014906,ny,-77.77793,43.17551,1382,3,6,3,100
055015000,ny,-77.87523,43.08024,2589,2,6,4,200
055015101,ny,-77.86723,43.31668,2066,3,7,4,133.3
055015102,ny,-77.95329,43.32711,1405,3,7,4,133.3
055015200,ny,-77.92276,43.25329,2497,3,7,4,133.3
055015301,ny,-77.95196,43.21042,16,2,6,4,200
055015303,ny,-77.93917,43.20357,978,2,6,4,200
055015304,ny,-77.92887,43.21597,1425,2,6,4,200
055015400,ny,-77.94129,43.17538,1975,2,6,4,200
055980000,ny,-77.67305,43.11707,59,3,7,4,133.3
055980100,ny,-77.56695,43.2343,26,3,7,4,133.3
055980200,ny,-77.67095,43.16944,200,3,7,4,133.3
057070200,ny,-74.20185,42.93315,883,2,6,4,200
057070300,ny,-74.19382,42.94531,679,2,7,5,250
057070400,ny,-74.20862,42.95048,853,3,7,4,133.3
057070500,ny,-74.19862,42.95575,1128,3,7,4,133.3
057070600,ny,-74.18263,42.94536,722,2,7,5,250
057070700,ny,-74.17315,42.95165,1065,2,6,4,200
057070800,ny,-74.17054,42.93586,989,2,6,4,200
057070900,ny,-74.18297,42.93211,627,2,6,4,200
057072100,ny,-74.16684,42.95518,3409,2,7,5,250
057072200,ny,-74.39611,42.95722,2051,3,8,5,166.7
057072300,ny,-74.54977,42.94609,1674,2,7,5,250
057072400,ny,-74.67781,43.00656,1408,3,8,5,166.7
057072500,ny,-74.69749,42.92714,2206,2,7,5,250
057072600,ny,-74.60513,42.8657,1933,2,6,4,200
057072700,ny,-74.41999,42.86789,2756,2,5,3,150
057072800,ny,-74.27037,42.85939,2823,2,5,3,150
059300100,ny,-73.74548,40.81858,1641,4,10,6,150
059300300,ny,-73.74183,40.804,1230,4,10,6,150
059300400,ny,-73.72601,40.80196,1722,4,10,6,150
059300500,ny,-73.74528,40.78921,1665,4,10,6,150
059300600,ny,-73.72033,40.78945,2000,5,10,5,100
059300700,ny,-73.72567,40.78702,319,4,10,6,150
059300800,ny,-73.72792,40.77509,1225,4,10,6,150
059300901,ny,-73.70892,40.76801,959,4,10,6,150
059300902,ny,-73.67785,40.77645,939,5,11,6,120
059301000,ny,-73.70266,40.85133,2036,4,10,6,150
059301101,ny,-73.7126,40.83949,1502,4,10,6,150
059301102,ny,-73.70075,40.84501,1309,4,10,6,150
059301200,ny,-73.70384,40.82737,1896,4,10,6,150
059301300,ny,-73.68832,40.83147,1494,4,10,6,150
059301400,ny,-73.66209,40.81701,813,4,10,6,150
059301500,ny,-73.70079,40.81022,1165,5,10,5,100
059301600,ny,-73.67557,40.80749,1572,5,11,6,120
059301700,ny,-73.67985,40.79899,877,5,11,6,120
059301800,ny,-73.699,40.78716,1643,5,10,5,100
059301900,ny,-73.67964,40.79234,1083,5,11,6,120
059302000,ny,-73.64746,40.80712,1552,5,11,6,120
059302101,ny,-73.62832,40.80319,1512,5,11,6,120
059302102,ny,-73.63041,40.78773,1201,5,11,6,120
059302200,ny,-73.64773,40.78645,1250,5,11,6,120
059302300,ny,-73.66033,40.77047,1667,4,10,6,150
059302400,ny,-73.64815,40.77159,1904,4,10,6,150
059302501,ny,-73.63345,40.77295,919,4,9,5,125
059302502,ny,-73.6034,40.77966,1138,4,10,6,150
059302600,ny,-73.70186,40.7319,734,4,10,6,150
059302700,ny,-73.697,40.74063,1388,4,10,6,150
059302800,ny,-73.69192,40.74867,2158,4,10,6,150
059302900,ny,-73.67814,40.74598,1654,4,10,6,150
059303000,ny,-73.68551,40.73533,1845,4,10,6,150
059303101,ny,-73.68087,40.75914,1172,4,10,6,150
059303102,ny,-73.66349,40.75668,1417,4,10,6,150
059303203,ny,-73.6635,40.74853,1100,4,10,6,150
059303204,ny,-73.66425,40.74035,1483,4,10,6,150
059303301,ny,-73.64984,40.75931,1066,4,10,6,150
059303302,ny,-73.64423,40.75835,1356,4,10,6,150
059303400,ny,-73.63361,40.76085,896,3,8,5,166.7
059303500,ny,-73.65104,40.74714,1824,4,10,6,150
059303600,ny,-73.64133,40.745,1652,3,9,6,200
059303700,ny,-73.62835,40.74889,1986,3,8,5,166.7
059303800,ny,-73.61237,40.7499,1686,3,8,5,166.7
059303900,ny,-73.59042,40.76505,1295,3,8,5,166.7
059304001,ny,-73.59923,40.75229,844,3,8,5,166.7
059304002,ny,-73.59255,40.75569,1174,3,8,5,166.7
059304100,ny,-73.58036,40.7596,1049,3,8,5,166.7
059304202,ny,-73.56319,40.75841,1173,3,7,4,133.3
059304203,ny,-73.56253,40.76374,1040,3,7,4,133.3
059304204,ny,-73.57309,40.75957,770,3,8,5,166.7
059404300,ny,-73.7209,40.72321,1024,4,10,6,150
059404400,ny,-73.71161,40.72095,1515,4,10,6,150
059404500,ny,-73.69745,40.72495,1284,4,10,6,150
059404600,ny,-73.69921,40.7177,1387,4,10,6,150
059404700,ny,-73.68563,40.72577,2069,4,10,6,150
059404800,ny,-73.70993,40.7127,1591,4,10,6,150
059404901,ny,-73.7221,40.7022,1369,4,10,6,150
059404902,ny,-73.71508,40.70402,972,4,10,6,150
059405000,ny,-73.70318,40.7012,1287,4,10,6,150
059405100,ny,-73.7035,40.69216,2076,4,10,6,150
059405200,ny,-73.6926,40.70072,1473,4,10,6,150
059405301,ny,-73.6829,40.71179,1055,4,10,6,150
059405302,ny,-73.67097,40.71226,1293,4,10,6,150
059405400,ny,-73.68539,40.69863,2090,4,10,6,150
059405500,ny,-73.67173,40.70263,1758,4,10,6,150
059405600,ny,-73.67342,40.69561,1332,4,10,6,150
059405700,ny,-73.6775,40.6875,1506,4,9,5,125
059405800,ny,-73.66047,40.71215,1451,4,10,6,150
059405900,ny,-73.6611,40.68998,1726,4,10,6,150
059406001,ny,-73.65376,40.7009,1583,4,10,6,150
059406002,ny,-73.64965,40.69595,951,4,10,6,150
059406100,ny,-73.64714,40.70809,1025,4,10,6,150
059406201,ny,-73.64186,40.69234,877,4,9,5,125
059406202,ny,-73.6493,40.67753,1675,4,9,5,125
059406300,ny,-73.67665,40.72393,1390,4,10,6,150
059406400,ny,-73.65178,40.72979,2019,4,10,6,150
059406501,ny,-73.6395,40.71994,2173,3,8,5,166.7
059406600,ny,-73.62472,40.73416,1547,3,8,5,166.7
059406701,ny,-73.63171,40.70246,596,3,7,4,133.3
059406702,ny,-73.63518,40.711,510,3,8,5,166.7
059406801,ny,-73.62432,40.71116,540,3,7,4,133.3
059406802,ny,-73.62209,40.71313,279,3,7,4,133.3
059406900,ny,-73.61406,40.71594,1463,3,7,4,133.3
059407000,ny,-73.62496,40.69653,1367,3,7,4,133.3
059407101,ny,-73.61671,40.69483,1080,3,7,4,133.3
059407102,ny,-73.60889,40.69447,1395,3,7,4,133.3
059407201,ny,-73.61531,40.70649,367,3,7,4,133.3
059407203,ny,-73.6094,40.70595,772,3,7,4,133.3
059407204,ny,-73.60271,40.70964,643,3,7,4,133.3
059407301,ny,-73.59805,40.73171,504,3,7,4,133.3
059407302,ny,-73.58912,40.71479,1364,2,7,5,250
059407401,ny,-73.59395,40.70463,1360,2,7,5,250
059407402,ny,-73.58257,40.7032,706,2,7,5,250
059407501,ny,-73.601,40.69281,1077,2,7,5,250
059407502,ny,-73.58814,40.69357,1212,2,7,5,250
059407600,ny,-73.56856,40.74615,1809,3,8,5,166.7
059407700,ny,-73.56822,40.73651,1546,3,7,4,133.3
059407801,ny,-73.54769,40.73721,1723,2,7,5,250
059407802,ny,-73.5525,40.73162,38,2,7,5,250
059407900,ny,-73.57459,40.70742,1171,2,7,5,250
059408000,ny,-73.56803,40.71476,2037,2,7,5,250
059408100,ny,-73.55535,40.70611,2130,2,6,4,200
059408200,ny,-73.55415,40.71914,2107,2,6,4,200
059408300,ny,-73.53764,40.71403,2199,2,6,4,200
059408400,ny,-73.56346,40.6937,1275,2,7,5,250
059408500,ny,-73.54349,40.69988,2009,2,6,4,200
059408600,ny,-73.53289,40.73679,1411,2,7,5,250
059408700,ny,-73.52545,40.73979,1441,2,7,5,250
059408800,ny,-73.50331,40.73766,2088,2,6,4,200
059408900,ny,-73.52814,40.72917,1794,2,6,4,200
059409000,ny,-73.50037,40.72658,1830,2,5,3,150
059409100,ny,-73.52509,40.71525,1738,2,6,4,200
059409200,ny,-73.51379,40.72064,1913,2,6,4,200
059409300,ny,-73.50835,40.71049,1396,2,5,3,150
059409400,ny,-73.49636,40.71216,1405,2,5,3,150
059409500,ny,-73.49232,40.707,1323,2,5,3,150
059409600,ny,-73.52112,40.70091,1656,2,6,4,200
059409700,ny,-73.50557,40.69652,1384,2,5,3,150
059409800,ny,-73.71443,40.6888,1507,4,9,5,125
059409900,ny,-73.71502,40.68185,1948,4,9,5,125
059410000,ny,-73.69198,40.68129,967,4,9,5,125
059410100,ny,-73.67401,40.67732,2314,4,9,5,125
059410200,ny,-73.66734,40.67099,1378,4,9,5,125
059410300,ny,-73.71678,40.674,1781,4,9,5,125
059410400,ny,-73.71883,40.66699,1532,4,9,5,125
059410500,ny,-73.70114,40.66783,2019,4,9,5,125
059410600,ny,-73.69102,40.67038,2183,4,9,5,125
059410700,ny,-73.69624,40.65313,1828,3,8,5,166.7
059410800,ny,-73.7072,40.65309,1623,3,8,5,166.7
059410900,ny,-73.71854,40.65579,1680,3,9,6,200
059411000,ny,-73.75185,40.62307,1518,1,5,4,400
059411100,ny,-73.74394,40.61543,805,1,5,4,400
059411200,ny,-73.72783,40.6252,1689,1,5,4,400
059411301,ny,-73.73359,40.64225,1390,2,5,3,150
059411302,ny,-73.72004,40.63845,2237,1,5,4,400
059411400,ny,-73.71036,40.63058,1773,1,5,4,400
059411500,ny,-73.69291,40.62955,1077,1,5,4,400
059411600,ny,-73.71502,40.60409,1940,1,5,4,400
059411700,ny,-73.6942,40.64216,1994,1,5,4,400
059411800,ny,-73.67926,40.66212,1989,4,9,5,125
059411901,ny,-73.67583,40.65319,762,3,9,6,200
059411902,ny,-73.6828,40.65065,1157,3,8,5,166.7
059412000,ny,-73.66404,40.65927,1967,4,9,5,125
059412100,ny,-73.66642,40.64583,1753,2,6,4,200
059412200,ny,-73.66759,40.63332,1993,2,5,3,150
059412301,ny,-73.64796,40.65454,675,3,9,6,200
059412302,ny,-73.63953,40.65219,1102,2,6,4,200
059412400,ny,-73.64228,40.66101,948,3,8,5,166.7
059412500,ny,-73.64156,40.66748,1387,3,8,5,166.7
059412600,ny,-73.63299,40.67864,1275,3,7,4,133.3
059412700,ny,-73.62526,40.66635,1425,3,7,4,133.3
059412800,ny,-73.62333,40.68134,1076,3,7,4,133.3
059412900,ny,-73.60902,40.67992,1854,2,7,5,250
059413001,ny,-73.64896,40.64414,1271,1,5,4,400
059413002,ny,-73.65415,40.63137,1455,2,5,3,150
059413100,ny,-73.62784,40.64985,1711,2,5,3,150
059413200,ny,-73.64413,40.63035,2045,1,5,4,400
059413300,ny,-73.62841,40.63821,2362,1,4,3,300
059413400,ny,-73.62781,40.62326,2073,1,4,3,300
059413500,ny,-73.61075,40.66932,2252,3,7,4,133.3
059413600,ny,-73.61147,40.6572,1682,3,7,4,133.3
059413700,ny,-73.61036,40.64557,1586,1,4,3,300
059413803,ny,-73.60872,40.63008,1428,1,4,3,300
059413804,ny,-73.59619,40.62917,1384,1,4,3,300
059413900,ny,-73.59149,40.67927,1899,2,6,4,200
059414001,ny,-73.58058,40.68571,1087,2,6,4,200
059414002,ny,-73.5767,40.6741,1181,2,6,4,200
059414100,ny,-73.59078,40.66871,1830,2,6,4,200
059414201,ny,-73.5956,40.66011,710,2,6,4,200
059414202,ny,-73.58376,40.66336,900,2,6,4,200
059414301,ny,-73.59335,40.65457,563,2,6,4,200
059414303,ny,-73.59398,40.6482,1085,1,4,3,300
059414304,ny,-73.58095,40.64992,582,1,4,3,300
059414400,ny,-73.57275,40.6535,1287,2,5,3,150
059414501,ny,-73.59034,40.63764,1778,1,3,2,200
059414502,ny,-73.57934,40.63616,1566,1,3,2,200
059414600,ny,-73.56652,40.68373,1214,2,6,4,200
059414700,ny,-73.55461,40.68399,1576,2,6,4,200
059414800,ny,-73.54246,40.68338,2264,2,6,4,200
059414900,ny,-73.53117,40.68874,2402,2,6,4,200
059415000,ny,-73.56277,40.66952,2047,2,6,4,200
059415101,ny,-73.55786,40.65798,1033,2,6,4,200
059415102,ny,-73.55729,40.64138,1864,1,4,3,300
059415201,ny,-73.54874,40.66707,1424,2,6,4,200
059415202,ny,-73.53715,40.64516,1582,1,4,3,300
059415300,ny,-73.53297,40.6724,2063,2,6,4,200
059415401,ny,-73.5316,40.65781,2035,2,5,3,150
059415402,ny,-73.52246,40.64583,1723,1,5,4,400
059415500,ny,-73.48832,40.69595,890,2,5,3,150
059415600,ny,-73.51619,40.67952,1922,2,5,3,150
059415700,ny,-73.51062,40.6529,2231,1,5,4,400
059415802,ny,-73.50259,40.6833,2359,1,5,4,400
059416000,ny,-73.49195,40.67051,1396,1,5,4,400
059416100,ny,-73.4945,40.65708,2576,1,5,4,400
059416201,ny,-73.66805,40.60993,1688,2,5,3,150
059416202,ny,-73.6553,40.60522,1439,2,5,3,150
059416300,ny,-73.72815,40.58584,2120,2,5,3,150
059416401,ny,-73.69572,40.58491,1609,2,5,3,150
059416402,ny,-73.68556,40.58552,1096,2,5,3,150
059416500,ny,-73.66895,40.59172,1109,2,5,3,150
059416600,ny,-73.66923,40.58298,1000,2,5,3,150
059416701,ny,-73.65217,40.59076,1235,2,5,3,150
059416702,ny,-73.65233,40.58078,329,2,5,3,150
059416801,ny,-73.64215,40.59223,912,1,5,4,400
059416802,ny,-73.64181,40.5816,678,1,5,4,400
059416900,ny,-73.55615,40.60448,2074,1,4,3,300
059517000,ny,-73.64339,40.88195,1330,4,9,5,125
059517101,ny,-73.64662,40.86262,1440,4,9,5,125
059517102,ny,-73.62331,40.87792,875,4,9,5,125
059517201,ny,-73.63391,40.85925,818,4,9,5,125
059517202,ny,-73.62726,40.85326,860,4,9,5,125
059517301,ny,-73.61638,40.86794,955,4,9,5,125
059517302,ny,-73.60628,40.86021,1378,4,9,5,125
059517400,ny,-73.65039,40.8463,1945,4,10,6,150
059517500,ny,-73.63703,40.82824,1501,4,9,5,125
059517600,ny,-73.61802,40.84492,1781,4,9,5,125
059517701,ny,-73.56337,40.83409,3061,4,10,6,150
059517705,ny,-73.57667,40.80839,1005,4,10,6,150
059517801,ny,-73.58175,40.88301,1617,4,9,5,125
059517802,ny,-73.58825,40.87826,1277,4,9,5,125
059517901,ny,-73.57047,40.90874,1808,4,10,6,150
059517902,ny,-73.50755,40.91763,1364,5,11,6,120
059518000,ny,-73.53122,40.86878,1964,4,9,5,125
059518100,ny,-73.52885,40.84952,1061,4,9,5,125
059518201,ny,-73.49276,40.8676,1802,4,10,6,150
059518203,ny,-73.4697,40.82678,978,4,10,6,150
059518204,ny,-73.47106,40.80745,1064,4,10,6,150
059518300,ny,-73.50602,40.8294,1938,4,10,6,150
059518400,ny,-73.49189,40.82331,1318,4,10,6,150
059518501,ny,-73.55173,40.78565,1726,4,10,6,150
059518502,ny,-73.52551,40.78287,786,5,11,6,120
059518600,ny,-73.52717,40.79316,1351,5,11,6,120
059518700,ny,-73.50656,40.80372,2022,5,11,6,120
059518800,ny,-73.50068,40.79391,1065,5,11,6,120
059518900,ny,-73.54041,40.76814,2290,3,8,5,166.7
059519000,ny,-73.53971,40.75199,2055,3,7,4,133.3
059519100,ny,-73.52574,40.75076,2003,3,7,4,133.3
059519200,ny,-73.51402,40.75249,2060,2,6,4,200
059519300,ny,-73.51382,40.76576,2061,3,7,4,133.3
059519400,ny,-73.50857,40.77361,1441,3,7,4,133.3
059519500,ny,-73.51144,40.78364,1980,4,10,6,150
059519601,ny,-73.49755,40.77977,1518,4,9,5,125
059519602,ny,-73.48821,40.77684,744,4,10,6,150
059519702,ny,-73.46006,40.79052,1808,4,10,6,150
059519703,ny,-73.4863,40.78854,1242,5,11,6,120
059519704,ny,-73.47648,40.78184,1103,4,10,6,150
059519801,ny,-73.48815,40.76937,803,2,6,4,200
059519802,ny,-73.47009,40.77,1620,2,6,4,200
059519900,ny,-73.4843,40.76231,1776,2,6,4,200
059520001,ny,-73.492,40.74789,2113,2,6,4,200
059520002,ny,-73.47546,40.74184,1465,2,6,4,200
059520100,ny,-73.45452,40.75575,1898,2,6,4,200
059520200,ny,-73.47797,40.7291,1046,2,5,3,150
059520300,ny,-73.47639,40.72084,1885,2,5,3,150
059520401,ny,-73.44985,40.73563,1177,2,6,4,200
059520402,ny,-73.4432,40.72956,1039,2,5,3,150
059520501,ny,-73.45671,40.72523,1168,2,5,3,150
059520502,ny,-73.44944,40.71494,1778,2,5,3,150
059520600,ny,-73.43744,40.71438,1837,2,5,3,150
059520700,ny,-73.47014,40.71374,1582,2,5,3,150
059520800,ny,-73.47098,40.70771,1309,2,5,3,150
059520900,ny,-73.4757,40.69794,1493,2,5,3,150
059521000,ny,-73.45963,40.69726,1675,2,5,3,150
059521100,ny,-73.47066,40.68841,1550,2,5,3,150
059521200,ny,-73.47195,40.68047,1116,1,5,4,400
059521301,ny,-73.47287,40.67195,877,1,5,4,400
059521302,ny,-73.47866,40.65711,1975,1,5,4,400
059521400,ny,-73.46273,40.65763,2274,1,5,4,400
059521500,ny,-73.44458,40.69795,1622,2,5,3,150
059521601,ny,-73.45276,40.68454,1479,2,5,3,150
059521602,ny,-73.44335,40.68527,1156,2,5,3,150
059521700,ny,-73.45418,40.66657,1682,2,5,3,150
059521801,ny,-73.436,40.69221,1160,2,5,3,150
059521802,ny,-73.44245,40.67254,1300,2,5,3,150
059521902,ny,-73.45389,40.62515,1777,1,5,4,400
059522000,ny,-73.42888,40.67708,2122,2,5,3,150
059522700,ny,-73.48848,40.68345,1612,1,5,4,400
059980100,ny,-73.65207,40.7205,4,4,10,6,150
059981100,ny,-73.59094,40.81579,23,4,10,6,150
059982100,ny,-73.57026,40.79344,27,5,11,6,120
061000100,ny,-74.04384,40.6922,1,6,13,7,116.7
061000201,ny,-73.98564,40.70983,41,6,13,7,116.7
061000202,ny,-73.97998,40.71005,53,6,13,7,116.7
061000500,ny,-74.01861,40.69075,1,6,13,7,116.7
061000600,ny,-73.98914,40.7101,163,6,13,7,116.7
061000700,ny,-74.00472,40.70323,66,6,13,7,116.7
061000800,ny,-73.99379,40.7098,249,6,13,7,116.7
061000900,ny,-74.00744,40.70007,99,6,13,7,116.7
061001001,ny,-73.97349,40.71216,4,6,13,7,116.7
061001002,ny,-73.97394,40.71631,7,6,13,7,116.7
061001200,ny,-73.98209,40.71591,34,6,13,7,116.7
061001300,ny,-74.01299,40.70913,88,6,13,7,116.7
061001401,ny,-73.98733,40.71516,11,6,13,7,116.7
061001402,ny,-73.98588,40.71751,87,6,13,7,116.7
061001501,ny,-74.00162,40.70776,139,6,13,7,116.7
061001502,ny,-74.00309,40.70555,135,6,13,7,116.7
061001600,ny,-73.99327,40.71596,313,6,13,7,116.7
061001800,ny,-73.99084,40.71905,314,6,13,7,116.7
061002000,ny,-73.97284,40.71933,4,6,13,7,116.7
061002100,ny,-74.01005,40.71433,174,6,13,7,116.7
061002201,ny,-73.98184,40.71912,103,6,13,7,116.7
061002202,ny,-73.98114,40.72126,97,6,13,7,116.7
061002400,ny,-73.96979,40.72267,7,6,13,7,116.7
061002500,ny,-73.99763,40.70878,6,6,13,7,116.7
061002601,ny,-73.97993,40.72258,145,6,13,7,116.7
061002602,ny,-73.97862,40.72439,200,6,13,7,116.7
061002700,ny,-73.99901,40.71255,50,6,13,7,116.7
061002800,ny,-73.97681,40.72686,159,6,13,7,116.7
061002901,ny,-74.00188,40.71337,19,6,13,7,116.7
061002902,ny,-73.99883,40.71516,206,6,13,7,116.7
061003001,ny,-73.98684,40.72101,216,6,13,7,116.7
061003002,ny,-73.98587,40.72296,86,6,13,7,116.7
061003100,ny,-74.00381,40.71531,84,6,13,7,116.7
061003200,ny,-73.98372,40.72556,290,6,13,7,116.7
061003300,ny,-74.00615,40.71886,368,6,13,7,116.7
061003400,ny,-73.98146,40.72901,334,6,13,7,116.7
061003601,ny,-73.99114,40.72232,97,6,13,7,116.7
061003602,ny,-73.99021,40.72456,130,6,13,7,116.7
061003700,ny,-74.01173,40.7265,229,6,13,7,116.7
061003800,ny,-73.98847,40.72737,454,6,13,7,116.7
061003900,ny,-74.01479,40.72173,228,6,13,7,116.7
061004001,ny,-73.9849,40.73027,158,6,13,7,116.7
061004002,ny,-73.98721,40.73124,145,6,13,7,116.7
061004100,ny,-73.9967,40.71916,363,6,13,7,116.7
061004200,ny,-73.98937,40.7318,76,6,13,7,116.7
061004300,ny,-73.99547,40.72332,236,6,13,7,116.7
061004400,ny,-73.97135,40.72896,6,6,13,7,116.7
061004500,ny,-73.99939,40.72057,142,6,13,7,116.7
061004700,ny,-74.00286,40.72242,273,6,13,7,116.7
061004800,ny,-73.98373,40.73386,243,6,13,7,116.7
061004900,ny,-74.00048,40.72506,354,6,13,7,116.7
061005000,ny,-73.98721,40.73611,188,6,13,7,116.7
061005200,ny,-73.99046,40.73744,157,6,13,7,116.7
061005400,ny,-73.99368,40.73881,189,6,13,7,116.7
061005501,ny,-73.99708,40.72767,26,6,13,7,116.7
061005502,ny,-73.99387,40.72622,164,6,13,7,116.7
061005600,ny,-73.9873,40.74179,90,6,13,7,116.7
061005700,ny,-73.99239,40.72942,56,6,13,7,116.7
061005800,ny,-73.99052,40.74315,187,6,13,7,116.7
061005900,ny,-73.99456,40.73129,87,6,13,7,116.7
061006000,ny,-73.97027,40.73216,4,6,13,7,116.7
061006100,ny,-73.99233,40.73371,159,6,13,7,116.7
061006200,ny,-73.96922,40.73711,20,6,13,7,116.7
061006300,ny,-73.99686,40.73442,315,6,13,7,116.7
061006400,ny,-73.98146,40.73695,161,6,13,7,116.7
061006500,ny,-73.99958,40.72997,279,6,13,7,116.7
061006600,ny,-73.97923,40.74007,157,6,13,7,116.7
061006700,ny,-74.00412,40.73045,381,6,13,7,116.7
061006800,ny,-73.98408,40.74044,191,6,13,7,116.7
061006900,ny,-74.01364,40.73061,69,6,13,7,116.7
061007001,ny,-73.97582,40.74271,52,6,13,7,116.7
061007002,ny,-73.97813,40.74368,177,6,13,7,116.7
061007100,ny,-73.99991,40.73545,324,6,13,7,116.7
061007200,ny,-73.98086,40.74487,241,6,13,7,116.7
061007300,ny,-74.00411,40.73411,441,6,13,7,116.7
061007400,ny,-73.98408,40.74621,165,6,13,7,116.7
061007500,ny,-74.01295,40.73438,211,6,13,7,116.7
061007600,ny,-73.9873,40.74757,176,6,13,7,116.7
061007700,ny,-74.0033,40.73808,362,6,13,7,116.7
061007800,ny,-73.97467,40.74632,161,6,13,7,116.7
061007900,ny,-74.01238,40.73954,251,6,13,7,116.7
061008000,ny,-73.97765,40.74926,257,6,13,7,116.7
061008100,ny,-73.99877,40.73981,264,6,13,7,116.7
061008200,ny,-73.98087,40.75061,137,6,13,7,116.7
061008300,ny,-74.00445,40.7422,124,6,13,7,116.7
061008400,ny,-73.98409,40.75197,157,6,13,7,116.7
061008601,ny,-73.96667,40.74404,20,6,13,7,116.7
061008602,ny,-73.96392,40.74854,4,6,13,7,116.7
061008603,ny,-73.96289,40.75317,91,6,13,7,116.7
061008700,ny,-73.997,40.74224,258,6,13,7,116.7
061008800,ny,-73.97238,40.7495,87,6,13,7,116.7
061008900,ny,-74.00268,40.74464,320,6,13,7,116.7
061009000,ny,-73.97009,40.75266,165,6,13,7,116.7
061009100,ny,-73.9952,40.74472,214,6,13,7,116.7
061009200,ny,-73.97474,40.75365,77,6,13,7,116.7
061009300,ny,-74.00088,40.74711,178,6,13,7,116.7
061009400,ny,-73.97775,40.75523,94,6,13,7,116.7
061009500,ny,-73.99336,40.74724,212,6,13,7,116.7
061009600,ny,-73.98089,40.75637,154,6,13,7,116.7
061009700,ny,-73.99903,40.74964,61,6,13,7,116.7
061009800,ny,-73.96777,40.75579,309,6,13,7,116.7
061009901,ny,-74.01073,40.74778,141,6,13,7,116.7
061009902,ny,-74.00829,40.75325,70,6,13,7,116.7
061009903,ny,-74.00586,40.75738,59,6,13,7,116.7
061010000,ny,-73.97123,40.75807,89,6,13,7,116.7
061010100,ny,-73.99154,40.74973,83,6,13,7,116.7
061010200,ny,-73.97445,40.75942,98,6,13,7,116.7
061010300,ny,-73.99722,40.75214,70,6,13,7,116.7
061010400,ny,-73.97767,40.76078,108,6,13,7,116.7
061010601,ny,-73.95999,40.75677,101,6,13,7,116.7
061010602,ny,-73.95804,40.75985,53,6,13,7,116.7
061010801,ny,-73.96617,40.75798,60,6,13,7,116.7
061010802,ny,-73.96388,40.75912,77,6,13,7,116.7
061010803,ny,-73.96618,40.76009,57,6,13,7,116.7
061010900,ny,-73.9897,40.75225,126,6,13,7,116.7
061011000,ny,-73.96314,40.76215,255,6,13,7,116.7
061011100,ny,-73.99539,40.75465,159,6,13,7,116.7
061011201,ny,-73.97535,40.76398,54,6,13,7,116.7
061011202,ny,-73.97213,40.7626,39,6,13,7,116.7
061011203,ny,-73.96891,40.76124,68,6,13,7,116.7
061011300,ny,-73.98787,40.75478,104,6,13,7,116.7
061011401,ny,-73.97049,40.76484,98,6,13,7,116.7
061011402,ny,-73.96728,40.76348,168,6,13,7,116.7
061011500,ny,-73.99355,40.75717,122,6,13,7,116.7
061011600,ny,-73.95492,40.7628,53,6,13,7,116.7
061011700,ny,-74.00272,40.7611,38,6,13,7,116.7
061011800,ny,-73.96086,40.76527,142,6,13,7,116.7
061011900,ny,-73.98602,40.75732,95,6,13,7,116.7
061012000,ny,-73.96477,40.76693,240,6,13,7,116.7
061012101,ny,-73.99028,40.75911,120,6,13,7,116.7
061012102,ny,-73.99312,40.76031,150,6,13,7,116.7
061012200,ny,-73.96798,40.76828,295,6,13,7,116.7
061012400,ny,-73.95267,40.76628,132,6,13,7,116.7
061012500,ny,-73.98418,40.75984,109,6,13,7,116.7
061012601,ny,-73.95741,40.76799,107,6,13,7,116.7
061012602,ny,-73.95971,40.76897,120,6,13,7,116.7
061012700,ny,-73.98986,40.76224,330,6,13,7,116.7
061012800,ny,-73.96152,40.77138,263,6,13,7,116.7
061012901,ny,-74.00116,40.76371,78,6,13,7,116.7
061012902,ny,-73.9992,40.7663,126,6,13,7,116.7
061013000,ny,-73.96473,40.77274,245,6,13,7,116.7
061013100,ny,-73.98235,40.76235,56,6,13,7,116.7
061013201,ny,-73.94963,40.76837,79,6,13,7,116.7
061013202,ny,-73.9497,40.76981,22,6,13,7,116.7
061013203,ny,-73.95227,40.77089,98,6,13,7,116.7
061013300,ny,-73.98804,40.76474,236,6,13,7,116.7
061013400,ny,-73.95617,40.7717,287,6,13,7,116.7
061013501,ny,-73.99721,40.76867,54,6,13,7,116.7
061013502,ny,-73.9958,40.77161,52,6,13,7,116.7
061013601,ny,-73.94482,40.77157,19,6,13,7,116.7
061013602,ny,-73.94854,40.77187,54,6,13,7,116.7
061013603,ny,-73.95085,40.77284,60,6,13,7,116.7
061013604,ny,-73.9485,40.77396,148,6,13,7,116.7
061013700,ny,-73.98024,40.76521,132,6,13,7,116.7
061013800,ny,-73.95382,40.77492,303,6,13,7,116.7
061013900,ny,-73.98617,40.76729,177,6,13,7,116.7
061014000,ny,-73.95821,40.77591,279,6,13,7,116.7
061014200,ny,-73.96143,40.77727,278,6,14,8,133.3
061014300,ny,-73.96556,40.78248,1,6,14,8,133.3
061014401,ny,-73.94755,40.77525,108,6,13,7,116.7
061014402,ny,-73.94532,40.77624,202,6,14,8,133.3
061014500,ny,-73.98427,40.76982,33,6,13,7,116.7
061014601,ny,-73.95216,40.77719,129,6,14,8,133.3
061014602,ny,-73.95098,40.77881,150,6,14,8,133.3
061014700,ny,-73.9888,40.77133,15,6,13,7,116.7
061014801,ny,-73.95607,40.77884,53,6,14,8,133.3
061014802,ny,-73.95443,40.78109,155,6,14,8,133.3
061014900,ny,-73.98248,40.77235,55,6,13,7,116.7
061015001,ny,-73.95928,40.7802,38,6,14,8,133.3
061015002,ny,-73.95765,40.78245,91,6,14,8,133.3
061015101,ny,-73.98697,40.77384,16,6,13,7,116.7
061015102,ny,-73.99371,40.7756,31,6,13,7,116.7
061015200,ny,-73.94102,40.77821,64,6,14,8,133.3
061015301,ny,-73.97924,40.77426,139,6,13,7,116.7
061015302,ny,-73.98208,40.77545,68,6,14,8,133.3
061015401,ny,-73.94981,40.78041,113,6,14,8,133.3
061015402,ny,-73.94754,40.7815,100,6,14,8,133.3
061015403,ny,-73.94985,40.78248,9,6,14,8,133.3
061015501,ny,-73.98492,40.77665,15,6,14,8,133.3
061015502,ny,-73.99175,40.77928,16,6,14,8,133.3
061015601,ny,-73.9475,40.78357,74,6,14,8,133.3
061015602,ny,-73.94633,40.78518,19,6,14,8,133.3
061015700,ny,-73.97879,40.77742,322,6,14,8,133.3
061015801,ny,-73.9521,40.78428,220,6,14,8,133.3
061015802,ny,-73.95046,40.78652,58,6,14,8,133.3
061015900,ny,-73.98742,40.78054,221,6,14,8,133.3
061016001,ny,-73.95532,40.78563,180,6,14,8,133.3
061016002,ny,-73.95369,40.78788,46,6,14,8,133.3
061016100,ny,-73.97719,40.77995,326,6,14,8,133.3
061016200,ny,-73.9357,40.78418,31,6,14,8,133.3
061016300,ny,-73.98723,40.78398,211,6,14,8,133.3
061016400,ny,-73.94447,40.78771,64,6,14,8,133.3
061016500,ny,-73.975,40.78236,217,6,14,8,133.3
061016600,ny,-73.94839,40.78937,259,6,14,8,133.3
061016700,ny,-73.98372,40.78647,170,6,14,8,133.3
061016800,ny,-73.95136,40.79108,46,6,14,8,133.3
061016900,ny,-73.97312,40.7852,329,6,14,8,133.3
061017000,ny,-73.94215,40.7909,151,6,14,8,133.3
061017100,ny,-73.98249,40.78907,199,6,14,8,133.3
061017200,ny,-73.94513,40.79383,277,6,14,8,133.3
061017300,ny,-73.97124,40.78777,353,6,14,8,133.3
061017401,ny,-73.94858,40.79489,37,6,14,8,133.3
061017402,ny,-73.94716,40.7968,27,6,14,8,133.3
061017500,ny,-73.98064,40.79166,197,6,14,8,133.3
061017700,ny,-73.96939,40.79031,130,6,14,8,133.3
061017800,ny,-73.93213,40.7938,287,6,13,7,116.7
061017900,ny,-73.9788,40.79422,165,6,14,8,133.3
061018000,ny,-73.93959,40.7944,202,6,14,8,133.3
061018100,ny,-73.96775,40.79256,178,6,14,8,133.3
061018200,ny,-73.94185,40.79832,177,6,14,8,133.3
061018300,ny,-73.97685,40.79675,120,6,14,8,133.3
061018400,ny,-73.94507,40.79968,160,6,14,8,133.3
061018500,ny,-73.96636,40.7945,20,6,14,8,133.3
061018600,ny,-73.94971,40.79911,25,6,14,8,133.3
061018700,ny,-73.97506,40.79934,165,6,14,8,133.3
061018800,ny,-73.93726,40.79759,322,6,14,8,133.3
061018900,ny,-73.96425,40.79733,192,6,14,8,133.3
061019000,ny,-73.94762,40.80196,87,6,14,8,133.3
061019100,ny,-73.97311,40.80182,183,6,14,8,133.3
061019200,ny,-73.92941,40.79947,53,6,13,7,116.7
061019300,ny,-73.96196,40.80051,185,6,14,8,133.3
061019400,ny,-73.93519,40.80047,189,6,14,8,133.3
061019500,ny,-73.97126,40.80428,156,6,14,8,133.3
061019600,ny,-73.93858,40.80281,193,6,14,8,133.3
061019701,ny,-73.9594,40.80531,9,6,14,8,133.3
061019702,ny,-73.95799,40.80219,75,6,14,8,133.3
061019800,ny,-73.94236,40.8043,113,6,14,8,133.3
061019900,ny,-73.96966,40.80694,150,6,14,8,133.3
061020000,ny,-73.94523,40.80579,303,6,14,8,133.3
061020101,ny,-73.9602,40.80644,26,6,14,8,133.3
061020102,ny,-73.95663,40.80505,137,6,14,8,133.3
061020300,ny,-73.96156,40.80867,25,6,14,8,133.3
061020500,ny,-73.96807,40.81149,53,6,14,8,133.3
061020600,ny,-73.93879,40.80829,271,6,14,8,133.3
061020701,ny,-73.95846,40.80898,28,6,14,8,133.3
061020800,ny,-73.94201,40.80965,387,6,14,8,133.3
061020901,ny,-73.955,40.81156,72,6,14,8,133.3
061021000,ny,-73.93475,40.81392,11,6,14,8,133.3
061021100,ny,-73.96349,40.81572,84,6,14,8,133.3
061021200,ny,-73.939,40.81376,67,6,14,8,133.3
061021303,ny,-73.95314,40.81456,140,6,14,8,133.3
061021400,ny,-73.93621,40.81779,14,6,14,8,133.3
061021500,ny,-73.94947,40.81353,83,6,14,8,133.3
061021600,ny,-73.95439,40.80068,226,6,14,8,133.3
061021703,ny,-73.94976,40.81793,22,6,14,8,133.3
061021800,ny,-73.95252,40.80322,234,6,14,8,133.3
061021900,ny,-73.95994,40.81873,112,6,14,8,133.3
061022000,ny,-73.95066,40.80578,373,6,14,8,133.3
061022102,ny,-73.94619,40.81865,163,6,14,8,133.3
061022200,ny,-73.94879,40.80834,273,6,14,8,133.3
061022301,ny,-73.95768,40.82234,128,6,14,8,133.3
061022302,ny,-73.96044,40.82159,17,6,14,8,133.3
061022400,ny,-73.94696,40.81112,229,6,14,8,133.3
061022500,ny,-73.95648,40.82482,188,6,14,8,133.3
061022600,ny,-73.94481,40.81343,377,6,14,8,133.3
061022700,ny,-73.94646,40.82297,351,6,14,8,133.3
061022800,ny,-73.94325,40.81593,390,6,14,8,133.3
061022900,ny,-73.95461,40.82705,187,6,14,8,133.3
061023000,ny,-73.94139,40.81847,263,6,14,8,133.3
061023100,ny,-73.94409,40.82583,284,6,14,8,133.3
061023200,ny,-73.93953,40.82101,155,6,14,8,133.3
061023300,ny,-73.95394,40.83001,244,6,14,8,133.3
061023400,ny,-73.93867,40.82373,85,6,14,8,133.3
061023501,ny,-73.94184,40.829,184,6,14,8,133.3
061023502,ny,-73.93893,40.82789,47,6,14,8,133.3
061023600,ny,-73.93522,40.82451,69,6,14,8,133.3
061023700,ny,-73.95153,40.83294,165,6,14,8,133.3
061023802,ny,-73.9422,40.7684,1,6,13,7,116.7
061023803,ny,-73.94847,40.76176,4,6,13,7,116.7
061023804,ny,-73.95487,40.75438,17,6,13,7,116.7
061023900,ny,-73.94106,40.83234,50,6,14,8,133.3
061024000,ny,-73.92279,40.79016,8,6,13,7,116.7
061024100,ny,-73.95042,40.83572,119,6,14,8,133.3
061024200,ny,-73.93348,40.80583,121,6,14,8,133.3
061024301,ny,-73.93876,40.83597,137,6,14,8,133.3
061024302,ny,-73.93585,40.83172,7,6,14,8,133.3
061024500,ny,-73.9421,40.83663,229,6,14,8,133.3
061024700,ny,-73.95027,40.83976,67,6,14,8,133.3
061024900,ny,-73.93645,40.83913,40,6,14,8,133.3
061025100,ny,-73.93992,40.84033,77,6,14,8,133.3
061025300,ny,-73.93838,40.84289,163,6,14,8,133.3
061025500,ny,-73.94768,40.84609,70,6,14,8,133.3
061025700,ny,-73.95407,40.80844,198,6,14,8,133.3
061025900,ny,-73.94236,40.82321,88,6,14,8,133.3
061026100,ny,-73.93446,40.84578,159,6,14,8,133.3
061026300,ny,-73.93748,40.84682,102,6,14,8,133.3
061026500,ny,-73.94013,40.84962,84,6,14,8,133.3
061026700,ny,-73.92865,40.85033,18,6,14,8,133.3
061026900,ny,-73.93097,40.85056,218,6,14,8,133.3
061027100,ny,-73.93429,40.85194,122,6,14,8,133.3
061027300,ny,-73.93738,40.85398,72,6,14,8,133.3
061027500,ny,-73.94412,40.85586,30,6,14,8,133.3
061027700,ny,-73.92739,40.85544,62,6,14,8,133.3
061027900,ny,-73.93163,40.85586,124,6,14,8,133.3
061028100,ny,-73.93453,40.85706,25,6,14,8,133.3
061028300,ny,-73.92872,40.85891,68,6,14,8,133.3
061028500,ny,-73.92805,40.8615,91,6,14,8,133.3
061028700,ny,-73.93627,40.8656,55,6,14,8,133.3
061029100,ny,-73.92393,40.86431,127,6,14,8,133.3
061029300,ny,-73.92012,40.86593,95,6,14,8,133.3
061029500,ny,-73.92494,40.86752,103,6,14,8,133.3
061029700,ny,-73.92674,40.87449,6,6,14,8,133.3
061029900,ny,-73.91631,40.86448,95,6,14,8,133.3
061030300,ny,-73.91865,40.86922,60,6,14,8,133.3
061030700,ny,-73.91667,40.87127,63,6,14,8,133.3
061030900,ny,-73.91037,40.87585,227,6,14,8,133.3
061031100,ny,-73.92952,40.84639,4,6,14,8,133.3
061031703,ny,-74.01847,40.71604,24,6,13,7,116.7
061031704,ny,-74.02035,40.70847,22,6,13,7,116.7
061031900,ny,-74.01934,40.70245,4,6,13,7,116.7
063020100,ny,-79.05474,43.12229,1487,2,5,3,150
063020200,ny,-79.04314,43.1181,1045,2,5,3,150
063020300,ny,-79.0131,43.10624,1069,2,5,3,150
063020400,ny,-79.03907,43.10969,782,2,5,3,150
063020500,ny,-79.05502,43.10205,946,2,5,3,150
063020600,ny,-79.04437,43.10471,742,2,5,3,150
063020700,ny,-79.03409,43.10454,1069,2,5,3,150
063020900,ny,-79.0451,43.09811,858,2,5,3,150
063021000,ny,-79.03239,43.09829,1145,2,5,3,150
063021100,ny,-79.06071,43.08351,778,2,5,3,150
063021200,ny,-79.04608,43.08449,1344,2,5,3,150
063021300,ny,-79.03725,43.09182,858,2,5,3,150
063021400,ny,-79.02784,43.09157,895,2,5,3,150
063021700,ny,-79.01831,43.0798,1879,2,5,3,150
063022000,ny,-78.99316,43.08232,1764,2,5,3,150
063022100,ny,-78.97886,43.0877,1049,2,5,3,150
063022200,ny,-78.96583,43.07317,1559,2,5,3,150
063022300,ny,-78.96707,43.08528,1021,2,5,3,150
063022401,ny,-78.95256,43.08313,1171,2,5,3,150
063022500,ny,-78.95129,43.09298,1043,2,5,3,150
063022601,ny,-79.00043,43.12589,1380,2,5,3,150
063022602,ny,-78.96966,43.10937,2334,2,5,3,150
063022702,ny,-78.76639,43.1015,3112,2,5,3,150
063022713,ny,-78.88227,43.07662,1238,2,5,3,150
063022714,ny,-78.92331,43.07842,1785,2,5,3,150
063022715,ny,-78.91438,43.11357,963,2,5,3,150
063022716,ny,-78.83483,43.07104,1149,2,5,3,150
063022717,ny,-78.85706,43.10654,2426,2,5,3,150
063022803,ny,-78.85884,43.05583,1503,2,5,3,150
063022804,ny,-78.84527,43.05557,1574,2,5,3,150
063022901,ny,-78.89087,43.04801,895,2,5,3,150
063022902,ny,-78.89539,43.06151,1375,2,5,3,150
063023001,ny,-78.88196,43.03847,850,2,5,3,150
063023100,ny,-78.87372,43.03365,893,2,5,3,150
063023200,ny,-78.87632,43.02747,950,2,5,3,150
063023301,ny,-78.84175,43.03379,1326,2,4,2,100
063023302,ny,-78.85773,43.03324,1207,2,5,3,150
063023401,ny,-78.7037,43.18473,3055,2,5,3,150
063023402,ny,-78.63681,43.14648,2088,2,5,3,150
063023404,ny,-78.66603,43.11386,1757,2,5,3,150
063023405,ny,-78.688,43.12281,336,2,5,3,150
063023500,ny,-78.69028,43.18439,1170,2,6,4,200
063023600,ny,-78.71487,43.16776,1672,2,6,4,200
063023700,ny,-78.6918,43.16883,649,2,6,4,200
063023800,ny,-78.6768,43.17412,1291,2,6,4,200
063023901,ny,-78.69395,43.1572,1480,2,6,4,200
063023902,ny,-78.67069,43.16485,1851,2,6,4,200
063024001,ny,-78.54413,43.15154,3258,2,5,3,150
063024002,ny,-78.47573,43.21172,732,2,5,3,150
063024101,ny,-78.54986,43.26035,1946,2,5,3,150
063024102,ny,-78.54571,43.33719,1569,2,5,3,150
063024201,ny,-78.6856,43.25863,2660,2,6,4,200
063024202,ny,-78.70237,43.31307,1705,2,5,3,150
063024301,ny,-78.82644,43.31152,586,2,6,4,200
063024302,ny,-78.82381,43.27032,2511,3,6,3,100
063024303,ny,-78.82025,43.17659,2612,2,5,3,150
063024401,ny,-79.03998,43.17237,1186,2,5,3,150
063024404,ny,-79.02088,43.17039,2010,2,5,3,150
063024405,ny,-78.95758,43.19409,2610,2,6,4,200
063024406,ny,-78.97769,43.1416,1013,2,5,3,150
063024501,ny,-79.0422,43.23995,1267,2,5,3,150
063024502,ny,-78.96792,43.25627,2176,3,6,3,100
063024600,ny,-78.87443,43.0562,2072,2,5,3,150
063940001,ny,-78.95087,43.16288,1,2,5,3,150
063940100,ny,-78.47723,43.08889,2,2,5,3,150
065020102,ny,-75.23765,43.1061,672,2,6,4,200
065020300,ny,-75.23371,43.10047,565,2,6,4,200
065020705,ny,-75.25723,43.08517,715,2,6,4,200
065020802,ny,-75.19845,43.09382,1274,2,6,4,200
065020803,ny,-75.21643,43.09781,776,2,6,4,200
065020900,ny,-75.24721,43.10203,861,2,6,4,200
065021000,ny,-75.22393,43.09806,436,2,6,4,200
065021103,ny,-75.2675,43.08932,478,2,6,4,200
065021104,ny,-75.25015,43.09513,1109,2,6,4,200
065021201,ny,-75.2287,43.08995,712,2,6,4,200
065021202,ny,-75.23436,43.08429,793,2,6,4,200
065021301,ny,-75.19794,43.07878,410,2,6,4,200
065021302,ny,-75.21175,43.08791,1579,2,6,4,200
065021303,ny,-75.2199,43.0801,1084,2,6,4,200
065021401,ny,-75.25969,43.09742,1017,2,6,4,200
065021402,ny,-75.26057,43.10847,696,2,6,4,200
065021500,ny,-75.23712,43.08953,905,2,6,4,200
065021601,ny,-75.18731,43.11459,2135,3,8,5,166.7
065021602,ny,-75.21923,43.12361,1210,3,8,5,166.7
065021701,ny,-75.27177,43.07563,1468,2,6,4,200
065021702,ny,-75.28236,43.0842,1173,2,6,4,200
065021900,ny,-75.47049,43.20736,880,2,6,4,200
065022000,ny,-75.47665,43.22461,1317,2,6,4,200
065022100,ny,-75.46661,43.23034,1137,2,6,4,200
065022200,ny,-75.44928,43.22807,950,2,6,4,200
065022400,ny,-75.43937,43.21983,1289,2,6,4,200
065022500,ny,-75.4313,43.21012,1417,2,6,4,200
065022701,ny,-75.44843,43.23958,840,2,6,4,200
065022702,ny,-75.49345,43.25511,2201,2,6,4,200
065022800,ny,-75.51182,43.20496,1679,2,6,4,200
065023000,ny,-75.44759,43.12156,2956,2,5,3,150
065023200,ny,-75.29071,43.12593,1829,3,8,5,166.7
065023300,ny,-75.27396,43.11245,1329,3,8,5,166.7
065023400,ny,-75.28865,43.09966,1908,2,7,5,250
065023501,ny,-75.30672,43.10896,1133,3,7,4,133.3
065023502,ny,-75.33622,43.12089,1938,2,7,5,250
065023702,ny,-75.32976,43.24624,1664,2,5,3,150
065023901,ny,-75.19876,43.12925,1043,3,8,5,166.7
065023902,ny,-75.14528,43.18407,1008,1,4,3,300
065024000,ny,-75.20207,43.25474,2316,1,4,3,300
065024101,ny,-75.15486,43.4955,3494,0,1,1,NA
065024102,ny,-75.20958,43.35417,2506,0,2,2,NA
065024200,ny,-75.29278,43.4661,2901,0,2,2,NA
065024301,ny,-75.4741,43.28819,1392,2,5,3,150
065024302,ny,-75.52159,43.32927,1770,1,4,3,300
065024303,ny,-75.41536,43.37216,1853,1,3,2,200
065024400,ny,-75.68012,43.38425,2646,1,4,3,300
065024500,ny,-75.77957,43.34364,2681,1,4,3,300
065024700,ny,-75.61889,43.15918,3388,2,6,4,200
065024800,ny,-75.59922,43.07044,1257,2,5,3,150
065024900,ny,-75.53175,43.06576,2443,2,5,3,150
065025001,ny,-75.34834,43.05104,1148,2,5,3,150
065025002,ny,-75.37388,43.02637,1657,1,4,3,300
065025003,ny,-75.42501,43.03182,746,2,5,3,150
065025100,ny,-75.28862,43.07104,772,2,6,4,200
065025200,ny,-75.33196,43.08538,1767,2,6,4,200
065025300,ny,-75.29838,43.04912,2956,2,5,3,150
065025400,ny,-75.24476,43.04834,2605,1,4,3,300
065025500,ny,-75.26614,42.97989,2144,1,3,2,200
065025601,ny,-75.3862,42.96712,1140,1,3,2,200
065025602,ny,-75.50223,42.97718,1154,1,3,2,200
065025700,ny,-75.37648,42.90037,1236,1,3,2,200
065025800,ny,-75.25882,42.90577,724,1,3,2,200
065025900,ny,-75.48286,43.18231,11,2,5,3,150
065026100,ny,-75.36793,43.15386,1167,2,6,4,200
065026200,ny,-75.26506,43.17347,2827,2,6,4,200
065026300,ny,-75.45753,43.21597,1346,2,6,4,200
065026400,ny,-75.24418,43.09116,1324,2,6,4,200
065026501,ny,-75.27046,43.09782,10,2,6,4,200
065026502,ny,-75.25819,43.1027,11,2,6,4,200
065026600,ny,-75.30438,43.16326,4,2,6,4,200
065026700,ny,-75.7777,43.23443,4095,2,6,4,200
065980002,ny,-75.20909,43.10779,179,2,7,5,250
065980003,ny,-75.24657,43.07712,9,2,6,4,200
065980100,ny,-75.40735,43.22811,69,2,6,4,200
067000100,ny,-76.17395,43.06647,415,3,8,5,166.7
067000200,ny,-76.1584,43.07478,1075,3,8,5,166.7
067000300,ny,-76.14838,43.08108,577,3,8,5,166.7
067000400,ny,-76.13777,43.07618,1397,3,8,5,166.7
067000501,ny,-76.15699,43.06375,746,3,8,5,166.7
067000600,ny,-76.15264,43.06999,749,3,8,5,166.7
067000700,ny,-76.14574,43.06925,452,3,8,5,166.7
067000800,ny,-76.13874,43.06811,789,3,7,4,133.3
067000900,ny,-76.12712,43.06784,1131,3,7,4,133.3
067001000,ny,-76.10957,43.07222,1106,3,7,4,133.3
067001400,ny,-76.14812,43.06384,654,3,8,5,166.7
067001500,ny,-76.1401,43.06126,655,3,7,4,133.3
067001600,ny,-76.13794,43.05704,248,3,7,4,133.3
067001701,ny,-76.12621,43.05754,754,3,6,3,100
067001702,ny,-76.11791,43.06085,903,3,7,4,133.3
067001800,ny,-76.10988,43.06228,952,3,7,4,133.3
067001900,ny,-76.09686,43.06356,1621,3,7,4,133.3
067002000,ny,-76.1933,43.05681,813,3,7,4,133.3
067002101,ny,-76.17134,43.05262,932,3,8,5,166.7
067002300,ny,-76.14839,43.05552,366,3,8,5,166.7
067002400,ny,-76.13515,43.05401,527,3,7,4,133.3
067002700,ny,-76.19073,43.05014,621,3,7,4,133.3
067002901,ny,-76.1819,43.04419,1042,3,7,4,133.3
067003000,ny,-76.1632,43.04615,455,3,8,5,166.7
067003200,ny,-76.15036,43.04782,366,3,8,5,166.7
067003400,ny,-76.1342,43.04858,408,3,7,4,133.3
067003500,ny,-76.11984,43.04836,595,3,6,3,100
067003601,ny,-76.10928,43.05095,678,3,6,3,100
067003602,ny,-76.09555,43.05379,742,3,7,4,133.3
067003800,ny,-76.17987,43.03595,697,3,8,5,166.7
067003900,ny,-76.16608,43.03697,1063,3,8,5,166.7
067004000,ny,-76.16239,43.04158,441,3,8,5,166.7
067004200,ny,-76.14909,43.03867,287,3,8,5,166.7
067004301,ny,-76.14001,43.03886,50,3,7,4,133.3
067004302,ny,-76.13466,43.04005,206,3,7,4,133.3
067004401,ny,-76.1209,43.03349,1148,3,6,3,100
067004500,ny,-76.12239,43.04045,778,3,6,3,100
067004600,ny,-76.09778,43.0401,1978,3,7,4,133.3
067004800,ny,-76.19215,43.0278,698,3,7,4,133.3
067004900,ny,-76.1785,43.02634,567,3,7,4,133.3
067005000,ny,-76.1699,43.02664,929,3,7,4,133.3
067005100,ny,-76.1604,43.02368,846,3,7,4,133.3
067005200,ny,-76.15905,43.03219,898,3,8,5,166.7
067005300,ny,-76.14764,43.03171,514,3,8,5,166.7
067005400,ny,-76.14556,43.02452,959,3,7,4,133.3
067005500,ny,-76.13376,43.02104,738,2,5,3,150
067005601,ny,-76.12122,43.02437,714,2,6,4,200
067005602,ny,-76.11718,43.01801,36,2,5,3,150
067005700,ny,-76.16376,43.01527,794,3,6,3,100
067005800,ny,-76.15264,43.01991,881,3,7,4,133.3
067005900,ny,-76.14456,43.01703,667,3,6,3,100
067006000,ny,-76.15581,42.99772,1402,3,6,3,100
067006101,ny,-76.14147,43.00719,1046,2,6,4,200
067006102,ny,-76.13025,42.99852,121,2,5,3,150
067006103,ny,-76.14162,42.99266,1143,2,6,4,200
067010100,ny,-76.03126,43.18345,1565,3,7,4,133.3
067010200,ny,-76.12071,43.21099,2654,3,8,5,166.7
067010301,ny,-76.11028,43.1648,2206,3,8,5,166.7
067010321,ny,-76.08381,43.18315,1186,3,8,5,166.7
067010322,ny,-76.1019,43.18813,1412,3,8,5,166.7
067010400,ny,-76.03069,43.14661,1753,3,8,5,166.7
067010500,ny,-76.10686,43.14537,1043,3,8,5,166.7
067010600,ny,-76.10356,43.12636,1048,3,8,5,166.7
067010700,ny,-76.12196,43.13608,870,3,8,5,166.7
067010800,ny,-76.13749,43.13202,1724,3,8,5,166.7
067010900,ny,-76.14691,43.12376,1112,3,8,5,166.7
067011011,ny,-76.17075,43.12413,1186,3,8,5,166.7
067011012,ny,-76.18113,43.13297,903,3,8,5,166.7
067011021,ny,-76.16471,43.151,979,3,8,5,166.7
067011022,ny,-76.15383,43.13615,1076,3,8,5,166.7
067011101,ny,-76.22218,43.14137,2183,3,8,5,166.7
067011102,ny,-76.20016,43.13182,525,3,8,5,166.7
067011201,ny,-76.24947,43.16609,1111,3,8,5,166.7
067011202,ny,-76.23955,43.17655,1687,3,8,5,166.7
067011231,ny,-76.22138,43.15768,1737,3,8,5,166.7
067011232,ny,-76.20632,43.16923,1757,3,8,5,166.7
067011241,ny,-76.17268,43.17525,1077,3,8,5,166.7
067011242,ny,-76.14123,43.16455,2262,3,8,5,166.7
067011300,ny,-76.20262,43.21281,1871,3,8,5,166.7
067011401,ny,-76.30253,43.19432,2533,3,8,5,166.7
067011402,ny,-76.41201,43.18528,2440,3,8,5,166.7
067011500,ny,-76.27605,43.14882,2521,3,8,5,166.7
067011600,ny,-76.33998,43.16878,2038,3,8,5,166.7
067011700,ny,-76.33977,43.1491,1127,3,8,5,166.7
067011800,ny,-76.30028,43.12885,1882,3,8,5,166.7
067011900,ny,-76.36661,43.11822,2295,3,8,5,166.7
067012000,ny,-76.43884,43.05344,2894,3,7,4,133.3
067012100,ny,-76.32489,43.0601,2289,3,7,4,133.3
067012200,ny,-76.30944,43.03879,455,2,6,4,200
067012300,ny,-76.30676,43.02558,1312,2,5,3,150
067012400,ny,-76.28093,43.05098,1631,2,6,4,200
067012500,ny,-76.25434,43.04755,1314,2,6,4,200
067012600,ny,-76.24994,43.0372,2277,2,6,4,200
067012700,ny,-76.25005,43.06453,1033,2,6,4,200
067012800,ny,-76.23192,43.09157,1626,3,8,5,166.7
067012900,ny,-76.2151,43.06193,854,3,7,4,133.3
067013000,ny,-76.21016,43.0534,1658,3,7,4,133.3
067013100,ny,-76.22114,43.0425,2072,3,7,4,133.3
067013200,ny,-76.20157,43.03945,1303,3,7,4,133.3
067013300,ny,-76.2095,43.10644,1077,3,8,5,166.7
067013400,ny,-76.23063,43.11986,1921,3,8,5,166.7
067013500,ny,-76.17786,43.10914,1761,3,8,5,166.7
067013600,ny,-76.19341,43.10181,959,3,8,5,166.7
067013701,ny,-76.19003,43.08933,1844,3,8,5,166.7
067013800,ny,-76.15432,43.10848,941,3,8,5,166.7
067013900,ny,-76.13112,43.10763,1167,3,8,5,166.7
067014000,ny,-76.14271,43.0974,1409,3,8,5,166.7
067014200,ny,-76.1391,43.08564,2150,3,8,5,166.7
067014300,ny,-76.07003,43.0638,1297,3,7,4,133.3
067014400,ny,-76.09675,43.09606,1716,3,8,5,166.7
067014500,ny,-76.05915,43.0954,1819,3,8,5,166.7
067014600,ny,-76.0598,43.05049,1614,3,7,4,133.3
067014700,ny,-76.08812,43.02186,2400,2,6,4,200
067014800,ny,-76.0485,43.01277,1416,2,5,3,150
067014900,ny,-76.07724,42.99258,719,2,5,3,150
067015000,ny,-75.99365,43.04212,2291,3,6,3,100
067015100,ny,-76.00026,43.01923,2155,2,5,3,150
067015201,ny,-76.00688,43.00301,1081,2,5,3,150
067015202,ny,-75.95654,43.00546,1764,1,4,3,300
067015203,ny,-75.98509,42.99159,1050,2,5,3,150
067015400,ny,-76.01722,43.07781,2481,3,7,4,133.3
067015500,ny,-76.02238,43.05226,1340,3,7,4,133.3
067015601,ny,-75.9857,43.09163,1122,3,7,4,133.3
067015602,ny,-75.93617,43.03435,797,1,4,3,300
067015701,ny,-75.98069,42.89142,1355,1,2,1,100
067015702,ny,-75.97997,42.95489,2235,1,3,2,200
067015800,ny,-76.10282,42.90587,2535,1,3,2,200
067016001,ny,-76.23369,42.94461,1886,2,4,2,100
067016002,ny,-76.26352,43.00372,1248,2,4,2,100
067016100,ny,-76.11955,42.97325,943,1,4,3,300
067016200,ny,-76.14721,42.97617,1148,2,4,2,100
067016300,ny,-76.1881,42.99516,2507,2,5,3,150
067016400,ny,-76.22779,43.02202,1513,2,5,3,150
067016501,ny,-76.32046,42.93502,1094,1,4,3,300
067016502,ny,-76.33493,42.98963,1835,2,4,2,100
067016600,ny,-76.41429,42.97707,2371,2,5,3,150
067016700,ny,-76.41225,42.89959,1780,2,5,3,150
067016801,ny,-76.29134,42.83465,1922,1,3,2,200
067016802,ny,-76.22302,42.86489,1861,1,3,2,200
067016901,ny,-76.13528,42.81136,1513,1,2,1,100
067016902,ny,-75.99126,42.82196,1390,1,2,1,100
067940000,ny,-76.15766,42.94013,6,1,4,3,300
069050101,ny,-77.45711,43.00136,1430,3,7,4,133.3
069050103,ny,-77.38453,42.98232,903,3,7,4,133.3
069050104,ny,-77.40665,43.01737,1549,3,7,4,133.3
069050105,ny,-77.40995,42.98589,1306,3,7,4,133.3
069050106,ny,-77.43084,42.95885,750,3,6,3,100
069050203,ny,-77.3633,42.9747,684,3,7,4,133.3
069050204,ny,-77.29812,42.99539,1535,3,8,5,166.7
069050205,ny,-77.34387,42.95387,1718,3,7,4,133.3
069050206,ny,-77.34145,42.9798,708,3,7,4,133.3
069050302,ny,-77.21453,42.96114,1452,3,7,4,133.3
069050303,ny,-77.15675,42.95925,659,3,6,3,100
069050304,ny,-77.18873,43.00779,1181,3,7,4,133.3
069050401,ny,-77.04353,42.92787,1694,3,7,4,133.3
069050402,ny,-77.05175,42.9823,1700,3,7,4,133.3
069050501,ny,-77.42357,42.89949,1759,2,4,2,100
069050502,ny,-77.51833,42.90091,988,2,5,3,150
069050601,ny,-77.32397,42.8256,3014,2,6,4,200
069050603,ny,-77.33859,42.91036,810,2,6,4,200
069050604,ny,-77.27403,42.91804,1007,3,6,3,100
069050800,ny,-77.29537,42.89359,865,3,7,4,133.3
069050900,ny,-77.28019,42.90118,1058,3,7,4,133.3
069051001,ny,-77.28829,42.88139,574,3,7,4,133.3
069051101,ny,-77.27232,42.88941,607,3,7,4,133.3
069051102,ny,-77.27017,42.87739,789,3,7,4,133.3
069051200,ny,-77.18851,42.90018,1509,2,6,4,200
069051301,ny,-77.19454,42.83355,975,2,4,2,100
069051302,ny,-77.21152,42.78591,1782,1,4,3,300
069051400,ny,-77.07377,42.8331,1542,2,5,3,150
069051501,ny,-76.99938,42.80865,1201,3,8,5,166.7
069051502,ny,-77.00018,42.88706,583,3,7,4,133.3
069051600,ny,-77.00331,42.87036,877,3,8,5,166.7
069051700,ny,-76.97745,42.87902,1076,3,8,5,166.7
069051801,ny,-76.98806,42.86809,1909,3,8,5,166.7
069051900,ny,-76.98791,42.85214,659,3,8,5,166.7
069052001,ny,-77.55439,42.71597,1307,1,2,1,100
069052002,ny,-77.53904,42.8147,957,1,4,3,300
069052003,ny,-77.50047,42.75217,1310,1,3,2,200
069052101,ny,-77.40911,42.71567,1926,1,3,2,200
069052102,ny,-77.42377,42.80645,1437,1,3,2,200
069052200,ny,-77.42851,42.62233,1777,1,2,1,100
071000100,ny,-74.01507,41.51412,662,8,16,8,100
071000200,ny,-74.03556,41.511,746,7,15,8,114.3
071000301,ny,-74.02178,41.50143,489,8,16,8,100
071000302,ny,-74.02397,41.50701,1076,8,16,8,100
071000400,ny,-74.0051,41.50556,1225,8,17,9,112.5
071000501,ny,-74.01352,41.49797,631,8,16,8,100
071000502,ny,-74.00758,41.49271,944,8,17,9,112.5
071000600,ny,-74.03654,41.4984,714,7,15,8,114.3
071001100,ny,-74.40657,41.45203,1228,6,14,8,133.3
071001200,ny,-74.40982,41.46041,649,6,14,8,133.3
071001300,ny,-74.4226,41.45955,1113,6,14,8,133.3
071001500,ny,-74.41593,41.43649,1546,6,14,8,133.3
071001601,ny,-74.43993,41.42685,683,6,13,7,116.7
071001602,ny,-74.43222,41.43742,1025,6,14,8,133.3
071002100,ny,-74.68816,41.38372,1178,3,8,5,166.7
071002200,ny,-74.6877,41.37142,1044,4,9,5,125
071002300,ny,-74.69755,41.37364,859,4,9,5,125
071010101,ny,-74.09838,41.57633,1772,4,9,5,125
071010102,ny,-74.02039,41.57333,1854,5,12,7,140
071010200,ny,-74.00744,41.54143,2064,8,16,8,100
071010300,ny,-74.05484,41.53681,1535,5,12,7,140
071010400,ny,-74.05985,41.51111,1731,6,13,7,116.7
071010501,ny,-74.10411,41.52292,1511,4,10,6,150
071010502,ny,-74.09193,41.54038,1624,4,9,5,125
071010601,ny,-74.24234,41.55056,1326,5,11,6,120
071010602,ny,-74.15357,41.55261,1532,4,9,5,125
071010701,ny,-74.19803,41.5626,803,4,10,6,150
071010702,ny,-74.18413,41.55937,1414,4,10,6,150
071010801,ny,-74.22699,41.50427,1486,4,11,7,175
071010802,ny,-74.20445,41.53436,1662,5,11,6,120
071010901,ny,-74.28011,41.59793,1381,5,12,7,140
071010902,ny,-74.33329,41.55537,2305,5,12,7,140
071011000,ny,-74.3581,41.49748,2309,6,13,7,116.7
071011101,ny,-74.3798,41.48302,930,6,13,7,116.7
071011102,ny,-74.35847,41.47348,909,6,14,8,133.3
071011200,ny,-74.38526,41.4412,1714,6,14,8,133.3
071011301,ny,-74.4122,41.46758,1179,6,14,8,133.3
071011302,ny,-74.38054,41.46658,717,6,14,8,133.3
071011400,ny,-74.45246,41.47937,2043,5,12,7,140
071011500,ny,-74.52804,41.46,2625,4,9,5,125
071011601,ny,-74.64212,41.42118,2093,3,7,4,133.3
071011602,ny,-74.67541,41.46159,2076,3,7,4,133.3
071011701,ny,-74.5945,41.37402,2033,3,8,5,166.7
071011702,ny,-74.53767,41.33236,1980,5,12,7,140
071011801,ny,-74.47136,41.40226,1911,6,13,7,116.7
071011802,ny,-74.45056,41.36292,1205,6,14,8,133.3
071011900,ny,-74.3611,41.37972,2837,5,12,7,140
071012100,ny,-74.31984,41.38281,1258,5,12,7,140
071012200,ny,-74.29895,41.39354,1377,5,13,8,160
071012300,ny,-74.25454,41.448,2214,5,12,7,140
071012601,ny,-74.06006,41.4805,1122,6,14,8,133.3
071012602,ny,-74.05325,41.45892,631,7,15,8,114.3
071012700,ny,-74.02643,41.4817,1440,7,15,8,114.3
071012800,ny,-74.01943,41.46724,1597,7,15,8,114.3
071012900,ny,-74.01639,41.44502,1185,6,13,7,116.7
071013000,ny,-74.04734,41.44214,1448,5,11,6,120
071013100,ny,-74.05056,41.41242,2175,4,10,6,150
071013201,ny,-74.13872,41.4331,1475,4,9,5,125
071013202,ny,-74.17007,41.42985,753,4,9,5,125
071013301,ny,-74.16652,41.4064,2353,4,10,6,150
071013302,ny,-74.21945,41.37283,1144,4,10,6,150
071013400,ny,-74.17448,41.37733,1034,3,9,6,200
071013500,ny,-74.13172,41.36362,2249,4,9,5,125
071013600,ny,-74.00994,41.3652,7,7,14,7,100
071013700,ny,-73.96898,41.37189,827,7,15,8,114.3
071013800,ny,-74.0068,41.32938,1101,7,15,8,114.3
071013900,ny,-74.09126,41.31819,2224,4,9,5,125
071014101,ny,-74.18107,41.32639,1283,3,9,6,200
071014102,ny,-74.15488,41.31337,1404,3,8,5,166.7
071014201,ny,-74.21098,41.32431,1534,3,8,5,166.7
071014202,ny,-74.19945,41.29121,2689,3,8,5,166.7
071014301,ny,-74.26969,41.36235,1952,5,11,6,120
071014302,ny,-74.27132,41.32131,2675,3,9,6,200
071014400,ny,-74.35204,41.31032,2124,4,10,6,150
071014501,ny,-74.45026,41.29289,2525,5,12,7,140
071014502,ny,-74.36955,41.23905,2340,3,8,5,166.7
071014601,ny,-74.34149,41.25494,1158,3,8,5,166.7
071014602,ny,-74.35736,41.26404,1073,3,8,5,166.7
071014700,ny,-74.30409,41.27675,1505,3,9,6,200
071014801,ny,-74.28058,41.19524,2034,3,7,4,133.3
071014802,ny,-74.26849,41.24598,1538,2,7,5,250
071014900,ny,-74.17909,41.23014,1817,3,9,6,200
071015003,ny,-74.15917,41.3364,312,4,10,6,150
071015005,ny,-74.18174,41.35009,329,4,10,6,150
071015007,ny,-74.16708,41.33519,168,4,10,6,150
071015008,ny,-74.16589,41.34035,227,4,10,6,150
071015009,ny,-74.17486,41.34401,110,4,10,6,150
071015010,ny,-74.17028,41.34692,161,4,10,6,150
071015100,ny,-74.43076,41.4503,1426,6,14,8,133.3
071015201,ny,-74.1477,41.45896,1727,4,11,7,175
071015202,ny,-74.08996,41.46505,1383,6,13,7,116.7
071015203,ny,-74.15189,41.49395,294,4,10,6,150
073040200,ny,-78.38027,43.26343,1715,3,6,3,100
073040300,ny,-78.38665,43.1724,1328,2,5,3,150
073040400,ny,-78.38815,43.2264,1374,2,5,3,150
073040500,ny,-78.39156,43.21251,920,2,6,4,200
073040601,ny,-78.21114,43.17006,1313,3,6,3,100
073040602,ny,-78.21741,43.24429,2,3,7,4,133.3
073040603,ny,-78.21023,43.2575,1973,3,7,4,133.3
073040701,ny,-78.18839,43.23606,952,3,7,4,133.3
073040702,ny,-78.19572,43.25312,884,3,7,4,133.3
073040801,ny,-78.05634,43.17441,1652,3,6,3,100
073040802,ny,-78.05839,43.25479,2073,3,7,4,133.3
073401200,ny,-78.36038,43.33894,2597,3,8,5,166.7
073401300,ny,-78.11725,43.33551,3206,5,9,4,80
075020101,ny,-75.95411,43.58251,2325,1,2,1,100
075020102,ny,-75.83947,43.56399,2200,1,2,1,100
075020201,ny,-76.11176,43.63629,2467,0,2,2,NA
075020202,ny,-76.07738,43.6434,600,0,1,1,NA
075020301,ny,-76.12689,43.56557,980,1,2,1,100
075020303,ny,-76.17391,43.54333,1364,1,3,2,200
075020304,ny,-76.0893,43.55119,957,1,2,1,100
075020400,ny,-76.20565,43.45584,2740,1,4,3,300
075020501,ny,-76.03614,43.50306,1422,1,3,2,200
075020502,ny,-76.05276,43.41737,1607,1,4,3,300
075020503,ny,-75.92874,43.37693,1085,2,4,2,100
075020600,ny,-75.95981,43.25474,2863,2,6,4,200
075020703,ny,-76.15616,43.3405,2445,2,5,3,150
075020704,ny,-76.09182,43.26574,1055,3,7,4,133.3
075020705,ny,-76.05894,43.33014,831,2,5,3,150
075020706,ny,-76.14262,43.28896,748,2,6,4,200
075020707,ny,-76.16796,43.26985,1041,3,7,4,133.3
075020800,ny,-76.26171,43.36391,1850,2,6,4,200
075020901,ny,-76.29604,43.2316,767,3,8,5,166.7
075020903,ny,-76.23315,43.24103,1133,3,7,4,133.3
075020904,ny,-76.27902,43.28311,977,3,7,4,133.3
075020905,ny,-76.31804,43.24744,626,3,8,5,166.7
075021001,ny,-76.37643,43.39501,1160,2,6,4,200
075021002,ny,-76.37284,43.3465,957,3,7,4,133.3
075021003,ny,-76.3659,43.29522,680,3,7,4,133.3
075021101,ny,-76.41073,43.32836,1433,3,7,4,133.3
075021102,ny,-76.40206,43.31445,679,3,7,4,133.3
075021103,ny,-76.41948,43.30734,1160,3,7,4,133.3
075021104,ny,-76.42818,43.32211,971,3,7,4,133.3
075021201,ny,-76.4903,43.34773,490,2,6,4,200
075021202,ny,-76.45654,43.32243,1127,3,6,3,100
075021203,ny,-76.41684,43.25674,1488,3,7,4,133.3
075021300,ny,-76.55162,43.30954,2097,2,6,4,200
075021401,ny,-76.55702,43.40608,2160,2,5,3,150
075021402,ny,-76.48218,43.39864,814,2,6,4,200
075021501,ny,-76.31552,43.47432,1600,2,5,3,150
075021503,ny,-76.41904,43.43291,1233,2,5,3,150
075021504,ny,-76.4164,43.49285,1296,2,5,3,150
075021505,ny,-76.45952,43.45464,463,2,5,3,150
075021601,ny,-76.52078,43.46614,1018,2,5,3,150
075021602,ny,-76.52908,43.45236,1194,2,5,3,150
075021603,ny,-76.50359,43.43956,1651,2,6,4,200
075021604,ny,-76.48721,43.44596,1325,2,6,4,200
075021605,ny,-76.4947,43.47221,1713,2,6,4,200
077590101,ny,-74.79959,42.81985,2343,0,2,2,NA
077590102,ny,-74.86947,42.70161,1790,1,2,1,100
077590201,ny,-75.01534,42.64628,1544,1,3,2,200
077590202,ny,-74.97604,42.74315,2816,1,3,2,200
077590301,ny,-75.0496,42.85479,1749,1,2,1,100
077590302,ny,-75.13617,42.81036,1617,1,3,2,200
077590401,ny,-75.2519,42.71696,1403,1,4,3,300
077590402,ny,-75.17913,42.6553,3022,1,3,2,200
077590500,ny,-74.97797,42.54628,2251,1,3,2,200
077590600,ny,-74.75617,42.67692,2187,0,1,1,NA
077590701,ny,-74.85801,42.54229,1700,0,2,2,NA
077590702,ny,-74.71415,42.58338,1677,0,1,1,NA
077590800,ny,-75.06616,42.46572,2589,1,3,2,200
077590900,ny,-75.04595,42.45669,964,1,3,2,200
077591000,ny,-75.05977,42.46515,1090,1,3,2,200
077591100,ny,-75.07721,42.44715,1073,1,3,2,200
077591401,ny,-75.18666,42.43026,1821,1,3,2,200
077591402,ny,-75.11623,42.53795,1517,1,3,2,200
077591500,ny,-75.29765,42.49737,2758,1,3,2,200
077591601,ny,-75.28494,42.38334,1266,1,4,3,300
077591602,ny,-75.35966,42.36095,1357,1,4,3,300
077591700,ny,-75.07508,42.4604,459,1,3,2,200
079010100,ny,-73.54831,41.47467,1742,3,8,5,166.7
079010201,ny,-73.61455,41.47077,1648,4,10,6,150
079010202,ny,-73.58025,41.50452,1063,4,10,6,150
079010300,ny,-73.66065,41.46884,2279,4,9,5,125
079010400,ny,-73.67456,41.45468,1518,4,10,6,150
079010500,ny,-73.74105,41.47533,2839,3,9,6,200
079010600,ny,-73.9052,41.44723,1969,5,11,6,120
079010700,ny,-73.94947,41.4254,1102,8,17,9,112.5
079010800,ny,-73.9321,41.36008,1849,7,15,8,114.3
079010901,ny,-73.87957,41.36269,1744,6,13,7,116.7
079010902,ny,-73.85123,41.37279,2010,5,12,7,140
079011000,ny,-73.82547,41.41159,1922,4,10,6,150
079011100,ny,-73.77399,41.39613,1735,4,10,6,150
079011201,ny,-73.78628,41.35794,856,4,10,6,150
079011202,ny,-73.76017,41.35796,1488,4,10,6,150
079011300,ny,-73.73049,41.36034,1480,5,11,6,120
079011400,ny,-73.73946,41.40112,2392,4,10,6,150
079011501,ny,-73.66774,41.41364,1425,5,11,6,120
079011502,ny,-73.69906,41.41594,1061,4,11,7,175
079011600,ny,-73.69191,41.37265,1956,5,12,7,140
079011700,ny,-73.61194,41.37919,2041,5,11,6,120
079011801,ny,-73.62551,41.40414,924,5,11,6,120
079011802,ny,-73.61619,41.42972,2040,5,11,6,120
079011900,ny,-73.569,41.4151,1994,4,10,6,150
081000101,ny,-73.959,40.74113,48,6,13,7,116.7
081000102,ny,-73.95699,40.74651,19,6,13,7,116.7
081000103,ny,-73.95306,40.75068,29,6,13,7,116.7
081000104,ny,-73.94461,40.74084,122,6,13,7,116.7
081000200,ny,-73.86616,40.69329,469,6,13,7,116.7
081000400,ny,-73.86477,40.68968,685,6,13,7,116.7
081000600,ny,-73.86373,40.68591,654,6,13,7,116.7
081000701,ny,-73.95284,40.74285,263,6,13,7,116.7
081000702,ny,-73.95028,40.74642,453,6,13,7,116.7
081000800,ny,-73.85826,40.68735,639,6,13,7,116.7
081001000,ny,-73.8593,40.69075,548,6,13,7,116.7
081001200,ny,-73.86084,40.69428,579,6,13,7,116.7
081001400,ny,-73.85525,40.69508,588,6,13,7,116.7
081001600,ny,-73.85484,40.68972,528,6,13,7,116.7
081001800,ny,-73.85202,40.69028,485,6,13,7,116.7
081001901,ny,-73.94514,40.74469,74,6,13,7,116.7
081001902,ny,-73.9401,40.74818,109,6,13,7,116.7
081001903,ny,-73.94682,40.7506,212,6,13,7,116.7
081002000,ny,-73.84952,40.69135,325,6,12,6,100
081002200,ny,-73.85057,40.69598,311,6,13,7,116.7
081002400,ny,-73.84658,40.69719,326,6,13,7,116.7
081002500,ny,-73.94516,40.75496,10,6,13,7,116.7
081002600,ny,-73.84309,40.69726,353,6,13,7,116.7
081002800,ny,-73.84437,40.69239,470,6,13,7,116.7
081003000,ny,-73.84727,40.69164,262,6,12,6,100
081003100,ny,-73.9339,40.75318,232,6,13,7,116.7
081003200,ny,-73.84677,40.68732,306,5,12,7,140
081003301,ny,-73.93893,40.75142,108,6,13,7,116.7
081003302,ny,-73.93757,40.75595,331,6,13,7,116.7
081003400,ny,-73.85819,40.68477,419,6,13,7,116.7
081003600,ny,-73.85682,40.68377,515,6,13,7,116.7
081003700,ny,-73.94334,40.76242,24,6,13,7,116.7
081003800,ny,-73.84749,40.6848,364,6,12,6,100
081003900,ny,-73.94093,40.7628,215,6,13,7,116.7
081004001,ny,-73.84587,40.68325,345,5,12,7,140
081004002,ny,-73.84296,40.68153,196,5,12,7,140
081004200,ny,-73.85796,40.68181,568,6,13,7,116.7
081004300,ny,-73.93751,40.76095,64,6,13,7,116.7
081004401,ny,-73.85936,40.67718,523,6,13,7,116.7
081004500,ny,-73.93377,40.76453,186,6,13,7,116.7
081004700,ny,-73.93316,40.76029,167,6,13,7,116.7
081005000,ny,-73.85489,40.67768,3,6,13,7,116.7
081005100,ny,-73.93214,40.75564,224,6,13,7,116.7
081005200,ny,-73.85466,40.68076,374,6,13,7,116.7
081005300,ny,-73.92927,40.76035,517,6,13,7,116.7
081005400,ny,-73.84878,40.67875,1111,6,12,6,100
081005500,ny,-73.92779,40.75379,196,6,13,7,116.7
081005700,ny,-73.92567,40.75695,328,6,13,7,116.7
081005800,ny,-73.84869,40.67354,1237,6,12,6,100
081005900,ny,-73.92393,40.7597,443,6,13,7,116.7
081006100,ny,-73.92204,40.76203,516,6,13,7,116.7
081006201,ny,-73.84679,40.6668,115,6,12,6,100
081006202,ny,-73.85494,40.66533,831,6,13,7,116.7
081006300,ny,-73.92002,40.76448,555,6,13,7,116.7
081006501,ny,-73.91767,40.76804,264,6,13,7,116.7
081006502,ny,-73.91512,40.7668,440,6,13,7,116.7
081006900,ny,-73.92216,40.7715,444,6,13,7,116.7
081007100,ny,-73.92305,40.76908,405,6,13,7,116.7
081007300,ny,-73.92537,40.76699,209,6,13,7,116.7
081007500,ny,-73.92733,40.76454,186,6,13,7,116.7
081007700,ny,-73.93173,40.76673,200,6,13,7,116.7
081007900,ny,-73.92995,40.7691,315,6,13,7,116.7
081008100,ny,-73.93358,40.77008,162,6,13,7,116.7
081008300,ny,-73.9287,40.77262,327,6,13,7,116.7
081008500,ny,-73.94072,40.76002,292,6,13,7,116.7
081008600,ny,-73.84114,40.67709,637,5,12,7,140
081008700,ny,-73.93458,40.77435,90,6,13,7,116.7
081008800,ny,-73.83878,40.6708,800,5,12,7,140
081009100,ny,-73.92968,40.77586,245,6,13,7,116.7
081009400,ny,-73.83649,40.68142,485,5,12,7,140
081009500,ny,-73.9208,40.77447,342,6,13,7,116.7
081009600,ny,-73.83227,40.68091,606,5,12,7,140
081009700,ny,-73.9186,40.77648,614,6,13,7,116.7
081009800,ny,-73.83121,40.6854,410,5,12,7,140
081009900,ny,-73.92309,40.77856,3,6,13,7,116.7
081010000,ny,-73.82889,40.68115,615,5,12,7,140
081010100,ny,-73.91626,40.7784,486,6,13,7,116.7
081010200,ny,-73.82297,40.67878,499,5,12,7,140
081010300,ny,-73.91508,40.78106,471,6,13,7,116.7
081010400,ny,-73.82655,40.68297,554,5,12,7,140
081010500,ny,-73.91295,40.78279,227,6,13,7,116.7
081010600,ny,-73.82496,40.68568,489,5,12,7,140
081010701,ny,-73.90077,40.786,30,6,13,7,116.7
081010800,ny,-73.8306,40.68861,454,5,12,7,140
081011000,ny,-73.83501,40.68731,454,5,12,7,140
081011100,ny,-73.90731,40.7788,433,6,13,7,116.7
081011200,ny,-73.83907,40.6841,403,5,12,7,140
081011300,ny,-73.90847,40.77626,402,6,13,7,116.7
081011400,ny,-73.84183,40.68793,218,5,12,7,140
081011500,ny,-73.91335,40.77442,397,6,13,7,116.7
081011600,ny,-73.83881,40.68878,339,5,12,7,140
081011700,ny,-73.91046,40.77223,634,6,13,7,116.7
081011800,ny,-73.8339,40.69065,383,5,12,7,140
081011900,ny,-73.90606,40.77121,235,6,13,7,116.7
081012000,ny,-73.82865,40.6915,344,6,12,6,100
081012100,ny,-73.90351,40.77276,388,6,13,7,116.7
081012200,ny,-73.83107,40.6965,425,6,13,7,116.7
081012301,ny,-73.89908,40.77579,783,6,13,7,116.7
081012400,ny,-73.8343,40.69521,397,6,13,7,116.7
081012500,ny,-73.91567,40.77093,215,6,13,7,116.7
081012601,ny,-73.83741,40.69365,388,6,13,7,116.7
081012602,ny,-73.84071,40.69317,426,6,13,7,116.7
081012800,ny,-73.84012,40.69825,322,6,13,7,116.7
081013000,ny,-73.83784,40.70035,307,6,13,7,116.7
081013200,ny,-73.83439,40.70129,286,6,13,7,116.7
081013400,ny,-73.83498,40.70528,169,6,13,7,116.7
081013500,ny,-73.89898,40.77065,356,6,13,7,116.7
081013600,ny,-73.82865,40.7066,181,6,13,7,116.7
081013700,ny,-73.90491,40.76897,284,6,13,7,116.7
081013800,ny,-73.82516,40.70658,276,6,13,7,116.7
081014000,ny,-73.82905,40.70373,433,6,13,7,116.7
081014100,ny,-73.90669,40.76699,267,6,13,7,116.7
081014201,ny,-73.82464,40.70097,531,6,13,7,116.7
081014202,ny,-73.82035,40.69867,473,6,13,7,116.7
081014300,ny,-73.91151,40.7663,367,6,13,7,116.7
081014400,ny,-73.8285,40.6985,306,6,13,7,116.7
081014500,ny,-73.90751,40.76428,388,6,13,7,116.7
081014700,ny,-73.91075,40.763,402,6,13,7,116.7
081014800,ny,-73.82237,40.6945,343,6,13,7,116.7
081014900,ny,-73.91444,40.76185,283,6,13,7,116.7
081015000,ny,-73.82115,40.69341,380,6,13,7,116.7
081015100,ny,-73.91084,40.76017,334,6,13,7,116.7
081015200,ny,-73.81378,40.69375,437,6,13,7,116.7
081015300,ny,-73.91365,40.75808,316,6,13,7,116.7
081015400,ny,-73.82056,40.6922,333,6,13,7,116.7
081015500,ny,-73.9176,40.76004,386,6,13,7,116.7
081015600,ny,-73.82061,40.69034,510,5,12,7,140
081015700,ny,-73.92193,40.75501,98,6,13,7,116.7
081015801,ny,-73.81233,40.68888,679,5,12,7,140
081015802,ny,-73.81964,40.68755,791,5,12,7,140
081015900,ny,-73.91834,40.75579,399,6,13,7,116.7
081016100,ny,-73.91459,40.75508,260,6,13,7,116.7
081016300,ny,-73.90988,40.75631,161,6,13,7,116.7
081016400,ny,-73.81656,40.68508,599,5,12,7,140
081016600,ny,-73.8207,40.68128,562,5,12,7,140
081016800,ny,-73.81723,40.67937,545,5,12,7,140
081016900,ny,-73.91436,40.74827,490,6,13,7,116.7
081017000,ny,-73.812,40.68431,492,5,12,7,140
081017101,ny,-73.92826,40.74869,56,6,13,7,116.7
081017102,ny,-73.91975,40.75192,56,6,13,7,116.7
081017200,ny,-73.8114,40.68233,450,5,12,7,140
081017400,ny,-73.81055,40.68058,506,5,12,7,140
081017600,ny,-73.80971,40.67882,443,5,12,7,140
081017800,ny,-73.80876,40.67709,432,5,12,7,140
081017901,ny,-73.92598,40.74472,82,6,13,7,116.7
081017902,ny,-73.93138,40.74468,118,6,13,7,116.7
081018000,ny,-73.80541,40.67579,258,6,12,6,100
081018101,ny,-73.92412,40.74451,144,6,13,7,116.7
081018102,ny,-73.92227,40.74429,101,6,13,7,116.7
081018200,ny,-73.79916,40.67616,602,6,12,6,100
081018300,ny,-73.91967,40.74534,414,6,13,7,116.7
081018401,ny,-73.79222,40.67519,369,6,12,6,100
081018402,ny,-73.79436,40.67895,501,6,12,6,100
081018501,ny,-73.92243,40.73871,186,6,13,7,116.7
081018502,ny,-73.92206,40.74055,153,6,13,7,116.7
081018600,ny,-73.79896,40.67988,390,6,12,6,100
081018700,ny,-73.92466,40.73662,480,6,13,7,116.7
081018800,ny,-73.79985,40.68163,300,6,12,6,100
081018900,ny,-73.928,40.74008,334,6,13,7,116.7
081019000,ny,-73.79522,40.68539,529,6,12,6,100
081019200,ny,-73.80064,40.68382,521,6,12,6,100
081019400,ny,-73.80348,40.68592,650,6,12,6,100
081019600,ny,-73.79991,40.68947,467,6,12,6,100
081019800,ny,-73.8028,40.69184,495,6,13,7,116.7
081019901,ny,-73.9336,40.73865,198,6,13,7,116.7
081019902,ny,-73.93782,40.73553,94,6,13,7,116.7
081019903,ny,-73.93011,40.7331,7,6,13,7,116.7
081020200,ny,-73.80781,40.68976,316,6,12,6,100
081020400,ny,-73.80342,40.69517,476,6,13,7,116.7
081020500,ny,-73.9218,40.73039,336,6,13,7,116.7
081020600,ny,-73.80924,40.69434,296,6,13,7,116.7
081020800,ny,-73.80688,40.69838,552,6,13,7,116.7
081021200,ny,-73.81162,40.7009,337,6,13,7,116.7
081021400,ny,-73.8152,40.70607,631,6,13,7,116.7
081021601,ny,-73.82655,40.71308,36,6,13,7,116.7
081021602,ny,-73.81927,40.70439,191,6,13,7,116.7
081021603,ny,-73.82308,40.70861,3,6,13,7,116.7
081021900,ny,-73.9183,40.72349,190,6,13,7,116.7
081022001,ny,-73.82065,40.71362,273,6,13,7,116.7
081022002,ny,-73.81446,40.7132,513,6,13,7,116.7
081022900,ny,-73.91134,40.73428,25,6,13,7,116.7
081023000,ny,-73.80815,40.71264,337,6,13,7,116.7
081023200,ny,-73.81128,40.70959,461,6,13,7,116.7
081023501,ny,-73.91807,40.73766,265,6,13,7,116.7
081023502,ny,-73.91703,40.74134,193,6,13,7,116.7
081023600,ny,-73.80492,40.70734,230,6,13,7,116.7
081023800,ny,-73.80904,40.70522,249,6,13,7,116.7
081024000,ny,-73.80508,40.70328,248,6,13,7,116.7
081024300,ny,-73.90204,40.73667,1065,6,13,7,116.7
081024500,ny,-73.90505,40.73935,357,6,13,7,116.7
081024600,ny,-73.7965,40.7012,35,6,13,7,116.7
081024700,ny,-73.89945,40.74228,158,6,13,7,116.7
081024900,ny,-73.90426,40.74312,413,6,13,7,116.7
081025100,ny,-73.90966,40.74482,413,6,13,7,116.7
081025301,ny,-73.91652,40.74457,192,6,13,7,116.7
081025302,ny,-73.91314,40.74417,139,6,13,7,116.7
081025401,ny,-73.7976,40.69472,562,6,13,7,116.7
081025402,ny,-73.79233,40.69797,607,6,13,7,116.7
081025500,ny,-73.90792,40.75043,304,6,13,7,116.7
081025700,ny,-73.90517,40.7501,264,6,13,7,116.7
081025800,ny,-73.78728,40.69604,420,6,13,7,116.7
081025900,ny,-73.90353,40.74858,325,6,13,7,116.7
081026000,ny,-73.79331,40.69275,315,6,13,7,116.7
081026100,ny,-73.9006,40.74721,477,6,13,7,116.7
081026200,ny,-73.79209,40.69101,328,6,12,6,100
081026300,ny,-73.89703,40.74576,475,6,13,7,116.7
081026400,ny,-73.78579,40.69223,515,6,13,7,116.7
081026501,ny,-73.89269,40.7456,198,6,13,7,116.7
081026502,ny,-73.89418,40.74394,136,6,13,7,116.7
081026600,ny,-73.78169,40.69188,309,6,13,7,116.7
081026700,ny,-73.88803,40.74533,294,6,14,8,133.3
081026901,ny,-73.88221,40.74687,205,6,14,8,133.3
081026902,ny,-73.88295,40.74461,138,6,14,8,133.3
081027000,ny,-73.7914,40.68868,421,6,12,6,100
081027101,ny,-73.88027,40.74417,161,6,14,8,133.3
081027102,ny,-73.87805,40.74712,81,6,14,8,133.3
081027200,ny,-73.79132,40.68358,439,6,12,6,100
081027301,ny,-73.87226,40.75033,263,6,14,8,133.3
081027302,ny,-73.87321,40.75378,56,6,14,8,133.3
081027400,ny,-73.78899,40.6849,406,6,12,6,100
081027500,ny,-73.87557,40.75215,376,6,14,8,133.3
081027600,ny,-73.78624,40.68759,257,6,12,6,100
081027701,ny,-73.8778,40.75038,137,6,14,8,133.3
081027702,ny,-73.87805,40.75441,138,6,14,8,133.3
081027800,ny,-73.78292,40.6861,166,6,12,6,100
081027900,ny,-73.88022,40.75167,246,6,14,8,133.3
081028000,ny,-73.77972,40.68832,373,6,12,6,100
081028100,ny,-73.88259,40.75222,190,6,14,8,133.3
081028200,ny,-73.77389,40.68499,420,6,12,6,100
081028300,ny,-73.88487,40.75117,163,6,14,8,133.3
081028400,ny,-73.77786,40.6825,800,6,12,6,100
081028500,ny,-73.88712,40.75147,131,6,14,8,133.3
081028700,ny,-73.88944,40.75097,125,6,14,8,133.3
081028801,ny,-73.78913,40.67838,652,6,12,6,100
081028802,ny,-73.78259,40.68045,403,6,12,6,100
081028803,ny,-73.78571,40.67812,3,6,12,6,100
081028900,ny,-73.8919,40.75128,293,6,13,7,116.7
081029100,ny,-73.8952,40.75134,464,6,13,7,116.7
081029300,ny,-73.89948,40.75193,225,6,13,7,116.7
081029400,ny,-73.78107,40.67132,1388,6,12,6,100
081029500,ny,-73.90673,40.756,276,6,13,7,116.7
081029700,ny,-73.903,40.75868,553,6,13,7,116.7
081029900,ny,-73.8994,40.76399,20,6,13,7,116.7
081030600,ny,-73.7804,40.66488,1056,6,12,6,100
081030903,ny,-73.89006,40.75795,995,6,14,8,133.3
081030904,ny,-73.89105,40.76358,517,6,14,8,133.3
081030905,ny,-73.89607,40.76001,483,6,13,7,116.7
081030906,ny,-73.89623,40.75632,523,6,13,7,116.7
081031700,ny,-73.89304,40.77092,836,6,13,7,116.7
081032000,ny,-73.76497,40.66134,986,4,10,6,150
081032700,ny,-73.88542,40.75844,476,6,14,8,133.3
081032800,ny,-73.7557,40.67184,515,4,9,5,125
081032900,ny,-73.88273,40.76444,750,6,14,8,133.3
081033000,ny,-73.76374,40.67013,1463,4,10,6,150
081033100,ny,-73.87249,40.7763,8,6,13,7,116.7
081033401,ny,-73.76744,40.67918,770,5,11,6,120
081033403,ny,-73.77567,40.67752,3,6,12,6,100
081033404,ny,-73.77233,40.67496,3,6,12,6,100
081033405,ny,-73.76775,40.67344,330,5,11,6,120
081033700,ny,-73.88263,40.75873,497,6,14,8,133.3
081033900,ny,-73.87984,40.75902,358,6,14,8,133.3
081034700,ny,-73.87868,40.76688,550,6,14,8,133.3
081035100,ny,-73.87705,40.7591,314,6,14,8,133.3
081035200,ny,-73.7576,40.67948,689,4,9,5,125
081035300,ny,-73.87412,40.75961,381,6,14,8,133.3
081035700,ny,-73.87124,40.76802,839,6,14,8,133.3
081035800,ny,-73.75098,40.67579,933,4,9,5,125
081036100,ny,-73.87242,40.76128,376,6,14,8,133.3
081036300,ny,-73.86942,40.75968,327,6,14,8,133.3
081036500,ny,-73.86561,40.75952,444,6,14,8,133.3
081036600,ny,-73.76309,40.68563,738,4,9,5,125
081036700,ny,-73.86794,40.76322,496,6,14,8,133.3
081036800,ny,-73.76648,40.68532,568,4,10,6,150
081037100,ny,-73.86362,40.76414,309,6,14,8,133.3
081037300,ny,-73.86,40.75971,322,6,14,8,133.3
081037501,ny,-73.86773,40.74691,118,6,14,8,133.3
081037502,ny,-73.8712,40.7537,207,6,14,8,133.3
081037600,ny,-73.75412,40.68781,1534,4,9,5,125
081037700,ny,-73.86871,40.75566,353,6,14,8,133.3
081037900,ny,-73.86408,40.75547,543,6,14,8,133.3
081038100,ny,-73.85767,40.75613,534,6,14,8,133.3
081038301,ny,-73.84182,40.76113,139,6,13,7,116.7
081038302,ny,-73.84227,40.74327,32,6,13,7,116.7
081038400,ny,-73.74764,40.69334,646,4,10,6,150
081039400,ny,-73.75878,40.68964,705,4,9,5,125
081039800,ny,-73.76481,40.69456,375,4,10,6,150
081039901,ny,-73.85334,40.75076,264,6,14,8,133.3
081039902,ny,-73.85398,40.75356,86,6,14,8,133.3
081040000,ny,-73.76486,40.69815,344,4,10,6,150
081040101,ny,-73.85658,40.74976,239,6,14,8,133.3
081040102,ny,-73.85746,40.75268,300,6,14,8,133.3
081040200,ny,-73.76876,40.70003,376,6,13,7,116.7
081040301,ny,-73.85951,40.7489,209,6,14,8,133.3
081040302,ny,-73.86116,40.75205,295,6,14,8,133.3
081040400,ny,-73.77079,40.70519,855,6,13,7,116.7
081040501,ny,-73.86222,40.74835,110,6,14,8,133.3
081040502,ny,-73.86361,40.75174,158,6,14,8,133.3
081040701,ny,-73.86449,40.74805,174,6,14,8,133.3
081040702,ny,-73.86623,40.75165,395,6,14,8,133.3
081040901,ny,-73.86627,40.7475,145,6,14,8,133.3
081040902,ny,-73.86874,40.75154,222,6,14,8,133.3
081041100,ny,-73.86542,40.74379,414,6,14,8,133.3
081041300,ny,-73.86131,40.74474,396,6,14,8,133.3
081041400,ny,-73.78077,40.69963,787,6,13,7,116.7
081041500,ny,-73.8566,40.74661,392,6,14,8,133.3
081042400,ny,-73.77227,40.69539,714,6,13,7,116.7
081042600,ny,-73.7702,40.68887,20,6,12,6,100
081042700,ny,-73.85381,40.74372,450,6,14,8,133.3
081043200,ny,-73.77588,40.69131,319,6,12,6,100
081043400,ny,-73.77865,40.6962,447,6,13,7,116.7
081043701,ny,-73.8511,40.73915,257,6,14,8,133.3
081043702,ny,-73.85655,40.73811,327,6,14,8,133.3
081043900,ny,-73.85581,40.74187,458,6,14,8,133.3
081044000,ny,-73.78462,40.70268,827,6,13,7,116.7
081044301,ny,-73.85946,40.74074,233,6,14,8,133.3
081044302,ny,-73.86406,40.73981,449,6,14,8,133.3
081044400,ny,-73.78185,40.70576,701,6,13,7,116.7
081044601,ny,-73.79779,40.70495,137,6,13,7,116.7
081044602,ny,-73.79985,40.70819,229,6,13,7,116.7
081044800,ny,-73.80263,40.71102,325,6,13,7,116.7
081045000,ny,-73.80479,40.71422,401,6,13,7,116.7
081045200,ny,-73.79958,40.71463,85,6,13,7,116.7
081045400,ny,-73.79601,40.71265,361,6,13,7,116.7
081045500,ny,-73.86233,40.73631,27,6,14,8,133.3
081045600,ny,-73.79399,40.71663,229,6,13,7,116.7
081045700,ny,-73.86984,40.73772,381,6,14,8,133.3
081045800,ny,-73.79093,40.71526,277,6,13,7,116.7
081045900,ny,-73.87068,40.73988,401,6,14,8,133.3
081046000,ny,-73.79349,40.70826,281,6,13,7,116.7
081046100,ny,-73.87127,40.74171,308,6,14,8,133.3
081046200,ny,-73.78797,40.70985,519,6,13,7,116.7
081046300,ny,-73.87109,40.744,346,6,14,8,133.3
081046400,ny,-73.787,40.71686,201,6,13,7,116.7
081046500,ny,-73.8703,40.74697,343,6,14,8,133.3
081046600,ny,-73.7851,40.71401,135,6,13,7,116.7
081046700,ny,-73.87459,40.74546,318,6,14,8,133.3
081046800,ny,-73.78228,40.71049,558,6,13,7,116.7
081046901,ny,-73.87859,40.74336,134,6,14,8,133.3
081046902,ny,-73.87582,40.74698,141,6,14,8,133.3
081047000,ny,-73.7773,40.7113,588,6,13,7,116.7
081047100,ny,-73.87656,40.74098,357,6,14,8,133.3
081047200,ny,-73.77894,40.71763,566,6,13,7,116.7
081047300,ny,-73.87623,40.73722,261,6,14,8,133.3
081047500,ny,-73.87565,40.73364,587,6,13,7,116.7
081047600,ny,-73.77125,40.72248,455,6,13,7,116.7
081047801,ny,-73.76713,40.7198,398,5,12,7,140
081047802,ny,-73.76249,40.71874,293,4,10,6,150
081047900,ny,-73.88371,40.73549,788,6,14,8,133.3
081048000,ny,-73.773,40.71289,486,6,13,7,116.7
081048100,ny,-73.88505,40.74222,265,6,14,8,133.3
081048200,ny,-73.76792,40.71484,278,5,12,7,140
081048301,ny,-73.88964,40.7421,223,6,14,8,133.3
081048302,ny,-73.89468,40.74147,252,6,13,7,116.7
081048400,ny,-73.75994,40.71582,979,4,10,6,150
081048500,ny,-73.88434,40.73975,466,6,14,8,133.3
081048900,ny,-73.89218,40.73732,383,6,13,7,116.7
081049201,ny,-73.76008,40.72439,127,4,10,6,150
081049202,ny,-73.75605,40.7208,416,4,10,6,150
081049301,ny,-73.89425,40.73237,484,6,13,7,116.7
081049302,ny,-73.89179,40.7279,564,6,13,7,116.7
081049500,ny,-73.89049,40.72539,263,6,13,7,116.7
081049600,ny,-73.75312,40.71695,706,4,10,6,150
081049700,ny,-73.89037,40.73175,613,6,13,7,116.7
081049900,ny,-73.88335,40.73113,915,6,13,7,116.7
081050000,ny,-73.76362,40.71194,341,5,11,6,120
081050201,ny,-73.7649,40.7088,294,4,10,6,150
081050202,ny,-73.75929,40.71019,314,4,10,6,150
081050400,ny,-73.76436,40.70512,359,4,10,6,150
081050500,ny,-73.87475,40.72908,296,6,13,7,116.7
081050600,ny,-73.75967,40.70579,364,4,10,6,150
081050700,ny,-73.88159,40.72702,847,6,13,7,116.7
081050800,ny,-73.75542,40.70698,425,4,10,6,150
081051000,ny,-73.75372,40.70971,370,4,10,6,150
081051100,ny,-73.90017,40.72733,553,6,13,7,116.7
081051200,ny,-73.75012,40.71041,645,4,10,6,150
081051300,ny,-73.89751,40.73189,504,6,13,7,116.7
081051500,ny,-73.9015,40.73098,527,6,13,7,116.7
081051600,ny,-73.74727,40.70272,434,4,10,6,150
081051700,ny,-73.90029,40.72463,456,6,13,7,116.7
081051800,ny,-73.75201,40.70184,488,4,10,6,150
081052000,ny,-73.75469,40.70114,381,4,10,6,150
081052100,ny,-73.90152,40.72086,475,6,13,7,116.7
081052200,ny,-73.75737,40.70044,380,4,10,6,150
081052400,ny,-73.76196,40.70123,425,4,10,6,150
081052500,ny,-73.90664,40.71897,477,6,13,7,116.7
081052600,ny,-73.75976,40.69709,443,4,10,6,150
081052800,ny,-73.75873,40.69404,355,4,10,6,150
081053000,ny,-73.75254,40.69634,569,4,10,6,150
081053100,ny,-73.90833,40.72306,755,6,13,7,116.7
081053200,ny,-73.74909,40.7001,480,4,10,6,150
081053401,ny,-73.74415,40.69983,475,4,10,6,150
081053501,ny,-73.9126,40.71647,263,6,13,7,116.7
081053502,ny,-73.91841,40.71562,47,6,13,7,116.7
081053601,ny,-73.74587,40.7067,395,4,10,6,150
081053800,ny,-73.74253,40.70648,376,4,10,6,150
081053901,ny,-73.9178,40.71021,698,6,13,7,116.7
081053902,ny,-73.91322,40.71132,4,6,13,7,116.7
081054000,ny,-73.74322,40.71279,920,4,10,6,150
081054200,ny,-73.74649,40.71907,1200,4,10,6,150
081054500,ny,-73.91262,40.70555,303,6,13,7,116.7
081054700,ny,-73.90971,40.70363,388,6,13,7,116.7
081054800,ny,-73.75128,40.7232,539,4,10,6,150
081054900,ny,-73.90781,40.70219,390,6,13,7,116.7
081055100,ny,-73.90391,40.7016,401,6,13,7,116.7
081055200,ny,-73.74966,40.72779,457,4,10,6,150
081055300,ny,-73.90655,40.69895,278,6,13,7,116.7
081055400,ny,-73.74016,40.72779,511,4,10,6,150
081055500,ny,-73.90328,40.69722,297,6,13,7,116.7
081055600,ny,-73.745,40.72555,560,4,10,6,150
081055700,ny,-73.89831,40.69869,486,6,13,7,116.7
081055800,ny,-73.7417,40.72253,440,4,10,6,150
081055900,ny,-73.90173,40.6944,172,6,13,7,116.7
081056000,ny,-73.73656,40.72544,386,4,10,6,150
081056100,ny,-73.88554,40.6931,41,6,13,7,116.7
081056200,ny,-73.73319,40.72464,352,4,10,6,150
081056400,ny,-73.7334,40.72156,311,4,10,6,150
081056500,ny,-73.89687,40.69426,314,6,13,7,116.7
081056600,ny,-73.7384,40.71974,351,4,10,6,150
081056700,ny,-73.89218,40.69687,1003,6,13,7,116.7
081056800,ny,-73.73357,40.71557,994,4,10,6,150
081057700,ny,-73.89071,40.70039,543,6,13,7,116.7
081057900,ny,-73.89004,40.70349,193,6,13,7,116.7
081058000,ny,-73.73072,40.70725,883,4,10,6,150
081058100,ny,-73.89379,40.70397,373,6,13,7,116.7
081058200,ny,-73.73755,40.70699,1037,4,10,6,150
081058300,ny,-73.89762,40.70194,482,6,13,7,116.7
081058500,ny,-73.89942,40.70437,558,6,13,7,116.7
081058700,ny,-73.90028,40.70714,427,6,13,7,116.7
081058900,ny,-73.90504,40.70624,399,6,13,7,116.7
081059000,ny,-73.737,40.70126,314,4,10,6,150
081059100,ny,-73.90978,40.70811,609,6,13,7,116.7
081059200,ny,-73.72973,40.70124,325,4,10,6,150
081059300,ny,-73.90265,40.71021,622,6,13,7,116.7
081059400,ny,-73.73118,40.69847,468,4,10,6,150
081059501,ny,-73.90782,40.71171,335,6,13,7,116.7
081059502,ny,-73.90871,40.71525,466,6,13,7,116.7
081059600,ny,-73.73706,40.69714,399,4,10,6,150
081059800,ny,-73.74067,40.69829,450,4,10,6,150
081059900,ny,-73.90213,40.71724,366,6,13,7,116.7
081060000,ny,-73.7333,40.69506,364,4,10,6,150
081060100,ny,-73.90241,40.71521,434,6,13,7,116.7
081060300,ny,-73.899,40.71392,408,6,13,7,116.7
081060600,ny,-73.73533,40.69175,406,4,10,6,150
081060701,ny,-73.89398,40.71726,4,6,13,7,116.7
081060800,ny,-73.74131,40.6936,365,4,10,6,150
081061000,ny,-73.74325,40.69018,350,4,9,5,125
081061200,ny,-73.73673,40.68829,462,4,9,5,125
081061301,ny,-73.89318,40.70896,773,6,13,7,116.7
081061302,ny,-73.88353,40.70933,5,6,13,7,116.7
081061400,ny,-73.72951,40.68612,331,4,9,5,125
081061601,ny,-73.73188,40.68186,661,4,9,5,125
081061602,ny,-73.72924,40.67755,390,4,9,5,125
081061800,ny,-73.73642,40.67689,282,4,9,5,125
081061900,ny,-73.8771,40.70979,610,6,13,7,116.7
081062000,ny,-73.73782,40.68106,470,4,9,5,125
081062100,ny,-73.87266,40.71001,599,6,13,7,116.7
081062200,ny,-73.72888,40.69195,594,4,10,6,150
081062300,ny,-73.87818,40.70438,401,6,13,7,116.7
081062400,ny,-73.74199,40.68578,5,4,9,5,125
081062500,ny,-73.88241,40.70413,521,6,13,7,116.7
081062600,ny,-73.7481,40.68197,742,4,9,5,125
081062700,ny,-73.88645,40.70377,533,6,13,7,116.7
081062900,ny,-73.88296,40.70093,477,6,13,7,116.7
081063000,ny,-73.74358,40.68029,493,4,9,5,125
081063200,ny,-73.74051,40.67652,615,4,9,5,125
081063301,ny,-73.87457,40.70448,355,6,13,7,116.7
081063302,ny,-73.87141,40.70539,407,6,13,7,116.7
081063500,ny,-73.86696,40.70474,565,6,13,7,116.7
081063700,ny,-73.86229,40.70836,938,6,13,7,116.7
081063800,ny,-73.73305,40.66984,942,4,9,5,125
081063900,ny,-73.85693,40.7039,476,6,13,7,116.7
081064101,ny,-73.85174,40.69921,48,6,13,7,116.7
081064102,ny,-73.85348,40.70207,23,6,13,7,116.7
081064500,ny,-73.85225,40.70912,566,6,13,7,116.7
081064600,ny,-73.74233,40.67277,774,4,9,5,125
081065000,ny,-73.74482,40.66946,739,4,9,5,125
081065401,ny,-73.73755,40.66303,651,4,9,5,125
081065402,ny,-73.74412,40.66143,8,4,9,5,125
081065501,ny,-73.86665,40.71475,2,6,13,7,116.7
081065600,ny,-73.72956,40.65983,949,4,9,5,125
081065702,ny,-73.88296,40.71334,338,6,13,7,116.7
081065703,ny,-73.8753,40.71512,696,6,13,7,116.7
081065900,ny,-73.88248,40.71554,494,6,13,7,116.7
081066000,ny,-73.73336,40.65857,696,4,9,5,125
081066100,ny,-73.88179,40.71751,448,6,13,7,116.7
081066301,ny,-73.87477,40.72193,839,6,13,7,116.7
081066302,ny,-73.88031,40.72019,9,6,13,7,116.7
081066401,ny,-73.74339,40.64632,539,3,8,5,166.7
081066402,ny,-73.73765,40.65623,726,4,9,5,125
081066403,ny,-73.73309,40.65192,675,4,9,5,125
081066404,ny,-73.75422,40.65215,11,4,9,5,125
081066501,ny,-73.88736,40.71935,821,6,13,7,116.7
081066701,ny,-73.89134,40.72182,753,6,13,7,116.7
081066900,ny,-73.88592,40.72357,488,6,13,7,116.7
081067100,ny,-73.8781,40.72448,818,6,13,7,116.7
081067700,ny,-73.87243,40.71911,583,6,13,7,116.7
081067900,ny,-73.87018,40.72412,437,6,13,7,116.7
081068000,ny,-73.75008,40.66371,1102,4,9,5,125
081068200,ny,-73.75041,40.66779,314,4,9,5,125
081068300,ny,-73.86909,40.73498,68,6,14,8,133.3
081068700,ny,-73.8693,40.73031,421,6,13,7,116.7
081069000,ny,-73.75541,40.66035,637,4,9,5,125
081069300,ny,-73.86323,40.72889,162,6,13,7,116.7
081069400,ny,-73.75013,40.65587,677,4,9,5,125
081069500,ny,-73.86751,40.72606,426,6,13,7,116.7
081069701,ny,-73.8602,40.72688,110,6,13,7,116.7
081069702,ny,-73.86287,40.72225,815,6,13,7,116.7
081070300,ny,-73.85936,40.71628,536,6,13,7,116.7
081070700,ny,-73.85557,40.71507,653,6,13,7,116.7
081070900,ny,-73.85502,40.71927,604,6,13,7,116.7
081071100,ny,-73.85249,40.72207,460,6,13,7,116.7
081071303,ny,-73.84954,40.72581,41,6,13,7,116.7
081071304,ny,-73.85408,40.72886,62,6,13,7,116.7
081071305,ny,-73.85148,40.72419,101,6,13,7,116.7
081071306,ny,-73.85605,40.72616,246,6,13,7,116.7
081071600,ny,-73.78695,40.64687,14,4,10,6,150
081071701,ny,-73.85988,40.73133,75,6,13,7,116.7
081071702,ny,-73.86283,40.73348,42,6,13,7,116.7
081071900,ny,-73.85562,40.73469,306,6,14,8,133.3
081072100,ny,-73.85374,40.73119,255,6,13,7,116.7
081072300,ny,-73.84774,40.71624,645,6,13,7,116.7
081072900,ny,-73.85218,40.71281,435,6,13,7,116.7
081073100,ny,-73.84633,40.71095,510,6,13,7,116.7
081073700,ny,-73.84325,40.71844,231,6,13,7,116.7
081073900,ny,-73.84427,40.72369,130,6,13,7,116.7
081074100,ny,-73.84704,40.72828,141,6,13,7,116.7
081074300,ny,-73.84925,40.7323,329,6,13,7,116.7
081074500,ny,-73.85084,40.7361,166,6,14,8,133.3
081074700,ny,-73.84521,40.73262,307,6,13,7,116.7
081074900,ny,-73.84008,40.71325,563,6,13,7,116.7
081075701,ny,-73.83482,40.71822,105,6,13,7,116.7
081075702,ny,-73.8402,40.72434,332,6,13,7,116.7
081076901,ny,-73.83757,40.71646,271,6,13,7,116.7
081076902,ny,-73.83403,40.71503,89,6,13,7,116.7
081077300,ny,-73.83528,40.71091,114,6,13,7,116.7
081077500,ny,-73.83234,40.7091,262,6,13,7,116.7
081077902,ny,-73.82487,40.72527,1183,6,13,7,116.7
081077903,ny,-73.82159,40.71922,124,6,13,7,116.7
081077904,ny,-73.81416,40.72097,917,6,13,7,116.7
081077905,ny,-73.81296,40.71733,60,6,13,7,116.7
081077906,ny,-73.81876,40.7294,297,6,13,7,116.7
081077907,ny,-73.81848,40.72496,372,6,13,7,116.7
081077908,ny,-73.81369,40.72562,78,6,13,7,116.7
081078800,ny,-73.79036,40.67033,470,6,12,6,100
081079000,ny,-73.79662,40.67248,545,6,12,6,100
081079200,ny,-73.79696,40.66892,544,6,12,6,100
081079300,ny,-73.83146,40.73639,5,6,13,7,116.7
081079701,ny,-73.82476,40.75335,95,6,13,7,116.7
081079702,ny,-73.82939,40.75136,230,6,13,7,116.7
081079900,ny,-73.82738,40.74699,565,6,13,7,116.7
081080301,ny,-73.83088,40.7448,691,6,13,7,116.7
081080302,ny,-73.82622,40.74036,865,6,13,7,116.7
081080900,ny,-73.82234,40.73387,625,6,13,7,116.7
081081400,ny,-73.80393,40.6707,854,6,12,6,100
081081800,ny,-73.80908,40.67051,724,5,12,7,140
081083700,ny,-73.81978,40.74475,1292,6,13,7,116.7
081083800,ny,-73.81951,40.6703,1063,5,12,7,140
081084000,ny,-73.81765,40.67395,1327,5,12,7,140
081084500,ny,-73.82023,40.74996,297,6,13,7,116.7
081084601,ny,-73.82178,40.66734,566,5,12,7,140
081084602,ny,-73.81662,40.66513,230,5,12,7,140
081084901,ny,-73.83406,40.75395,217,6,13,7,116.7
081084902,ny,-73.83083,40.75626,144,6,13,7,116.7
081085300,ny,-73.82765,40.75715,128,6,13,7,116.7
081085500,ny,-73.82364,40.75964,53,6,13,7,116.7
081085700,ny,-73.82306,40.75706,111,6,13,7,116.7
081085900,ny,-73.8208,40.75499,154,6,13,7,116.7
081086100,ny,-73.81788,40.75681,192,6,13,7,116.7
081086300,ny,-73.81994,40.76127,115,6,13,7,116.7
081086400,ny,-73.83158,40.67334,534,5,12,7,140
081086500,ny,-73.82517,40.76269,106,6,13,7,116.7
081086900,ny,-73.83381,40.76533,468,6,13,7,116.7
081087100,ny,-73.83361,40.75902,284,6,13,7,116.7
081088400,ny,-73.83376,40.65564,2503,5,12,7,140
081088902,ny,-73.82981,40.76855,252,6,13,7,116.7
081088903,ny,-73.82697,40.77575,273,6,13,7,116.7
081089201,ny,-73.84495,40.65643,2561,5,12,7,140
081089202,ny,-73.84951,40.64895,3,4,9,5,125
081090700,ny,-73.83959,40.77332,479,6,13,7,116.7
081091602,ny,-73.88957,40.55944,4,3,8,5,166.7
081091603,ny,-73.91054,40.56452,21,3,8,5,166.7
081091604,ny,-73.92527,40.55247,11,3,8,5,166.7
081091800,ny,-73.8721,40.56819,27,3,8,5,166.7
081091900,ny,-73.8484,40.77679,930,6,13,7,116.7
081092200,ny,-73.86011,40.57311,808,3,8,5,166.7
081092500,ny,-73.84477,40.78248,671,6,12,6,100
081092800,ny,-73.85197,40.57382,1050,3,8,5,166.7
081092900,ny,-73.85742,40.78879,1341,6,13,7,116.7
081093401,ny,-73.84662,40.58092,833,3,8,5,166.7
081093402,ny,-73.83937,40.57551,526,3,8,5,166.7
081093800,ny,-73.82929,40.58004,350,3,8,5,166.7
081093900,ny,-73.843,40.79598,916,6,12,6,100
081094201,ny,-73.82101,40.58621,359,3,8,5,166.7
081094202,ny,-73.81043,40.59122,661,3,7,4,133.3
081094203,ny,-73.81,40.58246,182,3,7,4,133.3
081094500,ny,-73.83142,40.79048,1272,6,12,6,100
081094700,ny,-73.84137,40.78558,529,6,12,6,100
081095400,ny,-73.7995,40.59221,1134,3,7,4,133.3
081096400,ny,-73.79213,40.59287,1139,3,7,4,133.3
081097202,ny,-73.77918,40.58796,39,3,7,4,133.3
081097204,ny,-73.78113,40.59391,313,3,7,4,133.3
081097205,ny,-73.78551,40.59622,7,3,7,4,133.3
081097206,ny,-73.77591,40.59753,477,3,7,4,133.3
081097207,ny,-73.78032,40.60391,22,3,7,4,133.3
081097300,ny,-73.82273,40.79543,690,6,12,6,100
081098100,ny,-73.81708,40.799,827,6,12,6,100
081098700,ny,-73.80708,40.79651,767,5,12,7,140
081099100,ny,-73.79891,40.79221,1215,5,12,7,140
081099200,ny,-73.76701,40.59267,558,2,6,4,200
081099701,ny,-73.7899,40.78091,520,5,12,7,140
081099703,ny,-73.77471,40.78298,452,5,12,7,140
081099704,ny,-73.78068,40.78173,146,5,12,7,140
081099705,ny,-73.77576,40.7936,253,5,12,7,140
081099801,ny,-73.7576,40.59808,576,2,5,3,150
081099802,ny,-73.7585,40.59003,425,2,5,3,150
081099900,ny,-73.77672,40.79161,3,5,12,7,140
081100801,ny,-73.76773,40.61087,592,2,6,4,200
081100803,ny,-73.75754,40.60315,512,2,5,3,150
081100804,ny,-73.76695,40.60293,657,2,6,4,200
081101002,ny,-73.74141,40.5986,674,2,5,3,150
081101003,ny,-73.75043,40.60145,289,2,5,3,150
081101004,ny,-73.74871,40.59538,443,2,5,3,150
081101700,ny,-73.79825,40.77977,1264,5,12,7,140
081102900,ny,-73.80736,40.78387,606,5,12,7,140
081103201,ny,-73.75545,40.60863,522,1,5,4,400
081103202,ny,-73.74751,40.60667,746,2,5,3,150
081103300,ny,-73.80966,40.77918,1121,5,12,7,140
081103900,ny,-73.81904,40.78405,1502,6,12,6,100
081104700,ny,-73.82037,40.77482,1328,6,13,7,116.7
081105900,ny,-73.80706,40.77377,1182,6,13,7,116.7
081107201,ny,-73.82187,40.60377,1124,3,7,4,133.3
081107202,ny,-73.81271,40.61824,52,3,7,4,133.3
081108500,ny,-73.78907,40.77245,699,6,13,7,116.7
081109300,ny,-73.77073,40.77497,1045,5,12,7,140
081109700,ny,-73.77731,40.77035,551,6,13,7,116.7
081109900,ny,-73.78649,40.76795,936,6,13,7,116.7
081111300,ny,-73.76273,40.76746,762,4,10,6,150
081112300,ny,-73.77125,40.76629,424,6,13,7,116.7
081112900,ny,-73.77682,40.7654,484,6,13,7,116.7
081113300,ny,-73.78315,40.76415,373,6,13,7,116.7
081113900,ny,-73.79063,40.76423,652,6,13,7,116.7
081114100,ny,-73.79669,40.7691,811,6,13,7,116.7
081114700,ny,-73.80196,40.76827,527,6,13,7,116.7
081115100,ny,-73.80763,40.76857,349,6,13,7,116.7
081115500,ny,-73.81179,40.76784,351,6,13,7,116.7
081115700,ny,-73.81517,40.76757,486,6,13,7,116.7
081115900,ny,-73.82076,40.76864,429,6,13,7,116.7
081116100,ny,-73.8257,40.76686,153,6,13,7,116.7
081116301,ny,-73.82085,40.76488,164,6,13,7,116.7
081116302,ny,-73.81735,40.76262,153,6,13,7,116.7
081116700,ny,-73.81244,40.76217,259,6,13,7,116.7
081117100,ny,-73.80571,40.76326,500,6,13,7,116.7
081117500,ny,-73.79643,40.76147,819,6,13,7,116.7
081118100,ny,-73.78736,40.7595,394,6,13,7,116.7
081118500,ny,-73.80381,40.75947,293,6,13,7,116.7
081118700,ny,-73.81288,40.75963,329,6,13,7,116.7
081118900,ny,-73.81261,40.75651,392,6,13,7,116.7
081119100,ny,-73.80651,40.75667,523,6,13,7,116.7
081119300,ny,-73.79963,40.75718,419,6,13,7,116.7
081119500,ny,-73.79947,40.75487,345,6,13,7,116.7
081119900,ny,-73.80958,40.75346,358,6,13,7,116.7
081120100,ny,-73.81406,40.75321,328,6,13,7,116.7
081120300,ny,-73.81258,40.7488,343,6,13,7,116.7
081120500,ny,-73.81711,40.75127,374,6,13,7,116.7
081120701,ny,-73.80226,40.74972,692,6,13,7,116.7
081120702,ny,-73.79917,40.75199,1,6,13,7,116.7
081121100,ny,-73.80486,40.74532,7,6,13,7,116.7
081121500,ny,-73.80593,40.74036,885,6,13,7,116.7
081122300,ny,-73.79946,40.73498,857,6,13,7,116.7
081122702,ny,-73.81274,40.73315,194,6,13,7,116.7
081122703,ny,-73.80693,40.73526,384,6,13,7,116.7
081122704,ny,-73.80737,40.73007,264,6,13,7,116.7
081124100,ny,-73.80241,40.7268,1055,6,13,7,116.7
081124700,ny,-73.79625,40.72809,1084,6,13,7,116.7
081125700,ny,-73.80793,40.72413,547,6,13,7,116.7
081126500,ny,-73.80371,40.72049,395,6,13,7,116.7
081126700,ny,-73.79778,40.72033,604,6,13,7,116.7
081127700,ny,-73.78341,40.72441,1215,6,13,7,116.7
081128300,ny,-73.76879,40.73397,6,5,11,6,120
081129102,ny,-73.75438,40.73164,1006,4,10,6,150
081129103,ny,-73.75971,40.7367,280,4,9,5,125
081129104,ny,-73.75007,40.7381,457,4,9,5,125
081130100,ny,-73.73978,40.7335,571,4,9,5,125
081133300,ny,-73.77927,40.73192,1154,6,13,7,116.7
081133900,ny,-73.79004,40.72864,440,6,13,7,116.7
081134100,ny,-73.79118,40.73529,907,6,13,7,116.7
081134701,ny,-73.78485,40.73728,129,6,13,7,116.7
081134702,ny,-73.77829,40.73846,243,6,13,7,116.7
081136700,ny,-73.76031,40.7442,783,4,9,5,125
081137700,ny,-73.75005,40.74713,625,4,9,5,125
081138501,ny,-73.75479,40.75492,990,4,9,5,125
081138502,ny,-73.74552,40.75199,32,4,9,5,125
081139900,ny,-73.76248,40.74987,545,4,9,5,125
081140300,ny,-73.7696,40.74817,736,6,12,6,100
081140901,ny,-73.7749,40.74654,277,6,13,7,116.7
081140902,ny,-73.78215,40.74491,727,6,13,7,116.7
081141700,ny,-73.79172,40.74481,1257,6,13,7,116.7
081142900,ny,-73.78452,40.75106,1047,6,13,7,116.7
081143500,ny,-73.77028,40.75291,635,5,12,7,140
081144100,ny,-73.76381,40.75567,593,4,10,6,150
081144700,ny,-73.77245,40.75687,740,6,13,7,116.7
081145101,ny,-73.7847,40.75514,394,6,13,7,116.7
081145102,ny,-73.77815,40.75324,616,6,13,7,116.7
081145900,ny,-73.79195,40.75421,771,6,13,7,116.7
081146300,ny,-73.7811,40.75947,452,6,13,7,116.7
081146700,ny,-73.77321,40.7612,411,6,13,7,116.7
081147100,ny,-73.76344,40.76147,682,4,10,6,150
081147900,ny,-73.74229,40.76958,1102,4,9,5,125
081148300,ny,-73.75229,40.77614,1105,4,10,6,150
081150701,ny,-73.7397,40.7622,1006,4,9,5,125
081150702,ny,-73.73083,40.76637,959,4,9,5,125
081152901,ny,-73.73365,40.75233,640,4,9,5,125
081152902,ny,-73.72402,40.75931,771,4,9,5,125
081155101,ny,-73.71424,40.75664,7,4,10,6,150
081155103,ny,-73.7196,40.75188,171,4,10,6,150
081155104,ny,-73.71044,40.75044,367,4,10,6,150
081156700,ny,-73.72972,40.74051,127,4,9,5,125
081157101,ny,-73.71956,40.7385,1832,4,10,6,150
081157102,ny,-73.72505,40.73499,427,4,10,6,150
081157901,ny,-73.70461,40.74472,1350,4,10,6,150
081157902,ny,-73.712,40.74158,1112,4,10,6,150
081157903,ny,-73.70766,40.73383,1169,4,10,6,150
081161700,ny,-73.71761,40.72882,1383,4,10,6,150
081162100,ny,-73.72971,40.72843,1415,4,10,6,150
083040100,ny,-73.66859,42.7863,1198,3,8,5,166.7
083040200,ny,-73.67528,42.77138,1283,3,8,5,166.7
083040300,ny,-73.67955,42.75966,820,3,8,5,166.7
083040400,ny,-73.68343,42.74674,744,3,9,6,200
083040500,ny,-73.67625,42.74602,564,3,8,5,166.7
083040600,ny,-73.67992,42.73343,483,3,8,5,166.7
083040701,ny,-73.68872,42.73263,601,4,10,6,150
083040702,ny,-73.68246,42.7235,473,3,8,5,166.7
083040800,ny,-73.69292,42.72508,440,4,10,6,150
083040900,ny,-73.69216,42.71814,890,4,10,6,150
083041000,ny,-73.69601,42.70488,1076,4,10,6,150
083041101,ny,-73.67163,42.70208,1098,3,8,5,166.7
083041102,ny,-73.68064,42.71145,437,3,8,5,166.7
083041200,ny,-73.6636,42.71434,1071,3,8,5,166.7
083041300,ny,-73.66682,42.7298,1038,3,8,5,166.7
083041400,ny,-73.66469,42.76262,1012,3,8,5,166.7
083051500,ny,-73.74528,42.63282,979,4,10,6,150
083051601,ny,-73.7325,42.65365,1007,4,11,7,175
083051602,ny,-73.7162,42.66077,1114,3,9,6,200
083051701,ny,-73.35627,42.89004,1991,1,4,3,300
083051702,ny,-73.34996,42.90092,1365,1,4,3,300
083051800,ny,-73.50512,42.86467,2639,2,5,3,150
083051901,ny,-73.6074,42.9,1993,3,8,5,166.7
083051902,ny,-73.62899,42.82112,1591,2,7,5,250
083052002,ny,-73.55375,42.75961,916,1,4,3,300
083052003,ny,-73.62028,42.7759,1943,2,7,5,250
083052004,ny,-73.61873,42.72938,2523,2,7,5,250
083052101,ny,-73.45593,42.76848,1795,1,2,1,100
083052102,ny,-73.33338,42.77138,1012,1,2,1,100
083052103,ny,-73.37418,42.66713,1419,0,2,2,NA
083052201,ny,-73.52625,42.68647,2150,1,4,3,300
083052203,ny,-73.52585,42.6358,2761,1,4,3,300
083052204,ny,-73.59762,42.61171,1214,2,5,3,150
083052301,ny,-73.67947,42.66124,1864,3,8,5,166.7
083052303,ny,-73.63054,42.66354,602,2,6,4,200
083052305,ny,-73.62742,42.69098,1229,2,7,5,250
083052306,ny,-73.66331,42.68214,1637,2,7,5,250
083052402,ny,-73.66675,42.61654,976,2,7,5,250
083052405,ny,-73.73022,42.62343,1051,4,10,6,150
083052406,ny,-73.71258,42.62525,1690,3,9,6,200
083052407,ny,-73.70269,42.5911,1484,3,8,5,166.7
083052408,ny,-73.74011,42.59833,1233,4,10,6,150
083052501,ny,-73.72396,42.51908,2856,3,9,6,200
083052502,ny,-73.6405,42.54162,2341,2,7,5,250
083052503,ny,-73.75062,42.53415,538,4,10,6,150
083052601,ny,-73.54582,42.54365,2239,1,4,3,300
083052602,ny,-73.61075,42.51396,446,2,7,5,250
083052603,ny,-73.41076,42.55692,1721,1,2,1,100
085000300,ny,-74.066,40.64427,175,4,10,6,150
085000600,ny,-74.06029,40.61741,543,4,10,6,150
085000700,ny,-74.08109,40.64791,296,4,10,6,150
085000800,ny,-74.06771,40.61195,1575,4,10,6,150
085000900,ny,-74.08286,40.64221,365,4,10,6,150
085001100,ny,-74.08267,40.63878,686,4,10,6,150
085001700,ny,-74.08123,40.63441,425,4,10,6,150
085001800,ny,-74.05418,40.60169,1,4,10,6,150
085002001,ny,-74.07098,40.60689,489,4,10,6,150
085002002,ny,-74.0703,40.60147,633,4,10,6,150
085002100,ny,-74.06845,40.63126,1060,4,10,6,150
085002700,ny,-74.07643,40.62359,286,4,10,6,150
085002900,ny,-74.08274,40.61966,856,4,10,6,150
085003300,ny,-74.08662,40.6256,795,4,10,6,150
085003600,ny,-74.0759,40.61107,694,4,10,6,150
085003900,ny,-74.09335,40.62119,170,4,10,6,150
085004001,ny,-74.0757,40.61889,489,4,10,6,150
085004002,ny,-74.07942,40.61291,925,4,10,6,150
085004003,ny,-74.08339,40.61433,137,4,10,6,150
085004004,ny,-74.08527,40.60929,659,4,10,6,150
085004700,ny,-74.09474,40.6142,695,4,10,6,150
085005000,ny,-74.08603,40.60412,943,4,10,6,150
085005901,ny,-74.10157,40.62428,751,4,10,6,150
085005902,ny,-74.09438,40.6275,2,4,10,6,150
085006400,ny,-74.0785,40.59724,816,4,10,6,150
085006700,ny,-74.1011,40.63519,804,4,10,6,150
085007001,ny,-74.08683,40.58995,847,4,10,6,150
085007002,ny,-74.07383,40.58602,1536,4,10,6,150
085007400,ny,-74.06275,40.59213,1049,4,10,6,150
085007500,ny,-74.09095,40.6336,717,4,10,6,150
085007700,ny,-74.09027,40.63787,455,4,10,6,150
085008100,ny,-74.09377,40.6438,947,4,10,6,150
085009601,ny,-74.0886,40.59693,1058,4,10,6,150
085009602,ny,-74.09516,40.59078,989,4,10,6,150
085009701,ny,-74.11225,40.64267,874,4,10,6,150
085009702,ny,-74.10306,40.64364,10,4,10,6,150
085010500,ny,-74.11187,40.6338,1311,4,10,6,150
085011201,ny,-74.0855,40.57752,2280,4,10,6,150
085011203,ny,-74.09739,40.57377,2112,4,10,6,150
085011204,ny,-74.09303,40.56759,10,4,10,6,150
085011401,ny,-74.0991,40.58574,591,4,10,6,150
085011402,ny,-74.10495,40.58119,918,4,10,6,150
085012100,ny,-74.10964,40.62588,1180,4,10,6,150
085012200,ny,-74.11146,40.57597,1254,4,11,7,175
085012500,ny,-74.11885,40.62868,721,4,10,6,150
085012804,ny,-74.10155,40.56315,1408,4,10,6,150
085012805,ny,-74.11508,40.55297,1238,4,10,6,150
085012806,ny,-74.10733,40.55758,1229,4,10,6,150
085013201,ny,-74.12257,40.56478,556,4,10,6,150
085013203,ny,-74.14272,40.5497,1647,5,11,6,120
085013204,ny,-74.13024,40.55942,1484,4,10,6,150
085013301,ny,-74.11891,40.6356,17,4,10,6,150
085013302,ny,-74.1235,40.63589,933,4,10,6,150
085013400,ny,-74.11745,40.56988,1239,4,10,6,150
085013800,ny,-74.13188,40.57049,2116,4,11,7,175
085014100,ny,-74.12689,40.62886,588,4,10,6,150
085014604,ny,-74.15975,40.55004,1840,5,12,7,140
085014605,ny,-74.15012,40.5587,1247,5,12,7,140
085014606,ny,-74.14262,40.56256,1751,5,11,6,120
085014607,ny,-74.16412,40.55692,1225,5,12,7,140
085014608,ny,-74.15652,40.55847,1060,5,12,7,140
085014700,ny,-74.11643,40.61926,1018,4,10,6,150
085015100,ny,-74.12759,40.61953,1682,4,10,6,150
085015400,ny,-74.12693,40.54185,4,4,10,6,150
085015601,ny,-74.15458,40.54215,2209,5,12,7,140
085015602,ny,-74.1618,40.53602,1177,5,12,7,140
085015603,ny,-74.14626,40.53188,1527,5,12,7,140
085016901,ny,-74.10946,40.61239,911,4,10,6,150
085017005,ny,-74.18097,40.53929,1531,5,12,7,140
085017007,ny,-74.18795,40.55849,1897,6,12,6,100
085017009,ny,-74.18959,40.54293,1286,6,13,7,116.7
085017011,ny,-74.17023,40.54564,1275,5,12,7,140
085017012,ny,-74.17346,40.55298,1326,5,12,7,140
085017013,ny,-74.19783,40.55374,1455,6,13,7,116.7
085017014,ny,-74.19426,40.54844,961,6,13,7,116.7
085017015,ny,-74.18243,40.55128,755,5,12,7,140
085017016,ny,-74.17761,40.5587,1401,5,12,7,140
085017300,ny,-74.11828,40.60528,427,4,10,6,150
085017600,ny,-74.17198,40.52564,2105,5,12,7,140
085017701,ny,-74.1053,40.60319,1667,4,10,6,150
085017702,ny,-74.09729,40.59818,794,4,10,6,150
085018100,ny,-74.12078,40.5891,1041,4,11,7,175
085018701,ny,-74.12725,40.61074,576,4,10,6,150
085018703,ny,-74.12891,40.60336,876,4,11,7,175
085018704,ny,-74.12374,40.60438,840,4,10,6,150
085018901,ny,-74.14005,40.61192,1755,5,11,6,120
085018902,ny,-74.13798,40.60508,1264,5,11,6,120
085019700,ny,-74.13524,40.61698,652,4,10,6,150
085019800,ny,-74.20166,40.51335,2198,4,10,6,150
085020100,ny,-74.13426,40.62404,1009,4,10,6,150
085020701,ny,-74.1393,40.63882,672,4,10,6,150
085020702,ny,-74.1303,40.63923,707,4,10,6,150
085020803,ny,-74.21067,40.53282,1895,6,12,6,100
085020804,ny,-74.19953,40.5358,1594,6,13,7,116.7
085020805,ny,-74.21491,40.5476,1474,6,13,7,116.7
085020806,ny,-74.20579,40.54957,652,6,13,7,116.7
085021300,ny,-74.1389,40.63262,1239,4,10,6,150
085022300,ny,-74.15273,40.63887,820,6,13,7,116.7
085022601,ny,-74.22053,40.53146,2000,5,12,7,140
085022602,ny,-74.23397,40.54007,1237,5,12,7,140
085022801,ny,-74.19903,40.56815,44,6,13,7,116.7
085022802,ny,-74.17859,40.58288,20,6,13,7,116.7
085023100,ny,-74.15632,40.63012,1038,6,13,7,116.7
085023900,ny,-74.1493,40.62952,858,6,13,7,116.7
085024401,ny,-74.2389,40.50939,2063,4,10,6,150
085024402,ny,-74.23884,40.4996,1364,4,10,6,150
085024700,ny,-74.14176,40.62752,622,5,11,6,120
085024800,ny,-74.24452,40.51583,1466,4,10,6,150
085025100,ny,-74.14603,40.61802,1572,5,12,7,140
085027301,ny,-74.15185,40.59973,922,6,13,7,116.7
085027302,ny,-74.13872,40.59553,897,5,11,6,120
085027702,ny,-74.16366,40.5801,461,6,13,7,116.7
085027704,ny,-74.15151,40.58542,993,6,13,7,116.7
085027705,ny,-74.15698,40.58825,1226,6,13,7,116.7
085027706,ny,-74.1619,40.59094,532,6,13,7,116.7
085027900,ny,-74.14911,40.57496,812,5,11,6,120
085029102,ny,-74.19164,40.6089,1310,6,13,7,116.7
085029104,ny,-74.1635,40.61372,1659,6,13,7,116.7
085029105,ny,-74.17189,40.60617,877,6,13,7,116.7
085029106,ny,-74.16516,40.59736,769,6,13,7,116.7
085030301,ny,-74.15612,40.61892,729,6,13,7,116.7
085030302,ny,-74.15874,40.62353,1259,6,13,7,116.7
085031901,ny,-74.16332,40.6303,363,6,13,7,116.7
085031902,ny,-74.16567,40.6395,905,6,13,7,116.7
085032300,ny,-74.17931,40.63512,334,6,13,7,116.7
085990100,ny,-74.10914,40.52491,3,4,10,6,150
087010101,ny,-74.01602,41.26413,2286,7,14,7,100
087010102,ny,-73.99558,41.22307,1646,7,14,7,100
087010200,ny,-73.97513,41.23235,1443,7,16,9,128.6
087010501,ny,-74.01187,41.20594,1602,6,13,7,116.7
087010503,ny,-74.08757,41.20963,1131,4,11,7,175
087010504,ny,-74.0296,41.19262,2140,5,11,6,120
087010601,ny,-73.99507,41.20549,1221,7,14,7,100
087010602,ny,-73.96463,41.21182,1431,7,14,7,100
087010701,ny,-73.97185,41.19169,991,7,15,8,114.3
087010702,ny,-73.96649,41.19532,708,8,16,8,100
087010703,ny,-73.94405,41.19376,756,7,15,8,114.3
087010801,ny,-74.00657,41.17098,1691,6,13,7,116.7
087010802,ny,-73.96924,41.16369,1840,6,13,7,116.7
087010803,ny,-73.98904,41.15958,1697,6,13,7,116.7
087010804,ny,-73.98518,41.14406,1382,6,13,7,116.7
087010901,ny,-73.95141,41.14627,1648,6,13,7,116.7
087010902,ny,-73.92006,41.15254,1591,7,14,7,100
087011000,ny,-73.90577,41.11429,799,8,16,8,100
087011101,ny,-73.93701,41.1237,1953,6,14,8,133.3
087011102,ny,-73.94989,41.10237,2200,7,14,7,100
087011200,ny,-73.9782,41.10175,2310,6,13,7,116.7
087011302,ny,-74.02313,41.08922,1822,5,12,7,140
087011303,ny,-74.0003,41.09322,1776,6,13,7,116.7
087011304,ny,-74.03568,41.11326,635,5,11,6,120
087011305,ny,-74.02362,41.10517,618,5,12,7,140
087011401,ny,-74.00973,41.1383,1386,5,12,7,140
087011403,ny,-73.99223,41.12593,1823,5,12,7,140
087011404,ny,-74.02286,41.11602,1735,5,11,6,120
087011405,ny,-74.01432,41.12294,1089,5,12,7,140
087011505,ny,-74.03092,41.13786,336,5,11,6,120
087011506,ny,-74.02827,41.14428,837,5,11,6,120
087011507,ny,-74.06167,41.16625,1133,4,10,6,150
087011508,ny,-74.07682,41.15842,1156,4,10,6,150
087011509,ny,-74.03716,41.16852,1249,5,11,6,120
087011510,ny,-74.05166,41.14125,1031,4,11,7,175
087011511,ny,-74.04118,41.13244,770,5,11,6,120
087011512,ny,-74.03053,41.12748,992,5,11,6,120
087011601,ny,-74.1425,41.16039,1784,4,10,6,150
087011602,ny,-74.10166,41.12661,1859,4,10,6,150
087011603,ny,-74.11088,41.10113,1742,5,11,6,120
087011700,ny,-74.19014,41.16203,1249,4,9,5,125
087011800,ny,-74.17053,41.12636,417,5,11,6,120
087011901,ny,-74.14593,41.1104,1124,5,11,6,120
087011902,ny,-74.14501,41.11929,952,4,11,7,175
087012000,ny,-74.13254,41.10591,1337,5,11,6,120
087012107,ny,-74.05741,41.11978,684,4,11,7,175
087012108,ny,-74.06527,41.12116,513,4,10,6,150
087012109,ny,-74.06378,41.11369,349,4,10,6,150
087012110,ny,-74.05615,41.11322,426,5,11,6,120
087012111,ny,-74.08326,41.11685,602,4,10,6,150
087012112,ny,-74.07369,41.13059,631,4,10,6,150
087012113,ny,-74.07271,41.12111,662,4,10,6,150
087012114,ny,-74.07455,41.11183,475,4,10,6,150
087012115,ny,-74.04799,41.10064,353,5,11,6,120
087012116,ny,-74.06985,41.10535,502,4,11,7,175
087012203,ny,-74.06135,41.12658,599,4,10,6,150
087012204,ny,-74.05469,41.12705,522,5,11,6,120
087012205,ny,-74.04798,41.12301,150,5,11,6,120
087012206,ny,-74.04214,41.12317,220,5,11,6,120
087012301,ny,-74.05065,41.11629,480,5,11,6,120
087012302,ny,-74.04297,41.11628,505,5,11,6,120
087012401,ny,-74.05848,41.10718,512,5,11,6,120
087012403,ny,-74.04264,41.10688,289,5,11,6,120
087012404,ny,-74.04803,41.10793,293,5,11,6,120
087012503,ny,-74.05305,41.08914,688,5,11,6,120
087012504,ny,-74.04718,41.07503,1194,5,12,7,140
087012505,ny,-74.07595,41.09858,668,5,11,6,120
087012506,ny,-74.07862,41.08557,835,5,11,6,120
087012600,ny,-74.02302,41.0691,2158,6,13,7,116.7
087012700,ny,-74.01823,41.05697,1389,6,14,8,133.3
087012800,ny,-73.99008,41.05563,2363,7,14,7,100
087013001,ny,-73.97238,41.05004,786,7,15,8,114.3
087013002,ny,-73.95864,41.06274,1762,7,15,8,114.3
087013003,ny,-73.9251,41.061,1023,8,16,8,100
087013101,ny,-73.92673,41.09427,914,8,16,8,100
087013102,ny,-73.90817,41.09082,843,8,16,8,100
087013200,ny,-73.91265,41.07976,738,8,16,8,100
087013300,ny,-73.91477,41.04235,1161,8,17,9,112.5
087013401,ny,-73.9519,41.02826,1599,7,15,8,114.3
087013402,ny,-73.91293,41.02126,1475,8,16,8,100
089490100,ny,-74.85437,44.97809,1612,2,5,3,150
089490200,ny,-74.90586,44.93589,1805,2,5,3,150
089490300,ny,-74.80258,44.94527,2604,2,5,3,150
089490400,ny,-75.01382,44.90658,1966,2,5,3,150
089490500,ny,-75.1633,44.80296,2839,2,5,3,150
089490600,ny,-74.94674,44.83204,2609,2,5,3,150
089490700,ny,-74.79225,44.81077,4455,2,5,3,150
089490800,ny,-75.01131,44.63114,1484,1,4,3,300
089490900,ny,-74.96463,44.6913,1305,1,4,3,300
089491000,ny,-75.06948,44.69951,2473,2,4,2,100
089491100,ny,-75.00346,44.66119,32,1,4,3,300
089491200,ny,-74.97179,44.66196,2,1,4,3,300
089491300,ny,-75.31862,44.71064,2618,2,5,3,150
089491400,ny,-75.45795,44.71559,1513,2,6,4,200
089491500,ny,-75.48993,44.70121,1471,2,5,3,150
089491600,ny,-75.5041,44.69126,1151,2,5,3,150
089491700,ny,-75.48168,44.62946,2524,2,5,3,150
089491800,ny,-75.36043,44.4764,3121,2,4,2,100
089491900,ny,-75.14953,44.59031,8,2,4,2,100
089492000,ny,-75.15722,44.55633,2379,1,4,3,300
089492100,ny,-75.23682,44.60249,1382,2,4,2,100
089492301,ny,-74.87884,44.57642,3001,1,2,1,100
089492302,ny,-75.01366,44.52815,1766,1,3,2,200
089492401,ny,-74.70296,44.72545,1593,1,4,3,300
089492501,ny,-74.9966,44.22135,3271,0,2,2,NA
089492600,ny,-75.25749,44.31752,4778,1,3,2,200
089492700,ny,-75.48377,44.36733,2916,2,5,3,150
089492800,ny,-75.59998,44.48927,3376,2,5,3,150
089492900,ny,-75.70324,44.40062,2681,2,5,3,150
089493000,ny,-74.7013,44.37488,2463,0,2,2,NA
091060102,ny,-73.62911,43.28006,2283,3,9,6,200
091060103,ny,-73.71841,43.23808,941,3,9,6,200
091060104,ny,-73.64089,43.23494,1434,4,10,6,150
091060200,ny,-73.63509,43.29515,1414,3,9,6,200
091060301,ny,-73.82481,43.21143,1693,1,4,3,300
091060400,ny,-73.83102,43.24562,1092,2,5,3,150
091060501,ny,-73.90379,43.33593,1550,1,3,2,200
091060504,ny,-74.09284,43.22697,2113,1,2,1,100
091060505,ny,-74.03331,43.29978,2550,0,2,2,NA
091060506,ny,-74.02845,43.10256,1242,1,4,3,300
091060507,ny,-74.06742,43.13676,466,1,3,2,200
091060601,ny,-73.81587,43.14474,1284,3,8,5,166.7
091060602,ny,-73.9095,43.13162,2618,2,6,4,200
091060703,ny,-73.7449,43.17911,1332,3,9,6,200
091060704,ny,-73.70416,43.13904,1551,4,10,6,150
091060705,ny,-73.76187,43.14108,1128,4,10,6,150
091060706,ny,-73.75081,43.12413,2168,4,10,6,150
091060800,ny,-73.63055,43.16208,2224,4,10,6,150
091060901,ny,-73.64904,43.05942,2339,3,9,6,200
091060902,ny,-73.58589,43.0968,783,3,9,6,200
091061001,ny,-73.78103,43.07997,955,4,11,7,175
091061002,ny,-73.7886,43.08044,567,4,11,7,175
091061101,ny,-73.7711,43.0659,785,5,11,6,120
091061102,ny,-73.76235,43.0846,1755,5,11,6,120
091061201,ny,-73.78462,43.09095,701,4,11,7,175
091061202,ny,-73.7956,43.07277,1442,4,11,7,175
091061301,ny,-73.75321,43.06285,2157,4,11,7,175
091061303,ny,-73.78297,43.10058,7,4,11,7,175
091061304,ny,-73.82771,43.04546,1259,5,11,6,120
091061305,ny,-73.8241,43.0747,1494,4,11,7,175
091061401,ny,-73.91836,43.04297,1389,3,8,5,166.7
091061403,ny,-73.86426,43.02357,2102,4,10,6,150
091061404,ny,-73.86647,43.05774,1361,4,10,6,150
091061500,ny,-74.03088,43.02934,2744,2,5,3,150
091061600,ny,-73.98994,42.95432,2040,2,7,5,250
091061701,ny,-73.87375,42.96531,3071,3,9,6,200
091061702,ny,-73.89262,42.92893,1797,3,8,5,166.7
091061800,ny,-73.85301,43.00778,1979,4,10,6,150
091061904,ny,-73.8154,42.98253,1909,4,9,5,125
091061905,ny,-73.77033,43.01181,1635,4,10,6,150
091061906,ny,-73.78942,42.9423,803,4,9,5,125
091061907,ny,-73.77031,42.96336,1959,4,10,6,150
091062001,ny,-73.7124,42.94354,2004,4,10,6,150
091062002,ny,-73.6742,42.99041,1599,3,9,6,200
091062100,ny,-73.64386,42.94686,721,4,10,6,150
091062200,ny,-73.68749,42.90366,940,4,10,6,150
091062300,ny,-73.69372,42.90337,575,4,10,6,150
091062404,ny,-73.69647,42.85406,1421,4,10,6,150
091062406,ny,-73.75057,42.87381,965,3,9,6,200
091062407,ny,-73.75546,42.81813,1469,3,9,6,200
091062408,ny,-73.72718,42.83428,1398,4,10,6,150
091062409,ny,-73.743,42.85493,737,3,9,6,200
091062410,ny,-73.76011,42.84721,538,3,9,6,200
091062501,ny,-73.79862,42.91084,2069,3,9,6,200
091062503,ny,-73.79687,42.84777,1871,3,9,6,200
091062505,ny,-73.73617,42.90116,2194,4,9,5,125
091062506,ny,-73.78072,42.8173,2487,3,9,6,200
091062507,ny,-73.80718,42.80774,1431,3,9,6,200
091062508,ny,-73.78341,42.87797,1778,3,8,5,166.7
091062509,ny,-73.80485,42.87411,1155,3,8,5,166.7
091062601,ny,-73.85447,42.9014,1213,3,9,6,200
091062602,ny,-73.85233,42.85233,2945,3,8,5,166.7
091062700,ny,-73.69238,42.80509,2299,4,10,6,150
091062800,ny,-73.67903,42.79159,648,3,8,5,166.7
091062900,ny,-73.91901,43.23197,815,1,3,2,200
093020101,ny,-73.91135,42.82402,733,3,7,4,133.3
093020102,ny,-73.91614,42.82954,715,3,7,4,133.3
093020200,ny,-73.92599,42.82955,906,3,7,4,133.3
093020300,ny,-73.93773,42.81946,434,3,8,5,166.7
093020500,ny,-73.90909,42.81222,1797,3,8,5,166.7
093020600,ny,-73.91009,42.80137,1048,3,8,5,166.7
093020700,ny,-73.91577,42.79574,1552,3,8,5,166.7
093020800,ny,-73.92876,42.80845,1054,3,8,5,166.7
093020900,ny,-73.93497,42.80242,1050,3,8,5,166.7
093021001,ny,-73.93895,42.81289,250,3,8,5,166.7
093021002,ny,-73.94182,42.8068,635,3,8,5,166.7
093021200,ny,-73.9707,42.79981,1052,3,8,5,166.7
093021400,ny,-73.95006,42.80031,972,3,8,5,166.7
093021500,ny,-73.94524,42.79576,803,3,8,5,166.7
093021600,ny,-73.93559,42.79284,1350,3,8,5,166.7
093021700,ny,-73.92071,42.79088,920,3,8,5,166.7
093021801,ny,-73.89964,42.78546,1110,3,8,5,166.7
093021802,ny,-73.90614,42.77339,1706,3,8,5,166.7
093031901,ny,-73.86068,42.77806,1733,3,8,5,166.7
093031902,ny,-73.88635,42.78145,1191,3,8,5,166.7
093032000,ny,-73.90025,42.83087,2345,3,8,5,166.7
093032101,ny,-73.87453,42.81636,2283,3,8,5,166.7
093032102,ny,-73.84521,42.78714,771,3,9,6,200
093032200,ny,-73.95809,42.83282,1957,3,9,6,200
093032300,ny,-73.96967,42.82777,1030,3,8,5,166.7
093032402,ny,-73.92505,42.84952,1131,3,8,5,166.7
093032403,ny,-73.9909,42.84034,925,3,8,5,166.7
093032404,ny,-73.97303,42.86306,2622,3,8,5,166.7
093032502,ny,-73.9131,42.88104,1404,3,8,5,166.7
093032503,ny,-73.93254,42.89238,1566,3,8,5,166.7
093032504,ny,-74.03113,42.91037,1231,2,6,4,200
093032601,ny,-74.0123,42.78101,835,3,8,5,166.7
093032602,ny,-74.03409,42.83297,1821,3,7,4,133.3
093032700,ny,-73.98422,42.79348,1677,3,8,5,166.7
093032901,ny,-73.92539,42.77247,1766,3,8,5,166.7
093032902,ny,-73.94162,42.77868,1917,3,8,5,166.7
093033002,ny,-73.98185,42.76435,1093,3,9,6,200
093033003,ny,-73.95626,42.77066,1568,3,8,5,166.7
093033004,ny,-73.98335,42.78163,1226,3,8,5,166.7
093033101,ny,-74.07811,42.8113,1168,2,6,4,200
093033102,ny,-74.18049,42.7799,3481,1,4,3,300
093033200,ny,-73.9599,42.79358,1319,3,8,5,166.7
093033300,ny,-73.95649,42.78601,1069,3,8,5,166.7
093033400,ny,-73.9231,42.81683,571,3,8,5,166.7
093033500,ny,-73.95716,42.80917,640,3,8,5,166.7
095740100,ny,-74.31204,42.70903,2811,1,4,3,300
095740200,ny,-74.44743,42.68415,2421,1,2,1,100
095740300,ny,-74.50081,42.67308,7,0,2,2,NA
095740400,ny,-74.54168,42.7454,3545,1,3,2,200
095740500,ny,-74.58279,42.60081,2975,0,1,1,NA
095740600,ny,-74.50537,42.52291,3717,0,1,1,NA
095740700,ny,-74.28147,42.62929,3025,1,2,1,100
095740800,ny,-74.36964,42.44489,4410,0,1,1,NA
097950100,ny,-76.79303,42.46608,3603,1,4,3,300
097950200,ny,-76.93861,42.41978,1302,2,6,4,200
097950300,ny,-77.03986,42.37685,2937,1,3,2,200
097950400,ny,-76.90886,42.33698,2160,2,6,4,200
097950500,ny,-76.74716,42.32167,2829,1,4,3,300
099950100,ny,-76.84418,42.98349,1490,3,8,5,166.7
099950200,ny,-76.78609,42.93419,1105,4,9,5,125
099950300,ny,-76.76267,42.90351,1581,4,9,5,125
099950400,ny,-76.82665,42.91226,1154,4,9,5,125
099950500,ny,-76.88325,42.92605,1493,4,9,5,125
099950600,ny,-76.93276,42.90827,1703,3,8,5,166.7
099950700,ny,-76.85251,42.84653,2292,3,8,5,166.7
099950801,ny,-76.83876,42.70665,1,2,5,3,150
099950802,ny,-76.84004,42.74704,2335,3,7,4,133.3
099950900,ny,-76.80969,42.62054,2715,2,5,3,150
099951000,ny,-76.69897,42.58574,1581,2,6,4,200
101960100,ny,-77.19533,42.52116,1667,2,4,2,100
101960200,ny,-77.33243,42.48984,2761,1,2,1,100
101960300,ny,-77.48055,42.51575,1744,0,2,2,NA
101960400,ny,-77.5913,42.5287,2235,0,1,1,NA
101960500,ny,-77.64095,42.44142,1959,0,1,1,NA
101960600,ny,-77.67787,42.33477,2253,1,3,2,200
101960700,ny,-77.65853,42.3324,1335,1,3,2,200
101960800,ny,-77.66462,42.32036,1280,1,3,2,200
101960900,ny,-77.65305,42.32021,1061,1,3,2,200
101961000,ny,-77.4926,42.36592,2415,1,2,1,100
101961100,ny,-77.38113,42.32928,1986,1,3,2,200
101961200,ny,-77.30661,42.34833,1222,1,3,2,200
101961300,ny,-77.24759,42.31434,1839,1,3,2,200
101961400,ny,-77.22762,42.41082,1935,1,3,2,200
101961500,ny,-77.13423,42.38299,2098,1,3,2,200
101961600,ny,-77.03295,42.23291,958,1,3,2,200
101961700,ny,-77.16223,42.22813,1545,1,4,3,300
101961800,ny,-77.34696,42.19454,2408,1,3,2,200
101961900,ny,-77.5439,42.23557,1987,1,2,1,100
101962000,ny,-77.61335,42.11604,3436,0,1,1,NA
101962100,ny,-77.33832,42.05328,1911,1,3,2,200
101962200,ny,-77.24047,42.1372,1249,1,4,3,300
101962301,ny,-77.14643,42.13321,1947,2,4,2,100
101962302,ny,-77.1036,42.17406,1109,2,5,3,150
101962400,ny,-77.06924,42.156,1120,2,6,4,200
101962500,ny,-77.05285,42.15229,918,2,5,3,150
101962600,ny,-77.06386,42.14248,932,2,4,2,100
101962700,ny,-77.04444,42.13874,1220,2,5,3,150
101962800,ny,-77.01009,42.15995,1756,2,5,3,150
101962900,ny,-77.03338,42.11159,1365,2,5,3,150
101963000,ny,-77.08303,42.04574,2231,2,4,2,100
103110101,ny,-73.46195,40.91316,1554,5,11,6,120
103110103,ny,-73.43613,40.8633,815,4,10,6,150
103110104,ny,-73.45114,40.86234,1164,4,10,6,150
103110200,ny,-73.43113,40.88391,2186,4,10,6,150
103110300,ny,-73.41565,40.89948,2098,4,10,6,150
103110401,ny,-73.396,40.89306,970,5,11,6,120
103110402,ny,-73.38173,40.89277,1565,5,11,6,120
103110501,ny,-73.36442,40.89659,1269,5,11,6,120
103110502,ny,-73.36459,40.87367,1098,5,11,6,120
103110601,ny,-73.34428,40.90846,1742,5,12,7,140
103110602,ny,-73.34617,40.89543,1181,5,11,6,120
103110801,ny,-73.3915,40.93588,1258,5,12,7,140
103110803,ny,-73.3162,40.91297,2361,5,11,6,120
103110901,ny,-73.42431,40.86417,1173,4,10,6,150
103110902,ny,-73.42163,40.85272,1051,4,10,6,150
103111001,ny,-73.41326,40.86787,858,4,10,6,150
103111002,ny,-73.40401,40.85624,1400,4,10,6,150
103111101,ny,-73.41844,40.83214,772,4,10,6,150
103111102,ny,-73.42135,40.8452,561,4,10,6,150
103111103,ny,-73.42106,40.83901,951,4,10,6,150
103111201,ny,-73.40259,40.84393,1050,4,10,6,150
103111202,ny,-73.40396,40.83503,1552,4,10,6,150
103111300,ny,-73.38996,40.87175,1777,4,10,6,150
103111401,ny,-73.38918,40.8507,508,5,11,6,120
103111402,ny,-73.38525,40.84111,1778,5,11,6,120
103111503,ny,-73.3549,40.86101,1153,5,11,6,120
103111504,ny,-73.34357,40.85572,598,5,11,6,120
103111506,ny,-73.35078,40.84121,1123,5,11,6,120
103111507,ny,-73.36928,40.84003,620,5,11,6,120
103111508,ny,-73.37422,40.85502,1375,5,11,6,120
103111601,ny,-73.33376,40.88812,1408,5,11,6,120
103111602,ny,-73.32191,40.88994,1168,5,11,6,120
103111701,ny,-73.33199,40.87134,1968,5,11,6,120
103111703,ny,-73.30416,40.87781,1090,5,11,6,120
103111704,ny,-73.3086,40.87088,1131,5,11,6,120
103111801,ny,-73.32356,40.84746,2174,5,11,6,120
103111802,ny,-73.30509,40.86325,964,5,11,6,120
103111803,ny,-73.30411,40.85487,867,5,11,6,120
103111804,ny,-73.30288,40.84637,795,5,11,6,120
103111900,ny,-73.43389,40.81993,2270,4,10,6,150
103112001,ny,-73.40958,40.82245,1745,4,10,6,150
103112002,ny,-73.38448,40.82253,1796,5,11,6,120
103112102,ny,-73.34359,40.81855,1298,5,11,6,120
103112103,ny,-73.3013,40.8317,1571,5,11,6,120
103112104,ny,-73.34105,40.83005,803,5,11,6,120
103112204,ny,-73.39893,40.80739,1191,5,11,6,120
103112211,ny,-73.30636,40.80842,1458,5,11,6,120
103112212,ny,-73.36101,40.8018,1121,5,11,6,120
103112213,ny,-73.35449,40.78209,1960,4,10,6,150
103112215,ny,-73.42411,40.76902,1001,2,7,5,250
103112216,ny,-73.33052,40.79575,1529,5,11,6,120
103112217,ny,-73.30911,40.78967,800,5,11,6,120
103112218,ny,-73.4237,40.79265,1978,5,11,6,120
103112219,ny,-73.38895,40.79627,1479,5,11,6,120
103112220,ny,-73.38724,40.7746,1116,4,9,5,125
103122300,ny,-73.40954,40.74008,1704,2,6,4,200
103122405,ny,-73.36049,40.76483,971,2,5,3,150
103122406,ny,-73.37076,40.7497,1835,2,5,3,150
103122407,ny,-73.37958,40.76024,439,2,5,3,150
103122408,ny,-73.38479,40.7281,1381,2,5,3,150
103122501,ny,-73.35661,40.74655,1562,2,5,3,150
103122502,ny,-73.35728,40.73548,1287,2,5,3,150
103122602,ny,-73.33703,40.74866,1479,2,5,3,150
103122603,ny,-73.33093,40.73917,1638,2,5,3,150
103122604,ny,-73.33902,40.75569,1355,2,5,3,150
103122605,ny,-73.3238,40.75674,575,2,5,3,150
103122704,ny,-73.34843,40.76528,762,2,5,3,150
103122705,ny,-73.34039,40.76383,1035,2,5,3,150
103122706,ny,-73.3264,40.77018,1158,2,6,4,200
103122707,ny,-73.30777,40.77383,1011,3,7,4,133.3
103122801,ny,-73.30876,40.75645,1964,2,5,3,150
103122802,ny,-73.3157,40.74006,1385,2,5,3,150
103122901,ny,-73.36928,40.7221,1669,1,5,4,400
103122902,ny,-73.36187,40.71448,1103,1,5,4,400
103123001,ny,-73.35289,40.72498,1777,1,5,4,400
103123002,ny,-73.34031,40.71932,1568,1,5,4,400
103123101,ny,-73.32935,40.72381,1220,1,5,4,400
103123102,ny,-73.3175,40.72268,1315,1,5,4,400
103123201,ny,-73.42266,40.71547,872,2,5,3,150
103123203,ny,-73.40085,40.69782,809,2,5,3,150
103123204,ny,-73.40572,40.70888,1442,2,5,3,150
103123303,ny,-73.4141,40.69348,1108,2,5,3,150
103123304,ny,-73.42248,40.70078,909,2,5,3,150
103123401,ny,-73.39007,40.70297,1047,2,5,3,150
103123403,ny,-73.3873,40.71133,507,1,5,4,400
103123404,ny,-73.37689,40.7066,1548,1,5,4,400
103123500,ny,-73.41646,40.67945,1766,2,5,3,150
103123600,ny,-73.41504,40.66098,1725,2,5,3,150
103123701,ny,-73.4008,40.68609,1516,2,5,3,150
103123703,ny,-73.40084,40.67329,1105,2,5,3,150
103123704,ny,-73.39087,40.67562,1316,2,5,3,150
103123801,ny,-73.39374,40.66051,1868,2,5,3,150
103123802,ny,-73.37632,40.66485,1559,1,5,4,400
103123900,ny,-73.38476,40.69026,1592,1,5,4,400
103124001,ny,-73.3715,40.69586,1397,1,5,4,400
103124002,ny,-73.36343,40.69723,1060,1,5,4,400
103124101,ny,-73.37961,40.67876,1307,1,5,4,400
103124102,ny,-73.37057,40.67611,1264,1,5,4,400
103124200,ny,-73.36178,40.67947,2071,1,5,4,400
103124301,ny,-73.34426,40.70808,551,1,5,4,400
103124302,ny,-73.3515,40.70128,1334,1,5,4,400
103124401,ny,-73.34371,40.68204,1022,1,5,4,400
103124402,ny,-73.34045,40.64093,2214,1,4,3,300
103124500,ny,-73.32788,40.70535,1724,1,5,4,400
103124601,ny,-73.33461,40.68665,1117,1,5,4,400
103124602,ny,-73.32332,40.69057,1796,1,5,4,400
103134702,ny,-73.26456,40.87944,2419,3,8,5,166.7
103134703,ny,-73.27941,40.90977,1443,5,12,7,140
103134704,ny,-73.24909,40.90313,849,3,8,5,166.7
103134902,ny,-73.20765,40.87806,1631,2,7,5,250
103134906,ny,-73.22904,40.8773,1769,2,7,5,250
103134907,ny,-73.22998,40.89432,1518,2,7,5,250
103134908,ny,-73.18854,40.86723,1289,2,7,5,250
103134909,ny,-73.2008,40.85067,1709,2,7,5,250
103135002,ny,-73.16481,40.86903,1972,2,7,5,250
103135003,ny,-73.14571,40.87176,1835,2,7,5,250
103135004,ny,-73.18056,40.90746,1426,3,8,5,166.7
103135005,ny,-73.14496,40.88951,1371,2,6,4,200
103135101,ny,-73.28465,40.85836,1320,5,11,6,120
103135102,ny,-73.2722,40.85913,1475,5,11,6,120
103135103,ny,-73.25575,40.85706,1635,2,7,5,250
103135104,ny,-73.2349,40.86064,1834,2,7,5,250
103135201,ny,-73.26936,40.8422,732,4,10,6,150
103135205,ny,-73.28275,40.82042,1780,5,11,6,120
103135208,ny,-73.2711,40.83105,1095,4,10,6,150
103135209,ny,-73.25012,40.81701,1491,2,7,5,250
103135303,ny,-73.19071,40.84032,1491,2,7,5,250
103135305,ny,-73.21336,40.83445,615,2,7,5,250
103135306,ny,-73.18164,40.83316,1898,2,7,5,250
103135401,ny,-73.16069,40.84315,2205,2,7,5,250
103135402,ny,-73.14268,40.85066,2368,2,5,3,150
103135403,ny,-73.13319,40.83837,1720,1,4,3,300
103135500,ny,-73.24203,40.83686,1719,3,7,4,133.3
103145601,ny,-73.25859,40.80203,1273,3,7,4,133.3
103145602,ny,-73.25609,40.79342,1298,2,7,5,250
103145603,ny,-73.27144,40.78792,1147,4,9,5,125
103145604,ny,-73.25453,40.78409,958,2,7,5,250
103145605,ny,-73.24336,40.7941,778,2,7,5,250
103145701,ny,-73.21443,40.81295,1433,2,7,5,250
103145702,ny,-73.23254,40.79428,1326,2,7,5,250
103145703,ny,-73.21613,40.79504,1176,2,7,5,250
103145705,ny,-73.20024,40.80196,536,2,7,5,250
103145706,ny,-73.1922,40.79659,1203,2,7,5,250
103145803,ny,-73.17646,40.82113,1630,2,7,5,250
103145804,ny,-73.17108,40.80686,1301,2,7,5,250
103145807,ny,-73.13758,40.81588,1418,1,5,4,400
103145808,ny,-73.13731,40.80776,1011,2,5,3,150
103145809,ny,-73.12366,40.82403,777,1,4,3,300
103145810,ny,-73.14179,40.82336,1352,2,5,3,150
103145901,ny,-73.28615,40.7571,1186,1,5,4,400
103145903,ny,-73.27196,40.73974,1769,1,5,4,400
103145904,ny,-73.26725,40.76447,962,1,5,4,400
103145905,ny,-73.27589,40.75826,930,1,5,4,400
103146001,ny,-73.25325,40.77033,886,1,4,3,300
103146002,ny,-73.25399,40.75537,1074,1,4,3,300
103146004,ny,-73.25761,40.73712,395,1,4,3,300
103146005,ny,-73.24741,40.74386,1378,1,4,3,300
103146102,ny,-73.23931,40.75705,553,1,4,3,300
103146103,ny,-73.22854,40.74718,1205,1,4,3,300
103146105,ny,-73.23091,40.77076,1198,1,5,4,400
103146106,ny,-73.23916,40.76924,810,1,4,3,300
103146201,ny,-73.22137,40.7778,978,2,6,4,200
103146202,ny,-73.21112,40.77597,1052,2,6,4,200
103146203,ny,-73.20213,40.78427,1427,2,7,5,250
103146204,ny,-73.21766,40.76348,1235,1,4,3,300
103146205,ny,-73.21505,40.74923,763,1,4,3,300
103146206,ny,-73.20487,40.75319,660,1,4,3,300
103146300,ny,-73.19569,40.76961,892,2,6,4,200
103146402,ny,-73.16731,40.76137,1323,1,4,3,300
103146403,ny,-73.18588,40.78497,1250,2,7,5,250
103146404,ny,-73.1759,40.78335,830,2,6,4,200
103146500,ny,-73.18689,40.75027,1735,1,4,3,300
103146607,ny,-73.09561,40.77393,777,1,3,2,200
103146608,ny,-73.07521,40.77275,514,1,3,2,200
103146611,ny,-73.04715,40.80042,897,1,5,4,400
103146612,ny,-73.08117,40.79559,1727,1,4,3,300
103146613,ny,-73.07226,40.79254,1207,1,4,3,300
103146614,ny,-73.0609,40.79889,2256,1,4,3,300
103146616,ny,-73.13886,40.77349,1409,1,4,3,300
103146617,ny,-73.11503,40.76082,1152,0,3,3,NA
103146618,ny,-73.11847,40.79591,2055,1,4,3,300
103146619,ny,-73.05704,40.77813,697,1,4,3,300
103146620,ny,-73.04649,40.78184,387,1,5,4,400
103146703,ny,-73.29627,40.74707,1172,1,5,4,400
103146704,ny,-73.29931,40.73672,653,1,5,4,400
103146705,ny,-73.30592,40.72642,1109,1,5,4,400
103146706,ny,-73.28924,40.7298,872,1,5,4,400
103146800,ny,-73.30096,40.71505,1933,1,5,4,400
103146901,ny,-73.29999,40.7026,1845,1,5,4,400
103146902,ny,-73.29962,40.68986,1448,1,5,4,400
103147001,ny,-73.28336,40.70417,1449,1,5,4,400
103147003,ny,-73.27187,40.70788,1843,1,4,3,300
103147004,ny,-73.21511,40.66214,3171,0,2,2,NA
103147100,ny,-73.26388,40.7189,1239,1,4,3,300
103147201,ny,-73.24933,40.71449,1059,1,3,2,200
103147202,ny,-73.25804,40.72847,607,1,3,2,200
103147301,ny,-73.24171,40.73329,900,1,4,3,300
103147302,ny,-73.23428,40.71814,1209,1,3,2,200
103147401,ny,-73.215,40.7352,1583,1,4,3,300
103147402,ny,-73.21419,40.71527,1359,1,4,3,300
103147502,ny,-73.18115,40.7219,2103,1,4,3,300
103147503,ny,-73.16302,40.71309,527,1,4,3,300
103147504,ny,-73.19786,40.71617,578,1,4,3,300
103147505,ny,-73.18548,40.73848,1899,1,4,3,300
103147601,ny,-73.14809,40.73562,1052,1,4,3,300
103147602,ny,-73.12722,40.73887,1848,0,3,3,NA
103147701,ny,-73.10087,40.74893,1025,0,3,3,NA
103147702,ny,-73.10482,40.72936,1618,0,3,3,NA
103147802,ny,-73.08235,40.73112,1487,0,3,3,NA
103147803,ny,-73.08795,40.75426,964,0,3,3,NA
103147804,ny,-73.07177,40.75538,2008,0,3,3,NA
103147901,ny,-73.0517,40.7582,1317,1,3,2,200
103147902,ny,-73.05691,40.73613,1664,1,3,2,200
103158001,ny,-73.12241,40.96155,1803,2,7,5,250
103158009,ny,-73.10561,40.89548,894,1,4,3,300
103158010,ny,-73.10313,40.92226,1288,2,6,4,200
103158011,ny,-73.08723,40.90844,2073,2,6,4,200
103158012,ny,-73.13057,40.8903,1461,1,4,3,300
103158013,ny,-73.11696,40.88914,1227,1,4,3,300
103158014,ny,-73.11197,40.90762,10,2,6,4,200
103158015,ny,-73.12427,40.91039,46,2,6,4,200
103158016,ny,-73.12022,40.93813,864,2,6,4,200
103158017,ny,-73.13917,40.92918,2040,3,7,4,133.3
103158102,ny,-73.04488,40.88872,1527,1,5,4,400
103158103,ny,-73.09693,40.8679,1620,1,4,3,300
103158107,ny,-73.11626,40.86947,1445,1,4,3,300
103158108,ny,-73.08978,40.88762,923,1,4,3,300
103158111,ny,-73.05528,40.87055,955,1,5,4,400
103158112,ny,-73.04232,40.87309,1299,1,5,4,400
103158114,ny,-73.06216,40.89971,937,1,5,4,400
103158116,ny,-73.02372,40.87265,767,1,4,3,300
103158117,ny,-73.05797,40.88663,905,1,4,3,300
103158118,ny,-73.07207,40.89119,1010,1,4,3,300
103158119,ny,-73.08023,40.87152,1907,1,4,3,300
103158120,ny,-73.06565,40.87263,1023,1,4,3,300
103158205,ny,-73.03166,40.9442,647,2,6,4,200
103158206,ny,-73.06826,40.94177,1633,2,6,4,200
103158207,ny,-73.0645,40.95967,1942,2,6,4,200
103158208,ny,-73.0709,40.92352,1861,2,6,4,200
103158209,ny,-73.055,40.93016,997,2,6,4,200
103158304,ny,-73.01325,40.96049,2625,1,4,3,300
103158306,ny,-73.01005,40.92308,2360,1,4,3,300
103158309,ny,-72.98311,40.88739,1236,1,3,2,200
103158310,ny,-72.95958,40.8925,2288,1,3,2,200
103158315,ny,-72.99637,40.9008,1876,1,3,2,200
103158317,ny,-72.97227,40.96375,2492,1,3,2,200
103158318,ny,-72.95681,40.95249,1722,1,3,2,200
103158319,ny,-73.03155,40.90075,1557,2,5,3,150
103158320,ny,-73.01666,40.90647,1800,1,5,4,400
103158322,ny,-72.99999,40.93184,867,1,4,3,300
103158324,ny,-73.0202,40.88714,962,1,4,3,300
103158325,ny,-73.00443,40.88023,940,1,3,2,200
103158326,ny,-73.03659,40.9235,603,2,6,4,200
103158327,ny,-73.04707,40.90848,2139,2,6,4,200
103158328,ny,-72.97773,40.92474,2777,1,4,3,300
103158329,ny,-72.98511,40.94531,632,1,3,2,200
103158401,ny,-72.93556,40.92803,618,1,4,3,300
103158402,ny,-72.88276,40.95809,1677,1,3,2,200
103158403,ny,-72.93076,40.89688,713,1,3,2,200
103158407,ny,-72.93856,40.96145,2659,1,3,2,200
103158408,ny,-72.91876,40.95897,1783,1,4,3,300
103158409,ny,-72.8994,40.90211,1602,1,3,2,200
103158410,ny,-72.90081,40.92104,2400,1,4,3,300
103158411,ny,-72.88875,40.93334,1039,1,3,2,200
103158412,ny,-72.86316,40.92212,1087,1,3,2,200
103158502,ny,-73.1038,40.83323,874,1,4,3,300
103158505,ny,-73.11598,40.85309,1124,1,4,3,300
103158506,ny,-73.1191,40.84394,1232,1,4,3,300
103158509,ny,-73.03766,40.85982,1468,1,5,4,400
103158510,ny,-73.02958,40.84305,2299,1,4,3,300
103158511,ny,-73.08781,40.84789,2119,1,4,3,300
103158512,ny,-73.09992,40.84463,1103,1,4,3,300
103158513,ny,-73.05633,40.85457,1012,1,4,3,300
103158514,ny,-73.06124,40.84462,2096,1,4,3,300
103158604,ny,-73.08708,40.82085,1682,1,4,3,300
103158605,ny,-73.06884,40.82246,1655,1,4,3,300
103158606,ny,-73.0437,40.82789,1730,1,4,3,300
103158607,ny,-73.03679,40.81819,1079,1,5,4,400
103158608,ny,-73.11339,40.81717,1311,1,4,3,300
103158609,ny,-73.10079,40.81711,1536,1,4,3,300
103158705,ny,-72.96778,40.8645,1454,1,3,2,200
103158707,ny,-72.94022,40.83441,1042,1,3,2,200
103158708,ny,-72.94217,40.87132,1231,1,3,2,200
103158709,ny,-72.91739,40.8501,1477,1,3,2,200
103158710,ny,-72.8749,40.87608,1611,1,3,2,200
103158711,ny,-72.98852,40.83999,2269,1,3,2,200
103158712,ny,-72.98687,40.82636,2651,1,3,2,200
103158713,ny,-72.98769,40.86048,768,1,3,2,200
103158714,ny,-73.02312,40.85714,296,1,5,4,400
103158715,ny,-73.00965,40.85553,1520,1,3,2,200
103158802,ny,-73.03525,40.75183,2024,1,3,2,200
103158803,ny,-73.02796,40.80274,2063,1,5,4,400
103158805,ny,-73.03016,40.78348,1424,1,5,4,400
103158806,ny,-73.01444,40.78308,1352,1,3,2,200
103158901,ny,-73.02983,40.76863,904,1,3,2,200
103158902,ny,-73.01758,40.76713,1415,0,3,3,NA
103159000,ny,-73.01347,40.75463,1444,0,2,2,NA
103159103,ny,-72.93083,40.7857,3334,0,3,3,NA
103159106,ny,-72.92526,40.80849,2401,0,3,3,NA
103159107,ny,-73.00085,40.80512,1430,1,3,2,200
103159108,ny,-72.9741,40.80877,2517,1,3,2,200
103159109,ny,-73.00025,40.77305,1091,0,2,2,NA
103159110,ny,-72.97878,40.77586,1091,0,2,2,NA
103159111,ny,-72.99662,40.78735,1056,1,3,2,200
103159112,ny,-72.97379,40.79175,656,1,3,2,200
103159201,ny,-72.99478,40.75802,1117,0,2,2,NA
103159203,ny,-72.96812,40.75609,2777,0,2,2,NA
103159204,ny,-72.91579,40.77298,2039,0,2,2,NA
103159300,ny,-72.94248,40.75469,1210,0,2,2,NA
103159406,ny,-72.77067,40.81972,2736,0,1,1,NA
103159407,ny,-72.88088,40.8358,2247,0,3,3,NA
103159408,ny,-72.87438,40.81507,1229,0,2,2,NA
103159410,ny,-72.75777,40.87064,4052,0,2,2,NA
103159411,ny,-72.85285,40.82375,1461,0,2,2,NA
103159413,ny,-72.8026,40.8481,1780,0,2,2,NA
103159414,ny,-72.83473,40.84202,1401,0,2,2,NA
103159415,ny,-72.82419,40.81225,317,0,1,1,NA
103159416,ny,-72.84605,40.80762,2338,0,2,2,NA
103159509,ny,-72.85469,40.75239,2051,0,1,1,NA
103159510,ny,-72.97823,40.71468,2339,0,2,2,NA
103159511,ny,-72.84238,40.79414,2234,0,2,2,NA
103159512,ny,-72.83155,40.78265,893,0,1,1,NA
103159513,ny,-72.87237,40.7913,1749,0,2,2,NA
103159514,ny,-72.8806,40.76785,1420,0,2,2,NA
103159515,ny,-72.82481,40.76924,978,0,1,1,NA
103159516,ny,-72.83998,40.76262,2845,0,1,1,NA
103159517,ny,-72.86081,40.79075,1300,0,2,2,NA
103159518,ny,-72.86247,40.76288,2287,0,2,2,NA
103159602,ny,-72.75274,40.80306,1860,0,1,1,NA
103159603,ny,-72.82221,40.79592,382,0,1,1,NA
103159604,ny,-72.79469,40.79305,2297,0,1,1,NA
103159700,ny,-73.09517,40.93848,935,2,6,4,200
103169701,ny,-72.82226,40.95201,3172,1,3,2,200
103169703,ny,-72.74158,40.96866,1128,1,3,2,200
103169705,ny,-72.7136,40.94692,920,0,3,3,NA
103169706,ny,-72.77498,40.91814,1622,0,3,3,NA
103169800,ny,-72.66964,40.92508,2169,0,2,2,NA
103169903,ny,-72.67432,40.96312,1279,0,2,2,NA
103169904,ny,-72.63599,40.9261,683,0,2,2,NA
103169905,ny,-72.57387,40.94575,1396,0,1,1,NA
103169906,ny,-72.61818,40.96486,2213,0,2,2,NA
103170003,ny,-72.54926,40.97334,1936,0,1,1,NA
103170004,ny,-72.51227,40.98547,2055,0,1,1,NA
103170005,ny,-72.45913,40.99199,2239,0,1,1,NA
103170006,ny,-72.48805,41.03102,1361,0,1,1,NA
103170101,ny,-72.36336,41.10146,1083,0,1,1,NA
103170203,ny,-72.43775,41.07675,1778,0,1,1,NA
103170204,ny,-72.41219,41.03349,3275,0,1,1,NA
103170205,ny,-72.37549,41.10333,1624,0,1,1,NA
103170206,ny,-72.14566,41.2036,3289,0,1,1,NA
103180300,ny,-72.32133,41.06467,3525,0,1,1,NA
103190402,ny,-72.64083,40.85032,3746,0,1,1,NA
103190403,ny,-72.53912,40.89804,2094,0,1,1,NA
103190404,ny,-72.67941,40.8849,1941,0,2,2,NA
103190405,ny,-72.60397,40.89653,2460,0,1,1,NA
103190502,ny,-72.64181,40.8043,2936,0,1,1,NA
103190503,ny,-72.71011,40.81516,2138,0,1,1,NA
103190504,ny,-72.6895,40.79612,2138,0,1,1,NA
103190603,ny,-72.53393,40.8613,2497,0,1,1,NA
103190604,ny,-72.51743,40.84177,2619,0,1,1,NA
103190605,ny,-72.59594,40.81733,1894,0,1,1,NA
103190606,ny,-72.56618,40.84363,2220,0,1,1,NA
103190706,ny,-72.41614,40.92836,4695,0,1,1,NA
103190708,ny,-72.30724,41.01669,2123,0,1,1,NA
103190709,ny,-72.45663,40.87311,1666,0,1,1,NA
103190710,ny,-72.47943,40.91125,1384,0,1,1,NA
103190711,ny,-72.34835,40.99096,3374,0,1,1,NA
103190712,ny,-72.32715,40.90924,2617,0,1,1,NA
103190713,ny,-72.38241,40.95666,2043,0,1,1,NA
103190714,ny,-72.28627,40.94211,3077,0,1,1,NA
103190801,ny,-72.40434,40.86917,2355,0,0,0,NA
103190802,ny,-72.39394,40.8912,1377,0,0,0,NA
103200901,ny,-72.19466,40.94726,2018,0,0,0,NA
103200903,ny,-72.25485,40.963,2340,0,1,1,NA
103200904,ny,-72.20859,40.96704,1388,0,0,0,NA
103200905,ny,-72.24116,41.00526,2077,0,1,1,NA
103200906,ny,-72.20696,41.017,2248,0,1,1,NA
103201005,ny,-72.16858,40.97881,1544,0,0,0,NA
103201006,ny,-72.09921,40.98926,2895,0,0,0,NA
103201007,ny,-71.96817,41.032,2335,0,0,0,NA
103201008,ny,-71.91575,41.06879,2508,0,0,0,NA
103201009,ny,-72.16663,41.01249,3005,0,0,0,NA
103201010,ny,-72.12107,41.0666,2473,0,1,1,NA
103201200,ny,-73.28612,40.78802,111,4,10,6,150
103990100,ny,-72.54209,41.01101,77,0,1,1,NA
105950100,ny,-74.59106,41.87202,2894,1,2,1,100
105950201,ny,-74.86453,41.91101,1562,0,1,1,NA
105950202,ny,-74.77194,41.94895,1957,0,1,1,NA
105950300,ny,-75.02816,41.85956,2026,0,2,2,NA
105950400,ny,-74.92126,41.83409,2542,0,2,2,NA
105950500,ny,-74.73827,41.82447,2269,0,2,2,NA
105950600,ny,-74.82583,41.8055,1793,0,2,2,NA
105950701,ny,-74.78224,41.8081,1197,0,2,2,NA
105950702,ny,-74.7657,41.78332,1067,0,2,2,NA
105950801,ny,-74.66051,41.78804,1554,1,2,1,100
105950802,ny,-74.59667,41.78143,2032,1,3,2,200
105950900,ny,-74.65776,41.73455,1544,1,3,2,200
105951000,ny,-74.60094,41.69821,2299,1,3,2,200
105951100,ny,-74.55263,41.69973,1556,1,4,3,300
105951201,ny,-74.42789,41.60429,2390,4,11,7,175
105951202,ny,-74.45598,41.54527,1530,5,12,7,140
105951301,ny,-74.54598,41.54459,1973,3,7,4,133.3
105951302,ny,-74.49199,41.6333,2924,3,8,5,166.7
105951500,ny,-74.69046,41.69942,1737,1,2,1,100
105951600,ny,-74.73192,41.64261,2574,1,3,2,200
105951701,ny,-74.60963,41.62382,3736,1,3,2,200
105951702,ny,-74.69666,41.54681,1492,1,4,3,300
105951801,ny,-74.67175,41.64264,1243,1,3,2,200
105951802,ny,-74.70193,41.65168,1130,1,2,1,100
105951900,ny,-74.80133,41.71087,2386,1,3,2,200
105952000,ny,-74.87251,41.67751,5071,1,3,2,200
105952100,ny,-75.00357,41.75965,1995,1,3,2,200
105952200,ny,-74.99381,41.6794,1650,1,3,2,200
105952300,ny,-74.98297,41.58366,1918,1,4,3,300
105952400,ny,-74.8891,41.5387,2698,1,4,3,300
105952500,ny,-74.81157,41.49371,3047,2,5,3,150
107020101,ny,-76.18737,42.34392,1764,1,3,2,200
107020102,ny,-76.16291,42.23014,2056,1,3,2,200
107020200,ny,-76.33289,42.23181,2961,1,4,3,300
107020300,ny,-76.18165,42.1332,3585,2,4,2,100
107020401,ny,-76.20084,42.04194,2505,1,4,3,300
107020402,ny,-76.13518,42.05372,1600,1,3,2,200
107020500,ny,-76.26282,42.10431,1751,2,5,3,150
107020600,ny,-76.36016,42.07446,3706,2,5,3,150
107020701,ny,-76.47933,42.21457,1838,1,4,3,300
107020702,ny,-76.4973,42.08335,2329,2,6,4,200
107020703,ny,-76.53088,42.00634,1673,4,8,4,100
109000100,ny,-76.49849,42.43965,378,1,3,2,200
109000201,ny,-76.48622,42.44173,136,2,4,2,100
109000202,ny,-76.48884,42.44029,282,1,4,3,300
109000300,ny,-76.4675,42.44752,117,1,4,3,300
109000400,ny,-76.46091,42.45921,120,1,4,3,300
109000500,ny,-76.46812,42.47254,1036,1,4,3,300
109000600,ny,-76.50133,42.47744,1420,2,5,3,150
109000700,ny,-76.50019,42.45113,1048,2,5,3,150
109000800,ny,-76.50708,42.4445,842,2,5,3,150
109000900,ny,-76.54343,42.46358,1520,3,7,4,133.3
109001000,ny,-76.55093,42.41241,1592,1,4,3,300
109001100,ny,-76.48636,42.41002,1607,1,3,2,200
109001200,ny,-76.49351,42.423,43,1,3,2,200
109001301,ny,-76.48001,42.43633,624,1,3,2,200
109001302,ny,-76.4367,42.42049,1326,1,4,3,300
109001400,ny,-76.39137,42.44625,1392,1,3,2,200
109001500,ny,-76.47409,42.50693,2474,1,4,3,300
109001600,ny,-76.61798,42.51904,2258,2,5,3,150
109001700,ny,-76.63512,42.43621,2084,1,4,3,300
109001800,ny,-76.59263,42.33005,2346,1,3,2,200
109001901,ny,-76.32203,42.36693,1836,1,3,2,200
109001902,ny,-76.4557,42.33784,1798,1,3,2,200
109002000,ny,-76.29698,42.47528,1685,1,3,2,200
109002100,ny,-76.3452,42.52204,1901,1,3,2,200
109002200,ny,-76.33687,42.58769,2034,1,4,3,300
109002300,ny,-76.51286,42.58093,2784,2,5,3,150
111950100,ny,-73.98865,42.12412,3072,5,12,7,140
111950200,ny,-73.94745,42.07558,1534,7,15,8,114.3
111950300,ny,-73.94936,42.05123,1649,7,15,8,114.3
111950400,ny,-74.03068,42.06379,2497,4,11,7,175
111950500,ny,-74.0882,42.02538,2005,3,8,5,166.7
111950600,ny,-74.18182,42.06226,2743,2,5,3,150
111950900,ny,-74.53185,42.00859,2827,0,0,0,NA
111951000,ny,-74.2631,41.94695,3099,2,6,4,200
111951100,ny,-74.13588,42.00547,1379,3,8,5,166.7
111951200,ny,-74.11093,41.95141,2116,5,11,6,120
111951300,ny,-73.97189,41.99504,1589,6,14,8,133.3
111951400,ny,-73.98045,41.96177,1495,6,14,8,133.3
111951500,ny,-74.03615,41.98147,1887,5,12,7,140
111951600,ny,-74.03447,41.90858,1003,5,12,7,140
111951700,ny,-73.97549,41.92937,1920,6,13,7,116.7
111951800,ny,-73.98844,41.9392,544,6,13,7,116.7
111951900,ny,-73.99179,41.9289,1151,6,13,7,116.7
111952000,ny,-74.00326,41.93366,731,6,13,7,116.7
111952100,ny,-74.00807,41.92525,1073,6,13,7,116.7
111952200,ny,-74.01897,41.91859,1514,6,13,7,116.7
111952300,ny,-74.03455,41.93528,434,5,12,7,140
111952400,ny,-74.01525,41.93943,1098,6,13,7,116.7
111952500,ny,-73.97799,41.90449,1499,6,13,7,116.7
111952600,ny,-73.99469,41.83841,2800,5,12,7,140
111952700,ny,-74.07285,41.86843,1468,6,13,7,116.7
111952800,ny,-74.08473,41.82493,1503,6,14,8,133.3
111952901,ny,-74.13887,41.87211,2035,6,13,7,116.7
111952902,ny,-74.19362,41.86708,1861,5,12,7,140
111953000,ny,-74.21728,41.76164,1169,4,10,6,150
111953300,ny,-74.09013,41.75959,1976,5,11,6,120
111953400,ny,-74.07375,41.76099,1240,5,11,6,120
111953500,ny,-74.08915,41.73477,701,5,11,6,120
111953600,ny,-73.96457,41.71783,2045,6,13,7,116.7
111953700,ny,-74.0018,41.73059,2313,4,11,7,175
111953800,ny,-73.96656,41.63013,1582,7,14,7,100
111953900,ny,-74.00076,41.63531,2225,5,12,7,140
111954000,ny,-74.08254,41.66014,1648,3,8,5,166.7
111954100,ny,-74.06253,41.6372,1866,3,8,5,166.7
111954200,ny,-74.18689,41.6949,2927,5,12,7,140
111954401,ny,-74.23978,41.62567,1035,5,12,7,140
111954402,ny,-74.32705,41.64627,2195,5,12,7,140
111954500,ny,-74.34202,41.7158,1855,2,5,3,150
111954600,ny,-74.42738,41.79926,1303,2,6,4,200
111954700,ny,-74.48239,41.72921,1376,2,5,3,150
111954800,ny,-74.39746,41.72131,1678,2,5,3,150
111954900,ny,-73.96642,42.03573,944,7,14,7,100
111955001,ny,-74.32748,41.84965,2089,3,8,5,166.7
111955002,ny,-74.25748,41.79757,1590,5,11,6,120
111955300,ny,-74.37065,42.05431,2632,1,2,1,100
111955400,ny,-74.15798,41.6158,1422,4,10,6,150
113070100,ny,-73.65144,43.29871,1299,3,8,5,166.7
113070200,ny,-73.65485,43.3077,634,3,8,5,166.7
113070300,ny,-73.65737,43.31703,1330,3,8,5,166.7
113070400,ny,-73.63894,43.3204,1452,3,8,5,166.7
113070500,ny,-73.63109,43.31127,907,3,9,6,200
113070602,ny,-73.65255,43.43215,1692,2,5,3,150
113070603,ny,-73.62423,43.34537,1488,3,8,5,166.7
113070604,ny,-73.6609,43.37352,1516,2,7,5,250
113070701,ny,-73.6637,43.33675,1593,3,7,4,133.3
113070702,ny,-73.70205,43.3333,1730,3,7,4,133.3
113070801,ny,-73.68361,43.31006,1579,3,8,5,166.7
113070802,ny,-73.68532,43.28908,1574,3,8,5,166.7
113070900,ny,-73.73197,43.32613,2155,3,7,4,133.3
113071000,ny,-73.80273,43.32631,2945,1,4,3,300
113072001,ny,-73.70671,43.4064,1789,1,4,3,300
113072002,ny,-73.73001,43.44931,1750,2,5,3,150
113073000,ny,-73.7948,43.50541,2785,1,2,1,100
113073500,ny,-74.00109,43.4674,2019,0,2,2,NA
113074000,ny,-74.05341,43.63012,3542,0,1,1,NA
113075001,ny,-73.82896,43.63752,2257,1,2,1,100
113075002,ny,-73.89169,43.72402,1769,1,2,1,100
113076000,ny,-73.62708,43.71997,4386,1,3,2,200
113078000,ny,-73.65389,43.58107,3603,2,6,4,200
115080100,ny,-73.5839,43.30108,1553,3,9,6,200
115080200,ny,-73.57833,43.30945,905,3,9,6,200
115080301,ny,-73.57286,43.31969,1010,3,8,5,166.7
115080302,ny,-73.5326,43.34959,1371,3,8,5,166.7
115081001,ny,-73.55949,43.48919,1981,2,5,3,150
115081002,ny,-73.4634,43.43802,1169,3,8,5,166.7
115082001,ny,-73.35437,43.53945,3157,3,9,6,200
115082002,ny,-73.45409,43.66793,1957,2,5,3,150
115084001,ny,-73.30999,43.4502,1909,2,5,3,150
115084002,ny,-73.30707,43.38296,1613,1,4,3,300
115085000,ny,-73.41905,43.35914,1360,1,4,3,300
115086000,ny,-73.32392,43.28165,1604,1,3,2,200
115087000,ny,-73.46985,43.23827,2430,2,5,3,150
115088001,ny,-73.57692,43.28429,907,3,9,6,200
115088002,ny,-73.55876,43.22545,1876,3,9,6,200
115089000,ny,-73.47798,43.14045,2561,2,6,4,200
115090000,ny,-73.32005,43.16336,1750,1,4,3,300
115091000,ny,-73.37781,43.08753,1562,1,5,4,400
115092000,ny,-73.32777,43.00032,1829,1,4,3,300
115093000,ny,-73.44741,43.00072,1132,2,5,3,150
115094000,ny,-73.54365,43.02215,1397,2,6,4,200
117020103,ny,-77.34031,43.25321,1140,2,6,4,200
117020104,ny,-77.27893,43.25333,1065,2,6,4,200
117020105,ny,-77.33822,43.21453,1079,2,6,4,200
117020106,ny,-77.27723,43.21686,787,2,6,4,200
117020201,ny,-77.28659,43.1627,1938,3,7,4,133.3
117020202,ny,-77.34773,43.16415,1807,2,6,4,200
117020302,ny,-77.28278,43.0801,592,3,7,4,133.3
117020401,ny,-77.19248,43.25902,1478,2,6,4,200
117020402,ny,-77.19187,43.21683,1640,2,6,4,200
117020500,ny,-77.19417,43.16302,2089,3,7,4,133.3
117020601,ny,-77.17495,43.05836,742,3,7,4,133.3
117020602,ny,-77.19628,43.09985,1011,3,7,4,133.3
117020700,ny,-77.23152,43.05543,1210,3,7,4,133.3
117020800,ny,-77.04406,43.25298,2293,4,9,5,125
117020900,ny,-77.05689,43.19681,2391,3,8,5,166.7
117021000,ny,-77.04792,43.09383,3150,3,7,4,133.3
117021100,ny,-77.10917,43.04247,1794,3,7,4,133.3
117021200,ny,-77.08324,43.03804,1546,3,7,4,133.3
117021400,ny,-76.99329,43.06426,1555,3,7,4,133.3
117021501,ny,-76.89285,43.2438,2157,4,9,5,125
117021502,ny,-76.76913,43.26963,2551,3,8,5,166.7
117021600,ny,-76.8289,43.16813,2402,3,8,5,166.7
117021700,ny,-76.83619,43.07378,2291,3,7,4,133.3
117021800,ny,-76.87071,43.08395,990,2,6,4,200
117990100,ny,-77.06315,43.45877,40,3,8,5,166.7
119000101,ny,-73.89816,40.92636,284,7,14,7,100
119000103,ny,-73.90222,40.92937,347,7,14,7,100
119000104,ny,-73.90886,40.92974,17,7,14,7,100
119000202,ny,-73.90844,40.9212,472,7,14,7,100
119000203,ny,-73.90644,40.91582,201,7,14,7,100
119000204,ny,-73.89868,40.92178,233,7,14,7,100
119000205,ny,-73.89894,40.91801,217,7,14,7,100
119000300,ny,-73.89628,40.93166,388,7,14,7,100
119000401,ny,-73.90291,40.9377,335,7,14,7,100
119000403,ny,-73.90291,40.9454,268,7,15,8,114.3
119000404,ny,-73.8961,40.94546,192,7,15,8,114.3
119000501,ny,-73.88801,40.94029,410,6,14,8,133.3
119000502,ny,-73.89157,40.93684,63,6,14,8,133.3
119000601,ny,-73.88541,40.94433,455,7,14,7,100
119000602,ny,-73.89181,40.94393,203,7,15,8,114.3
119000701,ny,-73.88884,40.96244,647,7,15,8,114.3
119000702,ny,-73.8965,40.96351,272,7,15,8,114.3
119000801,ny,-73.88113,40.96148,1069,7,14,7,100
119000802,ny,-73.87629,40.95729,783,7,14,7,100
119000803,ny,-73.88644,40.9525,885,7,14,7,100
119000900,ny,-73.87043,40.97396,949,7,14,7,100
119001000,ny,-73.88467,40.93685,250,6,13,7,116.7
119001101,ny,-73.88954,40.93382,363,6,13,7,116.7
119001102,ny,-73.88404,40.93074,641,6,13,7,116.7
119001200,ny,-73.89198,40.92746,571,6,14,8,133.3
119001301,ny,-73.8864,40.9211,986,6,13,7,116.7
119001302,ny,-73.88895,40.91224,426,6,13,7,116.7
119001304,ny,-73.89334,40.91286,250,7,14,7,100
119001305,ny,-73.89535,40.91606,266,7,14,7,100
119001401,ny,-73.87299,40.92497,1155,6,13,7,116.7
119001402,ny,-73.87565,40.91682,572,6,13,7,116.7
119001403,ny,-73.88137,40.91037,532,6,13,7,116.7
119001502,ny,-73.86195,40.90423,523,6,13,7,116.7
119001503,ny,-73.87077,40.90963,703,6,13,7,116.7
119001504,ny,-73.86207,40.91321,1123,6,13,7,116.7
119001505,ny,-73.85396,40.91095,99,6,13,7,116.7
119001600,ny,-73.87562,40.94291,902,7,14,7,100
119001701,ny,-73.86929,40.94928,945,7,14,7,100
119001702,ny,-73.85975,40.94901,877,7,14,7,100
119001800,ny,-73.86672,40.9586,596,7,14,7,100
119001900,ny,-73.86597,40.96458,677,7,14,7,100
119002000,ny,-73.85039,40.96872,1615,6,14,8,133.3
119002101,ny,-73.83483,40.97766,947,6,14,8,133.3
119002103,ny,-73.82128,40.96792,1179,6,14,8,133.3
119002104,ny,-73.83633,40.96209,1030,6,14,8,133.3
119002105,ny,-73.82183,40.9815,667,6,14,8,133.3
119002106,ny,-73.82768,40.97367,85,6,14,8,133.3
119002107,ny,-73.82907,40.96929,335,6,14,8,133.3
119002201,ny,-73.83538,40.95481,689,6,14,8,133.3
119002202,ny,-73.84169,40.94623,877,6,14,8,133.3
119002203,ny,-73.84942,40.94947,32,6,14,8,133.3
119002204,ny,-73.84563,40.93604,754,6,13,7,116.7
119002300,ny,-73.86235,40.93773,1049,6,14,8,133.3
119002401,ny,-73.85473,40.93273,244,6,13,7,116.7
119002402,ny,-73.84474,40.92679,91,6,13,7,116.7
119002403,ny,-73.85057,40.91968,1071,6,13,7,116.7
119002404,ny,-73.85566,40.92355,831,6,13,7,116.7
119002405,ny,-73.86123,40.92703,765,6,13,7,116.7
119002600,ny,-73.82767,40.89641,1186,6,13,7,116.7
119002700,ny,-73.8308,40.90251,495,6,13,7,116.7
119002800,ny,-73.83718,40.90106,431,6,13,7,116.7
119002900,ny,-73.84011,40.90583,407,6,13,7,116.7
119003000,ny,-73.84435,40.90861,468,6,13,7,116.7
119003100,ny,-73.83479,40.90828,351,6,13,7,116.7
119003200,ny,-73.83064,40.90871,382,6,13,7,116.7
119003300,ny,-73.82462,40.90645,723,6,13,7,116.7
119003400,ny,-73.81794,40.90723,883,6,13,7,116.7
119003500,ny,-73.84849,40.91134,397,6,13,7,116.7
119003600,ny,-73.84026,40.91401,489,6,13,7,116.7
119003700,ny,-73.84308,40.91907,592,6,13,7,116.7
119003800,ny,-73.8387,40.9241,186,6,13,7,116.7
119003900,ny,-73.83399,40.92155,592,6,13,7,116.7
119004001,ny,-73.8326,40.91341,162,6,13,7,116.7
119004002,ny,-73.83077,40.91585,306,6,13,7,116.7
119004100,ny,-73.82016,40.91488,521,6,13,7,116.7
119004200,ny,-73.82535,40.9213,559,6,13,7,116.7
119004500,ny,-73.8356,40.93053,182,6,13,7,116.7
119004600,ny,-73.83381,40.94123,455,6,13,7,116.7
119004700,ny,-73.82361,40.93883,1027,6,13,7,116.7
119004801,ny,-73.82532,40.95083,571,6,14,8,133.3
119004802,ny,-73.8202,40.95582,881,6,14,8,133.3
119004900,ny,-73.81203,40.98328,31,7,14,7,100
119005001,ny,-73.80158,40.97667,1295,6,13,7,116.7
119005002,ny,-73.80735,40.96751,1341,6,13,7,116.7
119005100,ny,-73.81268,40.95457,911,6,14,8,133.3
119005200,ny,-73.80885,40.94177,1652,6,13,7,116.7
119005300,ny,-73.80706,40.91613,1293,5,12,7,140
119005400,ny,-73.80771,40.90596,543,5,12,7,140
119005500,ny,-73.80579,40.89304,1651,5,12,7,140
119005600,ny,-73.77041,40.88345,2,5,11,6,120
119005702,ny,-73.77961,40.90023,248,5,11,6,120
119005703,ny,-73.79136,40.89508,426,5,11,6,120
119005704,ny,-73.78315,40.88867,182,5,11,6,120
119005800,ny,-73.78558,40.90322,530,5,12,7,140
119005901,ny,-73.77675,40.90797,424,5,12,7,140
119005902,ny,-73.76356,40.89465,983,5,11,6,120
119006000,ny,-73.77625,40.91603,639,5,12,7,140
119006100,ny,-73.79331,40.90477,509,5,12,7,140
119006200,ny,-73.79693,40.91126,848,5,12,7,140
119006301,ny,-73.79035,40.91353,372,5,12,7,140
119006302,ny,-73.78696,40.91219,277,5,12,7,140
119006400,ny,-73.79533,40.91954,930,5,12,7,140
119006500,ny,-73.77831,40.92493,1312,5,12,7,140
119006600,ny,-73.79727,40.93011,1408,5,12,7,140
119006700,ny,-73.77993,40.93993,1799,5,12,7,140
119006801,ny,-73.7849,40.97418,1963,6,13,7,116.7
119006802,ny,-73.78833,40.95342,1800,6,13,7,116.7
119006900,ny,-73.75346,40.95569,1789,5,12,7,140
119007000,ny,-73.75312,40.91014,1682,5,11,6,120
119007100,ny,-73.74101,40.91006,1846,5,11,6,120
119007200,ny,-73.72499,40.92334,1331,5,12,7,140
119007300,ny,-73.74,40.9578,1169,5,12,7,140
119007401,ny,-73.72932,40.95754,1225,5,12,7,140
119007402,ny,-73.72069,40.9479,922,5,11,6,120
119007500,ny,-73.70325,40.95502,1395,5,11,6,120
119007600,ny,-73.6692,40.94487,1943,5,11,6,120
119007700,ny,-73.68705,40.98354,1133,5,11,6,120
119007800,ny,-73.66593,40.9921,551,5,12,7,140
119007901,ny,-73.67602,40.998,429,5,12,7,140
119007902,ny,-73.67137,41.00142,445,5,12,7,140
119008000,ny,-73.66427,41.00219,727,5,12,7,140
119008100,ny,-73.66003,41.01105,845,5,12,7,140
119008200,ny,-73.6705,41.01414,1958,5,12,7,140
119008301,ny,-73.68149,41.00571,773,5,12,7,140
119008302,ny,-73.68685,41.03329,2596,5,11,6,120
119008401,ny,-73.72648,40.97605,746,5,12,7,140
119008403,ny,-73.71876,40.9705,947,5,11,6,120
119008404,ny,-73.71498,40.96537,1051,5,11,6,120
119008500,ny,-73.71005,40.99952,1308,5,12,7,140
119008602,ny,-73.72277,41.04836,1536,5,11,6,120
119008700,ny,-73.74479,41.0432,1189,5,11,6,120
119008801,ny,-73.75713,41.0353,127,5,11,6,120
119008802,ny,-73.76176,41.0351,31,5,11,6,120
119008901,ny,-73.76631,41.04276,591,5,12,7,140
119008902,ny,-73.75665,41.05286,789,5,11,6,120
119009000,ny,-73.77293,41.04165,457,5,12,7,140
119009100,ny,-73.78306,41.03027,1016,5,12,7,140
119009201,ny,-73.77801,41.02461,547,6,13,7,116.7
119009202,ny,-73.77531,41.02002,391,6,13,7,116.7
119009300,ny,-73.76988,41.02959,141,5,12,7,140
119009400,ny,-73.76196,41.02902,331,5,11,6,120
119009500,ny,-73.76484,41.02232,477,6,13,7,116.7
119009600,ny,-73.76709,41.01202,1409,6,13,7,116.7
119009701,ny,-73.75503,41.00203,1197,5,12,7,140
119009702,ny,-73.74523,41.02069,724,5,12,7,140
119009703,ny,-73.73563,41.00235,1521,5,12,7,140
119009800,ny,-73.76184,40.97914,1632,6,13,7,116.7
119009900,ny,-73.77827,40.99695,1031,6,13,7,116.7
119010000,ny,-73.7929,41.00395,1719,6,13,7,116.7
119010100,ny,-73.7984,40.98393,1529,6,13,7,116.7
119010200,ny,-73.87097,40.9908,1828,7,15,8,114.3
119010300,ny,-73.88747,40.99002,620,7,15,8,114.3
119010400,ny,-73.87924,41.01512,744,7,15,8,114.3
119010500,ny,-73.86188,41.01071,2002,7,15,8,114.3
119010600,ny,-73.83929,41.01347,1723,7,14,7,100
119010701,ny,-73.8396,40.99525,1861,7,14,7,100
119010702,ny,-73.80888,41.00089,1010,6,14,8,133.3
119010801,ny,-73.81372,41.01934,1172,6,13,7,116.7
119010803,ny,-73.79841,41.03117,425,6,13,7,116.7
119010804,ny,-73.79195,41.01984,589,6,13,7,116.7
119010901,ny,-73.79178,41.06139,378,5,12,7,140
119010902,ny,-73.78164,41.04963,1424,5,12,7,140
119010903,ny,-73.80357,41.04267,1173,6,13,7,116.7
119011000,ny,-73.81467,41.06859,712,6,13,7,116.7
119011101,ny,-73.83405,41.05469,1540,6,13,7,116.7
119011102,ny,-73.83066,41.0279,1069,6,13,7,116.7
119011200,ny,-73.81317,41.05376,1421,6,13,7,116.7
119011300,ny,-73.86599,41.03487,1617,7,15,8,114.3
119011401,ny,-73.85006,41.07526,783,7,14,7,100
119011402,ny,-73.87107,41.05598,572,7,15,8,114.3
119011500,ny,-73.87368,41.07137,796,7,15,8,114.3
119011601,ny,-73.85989,41.08402,315,7,15,8,114.3
119011602,ny,-73.88107,41.08379,440,7,15,8,114.3
119011700,ny,-73.86271,41.09943,1007,7,15,8,114.3
119011800,ny,-73.82666,41.12407,2118,5,12,7,140
119011902,ny,-73.78404,41.0832,1607,4,11,7,175
119012000,ny,-73.79443,41.10304,1709,5,11,6,120
119012101,ny,-73.7603,41.11644,2033,4,10,6,150
119012102,ny,-73.77584,41.11993,1685,5,11,6,120
119012201,ny,-73.77728,41.13986,899,5,11,6,120
119012202,ny,-73.78923,41.13514,1418,5,11,6,120
119012301,ny,-73.75905,41.07432,883,5,11,6,120
119012303,ny,-73.72209,41.12068,1948,4,10,6,150
119012304,ny,-73.65839,41.15472,1902,5,11,6,120
119012400,ny,-73.57406,41.21099,2465,6,13,7,116.7
119012501,ny,-73.65773,41.2911,1304,5,13,8,160
119012502,ny,-73.58277,41.27967,2729,5,12,7,140
119012503,ny,-73.51895,41.23265,1950,5,12,7,140
119012600,ny,-73.65078,41.25342,1740,6,13,7,116.7
119012700,ny,-73.6574,41.1991,2011,5,12,7,140
119012803,ny,-73.71902,41.24158,964,6,13,7,116.7
119012804,ny,-73.68699,41.22624,1138,6,13,7,116.7
119012900,ny,-73.72786,41.20786,591,6,13,7,116.7
119013000,ny,-73.72815,41.20035,2163,5,12,7,140
119013102,ny,-73.73994,41.16588,2046,5,11,6,120
119013103,ny,-73.8102,41.19091,1861,6,13,7,116.7
119013104,ny,-73.76176,41.19643,2100,6,13,7,116.7
119013201,ny,-73.84856,41.13567,1279,6,14,8,133.3
119013202,ny,-73.83735,41.15519,822,6,14,8,133.3
119013301,ny,-73.87805,41.15736,587,7,15,8,114.3
119013304,ny,-73.87427,41.14604,794,7,15,8,114.3
119013401,ny,-73.85805,41.15489,277,7,15,8,114.3
119013402,ny,-73.84774,41.16428,942,6,14,8,133.3
119013500,ny,-73.84373,41.17223,1113,6,14,8,133.3
119013600,ny,-73.87928,41.16868,710,7,15,8,114.3
119013700,ny,-73.84576,41.17895,1508,6,14,8,133.3
119013800,ny,-73.87959,41.19321,1244,6,13,7,116.7
119013900,ny,-73.9043,41.20208,1686,7,14,7,100
119014000,ny,-73.94673,41.26421,843,8,17,9,112.5
119014100,ny,-73.93544,41.28103,1660,6,14,8,133.3
119014200,ny,-73.92723,41.29824,765,6,14,8,133.3
119014300,ny,-73.91442,41.29166,671,6,14,8,133.3
119014400,ny,-73.90511,41.29886,1695,6,14,8,133.3
119014500,ny,-73.90975,41.28412,1659,6,14,8,133.3
119014604,ny,-73.95032,41.24702,1717,8,16,8,100
119014605,ny,-73.91405,41.22949,484,7,15,8,114.3
119014606,ny,-73.87929,41.24565,2472,6,13,7,116.7
119014607,ny,-73.8771,41.28268,1627,6,13,7,116.7
119014701,ny,-73.93168,41.31322,1947,7,14,7,100
119014703,ny,-73.87713,41.32065,2236,6,13,7,116.7
119014704,ny,-73.86767,41.30229,710,5,12,7,140
119014805,ny,-73.81797,41.2449,1879,5,12,7,140
119014806,ny,-73.80965,41.31801,2063,4,11,7,175
119014808,ny,-73.79568,41.28757,1166,4,11,7,175
119014809,ny,-73.78536,41.25367,2198,5,12,7,140
119014810,ny,-73.79653,41.32495,294,4,11,7,175
119014811,ny,-73.78713,41.31609,2020,4,11,7,175
119014812,ny,-73.836,41.31932,1578,5,11,6,120
119014813,ny,-73.85282,41.32045,1000,5,12,7,140
119014901,ny,-73.71871,41.28937,2417,6,13,7,116.7
119014903,ny,-73.70812,41.33617,621,6,13,7,116.7
119014907,ny,-73.73531,41.3337,1872,5,12,7,140
119014908,ny,-73.75912,41.31557,1120,5,12,7,140
119014909,ny,-73.68259,41.34299,527,5,13,8,160
119015000,ny,-73.60439,41.33295,2435,5,12,7,140
119015100,ny,-73.82025,40.92606,1609,6,13,7,116.7
119981000,ny,-73.81052,41.08431,91,5,12,7,140
119982000,ny,-73.86849,41.15134,10,7,15,8,114.3
119983000,ny,-73.67801,41.24183,5,6,13,7,116.7
119984000,ny,-73.9362,41.23148,24,7,15,8,114.3
119985000,ny,-73.70019,41.04636,6,5,11,6,120
121970100,ny,-78.08261,42.82913,1685,1,3,2,200
121970202,ny,-78.24879,42.82554,1908,1,3,2,200
121970300,ny,-78.39675,42.82462,2038,1,2,1,100
121970400,ny,-78.32712,42.73813,2510,0,1,1,NA
121970500,ny,-78.1321,42.73908,2291,1,2,1,100
121970600,ny,-78.01483,42.75741,2383,1,3,2,200
121970700,ny,-78.02089,42.66527,2191,1,3,2,200
121970800,ny,-78.19161,42.65214,2271,0,1,1,NA
121970900,ny,-78.38591,42.6507,1649,0,1,1,NA
121971000,ny,-78.38638,42.56329,1972,0,1,1,NA
121971100,ny,-78.17292,42.56604,1992,0,1,1,NA
123150101,ny,-76.9426,42.52176,1939,2,6,4,200
123150102,ny,-76.95579,42.66013,1721,3,8,5,166.7
123150200,ny,-77.07636,42.71196,2318,2,5,3,150
123150301,ny,-77.24918,42.715,2077,1,3,2,200
123150302,ny,-77.25556,42.62272,2182,1,3,2,200
123150400,ny,-77.11679,42.59596,2614,2,4,2,100
123150501,ny,-77.03016,42.63759,863,2,5,3,150
123150502,ny,-77.04877,42.54904,1905,1,3,2,200
